User_ID,Year,Month,Balance,Scenario,Salary,Fixed_Expenses,Variable_Expenses,Total_Expenses,Savings,Savings_Rate,Expense_Fluctuation,Risk_Category
U001,2024,1,212532.0,Salary Increases & Fixed Expenses Increase,111417,58116.0,65694,123810.0,-12393.0,-11.12,-0.04,High Risk
U001,2024,2,200139.0,Salary Increases & Fixed Expenses Increase,111417,58116.0,55524,113640.0,-2223.0,-2.0,-0.04,High Risk
U001,2024,3,197916.0,Salary Increases & Fixed Expenses Increase,118127,58116.0,70024,128140.0,-10013.0,-8.48,-0.04,High Risk
U001,2024,4,187903.0,Salary Increases & Fixed Expenses Increase,118127,58116.0,51874,109990.0,8137.0,6.89,0.01,High Risk
U001,2024,5,196040.0,Salary Increases & Fixed Expenses Increase,118127,59390.0,63632,123022.0,-4895.0,-4.14,-0.03,High Risk
U001,2024,6,191145.0,Salary Increases & Fixed Expenses Increase,118127,59390.0,55142,114532.0,3595.0,3.04,-0.05,High Risk
U001,2024,7,194740.0,Salary Increases & Fixed Expenses Increase,118127,59390.0,49728,109118.0,9009.0,7.63,0.05,High Risk
U001,2024,8,203749.0,Salary Increases & Fixed Expenses Increase,118127,59390.0,57929,117319.0,808.0,0.68,0.01,High Risk
U001,2024,9,204557.0,Salary Increases & Fixed Expenses Increase,118127,59390.0,59418,118808.0,-681.0,-0.58,-0.01,High Risk
U001,2024,10,203876.0,Salary Increases & Fixed Expenses Increase,118127,59390.0,78640,138030.0,-19903.0,-16.85,-0.01,High Risk
U001,2024,11,183973.0,Salary Increases & Fixed Expenses Increase,118127,59390.0,50313,109703.0,8424.0,7.13,0.03,High Risk
U001,2024,12,192397.0,Salary Increases & Fixed Expenses Increase,118127,59390.0,71948,131338.0,-13211.0,-11.18,-0.04,High Risk
U002,2024,1,225010.0,Stable Salary & Increasing Fixed Expenses,46356,11091.0,24994,36085.0,10271.0,22.16,0.02,Medium Risk
U002,2024,2,235281.0,Stable Salary & Increasing Fixed Expenses,46356,11855.0,19284,31139.0,15217.0,32.83,0.05,Low Risk
U002,2024,3,250498.0,Stable Salary & Increasing Fixed Expenses,46356,13225.0,20371,33596.0,12760.0,27.53,-0.02,Low Risk
U002,2024,4,263258.0,Stable Salary & Increasing Fixed Expenses,46356,14480.0,20283,34763.0,11593.0,25.01,0.02,Low Risk
U002,2024,5,274851.0,Stable Salary & Increasing Fixed Expenses,46356,14480.0,21647,36127.0,10229.0,22.07,0.01,Medium Risk
U002,2024,6,285080.0,Stable Salary & Increasing Fixed Expenses,46356,14480.0,19125,33605.0,12751.0,27.51,-0.04,Low Risk
U002,2024,7,297831.0,Stable Salary & Increasing Fixed Expenses,46356,14480.0,22768,37248.0,9108.0,19.65,-0.02,Medium Risk
U002,2024,8,306939.0,Stable Salary & Increasing Fixed Expenses,46356,14480.0,27286,41766.0,4590.0,9.9,0.04,High Risk
U002,2024,9,311529.0,Stable Salary & Increasing Fixed Expenses,46356,14480.0,23671,38151.0,8205.0,17.7,-0.03,Medium Risk
U002,2024,10,319734.0,Stable Salary & Increasing Fixed Expenses,46356,14480.0,18549,33029.0,13327.0,28.75,0.04,Low Risk
U002,2024,11,333061.0,Stable Salary & Increasing Fixed Expenses,46356,15204.0,21671,36875.0,9481.0,20.45,0.04,Medium Risk
U002,2024,12,342542.0,Stable Salary & Increasing Fixed Expenses,46356,15204.0,22348,37552.0,8804.0,18.99,-0.03,Medium Risk
U003,2024,1,200370.0,Salary Increases & Fixed Expenses Remain Stable,157379,44963.0,56218,101181.0,56198.0,35.71,-0.01,Low Risk
U003,2024,2,256568.0,Salary Increases & Fixed Expenses Remain Stable,157379,44963.0,58547,103510.0,53869.0,34.23,0.03,Low Risk
U003,2024,3,310437.0,Salary Increases & Fixed Expenses Remain Stable,157379,44963.0,68717,113680.0,43699.0,27.77,-0.03,Low Risk
U003,2024,4,354136.0,Salary Increases & Fixed Expenses Remain Stable,177461,44963.0,65856,110819.0,66642.0,37.55,0.04,Low Risk
U003,2024,5,420778.0,Salary Increases & Fixed Expenses Remain Stable,177461,44963.0,57250,102213.0,75248.0,42.4,0.01,Low Risk
U003,2024,6,496026.0,Salary Increases & Fixed Expenses Remain Stable,177461,44963.0,66077,111040.0,66421.0,37.43,0.05,Low Risk
U003,2024,7,562447.0,Salary Increases & Fixed Expenses Remain Stable,177461,44963.0,55111,100074.0,77387.0,43.61,-0.04,Low Risk
U003,2024,8,639834.0,Salary Increases & Fixed Expenses Remain Stable,177461,44963.0,61620,106583.0,70878.0,39.94,0.05,Low Risk
U003,2024,9,710712.0,Salary Increases & Fixed Expenses Remain Stable,177461,44963.0,73600,118563.0,58898.0,33.19,0.04,Low Risk
U003,2024,10,769610.0,Salary Increases & Fixed Expenses Remain Stable,177461,44963.0,81367,126330.0,51131.0,28.81,0.01,Low Risk
U003,2024,11,820741.0,Salary Increases & Fixed Expenses Remain Stable,177461,44963.0,74628,119591.0,57870.0,32.61,-0.0,Low Risk
U003,2024,12,878611.0,Salary Increases & Fixed Expenses Remain Stable,177461,44963.0,81302,126265.0,51196.0,28.85,0.03,Low Risk
U004,2024,1,241316.0,Stable Salary & Stable Fixed Expenses,254030,114393.0,174070,288463.0,-34433.0,-13.55,0.02,High Risk
U004,2024,2,206883.0,Stable Salary & Stable Fixed Expenses,254030,114393.0,183433,297826.0,-43796.0,-17.24,-0.04,High Risk
U004,2024,3,163087.0,Stable Salary & Stable Fixed Expenses,254030,114393.0,176023,290416.0,-36386.0,-14.32,-0.04,High Risk
U004,2024,4,126701.0,Stable Salary & Stable Fixed Expenses,254030,114393.0,191815,306208.0,-52178.0,-20.54,-0.03,High Risk
U004,2024,5,74523.0,Stable Salary & Stable Fixed Expenses,254030,114393.0,192822,307215.0,-53185.0,-20.94,0.04,High Risk
U004,2024,6,21338.0,Stable Salary & Stable Fixed Expenses,254030,114393.0,193902,308295.0,-54265.0,-21.36,-0.04,High Risk
U004,2024,7,-32927.0,Stable Salary & Stable Fixed Expenses,254030,114393.0,186776,301169.0,-47139.0,-18.56,0.0,High Risk
U004,2024,8,-80066.0,Stable Salary & Stable Fixed Expenses,254030,114393.0,202994,317387.0,-63357.0,-24.94,0.04,High Risk
U004,2024,9,-143423.0,Stable Salary & Stable Fixed Expenses,254030,114393.0,191822,306215.0,-52185.0,-20.54,-0.04,High Risk
U004,2024,10,-195608.0,Stable Salary & Stable Fixed Expenses,254030,114393.0,214275,328668.0,-74638.0,-29.38,0.03,High Risk
U004,2024,11,-270246.0,Stable Salary & Stable Fixed Expenses,254030,114393.0,174443,288836.0,-34806.0,-13.7,0.0,High Risk
U004,2024,12,-305052.0,Stable Salary & Stable Fixed Expenses,254030,114393.0,188646,303039.0,-49009.0,-19.29,0.05,High Risk
U005,2024,1,246846.0,Stable Salary & Increasing Fixed Expenses,290257,88900.0,214557,303457.0,-13200.0,-4.55,-0.01,High Risk
U005,2024,2,233646.0,Stable Salary & Increasing Fixed Expenses,290257,88900.0,186598,275498.0,14759.0,5.08,-0.01,High Risk
U005,2024,3,248405.0,Stable Salary & Increasing Fixed Expenses,290257,90455.0,254802,345257.0,-55000.0,-18.95,0.03,High Risk
U005,2024,4,193405.0,Stable Salary & Increasing Fixed Expenses,290257,90455.0,212073,302528.0,-12271.0,-4.23,0.03,High Risk
U005,2024,5,181134.0,Stable Salary & Increasing Fixed Expenses,290257,90455.0,220854,311309.0,-21052.0,-7.25,-0.05,High Risk
U005,2024,6,160082.0,Stable Salary & Increasing Fixed Expenses,290257,90455.0,230223,320678.0,-30421.0,-10.48,0.05,High Risk
U005,2024,7,129661.0,Stable Salary & Increasing Fixed Expenses,290257,90455.0,222586,313041.0,-22784.0,-7.85,-0.02,High Risk
U005,2024,8,106877.0,Stable Salary & Increasing Fixed Expenses,290257,90455.0,178238,268693.0,21564.0,7.43,0.01,High Risk
U005,2024,9,128441.0,Stable Salary & Increasing Fixed Expenses,290257,92161.0,178259,270420.0,19837.0,6.83,0.02,High Risk
U005,2024,10,148278.0,Stable Salary & Increasing Fixed Expenses,290257,94001.0,238452,332453.0,-42196.0,-14.54,0.05,High Risk
U005,2024,11,106082.0,Stable Salary & Increasing Fixed Expenses,290257,94001.0,204159,298160.0,-7903.0,-2.72,-0.0,High Risk
U005,2024,12,98179.0,Stable Salary & Increasing Fixed Expenses,290257,94001.0,197654,291655.0,-1398.0,-0.48,0.0,High Risk
U006,2024,1,240936.0,Salary Increases & Fixed Expenses Increase,35386,19872.0,23307,43179.0,-7793.0,-22.02,0.03,High Risk
U006,2024,2,233143.0,Salary Increases & Fixed Expenses Increase,35386,20505.0,26549,47054.0,-11668.0,-32.97,0.03,High Risk
U006,2024,3,221475.0,Salary Increases & Fixed Expenses Increase,35386,21438.0,24401,45839.0,-10453.0,-29.54,-0.04,High Risk
U006,2024,4,211022.0,Salary Increases & Fixed Expenses Increase,35386,21438.0,22847,44285.0,-8899.0,-25.15,-0.04,High Risk
U006,2024,5,202123.0,Salary Increases & Fixed Expenses Increase,57262,21438.0,35256,56694.0,568.0,0.99,-0.03,High Risk
U006,2024,6,202691.0,Salary Increases & Fixed Expenses Increase,57262,22070.0,42016,64086.0,-6824.0,-11.92,-0.01,High Risk
U006,2024,7,195867.0,Salary Increases & Fixed Expenses Increase,57262,22070.0,44529,66599.0,-9337.0,-16.31,-0.04,High Risk
U006,2024,8,186530.0,Salary Increases & Fixed Expenses Increase,57262,22070.0,36682,58752.0,-1490.0,-2.6,-0.01,High Risk
U006,2024,9,185040.0,Salary Increases & Fixed Expenses Increase,57262,22070.0,45533,67603.0,-10341.0,-18.06,-0.05,High Risk
U006,2024,10,174699.0,Salary Increases & Fixed Expenses Increase,57262,22070.0,51071,73141.0,-15879.0,-27.73,0.02,High Risk
U006,2024,11,158820.0,Salary Increases & Fixed Expenses Increase,57262,22070.0,36143,58213.0,-951.0,-1.66,0.02,High Risk
U006,2024,12,157869.0,Salary Increases & Fixed Expenses Increase,57262,22070.0,39583,61653.0,-4391.0,-7.67,0.02,High Risk
U007,2024,1,217711.0,Salary Increases & Fixed Expenses Remain Stable,184868,61538.0,108583,170121.0,14747.0,7.98,-0.04,High Risk
U007,2024,2,232458.0,Salary Increases & Fixed Expenses Remain Stable,184868,61538.0,88611,150149.0,34719.0,18.78,0.01,Medium Risk
U007,2024,3,267177.0,Salary Increases & Fixed Expenses Remain Stable,184868,61538.0,78751,140289.0,44579.0,24.11,-0.03,Medium Risk
U007,2024,4,311756.0,Salary Increases & Fixed Expenses Remain Stable,184868,61538.0,79339,140877.0,43991.0,23.8,-0.02,Medium Risk
U007,2024,5,355747.0,Salary Increases & Fixed Expenses Remain Stable,184868,61538.0,107018,168556.0,16312.0,8.82,0.03,High Risk
U007,2024,6,372059.0,Salary Increases & Fixed Expenses Remain Stable,184868,61538.0,74227,135765.0,49103.0,26.56,-0.04,Low Risk
U007,2024,7,421162.0,Salary Increases & Fixed Expenses Remain Stable,184868,61538.0,92960,154498.0,30370.0,16.43,-0.0,Medium Risk
U007,2024,8,451532.0,Salary Increases & Fixed Expenses Remain Stable,198330,61538.0,105349,166887.0,31443.0,15.85,-0.01,Medium Risk
U007,2024,9,482975.0,Salary Increases & Fixed Expenses Remain Stable,198330,61538.0,82958,144496.0,53834.0,27.14,-0.01,Low Risk
U007,2024,10,536809.0,Salary Increases & Fixed Expenses Remain Stable,198330,61538.0,102964,164502.0,33828.0,17.06,-0.02,Medium Risk
U007,2024,11,570637.0,Salary Increases & Fixed Expenses Remain Stable,198330,61538.0,112695,174233.0,24097.0,12.15,0.0,High Risk
U007,2024,12,594734.0,Salary Increases & Fixed Expenses Remain Stable,198330,61538.0,80277,141815.0,56515.0,28.5,-0.05,Low Risk
U008,2024,1,230317.0,Salary Increases & Fixed Expenses Remain Stable,255211,100773.0,189640,290413.0,-35202.0,-13.79,-0.01,High Risk
U008,2024,2,195115.0,Salary Increases & Fixed Expenses Remain Stable,255211,100773.0,178437,279210.0,-23999.0,-9.4,0.01,High Risk
U008,2024,3,171116.0,Salary Increases & Fixed Expenses Remain Stable,255211,100773.0,213751,314524.0,-59313.0,-23.24,0.03,High Risk
U008,2024,4,111803.0,Salary Increases & Fixed Expenses Remain Stable,255211,100773.0,181498,282271.0,-27060.0,-10.6,0.03,High Risk
U008,2024,5,84743.0,Salary Increases & Fixed Expenses Remain Stable,255211,100773.0,158423,259196.0,-3985.0,-1.56,-0.03,High Risk
U008,2024,6,80758.0,Salary Increases & Fixed Expenses Remain Stable,255211,100773.0,156346,257119.0,-1908.0,-0.75,0.0,High Risk
U008,2024,7,78850.0,Salary Increases & Fixed Expenses Remain Stable,255211,100773.0,162109,262882.0,-7671.0,-3.01,0.02,High Risk
U008,2024,8,71179.0,Salary Increases & Fixed Expenses Remain Stable,268142,100773.0,173224,273997.0,-5855.0,-2.18,-0.05,High Risk
U008,2024,9,65324.0,Salary Increases & Fixed Expenses Remain Stable,268142,100773.0,185126,285899.0,-17757.0,-6.62,-0.04,High Risk
U008,2024,10,47567.0,Salary Increases & Fixed Expenses Remain Stable,268142,100773.0,261064,361837.0,-93695.0,-34.94,0.02,High Risk
U008,2024,11,-46128.0,Salary Increases & Fixed Expenses Remain Stable,268142,100773.0,182854,283627.0,-15485.0,-5.77,0.02,High Risk
U008,2024,12,-61613.0,Salary Increases & Fixed Expenses Remain Stable,268142,100773.0,209901,310674.0,-42532.0,-15.86,-0.02,High Risk
U009,2024,1,228554.0,Salary Increases & Fixed Expenses Increase,221602,62967.0,134942,197909.0,23693.0,10.69,0.04,High Risk
U009,2024,2,252247.0,Salary Increases & Fixed Expenses Increase,221602,62967.0,136650,199617.0,21985.0,9.92,-0.03,High Risk
U009,2024,3,274232.0,Salary Increases & Fixed Expenses Increase,221602,64250.0,151713,215963.0,5639.0,2.54,0.04,High Risk
U009,2024,4,279871.0,Salary Increases & Fixed Expenses Increase,221602,65070.0,160479,225549.0,-3947.0,-1.78,-0.0,High Risk
U009,2024,5,275924.0,Salary Increases & Fixed Expenses Increase,221602,65070.0,169167,234237.0,-12635.0,-5.7,-0.02,High Risk
U009,2024,6,263289.0,Salary Increases & Fixed Expenses Increase,232411,65070.0,153068,218138.0,14273.0,6.14,-0.01,High Risk
U009,2024,7,277562.0,Salary Increases & Fixed Expenses Increase,232411,66633.0,160174,226807.0,5604.0,2.41,0.02,High Risk
U009,2024,8,283166.0,Salary Increases & Fixed Expenses Increase,232411,66633.0,177862,244495.0,-12084.0,-5.2,-0.02,High Risk
U009,2024,9,271082.0,Salary Increases & Fixed Expenses Increase,232411,66633.0,173686,240319.0,-7908.0,-3.4,0.01,High Risk
U009,2024,10,263174.0,Salary Increases & Fixed Expenses Increase,232411,66633.0,165314,231947.0,464.0,0.2,-0.01,High Risk
U009,2024,11,263638.0,Salary Increases & Fixed Expenses Increase,232411,66633.0,149645,216278.0,16133.0,6.94,-0.04,High Risk
U009,2024,12,279771.0,Salary Increases & Fixed Expenses Increase,232411,66633.0,147069,213702.0,18709.0,8.05,0.04,High Risk
U010,2024,1,237426.0,Stable Salary & Stable Fixed Expenses,84729,30836.0,32729,63565.0,21164.0,24.98,-0.0,Medium Risk
U010,2024,2,258590.0,Stable Salary & Stable Fixed Expenses,84729,30836.0,25582,56418.0,28311.0,33.41,-0.03,Low Risk
U010,2024,3,286901.0,Stable Salary & Stable Fixed Expenses,84729,30836.0,29026,59862.0,24867.0,29.35,-0.04,Low Risk
U010,2024,4,311768.0,Stable Salary & Stable Fixed Expenses,84729,30836.0,26448,57284.0,27445.0,32.39,0.05,Low Risk
U010,2024,5,339213.0,Stable Salary & Stable Fixed Expenses,84729,30836.0,27574,58410.0,26319.0,31.06,-0.04,Low Risk
U010,2024,6,365532.0,Stable Salary & Stable Fixed Expenses,84729,30836.0,29653,60489.0,24240.0,28.61,0.04,Low Risk
U010,2024,7,389772.0,Stable Salary & Stable Fixed Expenses,84729,30836.0,29749,60585.0,24144.0,28.5,0.03,Low Risk
U010,2024,8,413916.0,Stable Salary & Stable Fixed Expenses,84729,30836.0,32475,63311.0,21418.0,25.28,-0.02,Low Risk
U010,2024,9,435334.0,Stable Salary & Stable Fixed Expenses,84729,30836.0,32457,63293.0,21436.0,25.3,0.04,Low Risk
U010,2024,10,456770.0,Stable Salary & Stable Fixed Expenses,84729,30836.0,30555,61391.0,23338.0,27.54,-0.01,Low Risk
U010,2024,11,480108.0,Stable Salary & Stable Fixed Expenses,84729,30836.0,30484,61320.0,23409.0,27.63,-0.05,Low Risk
U010,2024,12,503517.0,Stable Salary & Stable Fixed Expenses,84729,30836.0,32845,63681.0,21048.0,24.84,-0.01,Medium Risk
U011,2024,1,229052.0,Salary Increases & Fixed Expenses Decrease,86566,31533.0,40902,72435.0,14131.0,16.32,0.0,Medium Risk
U011,2024,2,243183.0,Salary Increases & Fixed Expenses Decrease,86566,31533.0,44875,76408.0,10158.0,11.73,0.04,High Risk
U011,2024,3,253341.0,Salary Increases & Fixed Expenses Decrease,86566,31533.0,42418,73951.0,12615.0,14.57,0.03,High Risk
U011,2024,4,265956.0,Salary Increases & Fixed Expenses Decrease,86566,31533.0,44398,75931.0,10635.0,12.29,-0.02,High Risk
U011,2024,5,276591.0,Salary Increases & Fixed Expenses Decrease,86566,31533.0,47880,79413.0,7153.0,8.26,-0.04,High Risk
U011,2024,6,283744.0,Salary Increases & Fixed Expenses Decrease,86566,31533.0,36627,68160.0,18406.0,21.26,-0.01,Medium Risk
U011,2024,7,302150.0,Salary Increases & Fixed Expenses Decrease,108217,31533.0,62931,94464.0,13753.0,12.71,0.01,High Risk
U011,2024,8,315903.0,Salary Increases & Fixed Expenses Decrease,108217,31533.0,59053,90586.0,17631.0,16.29,0.01,Medium Risk
U011,2024,9,333534.0,Salary Increases & Fixed Expenses Decrease,108217,31533.0,59724,91257.0,16960.0,15.67,0.03,Medium Risk
U011,2024,10,350494.0,Salary Increases & Fixed Expenses Decrease,108217,31533.0,60742,92275.0,15942.0,14.73,-0.04,High Risk
U011,2024,11,366436.0,Salary Increases & Fixed Expenses Decrease,108217,31533.0,51115,82648.0,25569.0,23.63,0.01,Medium Risk
U011,2024,12,392005.0,Salary Increases & Fixed Expenses Decrease,108217,31533.0,58113,89646.0,18571.0,17.16,0.02,Medium Risk
U012,2024,1,247699.0,Salary Increases & Fixed Expenses Decrease,286082,80795.0,136499,217294.0,68788.0,24.04,-0.0,Medium Risk
U012,2024,2,316487.0,Salary Increases & Fixed Expenses Decrease,286082,80795.0,143925,224720.0,61362.0,21.45,-0.03,Medium Risk
U012,2024,3,377849.0,Salary Increases & Fixed Expenses Decrease,286082,80795.0,147727,228522.0,57560.0,20.12,-0.04,Medium Risk
U012,2024,4,435409.0,Salary Increases & Fixed Expenses Decrease,286082,80795.0,146050,226845.0,59237.0,20.71,-0.03,Medium Risk
U012,2024,5,494646.0,Salary Increases & Fixed Expenses Decrease,286082,80795.0,128772,209567.0,76515.0,26.75,0.04,Low Risk
U012,2024,6,571161.0,Salary Increases & Fixed Expenses Decrease,296081,80795.0,166530,247325.0,48756.0,16.47,-0.03,Medium Risk
U012,2024,7,619917.0,Salary Increases & Fixed Expenses Decrease,296081,80795.0,128146,208941.0,87140.0,29.43,-0.01,Low Risk
U012,2024,8,707057.0,Salary Increases & Fixed Expenses Decrease,296081,80795.0,165559,246354.0,49727.0,16.8,0.02,Medium Risk
U012,2024,9,756784.0,Salary Increases & Fixed Expenses Decrease,296081,80795.0,142581,223376.0,72705.0,24.56,0.05,Medium Risk
U012,2024,10,829489.0,Salary Increases & Fixed Expenses Decrease,296081,80795.0,193998,274793.0,21288.0,7.19,0.03,High Risk
U012,2024,11,850777.0,Salary Increases & Fixed Expenses Decrease,296081,79382.0,151007,230389.0,65692.0,22.19,0.03,Medium Risk
U012,2024,12,916469.0,Salary Increases & Fixed Expenses Decrease,296081,79382.0,180588,259970.0,36111.0,12.2,0.02,High Risk
U013,2024,1,213767.0,Stable Salary & Stable Fixed Expenses,142083,78565.0,47885,126450.0,15633.0,11.0,-0.03,High Risk
U013,2024,2,229400.0,Stable Salary & Stable Fixed Expenses,142083,78565.0,48709,127274.0,14809.0,10.42,-0.02,High Risk
U013,2024,3,244209.0,Stable Salary & Stable Fixed Expenses,142083,78565.0,69615,148180.0,-6097.0,-4.29,0.01,High Risk
U013,2024,4,238112.0,Stable Salary & Stable Fixed Expenses,142083,78565.0,53740,132305.0,9778.0,6.88,-0.02,High Risk
U013,2024,5,247890.0,Stable Salary & Stable Fixed Expenses,142083,78565.0,45139,123704.0,18379.0,12.94,0.0,High Risk
U013,2024,6,266269.0,Stable Salary & Stable Fixed Expenses,142083,78565.0,43212,121777.0,20306.0,14.29,-0.02,High Risk
U013,2024,7,286575.0,Stable Salary & Stable Fixed Expenses,142083,78565.0,42758,121323.0,20760.0,14.61,0.05,High Risk
U013,2024,8,307335.0,Stable Salary & Stable Fixed Expenses,142083,78565.0,55589,134154.0,7929.0,5.58,0.05,High Risk
U013,2024,9,315264.0,Stable Salary & Stable Fixed Expenses,142083,78565.0,52326,130891.0,11192.0,7.88,0.03,High Risk
U013,2024,10,326456.0,Stable Salary & Stable Fixed Expenses,142083,78565.0,51238,129803.0,12280.0,8.64,0.02,High Risk
U013,2024,11,338736.0,Stable Salary & Stable Fixed Expenses,142083,78565.0,57002,135567.0,6516.0,4.59,-0.03,High Risk
U013,2024,12,345252.0,Stable Salary & Stable Fixed Expenses,142083,78565.0,56864,135429.0,6654.0,4.68,-0.04,High Risk
U014,2024,1,222146.0,Salary Increases & Fixed Expenses Remain Stable,230745,102984.0,71575,174559.0,56186.0,24.35,-0.01,Medium Risk
U014,2024,2,278332.0,Salary Increases & Fixed Expenses Remain Stable,230745,102984.0,86671,189655.0,41090.0,17.81,-0.05,Medium Risk
U014,2024,3,319422.0,Salary Increases & Fixed Expenses Remain Stable,230745,102984.0,86882,189866.0,40879.0,17.72,-0.0,Medium Risk
U014,2024,4,360301.0,Salary Increases & Fixed Expenses Remain Stable,230745,102984.0,77937,180921.0,49824.0,21.59,-0.0,Medium Risk
U014,2024,5,410125.0,Salary Increases & Fixed Expenses Remain Stable,230745,102984.0,91913,194897.0,35848.0,15.54,0.0,Medium Risk
U014,2024,6,445973.0,Salary Increases & Fixed Expenses Remain Stable,230745,102984.0,72892,175876.0,54869.0,23.78,-0.03,Medium Risk
U014,2024,7,500842.0,Salary Increases & Fixed Expenses Remain Stable,230745,102984.0,78961,181945.0,48800.0,21.15,-0.02,Medium Risk
U014,2024,8,549642.0,Salary Increases & Fixed Expenses Remain Stable,246534,102984.0,81478,184462.0,62072.0,25.18,0.02,Low Risk
U014,2024,9,611714.0,Salary Increases & Fixed Expenses Remain Stable,246534,102984.0,98129,201113.0,45421.0,18.42,0.05,Medium Risk
U014,2024,10,657135.0,Salary Increases & Fixed Expenses Remain Stable,246534,102984.0,87763,190747.0,55787.0,22.63,0.01,Medium Risk
U014,2024,11,712922.0,Salary Increases & Fixed Expenses Remain Stable,246534,102984.0,99537,202521.0,44013.0,17.85,0.03,Medium Risk
U014,2024,12,756935.0,Salary Increases & Fixed Expenses Remain Stable,246534,102984.0,113356,216340.0,30194.0,12.25,-0.01,High Risk
U015,2024,1,239101.0,Stable Salary & Stable Fixed Expenses,158393,67820.0,94753,162573.0,-4180.0,-2.64,-0.04,High Risk
U015,2024,2,234921.0,Stable Salary & Stable Fixed Expenses,158393,67820.0,68902,136722.0,21671.0,13.68,-0.03,High Risk
U015,2024,3,256592.0,Stable Salary & Stable Fixed Expenses,158393,67820.0,106587,174407.0,-16014.0,-10.11,0.02,High Risk
U015,2024,4,240578.0,Stable Salary & Stable Fixed Expenses,158393,67820.0,77324,145144.0,13249.0,8.36,-0.02,High Risk
U015,2024,5,253827.0,Stable Salary & Stable Fixed Expenses,158393,67820.0,78819,146639.0,11754.0,7.42,-0.04,High Risk
U015,2024,6,265581.0,Stable Salary & Stable Fixed Expenses,158393,67820.0,75779,143599.0,14794.0,9.34,-0.02,High Risk
U015,2024,7,280375.0,Stable Salary & Stable Fixed Expenses,158393,67820.0,78714,146534.0,11859.0,7.49,0.02,High Risk
U015,2024,8,292234.0,Stable Salary & Stable Fixed Expenses,158393,67820.0,87932,155752.0,2641.0,1.67,0.04,High Risk
U015,2024,9,294875.0,Stable Salary & Stable Fixed Expenses,158393,67820.0,95799,163619.0,-5226.0,-3.3,0.0,High Risk
U015,2024,10,289649.0,Stable Salary & Stable Fixed Expenses,158393,67820.0,94466,162286.0,-3893.0,-2.46,0.0,High Risk
U015,2024,11,285756.0,Stable Salary & Stable Fixed Expenses,158393,67820.0,91455,159275.0,-882.0,-0.56,0.0,High Risk
U015,2024,12,284874.0,Stable Salary & Stable Fixed Expenses,158393,67820.0,91730,159550.0,-1157.0,-0.73,0.0,High Risk
U016,2024,1,247949.0,Salary Increases & Fixed Expenses Remain Stable,84018,29746.0,59949,89695.0,-5677.0,-6.76,0.02,High Risk
U016,2024,2,242272.0,Salary Increases & Fixed Expenses Remain Stable,84018,29746.0,59277,89023.0,-5005.0,-5.96,-0.02,High Risk
U016,2024,3,237267.0,Salary Increases & Fixed Expenses Remain Stable,84018,29746.0,53477,83223.0,795.0,0.95,0.0,High Risk
U016,2024,4,238062.0,Salary Increases & Fixed Expenses Remain Stable,98297,29746.0,64808,94554.0,3743.0,3.81,0.04,High Risk
U016,2024,5,241805.0,Salary Increases & Fixed Expenses Remain Stable,98297,29746.0,69381,99127.0,-830.0,-0.84,0.01,High Risk
U016,2024,6,240975.0,Salary Increases & Fixed Expenses Remain Stable,98297,29746.0,74801,104547.0,-6250.0,-6.36,-0.01,High Risk
U016,2024,7,234725.0,Salary Increases & Fixed Expenses Remain Stable,98297,29746.0,71183,100929.0,-2632.0,-2.68,-0.02,High Risk
U016,2024,8,232093.0,Salary Increases & Fixed Expenses Remain Stable,98297,29746.0,77275,107021.0,-8724.0,-8.88,-0.0,High Risk
U016,2024,9,223369.0,Salary Increases & Fixed Expenses Remain Stable,98297,29746.0,75355,105101.0,-6804.0,-6.92,0.02,High Risk
U016,2024,10,216565.0,Salary Increases & Fixed Expenses Remain Stable,98297,29746.0,78554,108300.0,-10003.0,-10.18,-0.03,High Risk
U016,2024,11,206562.0,Salary Increases & Fixed Expenses Remain Stable,98297,29746.0,68914,98660.0,-363.0,-0.37,0.03,High Risk
U016,2024,12,206199.0,Salary Increases & Fixed Expenses Remain Stable,98297,29746.0,71188,100934.0,-2637.0,-2.68,-0.03,High Risk
U017,2024,1,242745.0,Salary Increases & Fixed Expenses Increase,255908,107508.0,188648,296156.0,-40248.0,-15.73,0.04,High Risk
U017,2024,2,202497.0,Salary Increases & Fixed Expenses Increase,255908,107508.0,159381,266889.0,-10981.0,-4.29,0.05,High Risk
U017,2024,3,191516.0,Salary Increases & Fixed Expenses Increase,269174,107508.0,181431,288939.0,-19765.0,-7.34,-0.03,High Risk
U017,2024,4,171751.0,Salary Increases & Fixed Expenses Increase,269174,107508.0,173889,281397.0,-12223.0,-4.54,0.01,High Risk
U017,2024,5,159528.0,Salary Increases & Fixed Expenses Increase,269174,107508.0,170942,278450.0,-9276.0,-3.45,0.04,High Risk
U017,2024,6,150252.0,Salary Increases & Fixed Expenses Increase,269174,107508.0,163059,270567.0,-1393.0,-0.52,0.05,High Risk
U017,2024,7,148859.0,Salary Increases & Fixed Expenses Increase,269174,107508.0,183954,291462.0,-22288.0,-8.28,-0.04,High Risk
U017,2024,8,126571.0,Salary Increases & Fixed Expenses Increase,269174,107508.0,179058,286566.0,-17392.0,-6.46,0.03,High Risk
U017,2024,9,109179.0,Salary Increases & Fixed Expenses Increase,269174,107508.0,209229,316737.0,-47563.0,-17.67,0.02,High Risk
U017,2024,10,61616.0,Salary Increases & Fixed Expenses Increase,269174,107508.0,198681,306189.0,-37015.0,-13.75,0.04,High Risk
U017,2024,11,24601.0,Salary Increases & Fixed Expenses Increase,269174,107508.0,193325,300833.0,-31659.0,-11.76,0.01,High Risk
U017,2024,12,-7058.0,Salary Increases & Fixed Expenses Increase,269174,108626.0,165028,273654.0,-4480.0,-1.66,0.03,High Risk
U018,2024,1,239581.0,Salary Increases & Fixed Expenses Increase,180488,50013.0,71801,121814.0,58674.0,32.51,-0.03,Low Risk
U018,2024,2,298255.0,Salary Increases & Fixed Expenses Increase,180488,50013.0,66947,116960.0,63528.0,35.2,0.03,Low Risk
U018,2024,3,361783.0,Salary Increases & Fixed Expenses Increase,199834,50013.0,100174,150187.0,49647.0,24.84,0.03,Medium Risk
U018,2024,4,411430.0,Salary Increases & Fixed Expenses Increase,199834,51352.0,69054,120406.0,79428.0,39.75,-0.03,Low Risk
U018,2024,5,490858.0,Salary Increases & Fixed Expenses Increase,199834,51352.0,73433,124785.0,75049.0,37.56,-0.01,Low Risk
U018,2024,6,565907.0,Salary Increases & Fixed Expenses Increase,199834,52443.0,67931,120374.0,79460.0,39.76,-0.05,Low Risk
U018,2024,7,645367.0,Salary Increases & Fixed Expenses Increase,199834,53755.0,72447,126202.0,73632.0,36.85,0.03,Low Risk
U018,2024,8,718999.0,Salary Increases & Fixed Expenses Increase,199834,53755.0,71135,124890.0,74944.0,37.5,0.04,Low Risk
U018,2024,9,793943.0,Salary Increases & Fixed Expenses Increase,199834,53755.0,73864,127619.0,72215.0,36.14,0.02,Low Risk
U018,2024,10,866158.0,Salary Increases & Fixed Expenses Increase,199834,53755.0,90599,144354.0,55480.0,27.76,-0.01,Low Risk
U018,2024,11,921638.0,Salary Increases & Fixed Expenses Increase,199834,53755.0,63843,117598.0,82236.0,41.15,-0.02,Low Risk
U018,2024,12,1003874.0,Salary Increases & Fixed Expenses Increase,199834,55361.0,62055,117416.0,82418.0,41.24,0.04,Low Risk
U019,2024,1,244547.0,Stable Salary & Stable Fixed Expenses,44745,20489.0,20746,41235.0,3510.0,7.84,-0.05,High Risk
U019,2024,2,248057.0,Stable Salary & Stable Fixed Expenses,44745,20489.0,21484,41973.0,2772.0,6.2,-0.01,High Risk
U019,2024,3,250829.0,Stable Salary & Stable Fixed Expenses,44745,20489.0,30797,51286.0,-6541.0,-14.62,0.02,High Risk
U019,2024,4,244288.0,Stable Salary & Stable Fixed Expenses,44745,20489.0,21532,42021.0,2724.0,6.09,-0.0,High Risk
U019,2024,5,247012.0,Stable Salary & Stable Fixed Expenses,44745,20489.0,21808,42297.0,2448.0,5.47,0.05,High Risk
U019,2024,6,249460.0,Stable Salary & Stable Fixed Expenses,44745,20489.0,20678,41167.0,3578.0,8.0,0.01,High Risk
U019,2024,7,253038.0,Stable Salary & Stable Fixed Expenses,44745,20489.0,23326,43815.0,930.0,2.08,0.01,High Risk
U019,2024,8,253968.0,Stable Salary & Stable Fixed Expenses,44745,20489.0,23740,44229.0,516.0,1.15,-0.04,High Risk
U019,2024,9,254484.0,Stable Salary & Stable Fixed Expenses,44745,20489.0,22978,43467.0,1278.0,2.86,0.04,High Risk
U019,2024,10,255762.0,Stable Salary & Stable Fixed Expenses,44745,20489.0,24804,45293.0,-548.0,-1.22,-0.01,High Risk
U019,2024,11,255214.0,Stable Salary & Stable Fixed Expenses,44745,20489.0,25598,46087.0,-1342.0,-3.0,0.03,High Risk
U019,2024,12,253872.0,Stable Salary & Stable Fixed Expenses,44745,20489.0,24992,45481.0,-736.0,-1.64,0.01,High Risk
U020,2024,1,206102.0,Salary Increases & Fixed Expenses Remain Stable,243328,106624.0,136420,243044.0,284.0,0.12,-0.01,High Risk
U020,2024,2,206386.0,Salary Increases & Fixed Expenses Remain Stable,243328,106624.0,139875,246499.0,-3171.0,-1.3,-0.05,High Risk
U020,2024,3,203215.0,Salary Increases & Fixed Expenses Remain Stable,243328,106624.0,114512,221136.0,22192.0,9.12,0.01,High Risk
U020,2024,4,225407.0,Salary Increases & Fixed Expenses Remain Stable,243328,106624.0,133015,239639.0,3689.0,1.52,-0.04,High Risk
U020,2024,5,229096.0,Salary Increases & Fixed Expenses Remain Stable,250805,106624.0,103771,210395.0,40410.0,16.11,0.04,Medium Risk
U020,2024,6,269506.0,Salary Increases & Fixed Expenses Remain Stable,250805,106624.0,104659,211283.0,39522.0,15.76,0.04,Medium Risk
U020,2024,7,309028.0,Salary Increases & Fixed Expenses Remain Stable,250805,106624.0,129479,236103.0,14702.0,5.86,0.04,High Risk
U020,2024,8,323730.0,Salary Increases & Fixed Expenses Remain Stable,250805,106624.0,124849,231473.0,19332.0,7.71,-0.02,High Risk
U020,2024,9,343062.0,Salary Increases & Fixed Expenses Remain Stable,250805,106624.0,116578,223202.0,27603.0,11.01,-0.04,High Risk
U020,2024,10,370665.0,Salary Increases & Fixed Expenses Remain Stable,250805,106624.0,112564,219188.0,31617.0,12.61,0.03,High Risk
U020,2024,11,402282.0,Salary Increases & Fixed Expenses Remain Stable,250805,106624.0,128322,234946.0,15859.0,6.32,-0.01,High Risk
U020,2024,12,418141.0,Salary Increases & Fixed Expenses Remain Stable,250805,106624.0,133607,240231.0,10574.0,4.22,0.01,High Risk
U021,2024,1,213900.0,Salary Increases & Fixed Expenses Decrease,269948,97681.0,166618,264299.0,5649.0,2.09,0.02,High Risk
U021,2024,2,219549.0,Salary Increases & Fixed Expenses Decrease,269948,97681.0,166869,264550.0,5398.0,2.0,-0.05,High Risk
U021,2024,3,224947.0,Salary Increases & Fixed Expenses Decrease,269948,97681.0,244719,342400.0,-72452.0,-26.84,0.0,High Risk
U021,2024,4,152495.0,Salary Increases & Fixed Expenses Decrease,269948,97681.0,208707,306388.0,-36440.0,-13.5,0.03,High Risk
U021,2024,5,116055.0,Salary Increases & Fixed Expenses Decrease,269948,97681.0,190243,287924.0,-17976.0,-6.66,0.02,High Risk
U021,2024,6,98079.0,Salary Increases & Fixed Expenses Decrease,269948,97681.0,191469,289150.0,-19202.0,-7.11,0.02,High Risk
U021,2024,7,78877.0,Salary Increases & Fixed Expenses Decrease,286507,97681.0,172210,269891.0,16616.0,5.8,-0.03,High Risk
U021,2024,8,95493.0,Salary Increases & Fixed Expenses Decrease,286507,97681.0,221427,319108.0,-32601.0,-11.38,-0.01,High Risk
U021,2024,9,62892.0,Salary Increases & Fixed Expenses Decrease,286507,97681.0,199374,297055.0,-10548.0,-3.68,0.03,High Risk
U021,2024,10,52344.0,Salary Increases & Fixed Expenses Decrease,286507,97681.0,233789,331470.0,-44963.0,-15.69,-0.01,High Risk
U021,2024,11,7381.0,Salary Increases & Fixed Expenses Decrease,286507,96220.0,203314,299534.0,-13027.0,-4.55,-0.04,High Risk
U021,2024,12,-5646.0,Salary Increases & Fixed Expenses Decrease,286507,96220.0,222649,318869.0,-32362.0,-11.3,0.01,High Risk
U022,2024,1,222203.0,Stable Salary & Increasing Fixed Expenses,107226,50023.0,59810,109833.0,-2607.0,-2.43,-0.0,High Risk
U022,2024,2,219596.0,Stable Salary & Increasing Fixed Expenses,107226,51722.0,42971,94693.0,12533.0,11.69,0.02,High Risk
U022,2024,3,232129.0,Stable Salary & Increasing Fixed Expenses,107226,51722.0,60416,112138.0,-4912.0,-4.58,0.05,High Risk
U022,2024,4,227217.0,Stable Salary & Increasing Fixed Expenses,107226,53528.0,53863,107391.0,-165.0,-0.15,-0.03,High Risk
U022,2024,5,227052.0,Stable Salary & Increasing Fixed Expenses,107226,53528.0,64291,117819.0,-10593.0,-9.88,-0.02,High Risk
U022,2024,6,216459.0,Stable Salary & Increasing Fixed Expenses,107226,53528.0,56605,110133.0,-2907.0,-2.71,0.01,High Risk
U022,2024,7,213552.0,Stable Salary & Increasing Fixed Expenses,107226,53528.0,43694,97222.0,10004.0,9.33,-0.02,High Risk
U022,2024,8,223556.0,Stable Salary & Increasing Fixed Expenses,107226,53528.0,51379,104907.0,2319.0,2.16,-0.04,High Risk
U022,2024,9,225875.0,Stable Salary & Increasing Fixed Expenses,107226,53528.0,59609,113137.0,-5911.0,-5.51,0.03,High Risk
U022,2024,10,219964.0,Stable Salary & Increasing Fixed Expenses,107226,53528.0,51407,104935.0,2291.0,2.14,0.04,High Risk
U022,2024,11,222255.0,Stable Salary & Increasing Fixed Expenses,107226,55429.0,64951,120380.0,-13154.0,-12.27,-0.01,High Risk
U022,2024,12,209101.0,Stable Salary & Increasing Fixed Expenses,107226,55429.0,79128,134557.0,-27331.0,-25.49,-0.03,High Risk
U023,2024,1,240305.0,Stable Salary & Increasing Fixed Expenses,32743,18531.0,22235,40766.0,-8023.0,-24.5,-0.01,High Risk
U023,2024,2,232282.0,Stable Salary & Increasing Fixed Expenses,32743,18531.0,20959,39490.0,-6747.0,-20.61,-0.04,High Risk
U023,2024,3,225535.0,Stable Salary & Increasing Fixed Expenses,32743,18531.0,25121,43652.0,-10909.0,-33.32,-0.02,High Risk
U023,2024,4,214626.0,Stable Salary & Increasing Fixed Expenses,32743,19951.0,25750,45701.0,-12958.0,-39.57,-0.02,High Risk
U023,2024,5,201668.0,Stable Salary & Increasing Fixed Expenses,32743,19951.0,23923,43874.0,-11131.0,-34.0,0.03,High Risk
U023,2024,6,190537.0,Stable Salary & Increasing Fixed Expenses,32743,19951.0,22628,42579.0,-9836.0,-30.04,-0.05,High Risk
U023,2024,7,180701.0,Stable Salary & Increasing Fixed Expenses,32743,19951.0,20864,40815.0,-8072.0,-24.65,-0.03,High Risk
U023,2024,8,172629.0,Stable Salary & Increasing Fixed Expenses,32743,19951.0,23003,42954.0,-10211.0,-31.19,0.02,High Risk
U023,2024,9,162418.0,Stable Salary & Increasing Fixed Expenses,32743,19951.0,21193,41144.0,-8401.0,-25.66,0.03,High Risk
U023,2024,10,154017.0,Stable Salary & Increasing Fixed Expenses,32743,19951.0,24526,44477.0,-11734.0,-35.84,-0.0,High Risk
U023,2024,11,142283.0,Stable Salary & Increasing Fixed Expenses,32743,19951.0,25596,45547.0,-12804.0,-39.1,0.05,High Risk
U023,2024,12,129479.0,Stable Salary & Increasing Fixed Expenses,32743,19951.0,24022,43973.0,-11230.0,-34.3,-0.0,High Risk
U024,2024,1,213233.0,Stable Salary & Increasing Fixed Expenses,289109,77995.0,205539,283534.0,5575.0,1.93,0.04,High Risk
U024,2024,2,218808.0,Stable Salary & Increasing Fixed Expenses,289109,77995.0,214323,292318.0,-3209.0,-1.11,-0.01,High Risk
U024,2024,3,215599.0,Stable Salary & Increasing Fixed Expenses,289109,77995.0,212964,290959.0,-1850.0,-0.64,0.0,High Risk
U024,2024,4,213749.0,Stable Salary & Increasing Fixed Expenses,289109,77995.0,178337,256332.0,32777.0,11.34,-0.03,High Risk
U024,2024,5,246526.0,Stable Salary & Increasing Fixed Expenses,289109,77995.0,178556,256551.0,32558.0,11.26,0.02,High Risk
U024,2024,6,279084.0,Stable Salary & Increasing Fixed Expenses,289109,79893.0,193716,273609.0,15500.0,5.36,0.04,High Risk
U024,2024,7,294584.0,Stable Salary & Increasing Fixed Expenses,289109,80627.0,199340,279967.0,9142.0,3.16,-0.04,High Risk
U024,2024,8,303726.0,Stable Salary & Increasing Fixed Expenses,289109,80627.0,197410,278037.0,11072.0,3.83,-0.03,High Risk
U024,2024,9,314798.0,Stable Salary & Increasing Fixed Expenses,289109,80627.0,182925,263552.0,25557.0,8.84,0.0,High Risk
U024,2024,10,340355.0,Stable Salary & Increasing Fixed Expenses,289109,80627.0,202004,282631.0,6478.0,2.24,-0.01,High Risk
U024,2024,11,346833.0,Stable Salary & Increasing Fixed Expenses,289109,80627.0,206422,287049.0,2060.0,0.71,0.0,High Risk
U024,2024,12,348893.0,Stable Salary & Increasing Fixed Expenses,289109,81991.0,198637,280628.0,8481.0,2.93,0.02,High Risk
U025,2024,1,247826.0,Salary Increases & Fixed Expenses Increase,21482,22423.0,6726,29149.0,-7667.0,-35.69,0.05,High Risk
U025,2024,2,240159.0,Salary Increases & Fixed Expenses Increase,21482,22423.0,8242,30665.0,-9183.0,-42.75,0.05,High Risk
U025,2024,3,230976.0,Salary Increases & Fixed Expenses Increase,21482,22423.0,8604,31027.0,-9545.0,-44.43,-0.01,High Risk
U025,2024,4,221431.0,Salary Increases & Fixed Expenses Increase,21482,22423.0,6934,29357.0,-7875.0,-36.66,0.05,High Risk
U025,2024,5,213556.0,Salary Increases & Fixed Expenses Increase,28196,22423.0,9243,31666.0,-3470.0,-12.31,0.04,High Risk
U025,2024,6,210086.0,Salary Increases & Fixed Expenses Increase,28196,22423.0,8888,31311.0,-3115.0,-11.05,0.0,High Risk
U025,2024,7,206971.0,Salary Increases & Fixed Expenses Increase,28196,22423.0,10972,33395.0,-5199.0,-18.44,-0.05,High Risk
U025,2024,8,201772.0,Salary Increases & Fixed Expenses Increase,28196,22999.0,11205,34204.0,-6008.0,-21.31,-0.02,High Risk
U025,2024,9,195764.0,Salary Increases & Fixed Expenses Increase,28196,22999.0,9470,32469.0,-4273.0,-15.15,0.01,High Risk
U025,2024,10,191491.0,Salary Increases & Fixed Expenses Increase,28196,22999.0,10753,33752.0,-5556.0,-19.7,0.01,High Risk
U025,2024,11,185935.0,Salary Increases & Fixed Expenses Increase,28196,24909.0,9263,34172.0,-5976.0,-21.19,0.03,High Risk
U025,2024,12,179959.0,Salary Increases & Fixed Expenses Increase,28196,26868.0,10405,37273.0,-9077.0,-32.19,0.04,High Risk
U026,2024,1,202823.0,Salary Increases & Fixed Expenses Increase,119379,47645.0,92318,139963.0,-20584.0,-17.24,0.04,High Risk
U026,2024,2,182239.0,Salary Increases & Fixed Expenses Increase,119379,47645.0,88542,136187.0,-16808.0,-14.08,0.03,High Risk
U026,2024,3,165431.0,Salary Increases & Fixed Expenses Increase,119379,47645.0,96426,144071.0,-24692.0,-20.68,-0.04,High Risk
U026,2024,4,140739.0,Salary Increases & Fixed Expenses Increase,119379,47645.0,72985,120630.0,-1251.0,-1.05,-0.03,High Risk
U026,2024,5,139488.0,Salary Increases & Fixed Expenses Increase,119379,47645.0,79788,127433.0,-8054.0,-6.75,-0.04,High Risk
U026,2024,6,131434.0,Salary Increases & Fixed Expenses Increase,119379,47645.0,83049,130694.0,-11315.0,-9.48,0.0,High Risk
U026,2024,7,120119.0,Salary Increases & Fixed Expenses Increase,144063,47645.0,105230,152875.0,-8812.0,-6.12,-0.0,High Risk
U026,2024,8,111307.0,Salary Increases & Fixed Expenses Increase,144063,47645.0,113313,160958.0,-16895.0,-11.73,0.04,High Risk
U026,2024,9,94412.0,Salary Increases & Fixed Expenses Increase,144063,47645.0,98446,146091.0,-2028.0,-1.41,0.02,High Risk
U026,2024,10,92384.0,Salary Increases & Fixed Expenses Increase,144063,47645.0,134657,182302.0,-38239.0,-26.54,0.04,High Risk
U026,2024,11,54145.0,Salary Increases & Fixed Expenses Increase,144063,47645.0,121151,168796.0,-24733.0,-17.17,-0.0,High Risk
U026,2024,12,29412.0,Salary Increases & Fixed Expenses Increase,144063,47645.0,132907,180552.0,-36489.0,-25.33,0.02,High Risk
U027,2024,1,203493.0,Stable Salary & Stable Fixed Expenses,215774,80734.0,102295,183029.0,32745.0,15.18,-0.01,Medium Risk
U027,2024,2,236238.0,Stable Salary & Stable Fixed Expenses,215774,80734.0,105726,186460.0,29314.0,13.59,-0.03,High Risk
U027,2024,3,265552.0,Stable Salary & Stable Fixed Expenses,215774,80734.0,90388,171122.0,44652.0,20.69,0.02,Medium Risk
U027,2024,4,310204.0,Stable Salary & Stable Fixed Expenses,215774,80734.0,91269,172003.0,43771.0,20.29,0.02,Medium Risk
U027,2024,5,353975.0,Stable Salary & Stable Fixed Expenses,215774,80734.0,88898,169632.0,46142.0,21.38,0.04,Medium Risk
U027,2024,6,400117.0,Stable Salary & Stable Fixed Expenses,215774,80734.0,95542,176276.0,39498.0,18.31,-0.01,Medium Risk
U027,2024,7,439615.0,Stable Salary & Stable Fixed Expenses,215774,80734.0,109801,190535.0,25239.0,11.7,-0.02,High Risk
U027,2024,8,464854.0,Stable Salary & Stable Fixed Expenses,215774,80734.0,106541,187275.0,28499.0,13.21,0.04,High Risk
U027,2024,9,493353.0,Stable Salary & Stable Fixed Expenses,215774,80734.0,112127,192861.0,22913.0,10.62,-0.03,High Risk
U027,2024,10,516266.0,Stable Salary & Stable Fixed Expenses,215774,80734.0,126875,207609.0,8165.0,3.78,0.0,High Risk
U027,2024,11,524431.0,Stable Salary & Stable Fixed Expenses,215774,80734.0,89620,170354.0,45420.0,21.05,-0.04,Medium Risk
U027,2024,12,569851.0,Stable Salary & Stable Fixed Expenses,215774,80734.0,91416,172150.0,43624.0,20.22,0.0,Medium Risk
U028,2024,1,247514.0,Salary Increases & Fixed Expenses Remain Stable,234480,78120.0,135491,213611.0,20869.0,8.9,-0.03,High Risk
U028,2024,2,268383.0,Salary Increases & Fixed Expenses Remain Stable,234480,78120.0,130201,208321.0,26159.0,11.16,0.04,High Risk
U028,2024,3,294542.0,Salary Increases & Fixed Expenses Remain Stable,234480,78120.0,102040,180160.0,54320.0,23.17,-0.03,Medium Risk
U028,2024,4,348862.0,Salary Increases & Fixed Expenses Remain Stable,234480,78120.0,112534,190654.0,43826.0,18.69,-0.01,Medium Risk
U028,2024,5,392688.0,Salary Increases & Fixed Expenses Remain Stable,234480,78120.0,113920,192040.0,42440.0,18.1,0.04,Medium Risk
U028,2024,6,435128.0,Salary Increases & Fixed Expenses Remain Stable,263554,78120.0,129981,208101.0,55453.0,21.04,-0.05,Medium Risk
U028,2024,7,490581.0,Salary Increases & Fixed Expenses Remain Stable,263554,78120.0,118483,196603.0,66951.0,25.4,0.03,Low Risk
U028,2024,8,557532.0,Salary Increases & Fixed Expenses Remain Stable,263554,78120.0,130227,208347.0,55207.0,20.95,-0.03,Medium Risk
U028,2024,9,612739.0,Salary Increases & Fixed Expenses Remain Stable,263554,78120.0,151363,229483.0,34071.0,12.93,-0.04,High Risk
U028,2024,10,646810.0,Salary Increases & Fixed Expenses Remain Stable,263554,78120.0,133594,211714.0,51840.0,19.67,-0.04,Medium Risk
U028,2024,11,698650.0,Salary Increases & Fixed Expenses Remain Stable,263554,78120.0,108704,186824.0,76730.0,29.11,-0.03,Low Risk
U028,2024,12,775380.0,Salary Increases & Fixed Expenses Remain Stable,263554,78120.0,122004,200124.0,63430.0,24.07,-0.01,Medium Risk
U029,2024,1,233438.0,Stable Salary & Stable Fixed Expenses,238105,103926.0,92276,196202.0,41903.0,17.6,0.04,Medium Risk
U029,2024,2,275341.0,Stable Salary & Stable Fixed Expenses,238105,103926.0,80806,184732.0,53373.0,22.42,0.02,Medium Risk
U029,2024,3,328714.0,Stable Salary & Stable Fixed Expenses,238105,103926.0,86473,190399.0,47706.0,20.04,0.03,Medium Risk
U029,2024,4,376420.0,Stable Salary & Stable Fixed Expenses,238105,103926.0,76835,180761.0,57344.0,24.08,-0.04,Medium Risk
U029,2024,5,433764.0,Stable Salary & Stable Fixed Expenses,238105,103926.0,82909,186835.0,51270.0,21.53,-0.02,Medium Risk
U029,2024,6,485034.0,Stable Salary & Stable Fixed Expenses,238105,103926.0,90248,194174.0,43931.0,18.45,-0.03,Medium Risk
U029,2024,7,528965.0,Stable Salary & Stable Fixed Expenses,238105,103926.0,93506,197432.0,40673.0,17.08,0.0,Medium Risk
U029,2024,8,569638.0,Stable Salary & Stable Fixed Expenses,238105,103926.0,92702,196628.0,41477.0,17.42,-0.02,Medium Risk
U029,2024,9,611115.0,Stable Salary & Stable Fixed Expenses,238105,103926.0,79452,183378.0,54727.0,22.98,0.0,Medium Risk
U029,2024,10,665842.0,Stable Salary & Stable Fixed Expenses,238105,103926.0,116062,219988.0,18117.0,7.61,-0.03,High Risk
U029,2024,11,683959.0,Stable Salary & Stable Fixed Expenses,238105,103926.0,75378,179304.0,58801.0,24.7,-0.03,Medium Risk
U029,2024,12,742760.0,Stable Salary & Stable Fixed Expenses,238105,103926.0,76012,179938.0,58167.0,24.43,-0.01,Medium Risk
U030,2024,1,204204.0,Stable Salary & Stable Fixed Expenses,293348,74532.0,150933,225465.0,67883.0,23.14,-0.02,Medium Risk
U030,2024,2,272087.0,Stable Salary & Stable Fixed Expenses,293348,74532.0,171039,245571.0,47777.0,16.29,-0.05,Medium Risk
U030,2024,3,319864.0,Stable Salary & Stable Fixed Expenses,293348,74532.0,134022,208554.0,84794.0,28.91,0.01,Low Risk
U030,2024,4,404658.0,Stable Salary & Stable Fixed Expenses,293348,74532.0,134228,208760.0,84588.0,28.84,-0.02,Low Risk
U030,2024,5,489246.0,Stable Salary & Stable Fixed Expenses,293348,74532.0,159363,233895.0,59453.0,20.27,0.03,Medium Risk
U030,2024,6,548699.0,Stable Salary & Stable Fixed Expenses,293348,74532.0,174863,249395.0,43953.0,14.98,0.03,High Risk
U030,2024,7,592652.0,Stable Salary & Stable Fixed Expenses,293348,74532.0,124313,198845.0,94503.0,32.22,0.04,Low Risk
U030,2024,8,687155.0,Stable Salary & Stable Fixed Expenses,293348,74532.0,160004,234536.0,58812.0,20.05,0.03,Medium Risk
U030,2024,9,745967.0,Stable Salary & Stable Fixed Expenses,293348,74532.0,159310,233842.0,59506.0,20.29,0.02,Medium Risk
U030,2024,10,805473.0,Stable Salary & Stable Fixed Expenses,293348,74532.0,132250,206782.0,86566.0,29.51,-0.02,Low Risk
U030,2024,11,892039.0,Stable Salary & Stable Fixed Expenses,293348,74532.0,120041,194573.0,98775.0,33.67,0.02,Low Risk
U030,2024,12,990814.0,Stable Salary & Stable Fixed Expenses,293348,74532.0,146757,221289.0,72059.0,24.56,-0.04,Medium Risk
U031,2024,1,247572.0,Salary Increases & Fixed Expenses Increase,275234,96690.0,109159,205849.0,69385.0,25.21,-0.04,Low Risk
U031,2024,2,316957.0,Salary Increases & Fixed Expenses Increase,275234,96690.0,107698,204388.0,70846.0,25.74,0.04,Low Risk
U031,2024,3,387803.0,Salary Increases & Fixed Expenses Increase,275234,96690.0,115127,211817.0,63417.0,23.04,0.02,Medium Risk
U031,2024,4,451220.0,Salary Increases & Fixed Expenses Increase,275234,96690.0,101668,198358.0,76876.0,27.93,0.05,Low Risk
U031,2024,5,528096.0,Salary Increases & Fixed Expenses Increase,275234,96690.0,85532,182222.0,93012.0,33.79,0.01,Low Risk
U031,2024,6,621108.0,Salary Increases & Fixed Expenses Increase,275234,96690.0,84275,180965.0,94269.0,34.25,-0.03,Low Risk
U031,2024,7,715377.0,Salary Increases & Fixed Expenses Increase,300557,96690.0,116130,212820.0,87737.0,29.19,0.03,Low Risk
U031,2024,8,803114.0,Salary Increases & Fixed Expenses Increase,300557,96690.0,108474,205164.0,95393.0,31.74,-0.01,Low Risk
U031,2024,9,898507.0,Salary Increases & Fixed Expenses Increase,300557,97374.0,106521,203895.0,96662.0,32.16,-0.02,Low Risk
U031,2024,10,995169.0,Salary Increases & Fixed Expenses Increase,300557,98837.0,132228,231065.0,69492.0,23.12,0.05,Medium Risk
U031,2024,11,1064661.0,Salary Increases & Fixed Expenses Increase,300557,100130.0,115680,215810.0,84747.0,28.2,0.04,Low Risk
U031,2024,12,1149408.0,Salary Increases & Fixed Expenses Increase,300557,100130.0,118643,218773.0,81784.0,27.21,-0.05,Low Risk
U032,2024,1,239452.0,Stable Salary & Decreasing Fixed Expenses,157799,45562.0,78554,124116.0,33683.0,21.35,-0.03,Medium Risk
U032,2024,2,273135.0,Stable Salary & Decreasing Fixed Expenses,157799,45562.0,72043,117605.0,40194.0,25.47,0.02,Low Risk
U032,2024,3,313329.0,Stable Salary & Decreasing Fixed Expenses,157799,45562.0,88431,133993.0,23806.0,15.09,-0.02,Medium Risk
U032,2024,4,337135.0,Stable Salary & Decreasing Fixed Expenses,157799,45562.0,69093,114655.0,43144.0,27.34,-0.02,Low Risk
U032,2024,5,380279.0,Stable Salary & Decreasing Fixed Expenses,157799,45562.0,80543,126105.0,31694.0,20.09,-0.03,Medium Risk
U032,2024,6,411973.0,Stable Salary & Decreasing Fixed Expenses,157799,45562.0,65848,111410.0,46389.0,29.4,-0.04,Low Risk
U032,2024,7,458362.0,Stable Salary & Decreasing Fixed Expenses,157799,45562.0,80089,125651.0,32148.0,20.37,0.04,Medium Risk
U032,2024,8,490510.0,Stable Salary & Decreasing Fixed Expenses,157799,45562.0,64595,110157.0,47642.0,30.19,-0.04,Low Risk
U032,2024,9,538152.0,Stable Salary & Decreasing Fixed Expenses,157799,45562.0,64864,110426.0,47373.0,30.02,-0.04,Low Risk
U032,2024,10,585525.0,Stable Salary & Decreasing Fixed Expenses,157799,45562.0,79596,125158.0,32641.0,20.69,0.0,Medium Risk
U032,2024,11,618166.0,Stable Salary & Decreasing Fixed Expenses,157799,45562.0,69155,114717.0,43082.0,27.3,-0.05,Low Risk
U032,2024,12,661248.0,Stable Salary & Decreasing Fixed Expenses,157799,45562.0,70872,116434.0,41365.0,26.21,0.03,Low Risk
U033,2024,1,244316.0,Salary Increases & Fixed Expenses Remain Stable,90067,33421.0,62182,95603.0,-5536.0,-6.15,-0.02,High Risk
U033,2024,2,238780.0,Salary Increases & Fixed Expenses Remain Stable,90067,33421.0,59244,92665.0,-2598.0,-2.88,0.01,High Risk
U033,2024,3,236182.0,Salary Increases & Fixed Expenses Remain Stable,90067,33421.0,81280,114701.0,-24634.0,-27.35,0.05,High Risk
U033,2024,4,211548.0,Salary Increases & Fixed Expenses Remain Stable,95741,33421.0,58422,91843.0,3898.0,4.07,0.01,High Risk
U033,2024,5,215446.0,Salary Increases & Fixed Expenses Remain Stable,95741,33421.0,71641,105062.0,-9321.0,-9.74,-0.04,High Risk
U033,2024,6,206125.0,Salary Increases & Fixed Expenses Remain Stable,95741,33421.0,65055,98476.0,-2735.0,-2.86,0.05,High Risk
U033,2024,7,203390.0,Salary Increases & Fixed Expenses Remain Stable,95741,33421.0,70426,103847.0,-8106.0,-8.47,0.02,High Risk
U033,2024,8,195284.0,Salary Increases & Fixed Expenses Remain Stable,95741,33421.0,74724,108145.0,-12404.0,-12.96,0.01,High Risk
U033,2024,9,182880.0,Salary Increases & Fixed Expenses Remain Stable,95741,33421.0,73236,106657.0,-10916.0,-11.4,-0.03,High Risk
U033,2024,10,171964.0,Salary Increases & Fixed Expenses Remain Stable,95741,33421.0,70877,104298.0,-8557.0,-8.94,-0.03,High Risk
U033,2024,11,163407.0,Salary Increases & Fixed Expenses Remain Stable,95741,33421.0,70840,104261.0,-8520.0,-8.9,-0.05,High Risk
U033,2024,12,154887.0,Salary Increases & Fixed Expenses Remain Stable,95741,33421.0,61018,94439.0,1302.0,1.36,-0.01,High Risk
U034,2024,1,202826.0,Salary Increases & Fixed Expenses Remain Stable,65314,26098.0,49399,75497.0,-10183.0,-15.59,0.03,High Risk
U034,2024,2,192643.0,Salary Increases & Fixed Expenses Remain Stable,65314,26098.0,49653,75751.0,-10437.0,-15.98,-0.05,High Risk
U034,2024,3,182206.0,Salary Increases & Fixed Expenses Remain Stable,65314,26098.0,49912,76010.0,-10696.0,-16.38,-0.03,High Risk
U034,2024,4,171510.0,Salary Increases & Fixed Expenses Remain Stable,65314,26098.0,45490,71588.0,-6274.0,-9.61,-0.04,High Risk
U034,2024,5,165236.0,Salary Increases & Fixed Expenses Remain Stable,65314,26098.0,47385,73483.0,-8169.0,-12.51,0.01,High Risk
U034,2024,6,157067.0,Salary Increases & Fixed Expenses Remain Stable,65314,26098.0,40341,66439.0,-1125.0,-1.72,-0.05,High Risk
U034,2024,7,155942.0,Salary Increases & Fixed Expenses Remain Stable,65314,26098.0,51669,77767.0,-12453.0,-19.07,-0.0,High Risk
U034,2024,8,143489.0,Salary Increases & Fixed Expenses Remain Stable,92734,26098.0,61846,87944.0,4790.0,5.17,0.02,High Risk
U034,2024,9,148279.0,Salary Increases & Fixed Expenses Remain Stable,92734,26098.0,61867,87965.0,4769.0,5.14,-0.05,High Risk
U034,2024,10,153048.0,Salary Increases & Fixed Expenses Remain Stable,92734,26098.0,93320,119418.0,-26684.0,-28.77,-0.03,High Risk
U034,2024,11,126364.0,Salary Increases & Fixed Expenses Remain Stable,92734,26098.0,68201,94299.0,-1565.0,-1.69,0.04,High Risk
U034,2024,12,124799.0,Salary Increases & Fixed Expenses Remain Stable,92734,26098.0,58589,84687.0,8047.0,8.68,-0.0,High Risk
U035,2024,1,206625.0,Stable Salary & Increasing Fixed Expenses,225307,60853.0,99568,160421.0,64886.0,28.8,-0.04,Low Risk
U035,2024,2,271511.0,Stable Salary & Increasing Fixed Expenses,225307,60853.0,110320,171173.0,54134.0,24.03,0.05,Medium Risk
U035,2024,3,325645.0,Stable Salary & Increasing Fixed Expenses,225307,62404.0,136097,198501.0,26806.0,11.9,-0.02,High Risk
U035,2024,4,352451.0,Stable Salary & Increasing Fixed Expenses,225307,62404.0,118802,181206.0,44101.0,19.57,-0.0,Medium Risk
U035,2024,5,396552.0,Stable Salary & Increasing Fixed Expenses,225307,62404.0,98448,160852.0,64455.0,28.61,0.03,Low Risk
U035,2024,6,461007.0,Stable Salary & Increasing Fixed Expenses,225307,62404.0,97438,159842.0,65465.0,29.06,0.0,Low Risk
U035,2024,7,526472.0,Stable Salary & Increasing Fixed Expenses,225307,63047.0,108709,171756.0,53551.0,23.77,-0.01,Medium Risk
U035,2024,8,580023.0,Stable Salary & Increasing Fixed Expenses,225307,63047.0,116949,179996.0,45311.0,20.11,-0.01,Medium Risk
U035,2024,9,625334.0,Stable Salary & Increasing Fixed Expenses,225307,63047.0,108511,171558.0,53749.0,23.86,0.0,Medium Risk
U035,2024,10,679083.0,Stable Salary & Increasing Fixed Expenses,225307,63047.0,126528,189575.0,35732.0,15.86,0.04,Medium Risk
U035,2024,11,714815.0,Stable Salary & Increasing Fixed Expenses,225307,63047.0,110882,173929.0,51378.0,22.8,-0.0,Medium Risk
U035,2024,12,766193.0,Stable Salary & Increasing Fixed Expenses,225307,63047.0,122378,185425.0,39882.0,17.7,-0.03,Medium Risk
U036,2024,1,236816.0,Stable Salary & Stable Fixed Expenses,201516,81749.0,60836,142585.0,58931.0,29.24,-0.04,Low Risk
U036,2024,2,295747.0,Stable Salary & Stable Fixed Expenses,201516,81749.0,73739,155488.0,46028.0,22.84,0.01,Medium Risk
U036,2024,3,341775.0,Stable Salary & Stable Fixed Expenses,201516,81749.0,97342,179091.0,22425.0,11.13,0.02,High Risk
U036,2024,4,364200.0,Stable Salary & Stable Fixed Expenses,201516,81749.0,65359,147108.0,54408.0,27.0,-0.03,Low Risk
U036,2024,5,418608.0,Stable Salary & Stable Fixed Expenses,201516,81749.0,80291,162040.0,39476.0,19.59,0.04,Medium Risk
U036,2024,6,458084.0,Stable Salary & Stable Fixed Expenses,201516,81749.0,70150,151899.0,49617.0,24.62,0.05,Medium Risk
U036,2024,7,507701.0,Stable Salary & Stable Fixed Expenses,201516,81749.0,62349,144098.0,57418.0,28.49,0.01,Low Risk
U036,2024,8,565119.0,Stable Salary & Stable Fixed Expenses,201516,81749.0,70664,152413.0,49103.0,24.37,-0.03,Medium Risk
U036,2024,9,614222.0,Stable Salary & Stable Fixed Expenses,201516,81749.0,76603,158352.0,43164.0,21.42,0.0,Medium Risk
U036,2024,10,657386.0,Stable Salary & Stable Fixed Expenses,201516,81749.0,86123,167872.0,33644.0,16.7,0.03,Medium Risk
U036,2024,11,691030.0,Stable Salary & Stable Fixed Expenses,201516,81749.0,60928,142677.0,58839.0,29.2,-0.01,Low Risk
U036,2024,12,749869.0,Stable Salary & Stable Fixed Expenses,201516,81749.0,77837,159586.0,41930.0,20.81,0.05,Medium Risk
U037,2024,1,232599.0,Salary Increases & Fixed Expenses Remain Stable,260267,101383.0,90869,192252.0,68015.0,26.13,0.02,Low Risk
U037,2024,2,300614.0,Salary Increases & Fixed Expenses Remain Stable,260267,101383.0,84940,186323.0,73944.0,28.41,-0.02,Low Risk
U037,2024,3,374558.0,Salary Increases & Fixed Expenses Remain Stable,260267,101383.0,111637,213020.0,47247.0,18.15,0.01,Medium Risk
U037,2024,4,421805.0,Salary Increases & Fixed Expenses Remain Stable,260267,101383.0,85714,187097.0,73170.0,28.11,0.02,Low Risk
U037,2024,5,494975.0,Salary Increases & Fixed Expenses Remain Stable,279418,101383.0,104692,206075.0,73343.0,26.25,-0.04,Low Risk
U037,2024,6,568318.0,Salary Increases & Fixed Expenses Remain Stable,279418,101383.0,96951,198334.0,81084.0,29.02,0.01,Low Risk
U037,2024,7,649402.0,Salary Increases & Fixed Expenses Remain Stable,279418,101383.0,111587,212970.0,66448.0,23.78,-0.01,Medium Risk
U037,2024,8,715850.0,Salary Increases & Fixed Expenses Remain Stable,279418,101383.0,88022,189405.0,90013.0,32.21,-0.03,Low Risk
U037,2024,9,805863.0,Salary Increases & Fixed Expenses Remain Stable,279418,101383.0,93510,194893.0,84525.0,30.25,-0.0,Low Risk
U037,2024,10,890388.0,Salary Increases & Fixed Expenses Remain Stable,279418,101383.0,117410,218793.0,60625.0,21.7,0.02,Medium Risk
U037,2024,11,951013.0,Salary Increases & Fixed Expenses Remain Stable,279418,101383.0,104993,206376.0,73042.0,26.14,-0.04,Low Risk
U037,2024,12,1024055.0,Salary Increases & Fixed Expenses Remain Stable,279418,101383.0,84378,185761.0,93657.0,33.52,-0.01,Low Risk
U038,2024,1,206223.0,Salary Increases & Fixed Expenses Increase,194824,69632.0,85577,155209.0,39615.0,20.33,0.05,Medium Risk
U038,2024,2,245838.0,Salary Increases & Fixed Expenses Increase,194824,69632.0,92794,162426.0,32398.0,16.63,-0.02,Medium Risk
U038,2024,3,278236.0,Salary Increases & Fixed Expenses Increase,194824,69632.0,127282,196914.0,-2090.0,-1.07,-0.04,High Risk
U038,2024,4,276146.0,Salary Increases & Fixed Expenses Increase,194824,69632.0,83334,152966.0,41858.0,21.49,-0.02,Medium Risk
U038,2024,5,318004.0,Salary Increases & Fixed Expenses Increase,194824,69632.0,92360,161992.0,32832.0,16.85,0.04,Medium Risk
U038,2024,6,350836.0,Salary Increases & Fixed Expenses Increase,194824,69632.0,87028,156660.0,38164.0,19.59,0.05,Medium Risk
U038,2024,7,389000.0,Salary Increases & Fixed Expenses Increase,194824,69632.0,87268,156900.0,37924.0,19.47,0.02,Medium Risk
U038,2024,8,426924.0,Salary Increases & Fixed Expenses Increase,222130,70819.0,103463,174282.0,47848.0,21.54,-0.04,Medium Risk
U038,2024,9,474772.0,Salary Increases & Fixed Expenses Increase,222130,70819.0,132961,203780.0,18350.0,8.26,0.02,High Risk
U038,2024,10,493122.0,Salary Increases & Fixed Expenses Increase,222130,70819.0,143334,214153.0,7977.0,3.59,0.01,High Risk
U038,2024,11,501099.0,Salary Increases & Fixed Expenses Increase,222130,70819.0,96612,167431.0,54699.0,24.62,0.03,Medium Risk
U038,2024,12,555798.0,Salary Increases & Fixed Expenses Increase,222130,70819.0,120378,191197.0,30933.0,13.93,-0.03,High Risk
U039,2024,1,239051.0,Salary Increases & Fixed Expenses Decrease,120664,75584.0,91963,167547.0,-46883.0,-38.85,0.01,High Risk
U039,2024,2,192168.0,Salary Increases & Fixed Expenses Decrease,120664,75584.0,80513,156097.0,-35433.0,-29.37,-0.03,High Risk
U039,2024,3,156735.0,Salary Increases & Fixed Expenses Decrease,120664,75584.0,93303,168887.0,-48223.0,-39.96,0.0,High Risk
U039,2024,4,108512.0,Salary Increases & Fixed Expenses Decrease,120664,75584.0,94197,169781.0,-49117.0,-40.71,-0.01,High Risk
U039,2024,5,59395.0,Salary Increases & Fixed Expenses Decrease,139009,75584.0,108503,184087.0,-45078.0,-32.43,0.05,High Risk
U039,2024,6,14317.0,Salary Increases & Fixed Expenses Decrease,139009,75584.0,87107,162691.0,-23682.0,-17.04,0.02,High Risk
U039,2024,7,-9365.0,Salary Increases & Fixed Expenses Decrease,139009,75584.0,92942,168526.0,-29517.0,-21.23,0.05,High Risk
U039,2024,8,-38882.0,Salary Increases & Fixed Expenses Decrease,139009,75584.0,87453,163037.0,-24028.0,-17.29,0.01,High Risk
U039,2024,9,-62910.0,Salary Increases & Fixed Expenses Decrease,139009,75584.0,102310,177894.0,-38885.0,-27.97,-0.01,High Risk
U039,2024,10,-101795.0,Salary Increases & Fixed Expenses Decrease,139009,75584.0,113039,188623.0,-49614.0,-35.69,-0.01,High Risk
U039,2024,11,-151409.0,Salary Increases & Fixed Expenses Decrease,139009,74654.0,107698,182352.0,-43343.0,-31.18,0.03,High Risk
U039,2024,12,-194752.0,Salary Increases & Fixed Expenses Decrease,139009,74654.0,91148,165802.0,-26793.0,-19.27,-0.02,High Risk
U040,2024,1,248480.0,Salary Increases & Fixed Expenses Increase,133889,51157.0,92096,143253.0,-9364.0,-6.99,-0.03,High Risk
U040,2024,2,239116.0,Salary Increases & Fixed Expenses Increase,133889,51157.0,105519,156676.0,-22787.0,-17.02,0.0,High Risk
U040,2024,3,216329.0,Salary Increases & Fixed Expenses Increase,133889,52877.0,102086,154963.0,-21074.0,-15.74,0.04,High Risk
U040,2024,4,195255.0,Salary Increases & Fixed Expenses Increase,155563,54798.0,117778,172576.0,-17013.0,-10.94,-0.03,High Risk
U040,2024,5,178242.0,Salary Increases & Fixed Expenses Increase,155563,54798.0,105068,159866.0,-4303.0,-2.77,-0.04,High Risk
U040,2024,6,173939.0,Salary Increases & Fixed Expenses Increase,155563,54798.0,108935,163733.0,-8170.0,-5.25,-0.04,High Risk
U040,2024,7,165769.0,Salary Increases & Fixed Expenses Increase,155563,54798.0,117186,171984.0,-16421.0,-10.56,-0.02,High Risk
U040,2024,8,149348.0,Salary Increases & Fixed Expenses Increase,155563,56573.0,113768,170341.0,-14778.0,-9.5,-0.03,High Risk
U040,2024,9,134570.0,Salary Increases & Fixed Expenses Increase,155563,56573.0,117924,174497.0,-18934.0,-12.17,0.04,High Risk
U040,2024,10,115636.0,Salary Increases & Fixed Expenses Increase,155563,56573.0,101669,158242.0,-2679.0,-1.72,0.04,High Risk
U040,2024,11,112957.0,Salary Increases & Fixed Expenses Increase,155563,56573.0,105305,161878.0,-6315.0,-4.06,0.04,High Risk
U040,2024,12,106642.0,Salary Increases & Fixed Expenses Increase,155563,56573.0,119252,175825.0,-20262.0,-13.02,0.03,High Risk
U041,2024,1,216721.0,Stable Salary & Stable Fixed Expenses,160889,40461.0,49146,89607.0,71282.0,44.31,0.05,Low Risk
U041,2024,2,288003.0,Stable Salary & Stable Fixed Expenses,160889,40461.0,62678,103139.0,57750.0,35.89,-0.03,Low Risk
U041,2024,3,345753.0,Stable Salary & Stable Fixed Expenses,160889,40461.0,73145,113606.0,47283.0,29.39,0.04,Low Risk
U041,2024,4,393036.0,Stable Salary & Stable Fixed Expenses,160889,40461.0,51804,92265.0,68624.0,42.65,-0.03,Low Risk
U041,2024,5,461660.0,Stable Salary & Stable Fixed Expenses,160889,40461.0,53305,93766.0,67123.0,41.72,-0.02,Low Risk
U041,2024,6,528783.0,Stable Salary & Stable Fixed Expenses,160889,40461.0,58207,98668.0,62221.0,38.67,-0.02,Low Risk
U041,2024,7,591004.0,Stable Salary & Stable Fixed Expenses,160889,40461.0,48575,89036.0,71853.0,44.66,-0.0,Low Risk
U041,2024,8,662857.0,Stable Salary & Stable Fixed Expenses,160889,40461.0,62330,102791.0,58098.0,36.11,0.04,Low Risk
U041,2024,9,720955.0,Stable Salary & Stable Fixed Expenses,160889,40461.0,51664,92125.0,68764.0,42.74,0.03,Low Risk
U041,2024,10,789719.0,Stable Salary & Stable Fixed Expenses,160889,40461.0,58818,99279.0,61610.0,38.29,0.0,Low Risk
U041,2024,11,851329.0,Stable Salary & Stable Fixed Expenses,160889,40461.0,55978,96439.0,64450.0,40.06,-0.0,Low Risk
U041,2024,12,915779.0,Stable Salary & Stable Fixed Expenses,160889,40461.0,59592,100053.0,60836.0,37.81,0.01,Low Risk
U042,2024,1,207882.0,Stable Salary & Stable Fixed Expenses,139247,74809.0,68935,143744.0,-4497.0,-3.23,-0.0,High Risk
U042,2024,2,203385.0,Stable Salary & Stable Fixed Expenses,139247,74809.0,60589,135398.0,3849.0,2.76,-0.02,High Risk
U042,2024,3,207234.0,Stable Salary & Stable Fixed Expenses,139247,74809.0,66722,141531.0,-2284.0,-1.64,-0.03,High Risk
U042,2024,4,204950.0,Stable Salary & Stable Fixed Expenses,139247,74809.0,73837,148646.0,-9399.0,-6.75,-0.01,High Risk
U042,2024,5,195551.0,Stable Salary & Stable Fixed Expenses,139247,74809.0,69878,144687.0,-5440.0,-3.91,0.01,High Risk
U042,2024,6,190111.0,Stable Salary & Stable Fixed Expenses,139247,74809.0,77191,152000.0,-12753.0,-9.16,0.05,High Risk
U042,2024,7,177358.0,Stable Salary & Stable Fixed Expenses,139247,74809.0,80219,155028.0,-15781.0,-11.33,0.0,High Risk
U042,2024,8,161577.0,Stable Salary & Stable Fixed Expenses,139247,74809.0,81692,156501.0,-17254.0,-12.39,0.0,High Risk
U042,2024,9,144323.0,Stable Salary & Stable Fixed Expenses,139247,74809.0,77008,151817.0,-12570.0,-9.03,-0.01,High Risk
U042,2024,10,131753.0,Stable Salary & Stable Fixed Expenses,139247,74809.0,74280,149089.0,-9842.0,-7.07,-0.04,High Risk
U042,2024,11,121911.0,Stable Salary & Stable Fixed Expenses,139247,74809.0,68530,143339.0,-4092.0,-2.94,-0.01,High Risk
U042,2024,12,117819.0,Stable Salary & Stable Fixed Expenses,139247,74809.0,62286,137095.0,2152.0,1.55,0.0,High Risk
U043,2024,1,208424.0,Salary Increases & Fixed Expenses Remain Stable,225873,115314.0,76628,191942.0,33931.0,15.02,0.03,Medium Risk
U043,2024,2,242355.0,Salary Increases & Fixed Expenses Remain Stable,225873,115314.0,75561,190875.0,34998.0,15.49,0.05,Medium Risk
U043,2024,3,277353.0,Salary Increases & Fixed Expenses Remain Stable,225873,115314.0,100445,215759.0,10114.0,4.48,-0.02,High Risk
U043,2024,4,287467.0,Salary Increases & Fixed Expenses Remain Stable,232485,115314.0,88488,203802.0,28683.0,12.34,0.02,High Risk
U043,2024,5,316150.0,Salary Increases & Fixed Expenses Remain Stable,232485,115314.0,86644,201958.0,30527.0,13.13,-0.03,High Risk
U043,2024,6,346677.0,Salary Increases & Fixed Expenses Remain Stable,232485,115314.0,73297,188611.0,43874.0,18.87,-0.01,Medium Risk
U043,2024,7,390551.0,Salary Increases & Fixed Expenses Remain Stable,232485,115314.0,79799,195113.0,37372.0,16.08,0.04,Medium Risk
U043,2024,8,427923.0,Salary Increases & Fixed Expenses Remain Stable,232485,115314.0,78028,193342.0,39143.0,16.84,0.03,Medium Risk
U043,2024,9,467066.0,Salary Increases & Fixed Expenses Remain Stable,232485,115314.0,84205,199519.0,32966.0,14.18,0.03,High Risk
U043,2024,10,500032.0,Salary Increases & Fixed Expenses Remain Stable,232485,115314.0,107665,222979.0,9506.0,4.09,-0.03,High Risk
U043,2024,11,509538.0,Salary Increases & Fixed Expenses Remain Stable,232485,115314.0,81042,196356.0,36129.0,15.54,0.01,Medium Risk
U043,2024,12,545667.0,Salary Increases & Fixed Expenses Remain Stable,232485,115314.0,91939,207253.0,25232.0,10.85,-0.02,High Risk
U044,2024,1,213831.0,Salary Increases & Fixed Expenses Decrease,295989,108374.0,95534,203908.0,92081.0,31.11,0.05,Low Risk
U044,2024,2,305912.0,Salary Increases & Fixed Expenses Decrease,295989,108374.0,90600,198974.0,97015.0,32.78,-0.02,Low Risk
U044,2024,3,402927.0,Salary Increases & Fixed Expenses Decrease,295989,108374.0,100263,208637.0,87352.0,29.51,-0.02,Low Risk
U044,2024,4,490279.0,Salary Increases & Fixed Expenses Decrease,295989,108374.0,100422,208796.0,87193.0,29.46,-0.03,Low Risk
U044,2024,5,577472.0,Salary Increases & Fixed Expenses Decrease,295989,108374.0,101453,209827.0,86162.0,29.11,0.0,Low Risk
U044,2024,6,663634.0,Salary Increases & Fixed Expenses Decrease,295989,108374.0,96171,204545.0,91444.0,30.89,0.01,Low Risk
U044,2024,7,755078.0,Salary Increases & Fixed Expenses Decrease,295989,108374.0,112765,221139.0,74850.0,25.29,-0.01,Low Risk
U044,2024,8,829928.0,Salary Increases & Fixed Expenses Decrease,325237,108374.0,127684,236058.0,89179.0,27.42,-0.01,Low Risk
U044,2024,9,919107.0,Salary Increases & Fixed Expenses Decrease,325237,108374.0,126604,234978.0,90259.0,27.75,-0.03,Low Risk
U044,2024,10,1009366.0,Salary Increases & Fixed Expenses Decrease,325237,108374.0,110424,218798.0,106439.0,32.73,0.04,Low Risk
U044,2024,11,1115805.0,Salary Increases & Fixed Expenses Decrease,325237,108374.0,99492,207866.0,117371.0,36.09,0.02,Low Risk
U044,2024,12,1233176.0,Salary Increases & Fixed Expenses Decrease,325237,108374.0,122245,230619.0,94618.0,29.09,0.05,Low Risk
U045,2024,1,216331.0,Stable Salary & Stable Fixed Expenses,27685,17263.0,18764,36027.0,-8342.0,-30.13,-0.04,High Risk
U045,2024,2,207989.0,Stable Salary & Stable Fixed Expenses,27685,17263.0,17524,34787.0,-7102.0,-25.65,0.01,High Risk
U045,2024,3,200887.0,Stable Salary & Stable Fixed Expenses,27685,17263.0,21912,39175.0,-11490.0,-41.5,-0.04,High Risk
U045,2024,4,189397.0,Stable Salary & Stable Fixed Expenses,27685,17263.0,17327,34590.0,-6905.0,-24.94,-0.04,High Risk
U045,2024,5,182492.0,Stable Salary & Stable Fixed Expenses,27685,17263.0,19576,36839.0,-9154.0,-33.06,0.02,High Risk
U045,2024,6,173338.0,Stable Salary & Stable Fixed Expenses,27685,17263.0,21849,39112.0,-11427.0,-41.28,0.04,High Risk
U045,2024,7,161911.0,Stable Salary & Stable Fixed Expenses,27685,17263.0,17748,35011.0,-7326.0,-26.46,0.0,High Risk
U045,2024,8,154585.0,Stable Salary & Stable Fixed Expenses,27685,17263.0,20688,37951.0,-10266.0,-37.08,-0.03,High Risk
U045,2024,9,144319.0,Stable Salary & Stable Fixed Expenses,27685,17263.0,20899,38162.0,-10477.0,-37.84,0.02,High Risk
U045,2024,10,133842.0,Stable Salary & Stable Fixed Expenses,27685,17263.0,19694,36957.0,-9272.0,-33.49,-0.01,High Risk
U045,2024,11,124570.0,Stable Salary & Stable Fixed Expenses,27685,17263.0,16960,34223.0,-6538.0,-23.62,-0.01,High Risk
U045,2024,12,118032.0,Stable Salary & Stable Fixed Expenses,27685,17263.0,19908,37171.0,-9486.0,-34.26,0.03,High Risk
U046,2024,1,200162.0,Salary Increases & Fixed Expenses Increase,47253,14955.0,18270,33225.0,14028.0,29.69,0.03,Low Risk
U046,2024,2,214190.0,Salary Increases & Fixed Expenses Increase,47253,16643.0,15432,32075.0,15178.0,32.12,-0.02,Low Risk
U046,2024,3,229368.0,Salary Increases & Fixed Expenses Increase,47253,16643.0,21349,37992.0,9261.0,19.6,-0.05,Medium Risk
U046,2024,4,238629.0,Salary Increases & Fixed Expenses Increase,47253,16643.0,14233,30876.0,16377.0,34.66,0.03,Low Risk
U046,2024,5,255006.0,Salary Increases & Fixed Expenses Increase,47253,16643.0,14305,30948.0,16305.0,34.51,0.02,Low Risk
U046,2024,6,271311.0,Salary Increases & Fixed Expenses Increase,47253,16643.0,16804,33447.0,13806.0,29.22,-0.02,Low Risk
U046,2024,7,285117.0,Salary Increases & Fixed Expenses Increase,47253,16643.0,14266,30909.0,16344.0,34.59,-0.03,Low Risk
U046,2024,8,301461.0,Salary Increases & Fixed Expenses Increase,60094,16643.0,18533,35176.0,24918.0,41.47,0.03,Low Risk
U046,2024,9,326379.0,Salary Increases & Fixed Expenses Increase,60094,17612.0,19467,37079.0,23015.0,38.3,-0.04,Low Risk
U046,2024,10,349394.0,Salary Increases & Fixed Expenses Increase,60094,17612.0,26609,44221.0,15873.0,26.41,-0.01,Low Risk
U046,2024,11,365267.0,Salary Increases & Fixed Expenses Increase,60094,17612.0,21697,39309.0,20785.0,34.59,0.03,Low Risk
U046,2024,12,386052.0,Salary Increases & Fixed Expenses Increase,60094,18744.0,29198,47942.0,12152.0,20.22,0.03,Medium Risk
U047,2024,1,230118.0,Stable Salary & Stable Fixed Expenses,121577,48213.0,58640,106853.0,14724.0,12.11,-0.03,High Risk
U047,2024,2,244842.0,Stable Salary & Stable Fixed Expenses,121577,48213.0,51037,99250.0,22327.0,18.36,0.04,Medium Risk
U047,2024,3,267169.0,Stable Salary & Stable Fixed Expenses,121577,48213.0,81943,130156.0,-8579.0,-7.06,0.01,High Risk
U047,2024,4,258590.0,Stable Salary & Stable Fixed Expenses,121577,48213.0,67725,115938.0,5639.0,4.64,0.04,High Risk
U047,2024,5,264229.0,Stable Salary & Stable Fixed Expenses,121577,48213.0,71570,119783.0,1794.0,1.48,0.04,High Risk
U047,2024,6,266023.0,Stable Salary & Stable Fixed Expenses,121577,48213.0,55879,104092.0,17485.0,14.38,-0.0,High Risk
U047,2024,7,283508.0,Stable Salary & Stable Fixed Expenses,121577,48213.0,49786,97999.0,23578.0,19.39,0.05,Medium Risk
U047,2024,8,307086.0,Stable Salary & Stable Fixed Expenses,121577,48213.0,53645,101858.0,19719.0,16.22,-0.0,Medium Risk
U047,2024,9,326805.0,Stable Salary & Stable Fixed Expenses,121577,48213.0,54297,102510.0,19067.0,15.68,0.03,Medium Risk
U047,2024,10,345872.0,Stable Salary & Stable Fixed Expenses,121577,48213.0,84739,132952.0,-11375.0,-9.36,0.0,High Risk
U047,2024,11,334497.0,Stable Salary & Stable Fixed Expenses,121577,48213.0,77018,125231.0,-3654.0,-3.01,0.03,High Risk
U047,2024,12,330843.0,Stable Salary & Stable Fixed Expenses,121577,48213.0,63449,111662.0,9915.0,8.16,-0.05,High Risk
U048,2024,1,222674.0,Salary Increases & Fixed Expenses Remain Stable,51515,28429.0,32839,61268.0,-9753.0,-18.93,-0.02,High Risk
U048,2024,2,212921.0,Salary Increases & Fixed Expenses Remain Stable,51515,28429.0,38537,66966.0,-15451.0,-29.99,-0.05,High Risk
U048,2024,3,197470.0,Salary Increases & Fixed Expenses Remain Stable,51515,28429.0,37392,65821.0,-14306.0,-27.77,-0.02,High Risk
U048,2024,4,183164.0,Salary Increases & Fixed Expenses Remain Stable,51515,28429.0,39506,67935.0,-16420.0,-31.87,0.03,High Risk
U048,2024,5,166744.0,Salary Increases & Fixed Expenses Remain Stable,51515,28429.0,34029,62458.0,-10943.0,-21.24,-0.01,High Risk
U048,2024,6,155801.0,Salary Increases & Fixed Expenses Remain Stable,57672,28429.0,42106,70535.0,-12863.0,-22.3,0.01,High Risk
U048,2024,7,142938.0,Salary Increases & Fixed Expenses Remain Stable,57672,28429.0,41502,69931.0,-12259.0,-21.26,0.05,High Risk
U048,2024,8,130679.0,Salary Increases & Fixed Expenses Remain Stable,57672,28429.0,36616,65045.0,-7373.0,-12.78,-0.04,High Risk
U048,2024,9,123306.0,Salary Increases & Fixed Expenses Remain Stable,57672,28429.0,45149,73578.0,-15906.0,-27.58,0.01,High Risk
U048,2024,10,107400.0,Salary Increases & Fixed Expenses Remain Stable,57672,28429.0,40097,68526.0,-10854.0,-18.82,0.01,High Risk
U048,2024,11,96546.0,Salary Increases & Fixed Expenses Remain Stable,57672,28429.0,36996,65425.0,-7753.0,-13.44,-0.02,High Risk
U048,2024,12,88793.0,Salary Increases & Fixed Expenses Remain Stable,57672,28429.0,37426,65855.0,-8183.0,-14.19,-0.02,High Risk
U049,2024,1,233355.0,Salary Increases & Fixed Expenses Increase,89140,36092.0,57087,93179.0,-4039.0,-4.53,0.04,High Risk
U049,2024,2,229316.0,Salary Increases & Fixed Expenses Increase,89140,36092.0,58702,94794.0,-5654.0,-6.34,0.04,High Risk
U049,2024,3,223662.0,Salary Increases & Fixed Expenses Increase,89140,36092.0,69107,105199.0,-16059.0,-18.02,-0.01,High Risk
U049,2024,4,207603.0,Salary Increases & Fixed Expenses Increase,89140,36092.0,57541,93633.0,-4493.0,-5.04,0.03,High Risk
U049,2024,5,203110.0,Salary Increases & Fixed Expenses Increase,89140,36092.0,56996,93088.0,-3948.0,-4.43,0.02,High Risk
U049,2024,6,199162.0,Salary Increases & Fixed Expenses Increase,104898,36809.0,73159,109968.0,-5070.0,-4.83,0.04,High Risk
U049,2024,7,194092.0,Salary Increases & Fixed Expenses Increase,104898,36809.0,63039,99848.0,5050.0,4.81,-0.02,High Risk
U049,2024,8,199142.0,Salary Increases & Fixed Expenses Increase,104898,36809.0,82160,118969.0,-14071.0,-13.41,0.02,High Risk
U049,2024,9,185071.0,Salary Increases & Fixed Expenses Increase,104898,36809.0,67425,104234.0,664.0,0.63,0.01,High Risk
U049,2024,10,185735.0,Salary Increases & Fixed Expenses Increase,104898,36809.0,71378,108187.0,-3289.0,-3.14,-0.05,High Risk
U049,2024,11,182446.0,Salary Increases & Fixed Expenses Increase,104898,36809.0,76494,113303.0,-8405.0,-8.01,-0.0,High Risk
U049,2024,12,174041.0,Salary Increases & Fixed Expenses Increase,104898,37917.0,66562,104479.0,419.0,0.4,0.03,High Risk
U050,2024,1,202594.0,Salary Increases & Fixed Expenses Increase,154105,75428.0,67202,142630.0,11475.0,7.45,0.02,High Risk
U050,2024,2,214069.0,Salary Increases & Fixed Expenses Increase,154105,75428.0,88236,163664.0,-9559.0,-6.2,0.01,High Risk
U050,2024,3,204510.0,Salary Increases & Fixed Expenses Increase,154105,76625.0,82285,158910.0,-4805.0,-3.12,0.02,High Risk
U050,2024,4,199705.0,Salary Increases & Fixed Expenses Increase,154105,78199.0,64073,142272.0,11833.0,7.68,-0.01,High Risk
U050,2024,5,211538.0,Salary Increases & Fixed Expenses Increase,164521,78199.0,69060,147259.0,17262.0,10.49,-0.02,High Risk
U050,2024,6,228800.0,Salary Increases & Fixed Expenses Increase,164521,78199.0,95124,173323.0,-8802.0,-5.35,-0.01,High Risk
U050,2024,7,219998.0,Salary Increases & Fixed Expenses Increase,164521,79487.0,98018,177505.0,-12984.0,-7.89,0.02,High Risk
U050,2024,8,207014.0,Salary Increases & Fixed Expenses Increase,164521,79487.0,66899,146386.0,18135.0,11.02,-0.01,High Risk
U050,2024,9,225149.0,Salary Increases & Fixed Expenses Increase,164521,80995.0,83127,164122.0,399.0,0.24,0.0,High Risk
U050,2024,10,225548.0,Salary Increases & Fixed Expenses Increase,164521,80995.0,82386,163381.0,1140.0,0.69,-0.01,High Risk
U050,2024,11,226688.0,Salary Increases & Fixed Expenses Increase,164521,82380.0,91657,174037.0,-9516.0,-5.78,0.03,High Risk
U050,2024,12,217172.0,Salary Increases & Fixed Expenses Increase,164521,82380.0,67373,149753.0,14768.0,8.98,0.0,High Risk
U051,2024,1,243633.0,Salary Increases & Fixed Expenses Remain Stable,245857,115897.0,194271,310168.0,-64311.0,-26.16,0.01,High Risk
U051,2024,2,179322.0,Salary Increases & Fixed Expenses Remain Stable,245857,115897.0,177157,293054.0,-47197.0,-19.2,0.01,High Risk
U051,2024,3,132125.0,Salary Increases & Fixed Expenses Remain Stable,245857,115897.0,149680,265577.0,-19720.0,-8.02,-0.03,High Risk
U051,2024,4,112405.0,Salary Increases & Fixed Expenses Remain Stable,245857,115897.0,193697,309594.0,-63737.0,-25.92,-0.03,High Risk
U051,2024,5,48668.0,Salary Increases & Fixed Expenses Remain Stable,245857,115897.0,172838,288735.0,-42878.0,-17.44,0.02,High Risk
U051,2024,6,5790.0,Salary Increases & Fixed Expenses Remain Stable,260446,115897.0,205611,321508.0,-61062.0,-23.45,0.01,High Risk
U051,2024,7,-55272.0,Salary Increases & Fixed Expenses Remain Stable,260446,115897.0,200370,316267.0,-55821.0,-21.43,0.02,High Risk
U051,2024,8,-111093.0,Salary Increases & Fixed Expenses Remain Stable,260446,115897.0,192981,308878.0,-48432.0,-18.6,-0.0,High Risk
U051,2024,9,-159525.0,Salary Increases & Fixed Expenses Remain Stable,260446,115897.0,156820,272717.0,-12271.0,-4.71,0.02,High Risk
U051,2024,10,-171796.0,Salary Increases & Fixed Expenses Remain Stable,260446,115897.0,162766,278663.0,-18217.0,-6.99,-0.0,High Risk
U051,2024,11,-190013.0,Salary Increases & Fixed Expenses Remain Stable,260446,115897.0,166668,282565.0,-22119.0,-8.49,-0.04,High Risk
U051,2024,12,-212132.0,Salary Increases & Fixed Expenses Remain Stable,260446,115897.0,174435,290332.0,-29886.0,-11.47,0.01,High Risk
U052,2024,1,244715.0,Stable Salary & Stable Fixed Expenses,182045,43806.0,69130,112936.0,69109.0,37.96,-0.02,Low Risk
U052,2024,2,313824.0,Stable Salary & Stable Fixed Expenses,182045,43806.0,56505,100311.0,81734.0,44.9,-0.04,Low Risk
U052,2024,3,395558.0,Stable Salary & Stable Fixed Expenses,182045,43806.0,84961,128767.0,53278.0,29.27,-0.02,Low Risk
U052,2024,4,448836.0,Stable Salary & Stable Fixed Expenses,182045,43806.0,67659,111465.0,70580.0,38.77,-0.04,Low Risk
U052,2024,5,519416.0,Stable Salary & Stable Fixed Expenses,182045,43806.0,65316,109122.0,72923.0,40.06,-0.04,Low Risk
U052,2024,6,592339.0,Stable Salary & Stable Fixed Expenses,182045,43806.0,72499,116305.0,65740.0,36.11,-0.01,Low Risk
U052,2024,7,658079.0,Stable Salary & Stable Fixed Expenses,182045,43806.0,70261,114067.0,67978.0,37.34,-0.03,Low Risk
U052,2024,8,726057.0,Stable Salary & Stable Fixed Expenses,182045,43806.0,57717,101523.0,80522.0,44.23,0.04,Low Risk
U052,2024,9,806579.0,Stable Salary & Stable Fixed Expenses,182045,43806.0,62558,106364.0,75681.0,41.57,0.04,Low Risk
U052,2024,10,882260.0,Stable Salary & Stable Fixed Expenses,182045,43806.0,81524,125330.0,56715.0,31.15,-0.03,Low Risk
U052,2024,11,938975.0,Stable Salary & Stable Fixed Expenses,182045,43806.0,66590,110396.0,71649.0,39.36,-0.02,Low Risk
U052,2024,12,1010624.0,Stable Salary & Stable Fixed Expenses,182045,43806.0,72633,116439.0,65606.0,36.04,-0.05,Low Risk
U053,2024,1,200411.0,Salary Increases & Fixed Expenses Remain Stable,33844,11493.0,18158,29651.0,4193.0,12.39,0.03,High Risk
U053,2024,2,204604.0,Salary Increases & Fixed Expenses Remain Stable,33844,11493.0,15484,26977.0,6867.0,20.29,-0.02,Medium Risk
U053,2024,3,211471.0,Salary Increases & Fixed Expenses Remain Stable,33844,11493.0,20228,31721.0,2123.0,6.27,0.03,High Risk
U053,2024,4,213594.0,Salary Increases & Fixed Expenses Remain Stable,58955,11493.0,28821,40314.0,18641.0,31.62,-0.02,Low Risk
U053,2024,5,232235.0,Salary Increases & Fixed Expenses Remain Stable,58955,11493.0,33066,44559.0,14396.0,24.42,0.01,Medium Risk
U053,2024,6,246631.0,Salary Increases & Fixed Expenses Remain Stable,58955,11493.0,27206,38699.0,20256.0,34.36,0.03,Low Risk
U053,2024,7,266887.0,Salary Increases & Fixed Expenses Remain Stable,58955,11493.0,30758,42251.0,16704.0,28.33,0.03,Low Risk
U053,2024,8,283591.0,Salary Increases & Fixed Expenses Remain Stable,58955,11493.0,33465,44958.0,13997.0,23.74,0.0,Medium Risk
U053,2024,9,297588.0,Salary Increases & Fixed Expenses Remain Stable,58955,11493.0,23842,35335.0,23620.0,40.06,0.04,Low Risk
U053,2024,10,321208.0,Salary Increases & Fixed Expenses Remain Stable,58955,11493.0,34600,46093.0,12862.0,21.82,-0.04,Medium Risk
U053,2024,11,334070.0,Salary Increases & Fixed Expenses Remain Stable,58955,11493.0,29158,40651.0,18304.0,31.05,0.03,Low Risk
U053,2024,12,352374.0,Salary Increases & Fixed Expenses Remain Stable,58955,11493.0,24630,36123.0,22832.0,38.73,-0.02,Low Risk
U054,2024,1,237302.0,Stable Salary & Increasing Fixed Expenses,80307,39450.0,36644,76094.0,4213.0,5.25,-0.01,High Risk
U054,2024,2,241515.0,Stable Salary & Increasing Fixed Expenses,80307,39450.0,36921,76371.0,3936.0,4.9,0.04,High Risk
U054,2024,3,245451.0,Stable Salary & Increasing Fixed Expenses,80307,39450.0,41922,81372.0,-1065.0,-1.33,0.0,High Risk
U054,2024,4,244386.0,Stable Salary & Increasing Fixed Expenses,80307,39450.0,42426,81876.0,-1569.0,-1.95,-0.05,High Risk
U054,2024,5,242817.0,Stable Salary & Increasing Fixed Expenses,80307,39450.0,45761,85211.0,-4904.0,-6.11,-0.02,High Risk
U054,2024,6,237913.0,Stable Salary & Increasing Fixed Expenses,80307,39450.0,36470,75920.0,4387.0,5.46,-0.02,High Risk
U054,2024,7,242300.0,Stable Salary & Increasing Fixed Expenses,80307,39450.0,43945,83395.0,-3088.0,-3.85,-0.04,High Risk
U054,2024,8,239212.0,Stable Salary & Increasing Fixed Expenses,80307,39450.0,46305,85755.0,-5448.0,-6.78,-0.01,High Risk
U054,2024,9,233764.0,Stable Salary & Increasing Fixed Expenses,80307,39450.0,37239,76689.0,3618.0,4.51,0.02,High Risk
U054,2024,10,237382.0,Stable Salary & Increasing Fixed Expenses,80307,39450.0,34897,74347.0,5960.0,7.42,-0.03,High Risk
U054,2024,11,243342.0,Stable Salary & Increasing Fixed Expenses,80307,39450.0,46156,85606.0,-5299.0,-6.6,0.01,High Risk
U054,2024,12,238043.0,Stable Salary & Increasing Fixed Expenses,80307,39450.0,33989,73439.0,6868.0,8.55,-0.01,High Risk
U055,2024,1,214485.0,Salary Increases & Fixed Expenses Decrease,272574,117761.0,101935,219696.0,52878.0,19.4,0.04,Medium Risk
U055,2024,2,267363.0,Salary Increases & Fixed Expenses Decrease,272574,115968.0,85639,201607.0,70967.0,26.04,-0.02,Low Risk
U055,2024,3,338330.0,Salary Increases & Fixed Expenses Decrease,302470,114836.0,127831,242667.0,59803.0,19.77,-0.01,Medium Risk
U055,2024,4,398133.0,Salary Increases & Fixed Expenses Decrease,302470,114836.0,107001,221837.0,80633.0,26.66,0.01,Low Risk
U055,2024,5,478766.0,Salary Increases & Fixed Expenses Decrease,302470,114836.0,103569,218405.0,84065.0,27.79,-0.01,Low Risk
U055,2024,6,562831.0,Salary Increases & Fixed Expenses Decrease,302470,114836.0,116332,231168.0,71302.0,23.57,0.03,Medium Risk
U055,2024,7,634133.0,Salary Increases & Fixed Expenses Decrease,302470,114836.0,107012,221848.0,80622.0,26.65,-0.0,Low Risk
U055,2024,8,714755.0,Salary Increases & Fixed Expenses Decrease,302470,114836.0,111340,226176.0,76294.0,25.22,0.04,Low Risk
U055,2024,9,791049.0,Salary Increases & Fixed Expenses Decrease,302470,114836.0,108674,223510.0,78960.0,26.11,0.04,Low Risk
U055,2024,10,870009.0,Salary Increases & Fixed Expenses Decrease,302470,114836.0,117008,231844.0,70626.0,23.35,-0.02,Medium Risk
U055,2024,11,940635.0,Salary Increases & Fixed Expenses Decrease,302470,114836.0,111533,226369.0,76101.0,25.16,-0.02,Low Risk
U055,2024,12,1016736.0,Salary Increases & Fixed Expenses Decrease,302470,114836.0,117937,232773.0,69697.0,23.04,-0.04,Medium Risk
U056,2024,1,246635.0,Salary Increases & Fixed Expenses Increase,259469,103354.0,82763,186117.0,73352.0,28.27,-0.05,Low Risk
U056,2024,2,319987.0,Salary Increases & Fixed Expenses Increase,259469,103354.0,102312,205666.0,53803.0,20.74,0.04,Medium Risk
U056,2024,3,373790.0,Salary Increases & Fixed Expenses Increase,259469,103354.0,122989,226343.0,33126.0,12.77,0.03,High Risk
U056,2024,4,406916.0,Salary Increases & Fixed Expenses Increase,286259,103354.0,110041,213395.0,72864.0,25.45,-0.01,Low Risk
U056,2024,5,479780.0,Salary Increases & Fixed Expenses Increase,286259,105215.0,98274,203489.0,82770.0,28.91,0.05,Low Risk
U056,2024,6,562550.0,Salary Increases & Fixed Expenses Increase,286259,105994.0,107637,213631.0,72628.0,25.37,0.03,Low Risk
U056,2024,7,635178.0,Salary Increases & Fixed Expenses Increase,286259,106537.0,89285,195822.0,90437.0,31.59,-0.01,Low Risk
U056,2024,8,725615.0,Salary Increases & Fixed Expenses Increase,286259,106537.0,98361,204898.0,81361.0,28.42,0.0,Low Risk
U056,2024,9,806976.0,Salary Increases & Fixed Expenses Increase,286259,106537.0,128475,235012.0,51247.0,17.9,-0.03,Medium Risk
U056,2024,10,858223.0,Salary Increases & Fixed Expenses Increase,286259,108298.0,112741,221039.0,65220.0,22.78,-0.03,Medium Risk
U056,2024,11,923443.0,Salary Increases & Fixed Expenses Increase,286259,109082.0,105345,214427.0,71832.0,25.09,-0.01,Low Risk
U056,2024,12,995275.0,Salary Increases & Fixed Expenses Increase,286259,109082.0,114157,223239.0,63020.0,22.02,0.0,Medium Risk
U057,2024,1,208110.0,Salary Increases & Fixed Expenses Remain Stable,196581,74138.0,103490,177628.0,18953.0,9.64,-0.02,High Risk
U057,2024,2,227063.0,Salary Increases & Fixed Expenses Remain Stable,196581,74138.0,116820,190958.0,5623.0,2.86,-0.01,High Risk
U057,2024,3,232686.0,Salary Increases & Fixed Expenses Remain Stable,196581,74138.0,99416,173554.0,23027.0,11.71,-0.03,High Risk
U057,2024,4,255713.0,Salary Increases & Fixed Expenses Remain Stable,196581,74138.0,115042,189180.0,7401.0,3.76,0.03,High Risk
U057,2024,5,263114.0,Salary Increases & Fixed Expenses Remain Stable,196581,74138.0,90129,164267.0,32314.0,16.44,0.05,Medium Risk
U057,2024,6,295428.0,Salary Increases & Fixed Expenses Remain Stable,220509,74138.0,109026,183164.0,37345.0,16.94,-0.04,Medium Risk
U057,2024,7,332773.0,Salary Increases & Fixed Expenses Remain Stable,220509,74138.0,113967,188105.0,32404.0,14.7,-0.01,High Risk
U057,2024,8,365177.0,Salary Increases & Fixed Expenses Remain Stable,220509,74138.0,105941,180079.0,40430.0,18.33,0.05,Medium Risk
U057,2024,9,405607.0,Salary Increases & Fixed Expenses Remain Stable,220509,74138.0,151583,225721.0,-5212.0,-2.36,0.03,High Risk
U057,2024,10,400395.0,Salary Increases & Fixed Expenses Remain Stable,220509,74138.0,112052,186190.0,34319.0,15.56,-0.04,Medium Risk
U057,2024,11,434714.0,Salary Increases & Fixed Expenses Remain Stable,220509,74138.0,113083,187221.0,33288.0,15.1,0.03,Medium Risk
U057,2024,12,468002.0,Salary Increases & Fixed Expenses Remain Stable,220509,74138.0,126721,200859.0,19650.0,8.91,0.05,High Risk
U058,2024,1,242067.0,Stable Salary & Stable Fixed Expenses,289805,60738.0,119268,180006.0,109799.0,37.89,-0.0,Low Risk
U058,2024,2,351866.0,Stable Salary & Stable Fixed Expenses,289805,60738.0,118403,179141.0,110664.0,38.19,0.01,Low Risk
U058,2024,3,462530.0,Stable Salary & Stable Fixed Expenses,289805,60738.0,174048,234786.0,55019.0,18.98,0.01,Medium Risk
U058,2024,4,517549.0,Stable Salary & Stable Fixed Expenses,289805,60738.0,143211,203949.0,85856.0,29.63,0.02,Low Risk
U058,2024,5,603405.0,Stable Salary & Stable Fixed Expenses,289805,60738.0,142731,203469.0,86336.0,29.79,0.03,Low Risk
U058,2024,6,689741.0,Stable Salary & Stable Fixed Expenses,289805,60738.0,166314,227052.0,62753.0,21.65,0.03,Medium Risk
U058,2024,7,752494.0,Stable Salary & Stable Fixed Expenses,289805,60738.0,139914,200652.0,89153.0,30.76,0.02,Low Risk
U058,2024,8,841647.0,Stable Salary & Stable Fixed Expenses,289805,60738.0,151026,211764.0,78041.0,26.93,-0.03,Low Risk
U058,2024,9,919688.0,Stable Salary & Stable Fixed Expenses,289805,60738.0,176537,237275.0,52530.0,18.13,-0.03,Medium Risk
U058,2024,10,972218.0,Stable Salary & Stable Fixed Expenses,289805,60738.0,177854,238592.0,51213.0,17.67,0.04,Medium Risk
U058,2024,11,1023431.0,Stable Salary & Stable Fixed Expenses,289805,60738.0,142452,203190.0,86615.0,29.89,0.03,Low Risk
U058,2024,12,1110046.0,Stable Salary & Stable Fixed Expenses,289805,60738.0,177962,238700.0,51105.0,17.63,0.0,Medium Risk
U059,2024,1,238545.0,Stable Salary & Increasing Fixed Expenses,170503,75733.0,56623,132356.0,38147.0,22.37,-0.04,Medium Risk
U059,2024,2,276692.0,Stable Salary & Increasing Fixed Expenses,170503,75733.0,65687,141420.0,29083.0,17.06,-0.02,Medium Risk
U059,2024,3,305775.0,Stable Salary & Increasing Fixed Expenses,170503,75733.0,76006,151739.0,18764.0,11.01,0.04,High Risk
U059,2024,4,324539.0,Stable Salary & Increasing Fixed Expenses,170503,75733.0,65774,141507.0,28996.0,17.01,-0.03,Medium Risk
U059,2024,5,353535.0,Stable Salary & Increasing Fixed Expenses,170503,75733.0,56263,131996.0,38507.0,22.58,-0.01,Medium Risk
U059,2024,6,392042.0,Stable Salary & Increasing Fixed Expenses,170503,75733.0,56492,132225.0,38278.0,22.45,-0.04,Medium Risk
U059,2024,7,430320.0,Stable Salary & Increasing Fixed Expenses,170503,75733.0,60571,136304.0,34199.0,20.06,0.04,Medium Risk
U059,2024,8,464519.0,Stable Salary & Increasing Fixed Expenses,170503,76447.0,54021,130468.0,40035.0,23.48,-0.05,Medium Risk
U059,2024,9,504554.0,Stable Salary & Increasing Fixed Expenses,170503,76447.0,62256,138703.0,31800.0,18.65,-0.0,Medium Risk
U059,2024,10,536354.0,Stable Salary & Increasing Fixed Expenses,170503,76447.0,60418,136865.0,33638.0,19.73,-0.02,Medium Risk
U059,2024,11,569992.0,Stable Salary & Increasing Fixed Expenses,170503,76447.0,55953,132400.0,38103.0,22.35,0.04,Medium Risk
U059,2024,12,608095.0,Stable Salary & Increasing Fixed Expenses,170503,76447.0,56796,133243.0,37260.0,21.85,-0.03,Medium Risk
U060,2024,1,213362.0,Salary Increases & Fixed Expenses Increase,160217,47258.0,50041,97299.0,62918.0,39.27,0.03,Low Risk
U060,2024,2,276280.0,Salary Increases & Fixed Expenses Increase,160217,47258.0,61808,109066.0,51151.0,31.93,-0.0,Low Risk
U060,2024,3,327431.0,Salary Increases & Fixed Expenses Increase,160217,47258.0,53099,100357.0,59860.0,37.36,-0.03,Low Risk
U060,2024,4,387291.0,Salary Increases & Fixed Expenses Increase,160217,47258.0,58632,105890.0,54327.0,33.91,-0.01,Low Risk
U060,2024,5,441618.0,Salary Increases & Fixed Expenses Increase,160217,47258.0,48066,95324.0,64893.0,40.5,0.04,Low Risk
U060,2024,6,506511.0,Salary Increases & Fixed Expenses Increase,160217,47258.0,62151,109409.0,50808.0,31.71,-0.02,Low Risk
U060,2024,7,557319.0,Salary Increases & Fixed Expenses Increase,160217,47258.0,60448,107706.0,52511.0,32.77,-0.0,Low Risk
U060,2024,8,609830.0,Salary Increases & Fixed Expenses Increase,186767,47258.0,60907,108165.0,78602.0,42.09,-0.03,Low Risk
U060,2024,9,688432.0,Salary Increases & Fixed Expenses Increase,186767,47258.0,63122,110380.0,76387.0,40.9,-0.01,Low Risk
U060,2024,10,764819.0,Salary Increases & Fixed Expenses Increase,186767,47258.0,59195,106453.0,80314.0,43.0,0.04,Low Risk
U060,2024,11,845133.0,Salary Increases & Fixed Expenses Increase,186767,47258.0,62584,109842.0,76925.0,41.19,0.03,Low Risk
U060,2024,12,922058.0,Salary Increases & Fixed Expenses Increase,186767,49137.0,57051,106188.0,80579.0,43.14,0.01,Low Risk
U061,2024,1,215947.0,Salary Increases & Fixed Expenses Remain Stable,59863,32619.0,19837,52456.0,7407.0,12.37,0.04,High Risk
U061,2024,2,223354.0,Salary Increases & Fixed Expenses Remain Stable,59863,32619.0,21019,53638.0,6225.0,10.4,0.04,High Risk
U061,2024,3,229579.0,Salary Increases & Fixed Expenses Remain Stable,59863,32619.0,25669,58288.0,1575.0,2.63,-0.03,High Risk
U061,2024,4,231154.0,Salary Increases & Fixed Expenses Remain Stable,59863,32619.0,20418,53037.0,6826.0,11.4,0.01,High Risk
U061,2024,5,237980.0,Salary Increases & Fixed Expenses Remain Stable,59863,32619.0,19403,52022.0,7841.0,13.1,0.02,High Risk
U061,2024,6,245821.0,Salary Increases & Fixed Expenses Remain Stable,59863,32619.0,23068,55687.0,4176.0,6.98,0.04,High Risk
U061,2024,7,249997.0,Salary Increases & Fixed Expenses Remain Stable,70099,32619.0,21123,53742.0,16357.0,23.33,0.02,Medium Risk
U061,2024,8,266354.0,Salary Increases & Fixed Expenses Remain Stable,70099,32619.0,21263,53882.0,16217.0,23.13,-0.02,Medium Risk
U061,2024,9,282571.0,Salary Increases & Fixed Expenses Remain Stable,70099,32619.0,30238,62857.0,7242.0,10.33,-0.03,High Risk
U061,2024,10,289813.0,Salary Increases & Fixed Expenses Remain Stable,70099,32619.0,26473,59092.0,11007.0,15.7,-0.04,Medium Risk
U061,2024,11,300820.0,Salary Increases & Fixed Expenses Remain Stable,70099,32619.0,24150,56769.0,13330.0,19.02,0.04,Medium Risk
U061,2024,12,314150.0,Salary Increases & Fixed Expenses Remain Stable,70099,32619.0,34693,67312.0,2787.0,3.98,-0.02,High Risk
U062,2024,1,232143.0,Stable Salary & Stable Fixed Expenses,26753,12751.0,10642,23393.0,3360.0,12.56,0.01,High Risk
U062,2024,2,235503.0,Stable Salary & Stable Fixed Expenses,26753,12751.0,10237,22988.0,3765.0,14.07,0.02,High Risk
U062,2024,3,239268.0,Stable Salary & Stable Fixed Expenses,26753,12751.0,10135,22886.0,3867.0,14.45,-0.04,High Risk
U062,2024,4,243135.0,Stable Salary & Stable Fixed Expenses,26753,12751.0,10197,22948.0,3805.0,14.22,-0.04,High Risk
U062,2024,5,246940.0,Stable Salary & Stable Fixed Expenses,26753,12751.0,9394,22145.0,4608.0,17.22,-0.02,Medium Risk
U062,2024,6,251548.0,Stable Salary & Stable Fixed Expenses,26753,12751.0,9153,21904.0,4849.0,18.13,0.03,Medium Risk
U062,2024,7,256397.0,Stable Salary & Stable Fixed Expenses,26753,12751.0,8914,21665.0,5088.0,19.02,0.04,Medium Risk
U062,2024,8,261485.0,Stable Salary & Stable Fixed Expenses,26753,12751.0,8165,20916.0,5837.0,21.82,-0.0,Medium Risk
U062,2024,9,267322.0,Stable Salary & Stable Fixed Expenses,26753,12751.0,10670,23421.0,3332.0,12.45,0.03,High Risk
U062,2024,10,270654.0,Stable Salary & Stable Fixed Expenses,26753,12751.0,11503,24254.0,2499.0,9.34,-0.01,High Risk
U062,2024,11,273153.0,Stable Salary & Stable Fixed Expenses,26753,12751.0,10055,22806.0,3947.0,14.75,0.03,High Risk
U062,2024,12,277100.0,Stable Salary & Stable Fixed Expenses,26753,12751.0,8492,21243.0,5510.0,20.6,-0.03,Medium Risk
U063,2024,1,218677.0,Salary Increases & Fixed Expenses Decrease,281757,113485.0,127432,240917.0,40840.0,14.49,-0.04,High Risk
U063,2024,2,259517.0,Salary Increases & Fixed Expenses Decrease,281757,113485.0,120004,233489.0,48268.0,17.13,-0.05,Medium Risk
U063,2024,3,307785.0,Salary Increases & Fixed Expenses Decrease,281757,113485.0,135722,249207.0,32550.0,11.55,-0.01,High Risk
U063,2024,4,340335.0,Salary Increases & Fixed Expenses Decrease,290572,113485.0,159252,272737.0,17835.0,6.14,-0.01,High Risk
U063,2024,5,358170.0,Salary Increases & Fixed Expenses Decrease,290572,113485.0,159842,273327.0,17245.0,5.93,0.01,High Risk
U063,2024,6,375415.0,Salary Increases & Fixed Expenses Decrease,290572,113485.0,169416,282901.0,7671.0,2.64,-0.01,High Risk
U063,2024,7,383086.0,Salary Increases & Fixed Expenses Decrease,290572,113485.0,142446,255931.0,34641.0,11.92,-0.01,High Risk
U063,2024,8,417727.0,Salary Increases & Fixed Expenses Decrease,290572,113485.0,139663,253148.0,37424.0,12.88,0.04,High Risk
U063,2024,9,455151.0,Salary Increases & Fixed Expenses Decrease,290572,112539.0,144633,257172.0,33400.0,11.49,0.03,High Risk
U063,2024,10,488551.0,Salary Increases & Fixed Expenses Decrease,290572,112539.0,180791,293330.0,-2758.0,-0.95,-0.04,High Risk
U063,2024,11,485793.0,Salary Increases & Fixed Expenses Decrease,290572,112539.0,157331,269870.0,20702.0,7.12,0.02,High Risk
U063,2024,12,506495.0,Salary Increases & Fixed Expenses Decrease,290572,112539.0,177933,290472.0,100.0,0.03,0.03,High Risk
U064,2024,1,235183.0,Salary Increases & Fixed Expenses Increase,233630,86986.0,107929,194915.0,38715.0,16.57,0.04,Medium Risk
U064,2024,2,273898.0,Salary Increases & Fixed Expenses Increase,233630,87784.0,131335,219119.0,14511.0,6.21,-0.0,High Risk
U064,2024,3,288409.0,Salary Increases & Fixed Expenses Increase,233630,87784.0,127062,214846.0,18784.0,8.04,0.04,High Risk
U064,2024,4,307193.0,Salary Increases & Fixed Expenses Increase,233630,87784.0,96171,183955.0,49675.0,21.26,-0.02,Medium Risk
U064,2024,5,356868.0,Salary Increases & Fixed Expenses Increase,233630,87784.0,97057,184841.0,48789.0,20.88,0.01,Medium Risk
U064,2024,6,405657.0,Salary Increases & Fixed Expenses Increase,242560,87784.0,111576,199360.0,43200.0,17.81,-0.04,Medium Risk
U064,2024,7,448857.0,Salary Increases & Fixed Expenses Increase,242560,89357.0,128048,217405.0,25155.0,10.37,0.05,High Risk
U064,2024,8,474012.0,Salary Increases & Fixed Expenses Increase,242560,89357.0,138753,228110.0,14450.0,5.96,-0.04,High Risk
U064,2024,9,488462.0,Salary Increases & Fixed Expenses Increase,242560,89357.0,121908,211265.0,31295.0,12.9,-0.03,High Risk
U064,2024,10,519757.0,Salary Increases & Fixed Expenses Increase,242560,90484.0,119185,209669.0,32891.0,13.56,0.04,High Risk
U064,2024,11,552648.0,Salary Increases & Fixed Expenses Increase,242560,90484.0,105691,196175.0,46385.0,19.12,0.0,Medium Risk
U064,2024,12,599033.0,Salary Increases & Fixed Expenses Increase,242560,90484.0,102869,193353.0,49207.0,20.29,-0.02,Medium Risk
U065,2024,1,203943.0,Stable Salary & Decreasing Fixed Expenses,230916,110193.0,73300,183493.0,47423.0,20.54,-0.0,Medium Risk
U065,2024,2,251366.0,Stable Salary & Decreasing Fixed Expenses,230916,110193.0,88705,198898.0,32018.0,13.87,-0.03,High Risk
U065,2024,3,283384.0,Stable Salary & Decreasing Fixed Expenses,230916,110193.0,103866,214059.0,16857.0,7.3,0.03,High Risk
U065,2024,4,300241.0,Stable Salary & Decreasing Fixed Expenses,230916,110193.0,88506,198699.0,32217.0,13.95,-0.04,High Risk
U065,2024,5,332458.0,Stable Salary & Decreasing Fixed Expenses,230916,110193.0,90235,200428.0,30488.0,13.2,-0.04,High Risk
U065,2024,6,362946.0,Stable Salary & Decreasing Fixed Expenses,230916,110193.0,76181,186374.0,44542.0,19.29,-0.01,Medium Risk
U065,2024,7,407488.0,Stable Salary & Decreasing Fixed Expenses,230916,110193.0,73059,183252.0,47664.0,20.64,0.04,Medium Risk
U065,2024,8,455152.0,Stable Salary & Decreasing Fixed Expenses,230916,110193.0,71141,181334.0,49582.0,21.47,0.03,Medium Risk
U065,2024,9,504734.0,Stable Salary & Decreasing Fixed Expenses,230916,108393.0,74011,182404.0,48512.0,21.01,-0.04,Medium Risk
U065,2024,10,553246.0,Stable Salary & Decreasing Fixed Expenses,230916,108393.0,109852,218245.0,12671.0,5.49,-0.04,High Risk
U065,2024,11,565917.0,Stable Salary & Decreasing Fixed Expenses,230916,108393.0,81617,190010.0,40906.0,17.71,-0.02,Medium Risk
U065,2024,12,606823.0,Stable Salary & Decreasing Fixed Expenses,230916,108393.0,72243,180636.0,50280.0,21.77,-0.04,Medium Risk
U066,2024,1,237003.0,Salary Increases & Fixed Expenses Remain Stable,286981,102941.0,144719,247660.0,39321.0,13.7,-0.02,High Risk
U066,2024,2,276324.0,Salary Increases & Fixed Expenses Remain Stable,286981,102941.0,169670,272611.0,14370.0,5.01,0.02,High Risk
U066,2024,3,290694.0,Salary Increases & Fixed Expenses Remain Stable,286981,102941.0,204780,307721.0,-20740.0,-7.23,0.0,High Risk
U066,2024,4,269954.0,Salary Increases & Fixed Expenses Remain Stable,286981,102941.0,120248,223189.0,63792.0,22.23,0.05,Medium Risk
U066,2024,5,333746.0,Salary Increases & Fixed Expenses Remain Stable,286981,102941.0,126427,229368.0,57613.0,20.08,-0.05,Medium Risk
U066,2024,6,391359.0,Salary Increases & Fixed Expenses Remain Stable,305330,102941.0,154935,257876.0,47454.0,15.54,-0.01,Medium Risk
U066,2024,7,438813.0,Salary Increases & Fixed Expenses Remain Stable,305330,102941.0,178323,281264.0,24066.0,7.88,-0.03,High Risk
U066,2024,8,462879.0,Salary Increases & Fixed Expenses Remain Stable,305330,102941.0,146392,249333.0,55997.0,18.34,0.0,Medium Risk
U066,2024,9,518876.0,Salary Increases & Fixed Expenses Remain Stable,305330,102941.0,176886,279827.0,25503.0,8.35,-0.03,High Risk
U066,2024,10,544379.0,Salary Increases & Fixed Expenses Remain Stable,305330,102941.0,174658,277599.0,27731.0,9.08,0.04,High Risk
U066,2024,11,572110.0,Salary Increases & Fixed Expenses Remain Stable,305330,102941.0,177402,280343.0,24987.0,8.18,-0.04,High Risk
U066,2024,12,597097.0,Salary Increases & Fixed Expenses Remain Stable,305330,102941.0,171939,274880.0,30450.0,9.97,-0.03,High Risk
U067,2024,1,201126.0,Stable Salary & Increasing Fixed Expenses,77032,37878.0,45769,83647.0,-6615.0,-8.59,0.03,High Risk
U067,2024,2,194511.0,Stable Salary & Increasing Fixed Expenses,77032,37878.0,36458,74336.0,2696.0,3.5,0.01,High Risk
U067,2024,3,197207.0,Stable Salary & Increasing Fixed Expenses,77032,37878.0,46087,83965.0,-6933.0,-9.0,0.04,High Risk
U067,2024,4,190274.0,Stable Salary & Increasing Fixed Expenses,77032,37878.0,31720,69598.0,7434.0,9.65,0.03,High Risk
U067,2024,5,197708.0,Stable Salary & Increasing Fixed Expenses,77032,37878.0,37862,75740.0,1292.0,1.68,0.01,High Risk
U067,2024,6,199000.0,Stable Salary & Increasing Fixed Expenses,77032,37878.0,38910,76788.0,244.0,0.32,-0.04,High Risk
U067,2024,7,199244.0,Stable Salary & Increasing Fixed Expenses,77032,37878.0,33604,71482.0,5550.0,7.2,-0.02,High Risk
U067,2024,8,204794.0,Stable Salary & Increasing Fixed Expenses,77032,39494.0,41854,81348.0,-4316.0,-5.6,0.03,High Risk
U067,2024,9,200478.0,Stable Salary & Increasing Fixed Expenses,77032,40521.0,40195,80716.0,-3684.0,-4.78,0.01,High Risk
U067,2024,10,196794.0,Stable Salary & Increasing Fixed Expenses,77032,42423.0,39674,82097.0,-5065.0,-6.58,-0.01,High Risk
U067,2024,11,191729.0,Stable Salary & Increasing Fixed Expenses,77032,42423.0,37274,79697.0,-2665.0,-3.46,-0.04,High Risk
U067,2024,12,189064.0,Stable Salary & Increasing Fixed Expenses,77032,42423.0,42249,84672.0,-7640.0,-9.92,-0.04,High Risk
U068,2024,1,200896.0,Stable Salary & Decreasing Fixed Expenses,137073,57792.0,75207,132999.0,4074.0,2.97,0.02,High Risk
U068,2024,2,204970.0,Stable Salary & Decreasing Fixed Expenses,137073,57792.0,55869,113661.0,23412.0,17.08,-0.03,Medium Risk
U068,2024,3,228382.0,Stable Salary & Decreasing Fixed Expenses,137073,57792.0,62211,120003.0,17070.0,12.45,0.03,High Risk
U068,2024,4,245452.0,Stable Salary & Decreasing Fixed Expenses,137073,57792.0,76676,134468.0,2605.0,1.9,0.01,High Risk
U068,2024,5,248057.0,Stable Salary & Decreasing Fixed Expenses,137073,57792.0,62084,119876.0,17197.0,12.55,-0.01,High Risk
U068,2024,6,265254.0,Stable Salary & Decreasing Fixed Expenses,137073,57792.0,79112,136904.0,169.0,0.12,0.02,High Risk
U068,2024,7,265423.0,Stable Salary & Decreasing Fixed Expenses,137073,57792.0,79740,137532.0,-459.0,-0.33,0.02,High Risk
U068,2024,8,264964.0,Stable Salary & Decreasing Fixed Expenses,137073,57792.0,58519,116311.0,20762.0,15.15,0.01,Medium Risk
U068,2024,9,285726.0,Stable Salary & Decreasing Fixed Expenses,137073,57792.0,55903,113695.0,23378.0,17.06,0.03,Medium Risk
U068,2024,10,309104.0,Stable Salary & Decreasing Fixed Expenses,137073,57792.0,81447,139239.0,-2166.0,-1.58,-0.03,High Risk
U068,2024,11,306938.0,Stable Salary & Decreasing Fixed Expenses,137073,57792.0,76903,134695.0,2378.0,1.73,-0.01,High Risk
U068,2024,12,309316.0,Stable Salary & Decreasing Fixed Expenses,137073,57792.0,65948,123740.0,13333.0,9.73,0.05,High Risk
U069,2024,1,214781.0,Stable Salary & Decreasing Fixed Expenses,124244,54454.0,70699,125153.0,-909.0,-0.73,0.03,High Risk
U069,2024,2,213872.0,Stable Salary & Decreasing Fixed Expenses,124244,54454.0,53819,108273.0,15971.0,12.85,0.02,High Risk
U069,2024,3,229843.0,Stable Salary & Decreasing Fixed Expenses,124244,54454.0,70162,124616.0,-372.0,-0.3,0.04,High Risk
U069,2024,4,229471.0,Stable Salary & Decreasing Fixed Expenses,124244,54454.0,63249,117703.0,6541.0,5.26,0.0,High Risk
U069,2024,5,236012.0,Stable Salary & Decreasing Fixed Expenses,124244,54454.0,49810,104264.0,19980.0,16.08,-0.03,Medium Risk
U069,2024,6,255992.0,Stable Salary & Decreasing Fixed Expenses,124244,54454.0,70496,124950.0,-706.0,-0.57,-0.0,High Risk
U069,2024,7,255286.0,Stable Salary & Decreasing Fixed Expenses,124244,54454.0,62813,117267.0,6977.0,5.62,0.01,High Risk
U069,2024,8,262263.0,Stable Salary & Decreasing Fixed Expenses,124244,54454.0,50973,105427.0,18817.0,15.15,0.0,Medium Risk
U069,2024,9,281080.0,Stable Salary & Decreasing Fixed Expenses,124244,54454.0,65318,119772.0,4472.0,3.6,0.0,High Risk
U069,2024,10,285552.0,Stable Salary & Decreasing Fixed Expenses,124244,54454.0,70109,124563.0,-319.0,-0.26,0.03,High Risk
U069,2024,11,285233.0,Stable Salary & Decreasing Fixed Expenses,124244,54454.0,65546,120000.0,4244.0,3.42,-0.03,High Risk
U069,2024,12,289477.0,Stable Salary & Decreasing Fixed Expenses,124244,54454.0,54795,109249.0,14995.0,12.07,-0.01,High Risk
U070,2024,1,245949.0,Salary Increases & Fixed Expenses Increase,268082,100821.0,84700,185521.0,82561.0,30.8,0.02,Low Risk
U070,2024,2,328510.0,Salary Increases & Fixed Expenses Increase,268082,100821.0,88758,189579.0,78503.0,29.28,0.05,Low Risk
U070,2024,3,407013.0,Salary Increases & Fixed Expenses Increase,268082,102644.0,92007,194651.0,73431.0,27.39,-0.0,Low Risk
U070,2024,4,480444.0,Salary Increases & Fixed Expenses Increase,298045,102644.0,113752,216396.0,81649.0,27.39,-0.02,Low Risk
U070,2024,5,562093.0,Salary Increases & Fixed Expenses Increase,298045,103721.0,112622,216343.0,81702.0,27.41,0.0,Low Risk
U070,2024,6,643795.0,Salary Increases & Fixed Expenses Increase,298045,104365.0,106637,211002.0,87043.0,29.2,-0.01,Low Risk
U070,2024,7,730838.0,Salary Increases & Fixed Expenses Increase,298045,104365.0,101840,206205.0,91840.0,30.81,0.01,Low Risk
U070,2024,8,822678.0,Salary Increases & Fixed Expenses Increase,298045,104365.0,117089,221454.0,76591.0,25.7,-0.0,Low Risk
U070,2024,9,899269.0,Salary Increases & Fixed Expenses Increase,298045,104365.0,97079,201444.0,96601.0,32.41,0.03,Low Risk
U070,2024,10,995870.0,Salary Increases & Fixed Expenses Increase,298045,104365.0,122711,227076.0,70969.0,23.81,-0.0,Medium Risk
U070,2024,11,1066839.0,Salary Increases & Fixed Expenses Increase,298045,105536.0,90496,196032.0,102013.0,34.23,0.02,Low Risk
U070,2024,12,1168852.0,Salary Increases & Fixed Expenses Increase,298045,105536.0,99393,204929.0,93116.0,31.24,0.03,Low Risk
U071,2024,1,208316.0,Salary Increases & Fixed Expenses Remain Stable,190521,79893.0,83841,163734.0,26787.0,14.06,-0.05,High Risk
U071,2024,2,235103.0,Salary Increases & Fixed Expenses Remain Stable,190521,79893.0,102415,182308.0,8213.0,4.31,-0.02,High Risk
U071,2024,3,243316.0,Salary Increases & Fixed Expenses Remain Stable,190521,79893.0,106620,186513.0,4008.0,2.1,-0.02,High Risk
U071,2024,4,247324.0,Salary Increases & Fixed Expenses Remain Stable,190521,79893.0,96737,176630.0,13891.0,7.29,-0.03,High Risk
U071,2024,5,261215.0,Salary Increases & Fixed Expenses Remain Stable,190521,79893.0,108293,188186.0,2335.0,1.23,-0.01,High Risk
U071,2024,6,263550.0,Salary Increases & Fixed Expenses Remain Stable,217554,79893.0,129155,209048.0,8506.0,3.91,-0.03,High Risk
U071,2024,7,272056.0,Salary Increases & Fixed Expenses Remain Stable,217554,79893.0,109997,189890.0,27664.0,12.72,-0.02,High Risk
U071,2024,8,299720.0,Salary Increases & Fixed Expenses Remain Stable,217554,79893.0,99130,179023.0,38531.0,17.71,0.04,Medium Risk
U071,2024,9,338251.0,Salary Increases & Fixed Expenses Remain Stable,217554,79893.0,128810,208703.0,8851.0,4.07,0.01,High Risk
U071,2024,10,347102.0,Salary Increases & Fixed Expenses Remain Stable,217554,79893.0,129559,209452.0,8102.0,3.72,0.01,High Risk
U071,2024,11,355204.0,Salary Increases & Fixed Expenses Remain Stable,217554,79893.0,98444,178337.0,39217.0,18.03,0.02,Medium Risk
U071,2024,12,394421.0,Salary Increases & Fixed Expenses Remain Stable,217554,79893.0,123342,203235.0,14319.0,6.58,0.03,High Risk
U072,2024,1,223433.0,Salary Increases & Fixed Expenses Remain Stable,32585,13104.0,22196,35300.0,-2715.0,-8.33,0.03,High Risk
U072,2024,2,220718.0,Salary Increases & Fixed Expenses Remain Stable,32585,13104.0,23052,36156.0,-3571.0,-10.96,-0.05,High Risk
U072,2024,3,217147.0,Salary Increases & Fixed Expenses Remain Stable,32585,13104.0,20220,33324.0,-739.0,-2.27,0.05,High Risk
U072,2024,4,216408.0,Salary Increases & Fixed Expenses Remain Stable,45265,13104.0,29831,42935.0,2330.0,5.15,-0.03,High Risk
U072,2024,5,218738.0,Salary Increases & Fixed Expenses Remain Stable,45265,13104.0,32855,45959.0,-694.0,-1.53,0.04,High Risk
U072,2024,6,218044.0,Salary Increases & Fixed Expenses Remain Stable,45265,13104.0,31284,44388.0,877.0,1.94,-0.02,High Risk
U072,2024,7,218921.0,Salary Increases & Fixed Expenses Remain Stable,45265,13104.0,35514,48618.0,-3353.0,-7.41,0.02,High Risk
U072,2024,8,215568.0,Salary Increases & Fixed Expenses Remain Stable,45265,13104.0,33615,46719.0,-1454.0,-3.21,-0.05,High Risk
U072,2024,9,214114.0,Salary Increases & Fixed Expenses Remain Stable,45265,13104.0,29209,42313.0,2952.0,6.52,-0.0,High Risk
U072,2024,10,217066.0,Salary Increases & Fixed Expenses Remain Stable,45265,13104.0,30655,43759.0,1506.0,3.33,0.03,High Risk
U072,2024,11,218572.0,Salary Increases & Fixed Expenses Remain Stable,45265,13104.0,35117,48221.0,-2956.0,-6.53,0.02,High Risk
U072,2024,12,215616.0,Salary Increases & Fixed Expenses Remain Stable,45265,13104.0,32892,45996.0,-731.0,-1.61,-0.04,High Risk
U073,2024,1,211466.0,Salary Increases & Fixed Expenses Increase,195401,54185.0,153447,207632.0,-12231.0,-6.26,0.05,High Risk
U073,2024,2,199235.0,Salary Increases & Fixed Expenses Increase,195401,54185.0,143752,197937.0,-2536.0,-1.3,0.02,High Risk
U073,2024,3,196699.0,Salary Increases & Fixed Expenses Increase,195401,54185.0,143070,197255.0,-1854.0,-0.95,-0.03,High Risk
U073,2024,4,194845.0,Salary Increases & Fixed Expenses Increase,195401,54185.0,123157,177342.0,18059.0,9.24,0.03,High Risk
U073,2024,5,212904.0,Salary Increases & Fixed Expenses Increase,195401,55675.0,144868,200543.0,-5142.0,-2.63,0.05,High Risk
U073,2024,6,207762.0,Salary Increases & Fixed Expenses Increase,217388,55675.0,158211,213886.0,3502.0,1.61,0.02,High Risk
U073,2024,7,211264.0,Salary Increases & Fixed Expenses Increase,217388,55675.0,141858,197533.0,19855.0,9.13,-0.02,High Risk
U073,2024,8,231119.0,Salary Increases & Fixed Expenses Increase,217388,55675.0,168443,224118.0,-6730.0,-3.1,0.04,High Risk
U073,2024,9,224389.0,Salary Increases & Fixed Expenses Increase,217388,55675.0,173413,229088.0,-11700.0,-5.38,0.01,High Risk
U073,2024,10,212689.0,Salary Increases & Fixed Expenses Increase,217388,56310.0,156731,213041.0,4347.0,2.0,-0.01,High Risk
U073,2024,11,217036.0,Salary Increases & Fixed Expenses Increase,217388,56310.0,171415,227725.0,-10337.0,-4.76,-0.0,High Risk
U073,2024,12,206699.0,Salary Increases & Fixed Expenses Increase,217388,56310.0,169882,226192.0,-8804.0,-4.05,0.04,High Risk
U074,2024,1,203897.0,Salary Increases & Fixed Expenses Remain Stable,99498,34626.0,68226,102852.0,-3354.0,-3.37,-0.04,High Risk
U074,2024,2,200543.0,Salary Increases & Fixed Expenses Remain Stable,99498,34626.0,64314,98940.0,558.0,0.56,0.02,High Risk
U074,2024,3,201101.0,Salary Increases & Fixed Expenses Remain Stable,99498,34626.0,61224,95850.0,3648.0,3.67,-0.01,High Risk
U074,2024,4,204749.0,Salary Increases & Fixed Expenses Remain Stable,99498,34626.0,72378,107004.0,-7506.0,-7.54,-0.03,High Risk
U074,2024,5,197243.0,Salary Increases & Fixed Expenses Remain Stable,99498,34626.0,72765,107391.0,-7893.0,-7.93,0.05,High Risk
U074,2024,6,189350.0,Salary Increases & Fixed Expenses Remain Stable,99498,34626.0,76875,111501.0,-12003.0,-12.06,-0.03,High Risk
U074,2024,7,177347.0,Salary Increases & Fixed Expenses Remain Stable,99498,34626.0,74756,109382.0,-9884.0,-9.93,0.03,High Risk
U074,2024,8,167463.0,Salary Increases & Fixed Expenses Remain Stable,111837,34626.0,83157,117783.0,-5946.0,-5.32,-0.02,High Risk
U074,2024,9,161517.0,Salary Increases & Fixed Expenses Remain Stable,111837,34626.0,69957,104583.0,7254.0,6.49,-0.01,High Risk
U074,2024,10,168771.0,Salary Increases & Fixed Expenses Remain Stable,111837,34626.0,75920,110546.0,1291.0,1.15,-0.03,High Risk
U074,2024,11,170062.0,Salary Increases & Fixed Expenses Remain Stable,111837,34626.0,71101,105727.0,6110.0,5.46,-0.01,High Risk
U074,2024,12,176172.0,Salary Increases & Fixed Expenses Remain Stable,111837,34626.0,70864,105490.0,6347.0,5.68,0.03,High Risk
U075,2024,1,247717.0,Stable Salary & Stable Fixed Expenses,230562,91766.0,83873,175639.0,54923.0,23.82,0.02,Medium Risk
U075,2024,2,302640.0,Stable Salary & Stable Fixed Expenses,230562,91766.0,89953,181719.0,48843.0,21.18,-0.0,Medium Risk
U075,2024,3,351483.0,Stable Salary & Stable Fixed Expenses,230562,91766.0,105074,196840.0,33722.0,14.63,-0.04,High Risk
U075,2024,4,385205.0,Stable Salary & Stable Fixed Expenses,230562,91766.0,82587,174353.0,56209.0,24.38,-0.03,Medium Risk
U075,2024,5,441414.0,Stable Salary & Stable Fixed Expenses,230562,91766.0,70183,161949.0,68613.0,29.76,-0.04,Low Risk
U075,2024,6,510027.0,Stable Salary & Stable Fixed Expenses,230562,91766.0,90537,182303.0,48259.0,20.93,-0.01,Medium Risk
U075,2024,7,558286.0,Stable Salary & Stable Fixed Expenses,230562,91766.0,83890,175656.0,54906.0,23.81,0.0,Medium Risk
U075,2024,8,613192.0,Stable Salary & Stable Fixed Expenses,230562,91766.0,88409,180175.0,50387.0,21.85,-0.04,Medium Risk
U075,2024,9,663579.0,Stable Salary & Stable Fixed Expenses,230562,91766.0,77939,169705.0,60857.0,26.4,-0.04,Low Risk
U075,2024,10,724436.0,Stable Salary & Stable Fixed Expenses,230562,91766.0,100014,191780.0,38782.0,16.82,-0.02,Medium Risk
U075,2024,11,763218.0,Stable Salary & Stable Fixed Expenses,230562,91766.0,82091,173857.0,56705.0,24.59,-0.02,Medium Risk
U075,2024,12,819923.0,Stable Salary & Stable Fixed Expenses,230562,91766.0,91669,183435.0,47127.0,20.44,-0.02,Medium Risk
U076,2024,1,216342.0,Stable Salary & Stable Fixed Expenses,133942,70128.0,76796,146924.0,-12982.0,-9.69,-0.01,High Risk
U076,2024,2,203360.0,Stable Salary & Stable Fixed Expenses,133942,70128.0,76884,147012.0,-13070.0,-9.76,-0.05,High Risk
U076,2024,3,190290.0,Stable Salary & Stable Fixed Expenses,133942,70128.0,87343,157471.0,-23529.0,-17.57,0.05,High Risk
U076,2024,4,166761.0,Stable Salary & Stable Fixed Expenses,133942,70128.0,78235,148363.0,-14421.0,-10.77,0.01,High Risk
U076,2024,5,152340.0,Stable Salary & Stable Fixed Expenses,133942,70128.0,57631,127759.0,6183.0,4.62,0.03,High Risk
U076,2024,6,158523.0,Stable Salary & Stable Fixed Expenses,133942,70128.0,56218,126346.0,7596.0,5.67,0.01,High Risk
U076,2024,7,166119.0,Stable Salary & Stable Fixed Expenses,133942,70128.0,68551,138679.0,-4737.0,-3.54,-0.01,High Risk
U076,2024,8,161382.0,Stable Salary & Stable Fixed Expenses,133942,70128.0,70236,140364.0,-6422.0,-4.79,-0.03,High Risk
U076,2024,9,154960.0,Stable Salary & Stable Fixed Expenses,133942,70128.0,66991,137119.0,-3177.0,-2.37,-0.04,High Risk
U076,2024,10,151783.0,Stable Salary & Stable Fixed Expenses,133942,70128.0,80307,150435.0,-16493.0,-12.31,0.01,High Risk
U076,2024,11,135290.0,Stable Salary & Stable Fixed Expenses,133942,70128.0,82405,152533.0,-18591.0,-13.88,0.04,High Risk
U076,2024,12,116699.0,Stable Salary & Stable Fixed Expenses,133942,70128.0,68866,138994.0,-5052.0,-3.77,0.03,High Risk
U077,2024,1,237101.0,Stable Salary & Stable Fixed Expenses,72848,31541.0,35108,66649.0,6199.0,8.51,-0.04,High Risk
U077,2024,2,243300.0,Stable Salary & Stable Fixed Expenses,72848,31541.0,29317,60858.0,11990.0,16.46,-0.01,Medium Risk
U077,2024,3,255290.0,Stable Salary & Stable Fixed Expenses,72848,31541.0,42399,73940.0,-1092.0,-1.5,0.01,High Risk
U077,2024,4,254198.0,Stable Salary & Stable Fixed Expenses,72848,31541.0,35988,67529.0,5319.0,7.3,0.04,High Risk
U077,2024,5,259517.0,Stable Salary & Stable Fixed Expenses,72848,31541.0,39413,70954.0,1894.0,2.6,0.02,High Risk
U077,2024,6,261411.0,Stable Salary & Stable Fixed Expenses,72848,31541.0,37552,69093.0,3755.0,5.15,-0.04,High Risk
U077,2024,7,265166.0,Stable Salary & Stable Fixed Expenses,72848,31541.0,33339,64880.0,7968.0,10.94,0.01,High Risk
U077,2024,8,273134.0,Stable Salary & Stable Fixed Expenses,72848,31541.0,41473,73014.0,-166.0,-0.23,-0.04,High Risk
U077,2024,9,272968.0,Stable Salary & Stable Fixed Expenses,72848,31541.0,30038,61579.0,11269.0,15.47,0.04,Medium Risk
U077,2024,10,284237.0,Stable Salary & Stable Fixed Expenses,72848,31541.0,41219,72760.0,88.0,0.12,-0.05,High Risk
U077,2024,11,284325.0,Stable Salary & Stable Fixed Expenses,72848,31541.0,36278,67819.0,5029.0,6.9,0.03,High Risk
U077,2024,12,289354.0,Stable Salary & Stable Fixed Expenses,72848,31541.0,29827,61368.0,11480.0,15.76,-0.01,Medium Risk
U078,2024,1,249605.0,Stable Salary & Increasing Fixed Expenses,119878,52291.0,70863,123154.0,-3276.0,-2.73,0.01,High Risk
U078,2024,2,246329.0,Stable Salary & Increasing Fixed Expenses,119878,52291.0,48319,100610.0,19268.0,16.07,0.03,Medium Risk
U078,2024,3,265597.0,Stable Salary & Increasing Fixed Expenses,119878,52291.0,69417,121708.0,-1830.0,-1.53,0.04,High Risk
U078,2024,4,263767.0,Stable Salary & Increasing Fixed Expenses,119878,52291.0,62149,114440.0,5438.0,4.54,0.02,High Risk
U078,2024,5,269205.0,Stable Salary & Increasing Fixed Expenses,119878,52291.0,57198,109489.0,10389.0,8.67,0.02,High Risk
U078,2024,6,279594.0,Stable Salary & Increasing Fixed Expenses,119878,52291.0,50726,103017.0,16861.0,14.07,0.01,High Risk
U078,2024,7,296455.0,Stable Salary & Increasing Fixed Expenses,119878,53830.0,65085,118915.0,963.0,0.8,0.02,High Risk
U078,2024,8,297418.0,Stable Salary & Increasing Fixed Expenses,119878,53830.0,53983,107813.0,12065.0,10.06,-0.05,High Risk
U078,2024,9,309483.0,Stable Salary & Increasing Fixed Expenses,119878,53830.0,49765,103595.0,16283.0,13.58,0.0,High Risk
U078,2024,10,325766.0,Stable Salary & Increasing Fixed Expenses,119878,53830.0,63374,117204.0,2674.0,2.23,0.04,High Risk
U078,2024,11,328440.0,Stable Salary & Increasing Fixed Expenses,119878,53830.0,57619,111449.0,8429.0,7.03,0.03,High Risk
U078,2024,12,336869.0,Stable Salary & Increasing Fixed Expenses,119878,53830.0,58365,112195.0,7683.0,6.41,-0.04,High Risk
U079,2024,1,226989.0,Salary Increases & Fixed Expenses Remain Stable,92161,32873.0,37102,69975.0,22186.0,24.07,0.02,Medium Risk
U079,2024,2,249175.0,Salary Increases & Fixed Expenses Remain Stable,92161,32873.0,37574,70447.0,21714.0,23.56,-0.05,Medium Risk
U079,2024,3,270889.0,Salary Increases & Fixed Expenses Remain Stable,92161,32873.0,47236,80109.0,12052.0,13.08,-0.03,High Risk
U079,2024,4,282941.0,Salary Increases & Fixed Expenses Remain Stable,92161,32873.0,50428,83301.0,8860.0,9.61,-0.03,High Risk
U079,2024,5,291801.0,Salary Increases & Fixed Expenses Remain Stable,92161,32873.0,44676,77549.0,14612.0,15.85,-0.03,Medium Risk
U079,2024,6,306413.0,Salary Increases & Fixed Expenses Remain Stable,92161,32873.0,43415,76288.0,15873.0,17.22,-0.01,Medium Risk
U079,2024,7,322286.0,Salary Increases & Fixed Expenses Remain Stable,119247,32873.0,59872,92745.0,26502.0,22.22,0.02,Medium Risk
U079,2024,8,348788.0,Salary Increases & Fixed Expenses Remain Stable,119247,32873.0,66538,99411.0,19836.0,16.63,-0.0,Medium Risk
U079,2024,9,368624.0,Salary Increases & Fixed Expenses Remain Stable,119247,32873.0,63098,95971.0,23276.0,19.52,-0.03,Medium Risk
U079,2024,10,391900.0,Salary Increases & Fixed Expenses Remain Stable,119247,32873.0,80322,113195.0,6052.0,5.08,0.04,High Risk
U079,2024,11,397952.0,Salary Increases & Fixed Expenses Remain Stable,119247,32873.0,75957,108830.0,10417.0,8.74,0.03,High Risk
U079,2024,12,408369.0,Salary Increases & Fixed Expenses Remain Stable,119247,32873.0,76211,109084.0,10163.0,8.52,-0.03,High Risk
U080,2024,1,212242.0,Salary Increases & Fixed Expenses Increase,107736,64329.0,47911,112240.0,-4504.0,-4.18,-0.02,High Risk
U080,2024,2,207738.0,Salary Increases & Fixed Expenses Increase,107736,64329.0,63792,128121.0,-20385.0,-18.92,0.03,High Risk
U080,2024,3,187353.0,Salary Increases & Fixed Expenses Increase,107736,64329.0,65253,129582.0,-21846.0,-20.28,-0.01,High Risk
U080,2024,4,165507.0,Salary Increases & Fixed Expenses Increase,107736,64329.0,51740,116069.0,-8333.0,-7.73,0.01,High Risk
U080,2024,5,157174.0,Salary Increases & Fixed Expenses Increase,107736,64329.0,57903,122232.0,-14496.0,-13.46,0.01,High Risk
U080,2024,6,142678.0,Salary Increases & Fixed Expenses Increase,120707,64329.0,49817,114146.0,6561.0,5.44,-0.0,High Risk
U080,2024,7,149239.0,Salary Increases & Fixed Expenses Increase,120707,64329.0,65365,129694.0,-8987.0,-7.45,-0.04,High Risk
U080,2024,8,140252.0,Salary Increases & Fixed Expenses Increase,120707,64329.0,64392,128721.0,-8014.0,-6.64,0.01,High Risk
U080,2024,9,132238.0,Salary Increases & Fixed Expenses Increase,120707,64329.0,66947,131276.0,-10569.0,-8.76,0.03,High Risk
U080,2024,10,121669.0,Salary Increases & Fixed Expenses Increase,120707,65269.0,81035,146304.0,-25597.0,-21.21,0.04,High Risk
U080,2024,11,96072.0,Salary Increases & Fixed Expenses Increase,120707,65269.0,71698,136967.0,-16260.0,-13.47,-0.04,High Risk
U080,2024,12,79812.0,Salary Increases & Fixed Expenses Increase,120707,66062.0,70453,136515.0,-15808.0,-13.1,-0.01,High Risk
U081,2024,1,231207.0,Salary Increases & Fixed Expenses Increase,29763,14512.0,13079,27591.0,2172.0,7.3,-0.03,High Risk
U081,2024,2,233379.0,Salary Increases & Fixed Expenses Increase,29763,14512.0,14184,28696.0,1067.0,3.58,0.04,High Risk
U081,2024,3,234446.0,Salary Increases & Fixed Expenses Increase,29763,14512.0,16831,31343.0,-1580.0,-5.31,0.01,High Risk
U081,2024,4,232866.0,Salary Increases & Fixed Expenses Increase,29763,14512.0,16843,31355.0,-1592.0,-5.35,-0.04,High Risk
U081,2024,5,231274.0,Salary Increases & Fixed Expenses Increase,29763,14512.0,16436,30948.0,-1185.0,-3.98,-0.05,High Risk
U081,2024,6,230089.0,Salary Increases & Fixed Expenses Increase,53294,14512.0,22912,37424.0,15870.0,29.78,-0.04,Low Risk
U081,2024,7,245959.0,Salary Increases & Fixed Expenses Increase,53294,16205.0,24762,40967.0,12327.0,23.13,-0.01,Medium Risk
U081,2024,8,258286.0,Salary Increases & Fixed Expenses Increase,53294,16205.0,30377,46582.0,6712.0,12.59,0.04,High Risk
U081,2024,9,264998.0,Salary Increases & Fixed Expenses Increase,53294,16205.0,30129,46334.0,6960.0,13.06,-0.04,High Risk
U081,2024,10,271958.0,Salary Increases & Fixed Expenses Increase,53294,16205.0,27082,43287.0,10007.0,18.78,0.03,Medium Risk
U081,2024,11,281965.0,Salary Increases & Fixed Expenses Increase,53294,16205.0,30101,46306.0,6988.0,13.11,0.03,High Risk
U081,2024,12,288953.0,Salary Increases & Fixed Expenses Increase,53294,18182.0,22058,40240.0,13054.0,24.49,-0.02,Medium Risk
U082,2024,1,227098.0,Salary Increases & Fixed Expenses Remain Stable,80932,27820.0,36104,63924.0,17008.0,21.02,0.02,Medium Risk
U082,2024,2,244106.0,Salary Increases & Fixed Expenses Remain Stable,80932,27820.0,34679,62499.0,18433.0,22.78,-0.02,Medium Risk
U082,2024,3,262539.0,Salary Increases & Fixed Expenses Remain Stable,80932,27820.0,51438,79258.0,1674.0,2.07,-0.04,High Risk
U082,2024,4,264213.0,Salary Increases & Fixed Expenses Remain Stable,86197,27820.0,46450,74270.0,11927.0,13.84,0.02,High Risk
U082,2024,5,276140.0,Salary Increases & Fixed Expenses Remain Stable,86197,27820.0,38370,66190.0,20007.0,23.21,-0.01,Medium Risk
U082,2024,6,296147.0,Salary Increases & Fixed Expenses Remain Stable,86197,27820.0,45938,73758.0,12439.0,14.43,0.02,High Risk
U082,2024,7,308586.0,Salary Increases & Fixed Expenses Remain Stable,86197,27820.0,35137,62957.0,23240.0,26.96,0.04,Low Risk
U082,2024,8,331826.0,Salary Increases & Fixed Expenses Remain Stable,86197,27820.0,48769,76589.0,9608.0,11.15,-0.03,High Risk
U082,2024,9,341434.0,Salary Increases & Fixed Expenses Remain Stable,86197,27820.0,50760,78580.0,7617.0,8.84,0.05,High Risk
U082,2024,10,349051.0,Salary Increases & Fixed Expenses Remain Stable,86197,27820.0,47283,75103.0,11094.0,12.87,-0.05,High Risk
U082,2024,11,360145.0,Salary Increases & Fixed Expenses Remain Stable,86197,27820.0,40472,68292.0,17905.0,20.77,0.04,Medium Risk
U082,2024,12,378050.0,Salary Increases & Fixed Expenses Remain Stable,86197,27820.0,51125,78945.0,7252.0,8.41,0.02,High Risk
U083,2024,1,220428.0,Stable Salary & Stable Fixed Expenses,269032,70947.0,135095,206042.0,62990.0,23.41,-0.04,Medium Risk
U083,2024,2,283418.0,Stable Salary & Stable Fixed Expenses,269032,70947.0,145305,216252.0,52780.0,19.62,0.04,Medium Risk
U083,2024,3,336198.0,Stable Salary & Stable Fixed Expenses,269032,70947.0,142117,213064.0,55968.0,20.8,0.01,Medium Risk
U083,2024,4,392166.0,Stable Salary & Stable Fixed Expenses,269032,70947.0,118049,188996.0,80036.0,29.75,0.05,Low Risk
U083,2024,5,472202.0,Stable Salary & Stable Fixed Expenses,269032,70947.0,109221,180168.0,88864.0,33.03,0.03,Low Risk
U083,2024,6,561066.0,Stable Salary & Stable Fixed Expenses,269032,70947.0,144523,215470.0,53562.0,19.91,0.03,Medium Risk
U083,2024,7,614628.0,Stable Salary & Stable Fixed Expenses,269032,70947.0,161273,232220.0,36812.0,13.68,0.02,High Risk
U083,2024,8,651440.0,Stable Salary & Stable Fixed Expenses,269032,70947.0,157268,228215.0,40817.0,15.17,0.0,Medium Risk
U083,2024,9,692257.0,Stable Salary & Stable Fixed Expenses,269032,70947.0,152947,223894.0,45138.0,16.78,-0.02,Medium Risk
U083,2024,10,737395.0,Stable Salary & Stable Fixed Expenses,269032,70947.0,121190,192137.0,76895.0,28.58,0.02,Low Risk
U083,2024,11,814290.0,Stable Salary & Stable Fixed Expenses,269032,70947.0,161120,232067.0,36965.0,13.74,-0.04,High Risk
U083,2024,12,851255.0,Stable Salary & Stable Fixed Expenses,269032,70947.0,144786,215733.0,53299.0,19.81,-0.03,Medium Risk
U084,2024,1,226834.0,Salary Increases & Fixed Expenses Remain Stable,21892,21897.0,14438,36335.0,-14443.0,-65.97,-0.01,High Risk
U084,2024,2,212391.0,Salary Increases & Fixed Expenses Remain Stable,21892,21897.0,13147,35044.0,-13152.0,-60.08,-0.02,High Risk
U084,2024,3,199239.0,Salary Increases & Fixed Expenses Remain Stable,21892,21897.0,16993,38890.0,-16998.0,-77.64,0.03,High Risk
U084,2024,4,182241.0,Salary Increases & Fixed Expenses Remain Stable,21892,21897.0,14461,36358.0,-14466.0,-66.08,0.01,High Risk
U084,2024,5,167775.0,Salary Increases & Fixed Expenses Remain Stable,21892,21897.0,15766,37663.0,-15771.0,-72.04,0.02,High Risk
U084,2024,6,152004.0,Salary Increases & Fixed Expenses Remain Stable,21892,21897.0,14374,36271.0,-14379.0,-65.68,-0.04,High Risk
U084,2024,7,137625.0,Salary Increases & Fixed Expenses Remain Stable,21892,21897.0,14045,35942.0,-14050.0,-64.18,-0.02,High Risk
U084,2024,8,123575.0,Salary Increases & Fixed Expenses Remain Stable,50968,21897.0,36559,58456.0,-7488.0,-14.69,-0.03,High Risk
U084,2024,9,116087.0,Salary Increases & Fixed Expenses Remain Stable,50968,21897.0,35138,57035.0,-6067.0,-11.9,0.02,High Risk
U084,2024,10,110020.0,Salary Increases & Fixed Expenses Remain Stable,50968,21897.0,31574,53471.0,-2503.0,-4.91,0.01,High Risk
U084,2024,11,107517.0,Salary Increases & Fixed Expenses Remain Stable,50968,21897.0,33453,55350.0,-4382.0,-8.6,0.02,High Risk
U084,2024,12,103135.0,Salary Increases & Fixed Expenses Remain Stable,50968,21897.0,37301,59198.0,-8230.0,-16.15,-0.02,High Risk
U085,2024,1,248254.0,Stable Salary & Increasing Fixed Expenses,67372,32653.0,28585,61238.0,6134.0,9.1,0.04,High Risk
U085,2024,2,254388.0,Stable Salary & Increasing Fixed Expenses,67372,32653.0,33891,66544.0,828.0,1.23,0.04,High Risk
U085,2024,3,255216.0,Stable Salary & Increasing Fixed Expenses,67372,32653.0,28430,61083.0,6289.0,9.33,-0.04,High Risk
U085,2024,4,261505.0,Stable Salary & Increasing Fixed Expenses,67372,32653.0,37425,70078.0,-2706.0,-4.02,-0.03,High Risk
U085,2024,5,258799.0,Stable Salary & Increasing Fixed Expenses,67372,32653.0,39777,72430.0,-5058.0,-7.51,-0.02,High Risk
U085,2024,6,253741.0,Stable Salary & Increasing Fixed Expenses,67372,32653.0,39002,71655.0,-4283.0,-6.36,-0.02,High Risk
U085,2024,7,249458.0,Stable Salary & Increasing Fixed Expenses,67372,32653.0,30973,63626.0,3746.0,5.56,-0.03,High Risk
U085,2024,8,253204.0,Stable Salary & Increasing Fixed Expenses,67372,32653.0,40116,72769.0,-5397.0,-8.01,-0.05,High Risk
U085,2024,9,247807.0,Stable Salary & Increasing Fixed Expenses,67372,32653.0,29872,62525.0,4847.0,7.19,0.01,High Risk
U085,2024,10,252654.0,Stable Salary & Increasing Fixed Expenses,67372,32653.0,38652,71305.0,-3933.0,-5.84,-0.0,High Risk
U085,2024,11,248721.0,Stable Salary & Increasing Fixed Expenses,67372,32653.0,36457,69110.0,-1738.0,-2.58,0.04,High Risk
U085,2024,12,246983.0,Stable Salary & Increasing Fixed Expenses,67372,32653.0,38448,71101.0,-3729.0,-5.53,0.02,High Risk
U086,2024,1,237677.0,Salary Increases & Fixed Expenses Decrease,75318,36854.0,32772,69626.0,5692.0,7.56,-0.01,High Risk
U086,2024,2,243369.0,Salary Increases & Fixed Expenses Decrease,75318,36854.0,37754,74608.0,710.0,0.94,0.03,High Risk
U086,2024,3,244079.0,Salary Increases & Fixed Expenses Decrease,92467,36854.0,51249,88103.0,4364.0,4.72,0.01,High Risk
U086,2024,4,248443.0,Salary Increases & Fixed Expenses Decrease,92467,36854.0,55007,91861.0,606.0,0.66,-0.03,High Risk
U086,2024,5,249049.0,Salary Increases & Fixed Expenses Decrease,92467,36854.0,40641,77495.0,14972.0,16.19,0.03,Medium Risk
U086,2024,6,264021.0,Salary Increases & Fixed Expenses Decrease,92467,36854.0,49146,86000.0,6467.0,6.99,0.01,High Risk
U086,2024,7,270488.0,Salary Increases & Fixed Expenses Decrease,92467,35161.0,43232,78393.0,14074.0,15.22,-0.01,Medium Risk
U086,2024,8,284562.0,Salary Increases & Fixed Expenses Decrease,92467,35161.0,45616,80777.0,11690.0,12.64,0.05,High Risk
U086,2024,9,296252.0,Salary Increases & Fixed Expenses Decrease,92467,35161.0,52498,87659.0,4808.0,5.2,0.03,High Risk
U086,2024,10,301060.0,Salary Increases & Fixed Expenses Decrease,92467,35161.0,46953,82114.0,10353.0,11.2,-0.02,High Risk
U086,2024,11,311413.0,Salary Increases & Fixed Expenses Decrease,92467,35161.0,46742,81903.0,10564.0,11.42,0.0,High Risk
U086,2024,12,321977.0,Salary Increases & Fixed Expenses Decrease,92467,35161.0,51165,86326.0,6141.0,6.64,-0.05,High Risk
U087,2024,1,218063.0,Stable Salary & Increasing Fixed Expenses,260653,96085.0,87487,183572.0,77081.0,29.57,-0.04,Low Risk
U087,2024,2,295144.0,Stable Salary & Increasing Fixed Expenses,260653,96085.0,97804,193889.0,66764.0,25.61,-0.04,Low Risk
U087,2024,3,361908.0,Stable Salary & Increasing Fixed Expenses,260653,97828.0,96342,194170.0,66483.0,25.51,0.02,Low Risk
U087,2024,4,428391.0,Stable Salary & Increasing Fixed Expenses,260653,97828.0,81741,179569.0,81084.0,31.11,0.01,Low Risk
U087,2024,5,509475.0,Stable Salary & Increasing Fixed Expenses,260653,97828.0,86689,184517.0,76136.0,29.21,0.03,Low Risk
U087,2024,6,585611.0,Stable Salary & Increasing Fixed Expenses,260653,97828.0,97806,195634.0,65019.0,24.94,0.03,Medium Risk
U087,2024,7,650630.0,Stable Salary & Increasing Fixed Expenses,260653,97828.0,102577,200405.0,60248.0,23.11,0.01,Medium Risk
U087,2024,8,710878.0,Stable Salary & Increasing Fixed Expenses,260653,97828.0,86192,184020.0,76633.0,29.4,-0.04,Low Risk
U087,2024,9,787511.0,Stable Salary & Increasing Fixed Expenses,260653,99581.0,80785,180366.0,80287.0,30.8,0.04,Low Risk
U087,2024,10,867798.0,Stable Salary & Increasing Fixed Expenses,260653,99581.0,92110,191691.0,68962.0,26.46,-0.03,Low Risk
U087,2024,11,936760.0,Stable Salary & Increasing Fixed Expenses,260653,100934.0,79077,180011.0,80642.0,30.94,-0.05,Low Risk
U087,2024,12,1017402.0,Stable Salary & Increasing Fixed Expenses,260653,102507.0,89456,191963.0,68690.0,26.35,-0.03,Low Risk
U088,2024,1,235055.0,Stable Salary & Stable Fixed Expenses,268586,96510.0,106427,202937.0,65649.0,24.44,-0.03,Medium Risk
U088,2024,2,300704.0,Stable Salary & Stable Fixed Expenses,268586,96510.0,91204,187714.0,80872.0,30.11,0.03,Low Risk
U088,2024,3,381576.0,Stable Salary & Stable Fixed Expenses,268586,96510.0,115240,211750.0,56836.0,21.16,-0.01,Medium Risk
U088,2024,4,438412.0,Stable Salary & Stable Fixed Expenses,268586,96510.0,106922,203432.0,65154.0,24.26,0.04,Medium Risk
U088,2024,5,503566.0,Stable Salary & Stable Fixed Expenses,268586,96510.0,96564,193074.0,75512.0,28.11,0.04,Low Risk
U088,2024,6,579078.0,Stable Salary & Stable Fixed Expenses,268586,96510.0,93356,189866.0,78720.0,29.31,-0.01,Low Risk
U088,2024,7,657798.0,Stable Salary & Stable Fixed Expenses,268586,96510.0,82910,179420.0,89166.0,33.2,0.01,Low Risk
U088,2024,8,746964.0,Stable Salary & Stable Fixed Expenses,268586,96510.0,105417,201927.0,66659.0,24.82,0.03,Medium Risk
U088,2024,9,813623.0,Stable Salary & Stable Fixed Expenses,268586,96510.0,105048,201558.0,67028.0,24.96,0.01,Medium Risk
U088,2024,10,880651.0,Stable Salary & Stable Fixed Expenses,268586,96510.0,110199,206709.0,61877.0,23.04,-0.02,Medium Risk
U088,2024,11,942528.0,Stable Salary & Stable Fixed Expenses,268586,96510.0,88901,185411.0,83175.0,30.97,-0.03,Low Risk
U088,2024,12,1025703.0,Stable Salary & Stable Fixed Expenses,268586,96510.0,92970,189480.0,79106.0,29.45,0.04,Low Risk
U089,2024,1,247226.0,Stable Salary & Stable Fixed Expenses,198703,71955.0,94320,166275.0,32428.0,16.32,0.03,Medium Risk
U089,2024,2,279654.0,Stable Salary & Stable Fixed Expenses,198703,71955.0,91906,163861.0,34842.0,17.53,0.02,Medium Risk
U089,2024,3,314496.0,Stable Salary & Stable Fixed Expenses,198703,71955.0,114446,186401.0,12302.0,6.19,-0.03,High Risk
U089,2024,4,326798.0,Stable Salary & Stable Fixed Expenses,198703,71955.0,79850,151805.0,46898.0,23.6,-0.0,Medium Risk
U089,2024,5,373696.0,Stable Salary & Stable Fixed Expenses,198703,71955.0,98604,170559.0,28144.0,14.16,0.03,High Risk
U089,2024,6,401840.0,Stable Salary & Stable Fixed Expenses,198703,71955.0,85699,157654.0,41049.0,20.66,-0.03,Medium Risk
U089,2024,7,442889.0,Stable Salary & Stable Fixed Expenses,198703,71955.0,113508,185463.0,13240.0,6.66,0.02,High Risk
U089,2024,8,456129.0,Stable Salary & Stable Fixed Expenses,198703,71955.0,80698,152653.0,46050.0,23.18,0.05,Medium Risk
U089,2024,9,502179.0,Stable Salary & Stable Fixed Expenses,198703,71955.0,98988,170943.0,27760.0,13.97,-0.03,High Risk
U089,2024,10,529939.0,Stable Salary & Stable Fixed Expenses,198703,71955.0,122086,194041.0,4662.0,2.35,0.03,High Risk
U089,2024,11,534601.0,Stable Salary & Stable Fixed Expenses,198703,71955.0,112439,184394.0,14309.0,7.2,-0.03,High Risk
U089,2024,12,548910.0,Stable Salary & Stable Fixed Expenses,198703,71955.0,89409,161364.0,37339.0,18.79,-0.03,Medium Risk
U090,2024,1,216149.0,Salary Increases & Fixed Expenses Increase,45657,15630.0,19159,34789.0,10868.0,23.8,-0.04,Medium Risk
U090,2024,2,227017.0,Salary Increases & Fixed Expenses Increase,45657,15630.0,18810,34440.0,11217.0,24.57,0.04,Medium Risk
U090,2024,3,238234.0,Salary Increases & Fixed Expenses Increase,45657,15630.0,24130,39760.0,5897.0,12.92,-0.03,High Risk
U090,2024,4,244131.0,Salary Increases & Fixed Expenses Increase,45657,15630.0,21935,37565.0,8092.0,17.72,0.01,Medium Risk
U090,2024,5,252223.0,Salary Increases & Fixed Expenses Increase,45657,15630.0,25641,41271.0,4386.0,9.61,0.02,High Risk
U090,2024,6,256609.0,Salary Increases & Fixed Expenses Increase,45657,15630.0,26446,42076.0,3581.0,7.84,-0.04,High Risk
U090,2024,7,260190.0,Salary Increases & Fixed Expenses Increase,45657,15630.0,23559,39189.0,6468.0,14.17,-0.02,High Risk
U090,2024,8,266658.0,Salary Increases & Fixed Expenses Increase,56157,16683.0,25311,41994.0,14163.0,25.22,-0.04,Low Risk
U090,2024,9,280821.0,Salary Increases & Fixed Expenses Increase,56157,16683.0,32621,49304.0,6853.0,12.2,-0.03,High Risk
U090,2024,10,287674.0,Salary Increases & Fixed Expenses Increase,56157,16683.0,30101,46784.0,9373.0,16.69,-0.04,Medium Risk
U090,2024,11,297047.0,Salary Increases & Fixed Expenses Increase,56157,16683.0,30060,46743.0,9414.0,16.76,0.05,Medium Risk
U090,2024,12,306461.0,Salary Increases & Fixed Expenses Increase,56157,16683.0,25112,41795.0,14362.0,25.57,-0.02,Low Risk
U091,2024,1,208307.0,Salary Increases & Fixed Expenses Remain Stable,258280,112399.0,103879,216278.0,42002.0,16.26,-0.01,Medium Risk
U091,2024,2,250309.0,Salary Increases & Fixed Expenses Remain Stable,258280,112399.0,140231,252630.0,5650.0,2.19,-0.04,High Risk
U091,2024,3,255959.0,Salary Increases & Fixed Expenses Remain Stable,258280,112399.0,175457,287856.0,-29576.0,-11.45,0.04,High Risk
U091,2024,4,226383.0,Salary Increases & Fixed Expenses Remain Stable,258280,112399.0,115424,227823.0,30457.0,11.79,0.02,High Risk
U091,2024,5,256840.0,Salary Increases & Fixed Expenses Remain Stable,258280,112399.0,144001,256400.0,1880.0,0.73,-0.0,High Risk
U091,2024,6,258720.0,Salary Increases & Fixed Expenses Remain Stable,272950,112399.0,116673,229072.0,43878.0,16.08,-0.02,Medium Risk
U091,2024,7,302598.0,Salary Increases & Fixed Expenses Remain Stable,272950,112399.0,135513,247912.0,25038.0,9.17,-0.05,High Risk
U091,2024,8,327636.0,Salary Increases & Fixed Expenses Remain Stable,272950,112399.0,116234,228633.0,44317.0,16.24,-0.03,Medium Risk
U091,2024,9,371953.0,Salary Increases & Fixed Expenses Remain Stable,272950,112399.0,145303,257702.0,15248.0,5.59,-0.01,High Risk
U091,2024,10,387201.0,Salary Increases & Fixed Expenses Remain Stable,272950,112399.0,142176,254575.0,18375.0,6.73,0.01,High Risk
U091,2024,11,405576.0,Salary Increases & Fixed Expenses Remain Stable,272950,112399.0,142656,255055.0,17895.0,6.56,0.0,High Risk
U091,2024,12,423471.0,Salary Increases & Fixed Expenses Remain Stable,272950,112399.0,122954,235353.0,37597.0,13.77,-0.04,High Risk
U092,2024,1,226647.0,Salary Increases & Fixed Expenses Remain Stable,85389,33858.0,52697,86555.0,-1166.0,-1.37,-0.01,High Risk
U092,2024,2,225481.0,Salary Increases & Fixed Expenses Remain Stable,85389,33858.0,67059,100917.0,-15528.0,-18.19,-0.03,High Risk
U092,2024,3,209953.0,Salary Increases & Fixed Expenses Remain Stable,85389,33858.0,57626,91484.0,-6095.0,-7.14,-0.02,High Risk
U092,2024,4,203858.0,Salary Increases & Fixed Expenses Remain Stable,85389,33858.0,67874,101732.0,-16343.0,-19.14,0.04,High Risk
U092,2024,5,187515.0,Salary Increases & Fixed Expenses Remain Stable,85389,33858.0,52510,86368.0,-979.0,-1.15,0.05,High Risk
U092,2024,6,186536.0,Salary Increases & Fixed Expenses Remain Stable,85389,33858.0,67776,101634.0,-16245.0,-19.02,-0.04,High Risk
U092,2024,7,170291.0,Salary Increases & Fixed Expenses Remain Stable,113946,33858.0,74339,108197.0,5749.0,5.05,0.02,High Risk
U092,2024,8,176040.0,Salary Increases & Fixed Expenses Remain Stable,113946,33858.0,71860,105718.0,8228.0,7.22,0.02,High Risk
U092,2024,9,184268.0,Salary Increases & Fixed Expenses Remain Stable,113946,33858.0,87375,121233.0,-7287.0,-6.4,0.03,High Risk
U092,2024,10,176981.0,Salary Increases & Fixed Expenses Remain Stable,113946,33858.0,72234,106092.0,7854.0,6.89,0.04,High Risk
U092,2024,11,184835.0,Salary Increases & Fixed Expenses Remain Stable,113946,33858.0,85484,119342.0,-5396.0,-4.74,0.03,High Risk
U092,2024,12,179439.0,Salary Increases & Fixed Expenses Remain Stable,113946,33858.0,85283,119141.0,-5195.0,-4.56,0.01,High Risk
U093,2024,1,233369.0,Stable Salary & Stable Fixed Expenses,121165,74670.0,59997,134667.0,-13502.0,-11.14,0.03,High Risk
U093,2024,2,219867.0,Stable Salary & Stable Fixed Expenses,121165,74670.0,62094,136764.0,-15599.0,-12.87,0.01,High Risk
U093,2024,3,204268.0,Stable Salary & Stable Fixed Expenses,121165,74670.0,88443,163113.0,-41948.0,-34.62,0.02,High Risk
U093,2024,4,162320.0,Stable Salary & Stable Fixed Expenses,121165,74670.0,59751,134421.0,-13256.0,-10.94,0.04,High Risk
U093,2024,5,149064.0,Stable Salary & Stable Fixed Expenses,121165,74670.0,71205,145875.0,-24710.0,-20.39,-0.04,High Risk
U093,2024,6,124354.0,Stable Salary & Stable Fixed Expenses,121165,74670.0,64242,138912.0,-17747.0,-14.65,-0.04,High Risk
U093,2024,7,106607.0,Stable Salary & Stable Fixed Expenses,121165,74670.0,53045,127715.0,-6550.0,-5.41,-0.02,High Risk
U093,2024,8,100057.0,Stable Salary & Stable Fixed Expenses,121165,74670.0,51166,125836.0,-4671.0,-3.86,-0.02,High Risk
U093,2024,9,95386.0,Stable Salary & Stable Fixed Expenses,121165,74670.0,56202,130872.0,-9707.0,-8.01,-0.01,High Risk
U093,2024,10,85679.0,Stable Salary & Stable Fixed Expenses,121165,74670.0,65920,140590.0,-19425.0,-16.03,-0.03,High Risk
U093,2024,11,66254.0,Stable Salary & Stable Fixed Expenses,121165,74670.0,81085,155755.0,-34590.0,-28.55,-0.0,High Risk
U093,2024,12,31664.0,Stable Salary & Stable Fixed Expenses,121165,74670.0,60872,135542.0,-14377.0,-11.87,0.05,High Risk
U094,2024,1,205876.0,Salary Increases & Fixed Expenses Remain Stable,48202,16917.0,27810,44727.0,3475.0,7.21,0.0,High Risk
U094,2024,2,209351.0,Salary Increases & Fixed Expenses Remain Stable,48202,16917.0,24894,41811.0,6391.0,13.26,0.01,High Risk
U094,2024,3,215742.0,Salary Increases & Fixed Expenses Remain Stable,69709,16917.0,35689,52606.0,17103.0,24.53,0.03,Medium Risk
U094,2024,4,232845.0,Salary Increases & Fixed Expenses Remain Stable,69709,16917.0,36362,53279.0,16430.0,23.57,-0.04,Medium Risk
U094,2024,5,249275.0,Salary Increases & Fixed Expenses Remain Stable,69709,16917.0,33721,50638.0,19071.0,27.36,-0.04,Low Risk
U094,2024,6,268346.0,Salary Increases & Fixed Expenses Remain Stable,69709,16917.0,37704,54621.0,15088.0,21.64,0.03,Medium Risk
U094,2024,7,283434.0,Salary Increases & Fixed Expenses Remain Stable,69709,16917.0,35488,52405.0,17304.0,24.82,-0.02,Medium Risk
U094,2024,8,300738.0,Salary Increases & Fixed Expenses Remain Stable,69709,16917.0,36725,53642.0,16067.0,23.05,-0.02,Medium Risk
U094,2024,9,316805.0,Salary Increases & Fixed Expenses Remain Stable,69709,16917.0,41249,58166.0,11543.0,16.56,-0.01,Medium Risk
U094,2024,10,328348.0,Salary Increases & Fixed Expenses Remain Stable,69709,16917.0,44279,61196.0,8513.0,12.21,-0.02,High Risk
U094,2024,11,336861.0,Salary Increases & Fixed Expenses Remain Stable,69709,16917.0,34836,51753.0,17956.0,25.76,-0.02,Low Risk
U094,2024,12,354817.0,Salary Increases & Fixed Expenses Remain Stable,69709,16917.0,49624,66541.0,3168.0,4.54,0.04,High Risk
U095,2024,1,209891.0,Stable Salary & Increasing Fixed Expenses,252102,69548.0,130946,200494.0,51608.0,20.47,0.01,Medium Risk
U095,2024,2,261499.0,Stable Salary & Increasing Fixed Expenses,252102,69548.0,138774,208322.0,43780.0,17.37,0.0,Medium Risk
U095,2024,3,305279.0,Stable Salary & Increasing Fixed Expenses,252102,69548.0,138584,208132.0,43970.0,17.44,-0.04,Medium Risk
U095,2024,4,349249.0,Stable Salary & Increasing Fixed Expenses,252102,69548.0,109659,179207.0,72895.0,28.91,0.03,Low Risk
U095,2024,5,422144.0,Stable Salary & Increasing Fixed Expenses,252102,69548.0,145034,214582.0,37520.0,14.88,-0.03,High Risk
U095,2024,6,459664.0,Stable Salary & Increasing Fixed Expenses,252102,69548.0,121006,190554.0,61548.0,24.41,0.0,Medium Risk
U095,2024,7,521212.0,Stable Salary & Increasing Fixed Expenses,252102,69548.0,139159,208707.0,43395.0,17.21,-0.01,Medium Risk
U095,2024,8,564607.0,Stable Salary & Increasing Fixed Expenses,252102,69548.0,106566,176114.0,75988.0,30.14,-0.05,Low Risk
U095,2024,9,640595.0,Stable Salary & Increasing Fixed Expenses,252102,69548.0,117515,187063.0,65039.0,25.8,-0.02,Low Risk
U095,2024,10,705634.0,Stable Salary & Increasing Fixed Expenses,252102,69548.0,128356,197904.0,54198.0,21.5,-0.05,Medium Risk
U095,2024,11,759832.0,Stable Salary & Increasing Fixed Expenses,252102,69548.0,124149,193697.0,58405.0,23.17,-0.03,Medium Risk
U095,2024,12,818237.0,Stable Salary & Increasing Fixed Expenses,252102,69548.0,151082,220630.0,31472.0,12.48,0.01,High Risk
U096,2024,1,225906.0,Stable Salary & Stable Fixed Expenses,149455,63103.0,105736,168839.0,-19384.0,-12.97,-0.04,High Risk
U096,2024,2,206522.0,Stable Salary & Stable Fixed Expenses,149455,63103.0,90798,153901.0,-4446.0,-2.97,0.05,High Risk
U096,2024,3,202076.0,Stable Salary & Stable Fixed Expenses,149455,63103.0,140754,203857.0,-54402.0,-36.4,0.01,High Risk
U096,2024,4,147674.0,Stable Salary & Stable Fixed Expenses,149455,63103.0,117187,180290.0,-30835.0,-20.63,-0.0,High Risk
U096,2024,5,116839.0,Stable Salary & Stable Fixed Expenses,149455,63103.0,112461,175564.0,-26109.0,-17.47,0.02,High Risk
U096,2024,6,90730.0,Stable Salary & Stable Fixed Expenses,149455,63103.0,102538,165641.0,-16186.0,-10.83,0.02,High Risk
U096,2024,7,74544.0,Stable Salary & Stable Fixed Expenses,149455,63103.0,114283,177386.0,-27931.0,-18.69,0.01,High Risk
U096,2024,8,46613.0,Stable Salary & Stable Fixed Expenses,149455,63103.0,110444,173547.0,-24092.0,-16.12,0.02,High Risk
U096,2024,9,22521.0,Stable Salary & Stable Fixed Expenses,149455,63103.0,116848,179951.0,-30496.0,-20.4,-0.03,High Risk
U096,2024,10,-7975.0,Stable Salary & Stable Fixed Expenses,149455,63103.0,121049,184152.0,-34697.0,-23.22,-0.0,High Risk
U096,2024,11,-42672.0,Stable Salary & Stable Fixed Expenses,149455,63103.0,95677,158780.0,-9325.0,-6.24,0.03,High Risk
U096,2024,12,-51997.0,Stable Salary & Stable Fixed Expenses,149455,63103.0,108999,172102.0,-22647.0,-15.15,0.01,High Risk
U097,2024,1,235167.0,Salary Increases & Fixed Expenses Increase,238616,77859.0,137841,215700.0,22916.0,9.6,-0.04,High Risk
U097,2024,2,258083.0,Salary Increases & Fixed Expenses Increase,238616,77859.0,111497,189356.0,49260.0,20.64,0.02,Medium Risk
U097,2024,3,307343.0,Salary Increases & Fixed Expenses Increase,267601,77859.0,150065,227924.0,39677.0,14.83,-0.04,High Risk
U097,2024,4,347020.0,Salary Increases & Fixed Expenses Increase,267601,77859.0,149732,227591.0,40010.0,14.95,-0.04,High Risk
U097,2024,5,387030.0,Salary Increases & Fixed Expenses Increase,267601,77859.0,113957,191816.0,75785.0,28.32,-0.04,Low Risk
U097,2024,6,462815.0,Salary Increases & Fixed Expenses Increase,267601,77859.0,124444,202303.0,65298.0,24.4,-0.05,Medium Risk
U097,2024,7,528113.0,Salary Increases & Fixed Expenses Increase,267601,77859.0,160494,238353.0,29248.0,10.93,-0.01,High Risk
U097,2024,8,557361.0,Salary Increases & Fixed Expenses Increase,267601,79662.0,118145,197807.0,69794.0,26.08,-0.05,Low Risk
U097,2024,9,627155.0,Salary Increases & Fixed Expenses Increase,267601,79662.0,141785,221447.0,46154.0,17.25,-0.04,Medium Risk
U097,2024,10,673309.0,Salary Increases & Fixed Expenses Increase,267601,79662.0,141767,221429.0,46172.0,17.25,0.03,Medium Risk
U097,2024,11,719481.0,Salary Increases & Fixed Expenses Increase,267601,79662.0,108497,188159.0,79442.0,29.69,-0.02,Low Risk
U097,2024,12,798923.0,Salary Increases & Fixed Expenses Increase,267601,79662.0,134873,214535.0,53066.0,19.83,-0.02,Medium Risk
U098,2024,1,232915.0,Stable Salary & Stable Fixed Expenses,94547,39893.0,34937,74830.0,19717.0,20.85,0.0,Medium Risk
U098,2024,2,252632.0,Stable Salary & Stable Fixed Expenses,94547,39893.0,34656,74549.0,19998.0,21.15,0.04,Medium Risk
U098,2024,3,272630.0,Stable Salary & Stable Fixed Expenses,94547,39893.0,34722,74615.0,19932.0,21.08,-0.01,Medium Risk
U098,2024,4,292562.0,Stable Salary & Stable Fixed Expenses,94547,39893.0,33637,73530.0,21017.0,22.23,0.05,Medium Risk
U098,2024,5,313579.0,Stable Salary & Stable Fixed Expenses,94547,39893.0,30412,70305.0,24242.0,25.64,0.04,Low Risk
U098,2024,6,337821.0,Stable Salary & Stable Fixed Expenses,94547,39893.0,32246,72139.0,22408.0,23.7,-0.01,Medium Risk
U098,2024,7,360229.0,Stable Salary & Stable Fixed Expenses,94547,39893.0,28541,68434.0,26113.0,27.62,0.03,Low Risk
U098,2024,8,386342.0,Stable Salary & Stable Fixed Expenses,94547,39893.0,31797,71690.0,22857.0,24.18,-0.03,Medium Risk
U098,2024,9,409199.0,Stable Salary & Stable Fixed Expenses,94547,39893.0,29970,69863.0,24684.0,26.11,-0.02,Low Risk
U098,2024,10,433883.0,Stable Salary & Stable Fixed Expenses,94547,39893.0,35902,75795.0,18752.0,19.83,-0.05,Medium Risk
U098,2024,11,452635.0,Stable Salary & Stable Fixed Expenses,94547,39893.0,39735,79628.0,14919.0,15.78,0.01,Medium Risk
U098,2024,12,467554.0,Stable Salary & Stable Fixed Expenses,94547,39893.0,39616,79509.0,15038.0,15.91,-0.02,Medium Risk
U099,2024,1,231260.0,Stable Salary & Increasing Fixed Expenses,67215,29820.0,49041,78861.0,-11646.0,-17.33,-0.05,High Risk
U099,2024,2,219614.0,Stable Salary & Increasing Fixed Expenses,67215,29820.0,42700,72520.0,-5305.0,-7.89,-0.04,High Risk
U099,2024,3,214309.0,Stable Salary & Increasing Fixed Expenses,67215,29820.0,54967,84787.0,-17572.0,-26.14,0.03,High Risk
U099,2024,4,196737.0,Stable Salary & Increasing Fixed Expenses,67215,29820.0,43155,72975.0,-5760.0,-8.57,0.0,High Risk
U099,2024,5,190977.0,Stable Salary & Increasing Fixed Expenses,67215,29820.0,46156,75976.0,-8761.0,-13.03,0.04,High Risk
U099,2024,6,182216.0,Stable Salary & Increasing Fixed Expenses,67215,29820.0,45527,75347.0,-8132.0,-12.1,-0.03,High Risk
U099,2024,7,174084.0,Stable Salary & Increasing Fixed Expenses,67215,29820.0,44327,74147.0,-6932.0,-10.31,0.01,High Risk
U099,2024,8,167152.0,Stable Salary & Increasing Fixed Expenses,67215,29820.0,44940,74760.0,-7545.0,-11.23,-0.04,High Risk
U099,2024,9,159607.0,Stable Salary & Increasing Fixed Expenses,67215,29820.0,49393,79213.0,-11998.0,-17.85,-0.05,High Risk
U099,2024,10,147609.0,Stable Salary & Increasing Fixed Expenses,67215,31218.0,59526,90744.0,-23529.0,-35.01,0.02,High Risk
U099,2024,11,124080.0,Stable Salary & Increasing Fixed Expenses,67215,31218.0,45824,77042.0,-9827.0,-14.62,-0.04,High Risk
U099,2024,12,114253.0,Stable Salary & Increasing Fixed Expenses,67215,31218.0,50275,81493.0,-14278.0,-21.24,-0.04,High Risk
U100,2024,1,237165.0,Stable Salary & Stable Fixed Expenses,166751,55925.0,67795,123720.0,43031.0,25.81,0.01,Low Risk
U100,2024,2,280196.0,Stable Salary & Stable Fixed Expenses,166751,55925.0,92321,148246.0,18505.0,11.1,0.03,High Risk
U100,2024,3,298701.0,Stable Salary & Stable Fixed Expenses,166751,55925.0,87223,143148.0,23603.0,14.15,-0.0,High Risk
U100,2024,4,322304.0,Stable Salary & Stable Fixed Expenses,166751,55925.0,94389,150314.0,16437.0,9.86,-0.04,High Risk
U100,2024,5,338741.0,Stable Salary & Stable Fixed Expenses,166751,55925.0,80749,136674.0,30077.0,18.04,-0.04,Medium Risk
U100,2024,6,368818.0,Stable Salary & Stable Fixed Expenses,166751,55925.0,95497,151422.0,15329.0,9.19,0.03,High Risk
U100,2024,7,384147.0,Stable Salary & Stable Fixed Expenses,166751,55925.0,88441,144366.0,22385.0,13.42,-0.02,High Risk
U100,2024,8,406532.0,Stable Salary & Stable Fixed Expenses,166751,55925.0,94506,150431.0,16320.0,9.79,-0.02,High Risk
U100,2024,9,422852.0,Stable Salary & Stable Fixed Expenses,166751,55925.0,75143,131068.0,35683.0,21.4,0.02,Medium Risk
U100,2024,10,458535.0,Stable Salary & Stable Fixed Expenses,166751,55925.0,115603,171528.0,-4777.0,-2.86,0.04,High Risk
U100,2024,11,453758.0,Stable Salary & Stable Fixed Expenses,166751,55925.0,76596,132521.0,34230.0,20.53,-0.0,Medium Risk
U100,2024,12,487988.0,Stable Salary & Stable Fixed Expenses,166751,55925.0,87547,143472.0,23279.0,13.96,0.01,High Risk
U101,2024,1,237737.0,Salary Increases & Fixed Expenses Remain Stable,166355,78636.0,96475,175111.0,-8756.0,-5.26,0.03,High Risk
U101,2024,2,228981.0,Salary Increases & Fixed Expenses Remain Stable,166355,78636.0,99551,178187.0,-11832.0,-7.11,-0.0,High Risk
U101,2024,3,217149.0,Salary Increases & Fixed Expenses Remain Stable,176064,78636.0,98383,177019.0,-955.0,-0.54,-0.05,High Risk
U101,2024,4,216194.0,Salary Increases & Fixed Expenses Remain Stable,176064,78636.0,74275,152911.0,23153.0,13.15,0.03,High Risk
U101,2024,5,239347.0,Salary Increases & Fixed Expenses Remain Stable,176064,78636.0,72020,150656.0,25408.0,14.43,-0.03,High Risk
U101,2024,6,264755.0,Salary Increases & Fixed Expenses Remain Stable,176064,78636.0,75524,154160.0,21904.0,12.44,0.03,High Risk
U101,2024,7,286659.0,Salary Increases & Fixed Expenses Remain Stable,176064,78636.0,75207,153843.0,22221.0,12.62,-0.01,High Risk
U101,2024,8,308880.0,Salary Increases & Fixed Expenses Remain Stable,176064,78636.0,89142,167778.0,8286.0,4.71,0.04,High Risk
U101,2024,9,317166.0,Salary Increases & Fixed Expenses Remain Stable,176064,78636.0,95242,173878.0,2186.0,1.24,0.01,High Risk
U101,2024,10,319352.0,Salary Increases & Fixed Expenses Remain Stable,176064,78636.0,99509,178145.0,-2081.0,-1.18,0.0,High Risk
U101,2024,11,317271.0,Salary Increases & Fixed Expenses Remain Stable,176064,78636.0,81008,159644.0,16420.0,9.33,0.02,High Risk
U101,2024,12,333691.0,Salary Increases & Fixed Expenses Remain Stable,176064,78636.0,86409,165045.0,11019.0,6.26,0.03,High Risk
U102,2024,1,217889.0,Stable Salary & Increasing Fixed Expenses,193660,42202.0,75445,117647.0,76013.0,39.25,-0.01,Low Risk
U102,2024,2,293902.0,Stable Salary & Increasing Fixed Expenses,193660,42202.0,76683,118885.0,74775.0,38.61,0.02,Low Risk
U102,2024,3,368677.0,Stable Salary & Increasing Fixed Expenses,193660,43899.0,72559,116458.0,77202.0,39.86,0.01,Low Risk
U102,2024,4,445879.0,Stable Salary & Increasing Fixed Expenses,193660,43899.0,58359,102258.0,91402.0,47.2,0.02,Low Risk
U102,2024,5,537281.0,Stable Salary & Increasing Fixed Expenses,193660,43899.0,61552,105451.0,88209.0,45.55,-0.03,Low Risk
U102,2024,6,625490.0,Stable Salary & Increasing Fixed Expenses,193660,43899.0,74516,118415.0,75245.0,38.85,0.04,Low Risk
U102,2024,7,700735.0,Stable Salary & Increasing Fixed Expenses,193660,43899.0,62712,106611.0,87049.0,44.95,0.0,Low Risk
U102,2024,8,787784.0,Stable Salary & Increasing Fixed Expenses,193660,43899.0,68249,112148.0,81512.0,42.09,-0.05,Low Risk
U102,2024,9,869296.0,Stable Salary & Increasing Fixed Expenses,193660,43899.0,87849,131748.0,61912.0,31.97,0.02,Low Risk
U102,2024,10,931208.0,Stable Salary & Increasing Fixed Expenses,193660,43899.0,83432,127331.0,66329.0,34.25,0.01,Low Risk
U102,2024,11,997537.0,Stable Salary & Increasing Fixed Expenses,193660,43899.0,67546,111445.0,82215.0,42.45,0.04,Low Risk
U102,2024,12,1079752.0,Stable Salary & Increasing Fixed Expenses,193660,43899.0,80854,124753.0,68907.0,35.58,-0.01,Low Risk
U103,2024,1,246864.0,Salary Increases & Fixed Expenses Remain Stable,198899,50431.0,93348,143779.0,55120.0,27.71,-0.03,Low Risk
U103,2024,2,301984.0,Salary Increases & Fixed Expenses Remain Stable,198899,50431.0,96533,146964.0,51935.0,26.11,-0.02,Low Risk
U103,2024,3,353919.0,Salary Increases & Fixed Expenses Remain Stable,198899,50431.0,140970,191401.0,7498.0,3.77,-0.01,High Risk
U103,2024,4,361417.0,Salary Increases & Fixed Expenses Remain Stable,198899,50431.0,99973,150404.0,48495.0,24.38,0.01,Medium Risk
U103,2024,5,409912.0,Salary Increases & Fixed Expenses Remain Stable,216073,50431.0,95632,146063.0,70010.0,32.4,0.02,Low Risk
U103,2024,6,479922.0,Salary Increases & Fixed Expenses Remain Stable,216073,50431.0,113188,163619.0,52454.0,24.28,0.02,Medium Risk
U103,2024,7,532376.0,Salary Increases & Fixed Expenses Remain Stable,216073,50431.0,129397,179828.0,36245.0,16.77,-0.01,Medium Risk
U103,2024,8,568621.0,Salary Increases & Fixed Expenses Remain Stable,216073,50431.0,120901,171332.0,44741.0,20.71,-0.03,Medium Risk
U103,2024,9,613362.0,Salary Increases & Fixed Expenses Remain Stable,216073,50431.0,114763,165194.0,50879.0,23.55,0.02,Medium Risk
U103,2024,10,664241.0,Salary Increases & Fixed Expenses Remain Stable,216073,50431.0,124447,174878.0,41195.0,19.07,-0.05,Medium Risk
U103,2024,11,705436.0,Salary Increases & Fixed Expenses Remain Stable,216073,50431.0,98083,148514.0,67559.0,31.27,0.02,Low Risk
U103,2024,12,772995.0,Salary Increases & Fixed Expenses Remain Stable,216073,50431.0,88358,138789.0,77284.0,35.77,-0.03,Low Risk
U104,2024,1,228553.0,Stable Salary & Stable Fixed Expenses,191993,60742.0,92870,153612.0,38381.0,19.99,0.0,Medium Risk
U104,2024,2,266934.0,Stable Salary & Stable Fixed Expenses,191993,60742.0,95409,156151.0,35842.0,18.67,-0.02,Medium Risk
U104,2024,3,302776.0,Stable Salary & Stable Fixed Expenses,191993,60742.0,97692,158434.0,33559.0,17.48,-0.03,Medium Risk
U104,2024,4,336335.0,Stable Salary & Stable Fixed Expenses,191993,60742.0,111072,171814.0,20179.0,10.51,0.05,High Risk
U104,2024,5,356514.0,Stable Salary & Stable Fixed Expenses,191993,60742.0,102084,162826.0,29167.0,15.19,0.0,Medium Risk
U104,2024,6,385681.0,Stable Salary & Stable Fixed Expenses,191993,60742.0,89035,149777.0,42216.0,21.99,-0.01,Medium Risk
U104,2024,7,427897.0,Stable Salary & Stable Fixed Expenses,191993,60742.0,96489,157231.0,34762.0,18.11,-0.05,Medium Risk
U104,2024,8,462659.0,Stable Salary & Stable Fixed Expenses,191993,60742.0,113526,174268.0,17725.0,9.23,0.0,High Risk
U104,2024,9,480384.0,Stable Salary & Stable Fixed Expenses,191993,60742.0,100137,160879.0,31114.0,16.21,0.03,Medium Risk
U104,2024,10,511498.0,Stable Salary & Stable Fixed Expenses,191993,60742.0,97079,157821.0,34172.0,17.8,-0.05,Medium Risk
U104,2024,11,545670.0,Stable Salary & Stable Fixed Expenses,191993,60742.0,92271,153013.0,38980.0,20.3,-0.02,Medium Risk
U104,2024,12,584650.0,Stable Salary & Stable Fixed Expenses,191993,60742.0,106276,167018.0,24975.0,13.01,-0.02,High Risk
U105,2024,1,235620.0,Salary Increases & Fixed Expenses Decrease,234603,72816.0,91636,164452.0,70151.0,29.9,0.01,Low Risk
U105,2024,2,305771.0,Salary Increases & Fixed Expenses Decrease,234603,72816.0,77464,150280.0,84323.0,35.94,-0.02,Low Risk
U105,2024,3,390094.0,Salary Increases & Fixed Expenses Decrease,234603,72816.0,81280,154096.0,80507.0,34.32,0.0,Low Risk
U105,2024,4,470601.0,Salary Increases & Fixed Expenses Decrease,234603,72816.0,80450,153266.0,81337.0,34.67,0.03,Low Risk
U105,2024,5,551938.0,Salary Increases & Fixed Expenses Decrease,234603,72816.0,91506,164322.0,70281.0,29.96,0.04,Low Risk
U105,2024,6,622219.0,Salary Increases & Fixed Expenses Decrease,234603,72816.0,82421,155237.0,79366.0,33.83,-0.03,Low Risk
U105,2024,7,701585.0,Salary Increases & Fixed Expenses Decrease,251639,72816.0,81088,153904.0,97735.0,38.84,-0.01,Low Risk
U105,2024,8,799320.0,Salary Increases & Fixed Expenses Decrease,251639,72816.0,96122,168938.0,82701.0,32.86,-0.02,Low Risk
U105,2024,9,882021.0,Salary Increases & Fixed Expenses Decrease,251639,72816.0,92017,164833.0,86806.0,34.5,0.04,Low Risk
U105,2024,10,968827.0,Salary Increases & Fixed Expenses Decrease,251639,72816.0,99060,171876.0,79763.0,31.7,0.04,Low Risk
U105,2024,11,1048590.0,Salary Increases & Fixed Expenses Decrease,251639,72816.0,82707,155523.0,96116.0,38.2,-0.01,Low Risk
U105,2024,12,1144706.0,Salary Increases & Fixed Expenses Decrease,251639,72816.0,86223,159039.0,92600.0,36.8,-0.04,Low Risk
U106,2024,1,230501.0,Salary Increases & Fixed Expenses Remain Stable,107755,47686.0,54961,102647.0,5108.0,4.74,-0.0,High Risk
U106,2024,2,235609.0,Salary Increases & Fixed Expenses Remain Stable,107755,47686.0,46225,93911.0,13844.0,12.85,0.05,High Risk
U106,2024,3,249453.0,Salary Increases & Fixed Expenses Remain Stable,107755,47686.0,57876,105562.0,2193.0,2.04,0.03,High Risk
U106,2024,4,251646.0,Salary Increases & Fixed Expenses Remain Stable,107755,47686.0,63342,111028.0,-3273.0,-3.04,-0.0,High Risk
U106,2024,5,248373.0,Salary Increases & Fixed Expenses Remain Stable,107755,47686.0,45634,93320.0,14435.0,13.4,-0.02,High Risk
U106,2024,6,262808.0,Salary Increases & Fixed Expenses Remain Stable,107755,47686.0,57031,104717.0,3038.0,2.82,0.0,High Risk
U106,2024,7,265846.0,Salary Increases & Fixed Expenses Remain Stable,118185,47686.0,70638,118324.0,-139.0,-0.12,0.03,High Risk
U106,2024,8,265707.0,Salary Increases & Fixed Expenses Remain Stable,118185,47686.0,70637,118323.0,-138.0,-0.12,0.03,High Risk
U106,2024,9,265569.0,Salary Increases & Fixed Expenses Remain Stable,118185,47686.0,67984,115670.0,2515.0,2.13,0.01,High Risk
U106,2024,10,268084.0,Salary Increases & Fixed Expenses Remain Stable,118185,47686.0,79798,127484.0,-9299.0,-7.87,-0.02,High Risk
U106,2024,11,258785.0,Salary Increases & Fixed Expenses Remain Stable,118185,47686.0,65127,112813.0,5372.0,4.55,0.04,High Risk
U106,2024,12,264157.0,Salary Increases & Fixed Expenses Remain Stable,118185,47686.0,67256,114942.0,3243.0,2.74,0.01,High Risk
U107,2024,1,230530.0,Salary Increases & Fixed Expenses Remain Stable,293120,83452.0,123706,207158.0,85962.0,29.33,0.03,Low Risk
U107,2024,2,316492.0,Salary Increases & Fixed Expenses Remain Stable,293120,83452.0,142902,226354.0,66766.0,22.78,0.04,Medium Risk
U107,2024,3,383258.0,Salary Increases & Fixed Expenses Remain Stable,293120,83452.0,160976,244428.0,48692.0,16.61,-0.03,Medium Risk
U107,2024,4,431950.0,Salary Increases & Fixed Expenses Remain Stable,293120,83452.0,129826,213278.0,79842.0,27.24,-0.01,Low Risk
U107,2024,5,511792.0,Salary Increases & Fixed Expenses Remain Stable,293120,83452.0,124323,207775.0,85345.0,29.12,-0.04,Low Risk
U107,2024,6,597137.0,Salary Increases & Fixed Expenses Remain Stable,293120,83452.0,133152,216604.0,76516.0,26.1,0.04,Low Risk
U107,2024,7,673653.0,Salary Increases & Fixed Expenses Remain Stable,299352,83452.0,137438,220890.0,78462.0,26.21,-0.02,Low Risk
U107,2024,8,752115.0,Salary Increases & Fixed Expenses Remain Stable,299352,83452.0,153733,237185.0,62167.0,20.77,0.01,Medium Risk
U107,2024,9,814282.0,Salary Increases & Fixed Expenses Remain Stable,299352,83452.0,172395,255847.0,43505.0,14.53,0.01,High Risk
U107,2024,10,857787.0,Salary Increases & Fixed Expenses Remain Stable,299352,83452.0,177182,260634.0,38718.0,12.93,0.0,High Risk
U107,2024,11,896505.0,Salary Increases & Fixed Expenses Remain Stable,299352,83452.0,139375,222827.0,76525.0,25.56,-0.02,Low Risk
U107,2024,12,973030.0,Salary Increases & Fixed Expenses Remain Stable,299352,83452.0,122644,206096.0,93256.0,31.15,0.04,Low Risk
U108,2024,1,218338.0,Salary Increases & Fixed Expenses Remain Stable,128556,42011.0,52076,94087.0,34469.0,26.81,0.03,Low Risk
U108,2024,2,252807.0,Salary Increases & Fixed Expenses Remain Stable,128556,42011.0,64467,106478.0,22078.0,17.17,-0.04,Medium Risk
U108,2024,3,274885.0,Salary Increases & Fixed Expenses Remain Stable,128556,42011.0,65567,107578.0,20978.0,16.32,-0.01,Medium Risk
U108,2024,4,295863.0,Salary Increases & Fixed Expenses Remain Stable,128556,42011.0,71746,113757.0,14799.0,11.51,0.04,High Risk
U108,2024,5,310662.0,Salary Increases & Fixed Expenses Remain Stable,134914,42011.0,76983,118994.0,15920.0,11.8,-0.02,High Risk
U108,2024,6,326582.0,Salary Increases & Fixed Expenses Remain Stable,134914,42011.0,72614,114625.0,20289.0,15.04,-0.04,Medium Risk
U108,2024,7,346871.0,Salary Increases & Fixed Expenses Remain Stable,134914,42011.0,70738,112749.0,22165.0,16.43,0.04,Medium Risk
U108,2024,8,369036.0,Salary Increases & Fixed Expenses Remain Stable,134914,42011.0,69426,111437.0,23477.0,17.4,-0.02,Medium Risk
U108,2024,9,392513.0,Salary Increases & Fixed Expenses Remain Stable,134914,42011.0,72064,114075.0,20839.0,15.45,0.01,Medium Risk
U108,2024,10,413352.0,Salary Increases & Fixed Expenses Remain Stable,134914,42011.0,79347,121358.0,13556.0,10.05,-0.02,High Risk
U108,2024,11,426908.0,Salary Increases & Fixed Expenses Remain Stable,134914,42011.0,63589,105600.0,29314.0,21.73,-0.0,Medium Risk
U108,2024,12,456222.0,Salary Increases & Fixed Expenses Remain Stable,134914,42011.0,75427,117438.0,17476.0,12.95,0.02,High Risk
U109,2024,1,234713.0,Salary Increases & Fixed Expenses Increase,220177,97249.0,71549,168798.0,51379.0,23.34,-0.03,Medium Risk
U109,2024,2,286092.0,Salary Increases & Fixed Expenses Increase,220177,97249.0,86456,183705.0,36472.0,16.56,0.01,Medium Risk
U109,2024,3,322564.0,Salary Increases & Fixed Expenses Increase,220177,97249.0,109325,206574.0,13603.0,6.18,-0.02,High Risk
U109,2024,4,336167.0,Salary Increases & Fixed Expenses Increase,220177,97249.0,78127,175376.0,44801.0,20.35,-0.01,Medium Risk
U109,2024,5,380968.0,Salary Increases & Fixed Expenses Increase,244401,97249.0,78518,175767.0,68634.0,28.08,0.0,Low Risk
U109,2024,6,449602.0,Salary Increases & Fixed Expenses Increase,244401,98213.0,85017,183230.0,61171.0,25.03,-0.04,Low Risk
U109,2024,7,510773.0,Salary Increases & Fixed Expenses Increase,244401,98213.0,86715,184928.0,59473.0,24.33,-0.01,Medium Risk
U109,2024,8,570246.0,Salary Increases & Fixed Expenses Increase,244401,98213.0,90261,188474.0,55927.0,22.88,0.01,Medium Risk
U109,2024,9,626173.0,Salary Increases & Fixed Expenses Increase,244401,98213.0,90531,188744.0,55657.0,22.77,-0.0,Medium Risk
U109,2024,10,681830.0,Salary Increases & Fixed Expenses Increase,244401,98213.0,111618,209831.0,34570.0,14.14,-0.03,High Risk
U109,2024,11,716400.0,Salary Increases & Fixed Expenses Increase,244401,98213.0,86290,184503.0,59898.0,24.51,0.0,Medium Risk
U109,2024,12,776298.0,Salary Increases & Fixed Expenses Increase,244401,99983.0,74247,174230.0,70171.0,28.71,0.04,Low Risk
U110,2024,1,200082.0,Stable Salary & Stable Fixed Expenses,242706,116668.0,129579,246247.0,-3541.0,-1.46,-0.03,High Risk
U110,2024,2,196541.0,Stable Salary & Stable Fixed Expenses,242706,116668.0,109854,226522.0,16184.0,6.67,0.03,High Risk
U110,2024,3,212725.0,Stable Salary & Stable Fixed Expenses,242706,116668.0,122442,239110.0,3596.0,1.48,-0.05,High Risk
U110,2024,4,216321.0,Stable Salary & Stable Fixed Expenses,242706,116668.0,138599,255267.0,-12561.0,-5.18,-0.01,High Risk
U110,2024,5,203760.0,Stable Salary & Stable Fixed Expenses,242706,116668.0,118952,235620.0,7086.0,2.92,-0.04,High Risk
U110,2024,6,210846.0,Stable Salary & Stable Fixed Expenses,242706,116668.0,118402,235070.0,7636.0,3.15,0.02,High Risk
U110,2024,7,218482.0,Stable Salary & Stable Fixed Expenses,242706,116668.0,108115,224783.0,17923.0,7.38,0.01,High Risk
U110,2024,8,236405.0,Stable Salary & Stable Fixed Expenses,242706,116668.0,100256,216924.0,25782.0,10.62,-0.03,High Risk
U110,2024,9,262187.0,Stable Salary & Stable Fixed Expenses,242706,116668.0,119062,235730.0,6976.0,2.87,0.01,High Risk
U110,2024,10,269163.0,Stable Salary & Stable Fixed Expenses,242706,116668.0,162406,279074.0,-36368.0,-14.98,-0.05,High Risk
U110,2024,11,232795.0,Stable Salary & Stable Fixed Expenses,242706,116668.0,103514,220182.0,22524.0,9.28,-0.01,High Risk
U110,2024,12,255319.0,Stable Salary & Stable Fixed Expenses,242706,116668.0,108992,225660.0,17046.0,7.02,0.03,High Risk
U111,2024,1,247499.0,Salary Increases & Fixed Expenses Decrease,135883,52243.0,105698,157941.0,-22058.0,-16.23,-0.02,High Risk
U111,2024,2,225441.0,Salary Increases & Fixed Expenses Decrease,135883,52243.0,82910,135153.0,730.0,0.54,-0.03,High Risk
U111,2024,3,226171.0,Salary Increases & Fixed Expenses Decrease,135883,52243.0,112292,164535.0,-28652.0,-21.09,0.01,High Risk
U111,2024,4,197519.0,Salary Increases & Fixed Expenses Decrease,135883,52243.0,87223,139466.0,-3583.0,-2.64,0.02,High Risk
U111,2024,5,193936.0,Salary Increases & Fixed Expenses Decrease,135883,52243.0,91394,143637.0,-7754.0,-5.71,-0.05,High Risk
U111,2024,6,186182.0,Salary Increases & Fixed Expenses Decrease,135883,52243.0,90164,142407.0,-6524.0,-4.8,-0.02,High Risk
U111,2024,7,179658.0,Salary Increases & Fixed Expenses Decrease,135883,52243.0,97514,149757.0,-13874.0,-10.21,0.01,High Risk
U111,2024,8,165784.0,Salary Increases & Fixed Expenses Decrease,150833,52243.0,119614,171857.0,-21024.0,-13.94,-0.04,High Risk
U111,2024,9,144760.0,Salary Increases & Fixed Expenses Decrease,150833,50528.0,94613,145141.0,5692.0,3.77,0.04,High Risk
U111,2024,10,150452.0,Salary Increases & Fixed Expenses Decrease,150833,50528.0,101931,152459.0,-1626.0,-1.08,-0.05,High Risk
U111,2024,11,148826.0,Salary Increases & Fixed Expenses Decrease,150833,50528.0,113535,164063.0,-13230.0,-8.77,0.04,High Risk
U111,2024,12,135596.0,Salary Increases & Fixed Expenses Decrease,150833,50528.0,118496,169024.0,-18191.0,-12.06,0.0,High Risk
U112,2024,1,208043.0,Stable Salary & Increasing Fixed Expenses,187121,56353.0,98338,154691.0,32430.0,17.33,0.04,Medium Risk
U112,2024,2,240473.0,Stable Salary & Increasing Fixed Expenses,187121,56924.0,107395,164319.0,22802.0,12.19,0.03,High Risk
U112,2024,3,263275.0,Stable Salary & Increasing Fixed Expenses,187121,58808.0,123339,182147.0,4974.0,2.66,0.01,High Risk
U112,2024,4,268249.0,Stable Salary & Increasing Fixed Expenses,187121,58808.0,90656,149464.0,37657.0,20.12,0.03,Medium Risk
U112,2024,5,305906.0,Stable Salary & Increasing Fixed Expenses,187121,58808.0,110140,168948.0,18173.0,9.71,0.03,High Risk
U112,2024,6,324079.0,Stable Salary & Increasing Fixed Expenses,187121,58808.0,79339,138147.0,48974.0,26.17,-0.0,Low Risk
U112,2024,7,373053.0,Stable Salary & Increasing Fixed Expenses,187121,58808.0,78353,137161.0,49960.0,26.7,-0.01,Low Risk
U112,2024,8,423013.0,Stable Salary & Increasing Fixed Expenses,187121,58808.0,89626,148434.0,38687.0,20.67,0.03,Medium Risk
U112,2024,9,461700.0,Stable Salary & Increasing Fixed Expenses,187121,58808.0,82614,141422.0,45699.0,24.42,0.01,Medium Risk
U112,2024,10,507399.0,Stable Salary & Increasing Fixed Expenses,187121,58808.0,103723,162531.0,24590.0,13.14,0.04,High Risk
U112,2024,11,531989.0,Stable Salary & Increasing Fixed Expenses,187121,59331.0,79133,138464.0,48657.0,26.0,-0.0,Low Risk
U112,2024,12,580646.0,Stable Salary & Increasing Fixed Expenses,187121,59331.0,86395,145726.0,41395.0,22.12,-0.01,Medium Risk
U113,2024,1,221098.0,Stable Salary & Stable Fixed Expenses,196775,57539.0,132000,189539.0,7236.0,3.68,0.02,High Risk
U113,2024,2,228334.0,Stable Salary & Stable Fixed Expenses,196775,57539.0,125284,182823.0,13952.0,7.09,0.02,High Risk
U113,2024,3,242286.0,Stable Salary & Stable Fixed Expenses,196775,57539.0,158786,216325.0,-19550.0,-9.94,-0.0,High Risk
U113,2024,4,222736.0,Stable Salary & Stable Fixed Expenses,196775,57539.0,145499,203038.0,-6263.0,-3.18,-0.04,High Risk
U113,2024,5,216473.0,Stable Salary & Stable Fixed Expenses,196775,57539.0,151604,209143.0,-12368.0,-6.29,0.02,High Risk
U113,2024,6,204105.0,Stable Salary & Stable Fixed Expenses,196775,57539.0,122733,180272.0,16503.0,8.39,-0.05,High Risk
U113,2024,7,220608.0,Stable Salary & Stable Fixed Expenses,196775,57539.0,137923,195462.0,1313.0,0.67,0.02,High Risk
U113,2024,8,221921.0,Stable Salary & Stable Fixed Expenses,196775,57539.0,123769,181308.0,15467.0,7.86,-0.04,High Risk
U113,2024,9,237388.0,Stable Salary & Stable Fixed Expenses,196775,57539.0,153963,211502.0,-14727.0,-7.48,0.02,High Risk
U113,2024,10,222661.0,Stable Salary & Stable Fixed Expenses,196775,57539.0,157217,214756.0,-17981.0,-9.14,-0.01,High Risk
U113,2024,11,204680.0,Stable Salary & Stable Fixed Expenses,196775,57539.0,140725,198264.0,-1489.0,-0.76,-0.03,High Risk
U113,2024,12,203191.0,Stable Salary & Stable Fixed Expenses,196775,57539.0,124902,182441.0,14334.0,7.28,-0.03,High Risk
U114,2024,1,225535.0,Stable Salary & Stable Fixed Expenses,77288,27113.0,33223,60336.0,16952.0,21.93,-0.04,Medium Risk
U114,2024,2,242487.0,Stable Salary & Stable Fixed Expenses,77288,27113.0,30952,58065.0,19223.0,24.87,0.0,Medium Risk
U114,2024,3,261710.0,Stable Salary & Stable Fixed Expenses,77288,27113.0,39819,66932.0,10356.0,13.4,0.05,High Risk
U114,2024,4,272066.0,Stable Salary & Stable Fixed Expenses,77288,27113.0,41996,69109.0,8179.0,10.58,-0.03,High Risk
U114,2024,5,280245.0,Stable Salary & Stable Fixed Expenses,77288,27113.0,35144,62257.0,15031.0,19.45,-0.0,Medium Risk
U114,2024,6,295276.0,Stable Salary & Stable Fixed Expenses,77288,27113.0,37163,64276.0,13012.0,16.84,-0.03,Medium Risk
U114,2024,7,308288.0,Stable Salary & Stable Fixed Expenses,77288,27113.0,34301,61414.0,15874.0,20.54,-0.05,Medium Risk
U114,2024,8,324162.0,Stable Salary & Stable Fixed Expenses,77288,27113.0,33566,60679.0,16609.0,21.49,-0.01,Medium Risk
U114,2024,9,340771.0,Stable Salary & Stable Fixed Expenses,77288,27113.0,43559,70672.0,6616.0,8.56,-0.03,High Risk
U114,2024,10,347387.0,Stable Salary & Stable Fixed Expenses,77288,27113.0,45622,72735.0,4553.0,5.89,0.04,High Risk
U114,2024,11,351940.0,Stable Salary & Stable Fixed Expenses,77288,27113.0,45945,73058.0,4230.0,5.47,0.02,High Risk
U114,2024,12,356170.0,Stable Salary & Stable Fixed Expenses,77288,27113.0,33025,60138.0,17150.0,22.19,-0.04,Medium Risk
U115,2024,1,204144.0,Salary Increases & Fixed Expenses Remain Stable,137480,40289.0,42843,83132.0,54348.0,39.53,-0.03,Low Risk
U115,2024,2,258492.0,Salary Increases & Fixed Expenses Remain Stable,137480,40289.0,54599,94888.0,42592.0,30.98,0.03,Low Risk
U115,2024,3,301084.0,Salary Increases & Fixed Expenses Remain Stable,149363,40289.0,54298,94587.0,54776.0,36.67,0.04,Low Risk
U115,2024,4,355860.0,Salary Increases & Fixed Expenses Remain Stable,149363,40289.0,58088,98377.0,50986.0,34.14,-0.02,Low Risk
U115,2024,5,406846.0,Salary Increases & Fixed Expenses Remain Stable,149363,40289.0,48004,88293.0,61070.0,40.89,0.04,Low Risk
U115,2024,6,467916.0,Salary Increases & Fixed Expenses Remain Stable,149363,40289.0,45905,86194.0,63169.0,42.29,0.0,Low Risk
U115,2024,7,531085.0,Salary Increases & Fixed Expenses Remain Stable,149363,40289.0,46454,86743.0,62620.0,41.92,-0.01,Low Risk
U115,2024,8,593705.0,Salary Increases & Fixed Expenses Remain Stable,149363,40289.0,54634,94923.0,54440.0,36.45,0.02,Low Risk
U115,2024,9,648145.0,Salary Increases & Fixed Expenses Remain Stable,149363,40289.0,66896,107185.0,42178.0,28.24,-0.02,Low Risk
U115,2024,10,690323.0,Salary Increases & Fixed Expenses Remain Stable,149363,40289.0,55132,95421.0,53942.0,36.11,-0.04,Low Risk
U115,2024,11,744265.0,Salary Increases & Fixed Expenses Remain Stable,149363,40289.0,61573,101862.0,47501.0,31.8,-0.0,Low Risk
U115,2024,12,791766.0,Salary Increases & Fixed Expenses Remain Stable,149363,40289.0,60504,100793.0,48570.0,32.52,-0.04,Low Risk
U116,2024,1,210682.0,Salary Increases & Fixed Expenses Remain Stable,209921,81347.0,90951,172298.0,37623.0,17.92,-0.03,Medium Risk
U116,2024,2,248305.0,Salary Increases & Fixed Expenses Remain Stable,209921,81347.0,91994,173341.0,36580.0,17.43,0.02,Medium Risk
U116,2024,3,284885.0,Salary Increases & Fixed Expenses Remain Stable,209921,81347.0,115184,196531.0,13390.0,6.38,-0.01,High Risk
U116,2024,4,298275.0,Salary Increases & Fixed Expenses Remain Stable,209921,81347.0,104441,185788.0,24133.0,11.5,-0.04,High Risk
U116,2024,5,322408.0,Salary Increases & Fixed Expenses Remain Stable,209921,81347.0,104569,185916.0,24005.0,11.44,0.03,High Risk
U116,2024,6,346413.0,Salary Increases & Fixed Expenses Remain Stable,209921,81347.0,89812,171159.0,38762.0,18.47,-0.0,Medium Risk
U116,2024,7,385175.0,Salary Increases & Fixed Expenses Remain Stable,209921,81347.0,119271,200618.0,9303.0,4.43,0.05,High Risk
U116,2024,8,394478.0,Salary Increases & Fixed Expenses Remain Stable,236232,81347.0,103437,184784.0,51448.0,21.78,-0.05,Medium Risk
U116,2024,9,445926.0,Salary Increases & Fixed Expenses Remain Stable,236232,81347.0,139853,221200.0,15032.0,6.36,-0.05,High Risk
U116,2024,10,460958.0,Salary Increases & Fixed Expenses Remain Stable,236232,81347.0,112589,193936.0,42296.0,17.9,-0.0,Medium Risk
U116,2024,11,503254.0,Salary Increases & Fixed Expenses Remain Stable,236232,81347.0,106520,187867.0,48365.0,20.47,0.01,Medium Risk
U116,2024,12,551619.0,Salary Increases & Fixed Expenses Remain Stable,236232,81347.0,121188,202535.0,33697.0,14.26,0.05,High Risk
U117,2024,1,213375.0,Salary Increases & Fixed Expenses Remain Stable,184094,79696.0,90005,169701.0,14393.0,7.82,0.02,High Risk
U117,2024,2,227768.0,Salary Increases & Fixed Expenses Remain Stable,184094,79696.0,94579,174275.0,9819.0,5.33,0.04,High Risk
U117,2024,3,237587.0,Salary Increases & Fixed Expenses Remain Stable,184094,79696.0,90236,169932.0,14162.0,7.69,0.04,High Risk
U117,2024,4,251749.0,Salary Increases & Fixed Expenses Remain Stable,184094,79696.0,101773,181469.0,2625.0,1.43,0.04,High Risk
U117,2024,5,254374.0,Salary Increases & Fixed Expenses Remain Stable,184094,79696.0,82666,162362.0,21732.0,11.8,0.03,High Risk
U117,2024,6,276106.0,Salary Increases & Fixed Expenses Remain Stable,194806,79696.0,97934,177630.0,17176.0,8.82,-0.04,High Risk
U117,2024,7,293282.0,Salary Increases & Fixed Expenses Remain Stable,194806,79696.0,87457,167153.0,27653.0,14.2,0.01,High Risk
U117,2024,8,320935.0,Salary Increases & Fixed Expenses Remain Stable,194806,79696.0,102483,182179.0,12627.0,6.48,0.02,High Risk
U117,2024,9,333562.0,Salary Increases & Fixed Expenses Remain Stable,194806,79696.0,102873,182569.0,12237.0,6.28,0.04,High Risk
U117,2024,10,345799.0,Salary Increases & Fixed Expenses Remain Stable,194806,79696.0,104272,183968.0,10838.0,5.56,0.05,High Risk
U117,2024,11,356637.0,Salary Increases & Fixed Expenses Remain Stable,194806,79696.0,92835,172531.0,22275.0,11.43,-0.02,High Risk
U117,2024,12,378912.0,Salary Increases & Fixed Expenses Remain Stable,194806,79696.0,112034,191730.0,3076.0,1.58,0.05,High Risk
U118,2024,1,213969.0,Stable Salary & Stable Fixed Expenses,281850,62504.0,202018,264522.0,17328.0,6.15,-0.03,High Risk
U118,2024,2,231297.0,Stable Salary & Stable Fixed Expenses,281850,62504.0,176710,239214.0,42636.0,15.13,0.02,Medium Risk
U118,2024,3,273933.0,Stable Salary & Stable Fixed Expenses,281850,62504.0,266671,329175.0,-47325.0,-16.79,0.02,High Risk
U118,2024,4,226608.0,Stable Salary & Stable Fixed Expenses,281850,62504.0,206169,268673.0,13177.0,4.68,-0.01,High Risk
U118,2024,5,239785.0,Stable Salary & Stable Fixed Expenses,281850,62504.0,198189,260693.0,21157.0,7.51,0.02,High Risk
U118,2024,6,260942.0,Stable Salary & Stable Fixed Expenses,281850,62504.0,175535,238039.0,43811.0,15.54,-0.02,Medium Risk
U118,2024,7,304753.0,Stable Salary & Stable Fixed Expenses,281850,62504.0,188325,250829.0,31021.0,11.01,-0.01,High Risk
U118,2024,8,335774.0,Stable Salary & Stable Fixed Expenses,281850,62504.0,222026,284530.0,-2680.0,-0.95,-0.0,High Risk
U118,2024,9,333094.0,Stable Salary & Stable Fixed Expenses,281850,62504.0,246944,309448.0,-27598.0,-9.79,0.03,High Risk
U118,2024,10,305496.0,Stable Salary & Stable Fixed Expenses,281850,62504.0,191029,253533.0,28317.0,10.05,-0.01,High Risk
U118,2024,11,333813.0,Stable Salary & Stable Fixed Expenses,281850,62504.0,189653,252157.0,29693.0,10.54,0.02,High Risk
U118,2024,12,363506.0,Stable Salary & Stable Fixed Expenses,281850,62504.0,269436,331940.0,-50090.0,-17.77,-0.03,High Risk
U119,2024,1,229686.0,Stable Salary & Increasing Fixed Expenses,119987,52462.0,58352,110814.0,9173.0,7.64,0.03,High Risk
U119,2024,2,238859.0,Stable Salary & Increasing Fixed Expenses,119987,52462.0,69690,122152.0,-2165.0,-1.8,-0.05,High Risk
U119,2024,3,236694.0,Stable Salary & Increasing Fixed Expenses,119987,52462.0,70206,122668.0,-2681.0,-2.23,0.02,High Risk
U119,2024,4,234013.0,Stable Salary & Increasing Fixed Expenses,119987,52462.0,54416,106878.0,13109.0,10.93,-0.02,High Risk
U119,2024,5,247122.0,Stable Salary & Increasing Fixed Expenses,119987,52462.0,62803,115265.0,4722.0,3.94,-0.05,High Risk
U119,2024,6,251844.0,Stable Salary & Increasing Fixed Expenses,119987,52462.0,60417,112879.0,7108.0,5.92,-0.02,High Risk
U119,2024,7,258952.0,Stable Salary & Increasing Fixed Expenses,119987,52462.0,67272,119734.0,253.0,0.21,0.04,High Risk
U119,2024,8,259205.0,Stable Salary & Increasing Fixed Expenses,119987,52462.0,50913,103375.0,16612.0,13.84,-0.05,High Risk
U119,2024,9,275817.0,Stable Salary & Increasing Fixed Expenses,119987,53272.0,66813,120085.0,-98.0,-0.08,0.04,High Risk
U119,2024,10,275719.0,Stable Salary & Increasing Fixed Expenses,119987,53272.0,72992,126264.0,-6277.0,-5.23,-0.01,High Risk
U119,2024,11,269442.0,Stable Salary & Increasing Fixed Expenses,119987,53272.0,53061,106333.0,13654.0,11.38,-0.02,High Risk
U119,2024,12,283096.0,Stable Salary & Increasing Fixed Expenses,119987,53272.0,66681,119953.0,34.0,0.03,-0.04,High Risk
U120,2024,1,204939.0,Stable Salary & Stable Fixed Expenses,87328,34671.0,63222,97893.0,-10565.0,-12.1,-0.02,High Risk
U120,2024,2,194374.0,Stable Salary & Stable Fixed Expenses,87328,34671.0,64389,99060.0,-11732.0,-13.43,0.01,High Risk
U120,2024,3,182642.0,Stable Salary & Stable Fixed Expenses,87328,34671.0,77717,112388.0,-25060.0,-28.7,-0.02,High Risk
U120,2024,4,157582.0,Stable Salary & Stable Fixed Expenses,87328,34671.0,69174,103845.0,-16517.0,-18.91,-0.0,High Risk
U120,2024,5,141065.0,Stable Salary & Stable Fixed Expenses,87328,34671.0,53456,88127.0,-799.0,-0.91,-0.02,High Risk
U120,2024,6,140266.0,Stable Salary & Stable Fixed Expenses,87328,34671.0,66139,100810.0,-13482.0,-15.44,0.04,High Risk
U120,2024,7,126784.0,Stable Salary & Stable Fixed Expenses,87328,34671.0,56463,91134.0,-3806.0,-4.36,-0.03,High Risk
U120,2024,8,122978.0,Stable Salary & Stable Fixed Expenses,87328,34671.0,60451,95122.0,-7794.0,-8.92,0.0,High Risk
U120,2024,9,115184.0,Stable Salary & Stable Fixed Expenses,87328,34671.0,58230,92901.0,-5573.0,-6.38,-0.01,High Risk
U120,2024,10,109611.0,Stable Salary & Stable Fixed Expenses,87328,34671.0,83859,118530.0,-31202.0,-35.73,0.03,High Risk
U120,2024,11,78409.0,Stable Salary & Stable Fixed Expenses,87328,34671.0,58924,93595.0,-6267.0,-7.18,0.01,High Risk
U120,2024,12,72142.0,Stable Salary & Stable Fixed Expenses,87328,34671.0,64734,99405.0,-12077.0,-13.83,0.01,High Risk
U121,2024,1,203288.0,Salary Increases & Fixed Expenses Increase,57913,36588.0,20029,56617.0,1296.0,2.24,-0.05,High Risk
U121,2024,2,204584.0,Salary Increases & Fixed Expenses Increase,57913,36588.0,19368,55956.0,1957.0,3.38,-0.04,High Risk
U121,2024,3,206541.0,Salary Increases & Fixed Expenses Increase,57913,37588.0,21452,59040.0,-1127.0,-1.95,-0.01,High Risk
U121,2024,4,205414.0,Salary Increases & Fixed Expenses Increase,57913,37588.0,19020,56608.0,1305.0,2.25,-0.01,High Risk
U121,2024,5,206719.0,Salary Increases & Fixed Expenses Increase,57913,37588.0,20323,57911.0,2.0,0.0,-0.03,High Risk
U121,2024,6,206721.0,Salary Increases & Fixed Expenses Increase,57913,37588.0,21040,58628.0,-715.0,-1.23,-0.05,High Risk
U121,2024,7,206006.0,Salary Increases & Fixed Expenses Increase,57913,37588.0,18471,56059.0,1854.0,3.2,0.0,High Risk
U121,2024,8,207860.0,Salary Increases & Fixed Expenses Increase,64212,37588.0,23167,60755.0,3457.0,5.38,0.05,High Risk
U121,2024,9,211317.0,Salary Increases & Fixed Expenses Increase,64212,37588.0,23635,61223.0,2989.0,4.65,-0.04,High Risk
U121,2024,10,214306.0,Salary Increases & Fixed Expenses Increase,64212,37588.0,31791,69379.0,-5167.0,-8.05,0.05,High Risk
U121,2024,11,209139.0,Salary Increases & Fixed Expenses Increase,64212,39285.0,23859,63144.0,1068.0,1.66,0.01,High Risk
U121,2024,12,210207.0,Salary Increases & Fixed Expenses Increase,64212,40919.0,21264,62183.0,2029.0,3.16,0.01,High Risk
U122,2024,1,233785.0,Stable Salary & Stable Fixed Expenses,259145,103473.0,116880,220353.0,38792.0,14.97,0.01,High Risk
U122,2024,2,272577.0,Stable Salary & Stable Fixed Expenses,259145,103473.0,146754,250227.0,8918.0,3.44,0.02,High Risk
U122,2024,3,281495.0,Stable Salary & Stable Fixed Expenses,259145,103473.0,141407,244880.0,14265.0,5.5,-0.0,High Risk
U122,2024,4,295760.0,Stable Salary & Stable Fixed Expenses,259145,103473.0,120307,223780.0,35365.0,13.65,0.02,High Risk
U122,2024,5,331125.0,Stable Salary & Stable Fixed Expenses,259145,103473.0,147889,251362.0,7783.0,3.0,-0.01,High Risk
U122,2024,6,338908.0,Stable Salary & Stable Fixed Expenses,259145,103473.0,144090,247563.0,11582.0,4.47,-0.05,High Risk
U122,2024,7,350490.0,Stable Salary & Stable Fixed Expenses,259145,103473.0,121870,225343.0,33802.0,13.04,0.03,High Risk
U122,2024,8,384292.0,Stable Salary & Stable Fixed Expenses,259145,103473.0,107581,211054.0,48091.0,18.56,0.0,Medium Risk
U122,2024,9,432383.0,Stable Salary & Stable Fixed Expenses,259145,103473.0,140202,243675.0,15470.0,5.97,0.0,High Risk
U122,2024,10,447853.0,Stable Salary & Stable Fixed Expenses,259145,103473.0,137298,240771.0,18374.0,7.09,-0.02,High Risk
U122,2024,11,466227.0,Stable Salary & Stable Fixed Expenses,259145,103473.0,104306,207779.0,51366.0,19.82,0.01,Medium Risk
U122,2024,12,517593.0,Stable Salary & Stable Fixed Expenses,259145,103473.0,119883,223356.0,35789.0,13.81,0.02,High Risk
U123,2024,1,206469.0,Stable Salary & Stable Fixed Expenses,155687,53155.0,68253,121408.0,34279.0,22.02,0.03,Medium Risk
U123,2024,2,240748.0,Stable Salary & Stable Fixed Expenses,155687,53155.0,85397,138552.0,17135.0,11.01,0.03,High Risk
U123,2024,3,257883.0,Stable Salary & Stable Fixed Expenses,155687,53155.0,80991,134146.0,21541.0,13.84,0.02,High Risk
U123,2024,4,279424.0,Stable Salary & Stable Fixed Expenses,155687,53155.0,71883,125038.0,30649.0,19.69,0.02,Medium Risk
U123,2024,5,310073.0,Stable Salary & Stable Fixed Expenses,155687,53155.0,79629,132784.0,22903.0,14.71,0.04,High Risk
U123,2024,6,332976.0,Stable Salary & Stable Fixed Expenses,155687,53155.0,69260,122415.0,33272.0,21.37,0.03,Medium Risk
U123,2024,7,366248.0,Stable Salary & Stable Fixed Expenses,155687,53155.0,90627,143782.0,11905.0,7.65,-0.01,High Risk
U123,2024,8,378153.0,Stable Salary & Stable Fixed Expenses,155687,53155.0,69873,123028.0,32659.0,20.98,-0.01,Medium Risk
U123,2024,9,410812.0,Stable Salary & Stable Fixed Expenses,155687,53155.0,76223,129378.0,26309.0,16.9,0.0,Medium Risk
U123,2024,10,437121.0,Stable Salary & Stable Fixed Expenses,155687,53155.0,66789,119944.0,35743.0,22.96,-0.04,Medium Risk
U123,2024,11,472864.0,Stable Salary & Stable Fixed Expenses,155687,53155.0,69075,122230.0,33457.0,21.49,-0.04,Medium Risk
U123,2024,12,506321.0,Stable Salary & Stable Fixed Expenses,155687,53155.0,71015,124170.0,31517.0,20.24,-0.02,Medium Risk
U124,2024,1,233125.0,Salary Increases & Fixed Expenses Increase,63017,37414.0,30838,68252.0,-5235.0,-8.31,-0.04,High Risk
U124,2024,2,227890.0,Salary Increases & Fixed Expenses Increase,63017,37414.0,31841,69255.0,-6238.0,-9.9,-0.04,High Risk
U124,2024,3,221652.0,Salary Increases & Fixed Expenses Increase,75613,37414.0,42093,79507.0,-3894.0,-5.15,0.04,High Risk
U124,2024,4,217758.0,Salary Increases & Fixed Expenses Increase,75613,38600.0,39870,78470.0,-2857.0,-3.78,-0.01,High Risk
U124,2024,5,214901.0,Salary Increases & Fixed Expenses Increase,75613,38600.0,34057,72657.0,2956.0,3.91,0.05,High Risk
U124,2024,6,217857.0,Salary Increases & Fixed Expenses Increase,75613,38600.0,31610,70210.0,5403.0,7.15,-0.0,High Risk
U124,2024,7,223260.0,Salary Increases & Fixed Expenses Increase,75613,38600.0,41889,80489.0,-4876.0,-6.45,-0.04,High Risk
U124,2024,8,218384.0,Salary Increases & Fixed Expenses Increase,75613,38600.0,44393,82993.0,-7380.0,-9.76,0.04,High Risk
U124,2024,9,211004.0,Salary Increases & Fixed Expenses Increase,75613,38600.0,41124,79724.0,-4111.0,-5.44,-0.01,High Risk
U124,2024,10,206893.0,Salary Increases & Fixed Expenses Increase,75613,39744.0,41469,81213.0,-5600.0,-7.41,-0.04,High Risk
U124,2024,11,201293.0,Salary Increases & Fixed Expenses Increase,75613,39744.0,38409,78153.0,-2540.0,-3.36,-0.02,High Risk
U124,2024,12,198753.0,Salary Increases & Fixed Expenses Increase,75613,39744.0,36171,75915.0,-302.0,-0.4,-0.0,High Risk
U125,2024,1,238814.0,Salary Increases & Fixed Expenses Remain Stable,174488,41684.0,52687,94371.0,80117.0,45.92,0.01,Low Risk
U125,2024,2,318931.0,Salary Increases & Fixed Expenses Remain Stable,174488,41684.0,52376,94060.0,80428.0,46.09,-0.02,Low Risk
U125,2024,3,399359.0,Salary Increases & Fixed Expenses Remain Stable,174488,41684.0,63453,105137.0,69351.0,39.75,-0.02,Low Risk
U125,2024,4,468710.0,Salary Increases & Fixed Expenses Remain Stable,174488,41684.0,52847,94531.0,79957.0,45.82,-0.05,Low Risk
U125,2024,5,548667.0,Salary Increases & Fixed Expenses Remain Stable,174488,41684.0,66791,108475.0,66013.0,37.83,0.03,Low Risk
U125,2024,6,614680.0,Salary Increases & Fixed Expenses Remain Stable,174488,41684.0,59991,101675.0,72813.0,41.73,-0.03,Low Risk
U125,2024,7,687493.0,Salary Increases & Fixed Expenses Remain Stable,184575,41684.0,73003,114687.0,69888.0,37.86,-0.04,Low Risk
U125,2024,8,757381.0,Salary Increases & Fixed Expenses Remain Stable,184575,41684.0,72494,114178.0,70397.0,38.14,-0.04,Low Risk
U125,2024,9,827778.0,Salary Increases & Fixed Expenses Remain Stable,184575,41684.0,63954,105638.0,78937.0,42.77,0.05,Low Risk
U125,2024,10,906715.0,Salary Increases & Fixed Expenses Remain Stable,184575,41684.0,88727,130411.0,54164.0,29.35,0.02,Low Risk
U125,2024,11,960879.0,Salary Increases & Fixed Expenses Remain Stable,184575,41684.0,65543,107227.0,77348.0,41.91,0.01,Low Risk
U125,2024,12,1038227.0,Salary Increases & Fixed Expenses Remain Stable,184575,41684.0,67693,109377.0,75198.0,40.74,-0.05,Low Risk
U126,2024,1,230162.0,Salary Increases & Fixed Expenses Increase,256644,93565.0,154914,248479.0,8165.0,3.18,0.04,High Risk
U126,2024,2,238327.0,Salary Increases & Fixed Expenses Increase,256644,93565.0,154230,247795.0,8849.0,3.45,0.03,High Risk
U126,2024,3,247176.0,Salary Increases & Fixed Expenses Increase,256644,93565.0,181880,275445.0,-18801.0,-7.33,0.03,High Risk
U126,2024,4,228375.0,Salary Increases & Fixed Expenses Increase,256644,95521.0,204327,299848.0,-43204.0,-16.83,-0.04,High Risk
U126,2024,5,185171.0,Salary Increases & Fixed Expenses Increase,256644,95521.0,184696,280217.0,-23573.0,-9.19,0.04,High Risk
U126,2024,6,161598.0,Salary Increases & Fixed Expenses Increase,256644,95521.0,164833,260354.0,-3710.0,-1.45,-0.05,High Risk
U126,2024,7,157888.0,Salary Increases & Fixed Expenses Increase,256644,95521.0,201576,297097.0,-40453.0,-15.76,0.04,High Risk
U126,2024,8,117435.0,Salary Increases & Fixed Expenses Increase,270033,96916.0,192910,289826.0,-19793.0,-7.33,0.03,High Risk
U126,2024,9,97642.0,Salary Increases & Fixed Expenses Increase,270033,96916.0,203352,300268.0,-30235.0,-11.2,-0.02,High Risk
U126,2024,10,67407.0,Salary Increases & Fixed Expenses Increase,270033,96916.0,173304,270220.0,-187.0,-0.07,0.02,High Risk
U126,2024,11,67220.0,Salary Increases & Fixed Expenses Increase,270033,96916.0,213062,309978.0,-39945.0,-14.79,-0.01,High Risk
U126,2024,12,27275.0,Salary Increases & Fixed Expenses Increase,270033,96916.0,181677,278593.0,-8560.0,-3.17,0.05,High Risk
U127,2024,1,245460.0,Salary Increases & Fixed Expenses Remain Stable,293841,85298.0,101622,186920.0,106921.0,36.39,-0.01,Low Risk
U127,2024,2,352381.0,Salary Increases & Fixed Expenses Remain Stable,293841,85298.0,108129,193427.0,100414.0,34.17,0.01,Low Risk
U127,2024,3,452795.0,Salary Increases & Fixed Expenses Remain Stable,293841,85298.0,92722,178020.0,115821.0,39.42,-0.02,Low Risk
U127,2024,4,568616.0,Salary Increases & Fixed Expenses Remain Stable,293841,85298.0,91978,177276.0,116565.0,39.67,-0.01,Low Risk
U127,2024,5,685181.0,Salary Increases & Fixed Expenses Remain Stable,293841,85298.0,108347,193645.0,100196.0,34.1,0.03,Low Risk
U127,2024,6,785377.0,Salary Increases & Fixed Expenses Remain Stable,293841,85298.0,93917,179215.0,114626.0,39.01,-0.02,Low Risk
U127,2024,7,900003.0,Salary Increases & Fixed Expenses Remain Stable,293841,85298.0,113791,199089.0,94752.0,32.25,-0.04,Low Risk
U127,2024,8,994755.0,Salary Increases & Fixed Expenses Remain Stable,304380,85298.0,114920,200218.0,104162.0,34.22,0.02,Low Risk
U127,2024,9,1098917.0,Salary Increases & Fixed Expenses Remain Stable,304380,85298.0,118768,204066.0,100314.0,32.96,0.01,Low Risk
U127,2024,10,1199231.0,Salary Increases & Fixed Expenses Remain Stable,304380,85298.0,109841,195139.0,109241.0,35.89,0.0,Low Risk
U127,2024,11,1308472.0,Salary Increases & Fixed Expenses Remain Stable,304380,85298.0,115438,200736.0,103644.0,34.05,-0.01,Low Risk
U127,2024,12,1412116.0,Salary Increases & Fixed Expenses Remain Stable,304380,85298.0,98058,183356.0,121024.0,39.76,0.04,Low Risk
U128,2024,1,226288.0,Stable Salary & Stable Fixed Expenses,203903,85200.0,62937,148137.0,55766.0,27.35,0.01,Low Risk
U128,2024,2,282054.0,Stable Salary & Stable Fixed Expenses,203903,85200.0,68348,153548.0,50355.0,24.7,-0.01,Medium Risk
U128,2024,3,332409.0,Stable Salary & Stable Fixed Expenses,203903,85200.0,78675,163875.0,40028.0,19.63,-0.02,Medium Risk
U128,2024,4,372437.0,Stable Salary & Stable Fixed Expenses,203903,85200.0,76302,161502.0,42401.0,20.79,0.02,Medium Risk
U128,2024,5,414838.0,Stable Salary & Stable Fixed Expenses,203903,85200.0,70170,155370.0,48533.0,23.8,0.03,Medium Risk
U128,2024,6,463371.0,Stable Salary & Stable Fixed Expenses,203903,85200.0,64658,149858.0,54045.0,26.51,0.01,Low Risk
U128,2024,7,517416.0,Stable Salary & Stable Fixed Expenses,203903,85200.0,77868,163068.0,40835.0,20.03,0.02,Medium Risk
U128,2024,8,558251.0,Stable Salary & Stable Fixed Expenses,203903,85200.0,71136,156336.0,47567.0,23.33,-0.03,Medium Risk
U128,2024,9,605818.0,Stable Salary & Stable Fixed Expenses,203903,85200.0,79793,164993.0,38910.0,19.08,-0.02,Medium Risk
U128,2024,10,644728.0,Stable Salary & Stable Fixed Expenses,203903,85200.0,89105,174305.0,29598.0,14.52,-0.02,High Risk
U128,2024,11,674326.0,Stable Salary & Stable Fixed Expenses,203903,85200.0,69113,154313.0,49590.0,24.32,-0.04,Medium Risk
U128,2024,12,723916.0,Stable Salary & Stable Fixed Expenses,203903,85200.0,80427,165627.0,38276.0,18.77,0.01,Medium Risk
U129,2024,1,248977.0,Stable Salary & Increasing Fixed Expenses,128773,60998.0,62703,123701.0,5072.0,3.94,-0.03,High Risk
U129,2024,2,254049.0,Stable Salary & Increasing Fixed Expenses,128773,60998.0,58845,119843.0,8930.0,6.93,0.04,High Risk
U129,2024,3,262979.0,Stable Salary & Increasing Fixed Expenses,128773,60998.0,73423,134421.0,-5648.0,-4.39,0.04,High Risk
U129,2024,4,257331.0,Stable Salary & Increasing Fixed Expenses,128773,60998.0,65339,126337.0,2436.0,1.89,0.0,High Risk
U129,2024,5,259767.0,Stable Salary & Increasing Fixed Expenses,128773,60998.0,74407,135405.0,-6632.0,-5.15,0.01,High Risk
U129,2024,6,253135.0,Stable Salary & Increasing Fixed Expenses,128773,60998.0,73287,134285.0,-5512.0,-4.28,-0.03,High Risk
U129,2024,7,247623.0,Stable Salary & Increasing Fixed Expenses,128773,60998.0,51730,112728.0,16045.0,12.46,-0.02,High Risk
U129,2024,8,263668.0,Stable Salary & Increasing Fixed Expenses,128773,60998.0,55705,116703.0,12070.0,9.37,0.03,High Risk
U129,2024,9,275738.0,Stable Salary & Increasing Fixed Expenses,128773,60998.0,65636,126634.0,2139.0,1.66,0.02,High Risk
U129,2024,10,277877.0,Stable Salary & Increasing Fixed Expenses,128773,60998.0,70470,131468.0,-2695.0,-2.09,-0.02,High Risk
U129,2024,11,275182.0,Stable Salary & Increasing Fixed Expenses,128773,60998.0,63043,124041.0,4732.0,3.67,0.01,High Risk
U129,2024,12,279914.0,Stable Salary & Increasing Fixed Expenses,128773,60998.0,95216,156214.0,-27441.0,-21.31,-0.01,High Risk
U130,2024,1,201413.0,Stable Salary & Stable Fixed Expenses,65901,26181.0,25080,51261.0,14640.0,22.22,-0.02,Medium Risk
U130,2024,2,216053.0,Stable Salary & Stable Fixed Expenses,65901,26181.0,22438,48619.0,17282.0,26.22,-0.01,Low Risk
U130,2024,3,233335.0,Stable Salary & Stable Fixed Expenses,65901,26181.0,28761,54942.0,10959.0,16.63,0.04,Medium Risk
U130,2024,4,244294.0,Stable Salary & Stable Fixed Expenses,65901,26181.0,21249,47430.0,18471.0,28.03,0.0,Low Risk
U130,2024,5,262765.0,Stable Salary & Stable Fixed Expenses,65901,26181.0,23931,50112.0,15789.0,23.96,0.0,Medium Risk
U130,2024,6,278554.0,Stable Salary & Stable Fixed Expenses,65901,26181.0,19879,46060.0,19841.0,30.11,0.05,Low Risk
U130,2024,7,298395.0,Stable Salary & Stable Fixed Expenses,65901,26181.0,24204,50385.0,15516.0,23.54,-0.03,Medium Risk
U130,2024,8,313911.0,Stable Salary & Stable Fixed Expenses,65901,26181.0,24878,51059.0,14842.0,22.52,0.04,Medium Risk
U130,2024,9,328753.0,Stable Salary & Stable Fixed Expenses,65901,26181.0,22291,48472.0,17429.0,26.45,-0.03,Low Risk
U130,2024,10,346182.0,Stable Salary & Stable Fixed Expenses,65901,26181.0,27715,53896.0,12005.0,18.22,-0.02,Medium Risk
U130,2024,11,358187.0,Stable Salary & Stable Fixed Expenses,65901,26181.0,28344,54525.0,11376.0,17.26,-0.03,Medium Risk
U130,2024,12,369563.0,Stable Salary & Stable Fixed Expenses,65901,26181.0,24477,50658.0,15243.0,23.13,-0.04,Medium Risk
U131,2024,1,216226.0,Salary Increases & Fixed Expenses Remain Stable,144778,45375.0,103350,148725.0,-3947.0,-2.73,0.03,High Risk
U131,2024,2,212279.0,Salary Increases & Fixed Expenses Remain Stable,144778,45375.0,98210,143585.0,1193.0,0.82,0.0,High Risk
U131,2024,3,213472.0,Salary Increases & Fixed Expenses Remain Stable,144778,45375.0,89418,134793.0,9985.0,6.9,0.03,High Risk
U131,2024,4,223457.0,Salary Increases & Fixed Expenses Remain Stable,144778,45375.0,99220,144595.0,183.0,0.13,0.01,High Risk
U131,2024,5,223640.0,Salary Increases & Fixed Expenses Remain Stable,144778,45375.0,104837,150212.0,-5434.0,-3.75,0.01,High Risk
U131,2024,6,218206.0,Salary Increases & Fixed Expenses Remain Stable,144778,45375.0,87644,133019.0,11759.0,8.12,-0.0,High Risk
U131,2024,7,229965.0,Salary Increases & Fixed Expenses Remain Stable,144778,45375.0,108807,154182.0,-9404.0,-6.5,-0.0,High Risk
U131,2024,8,220561.0,Salary Increases & Fixed Expenses Remain Stable,152336,45375.0,93927,139302.0,13034.0,8.56,0.02,High Risk
U131,2024,9,233595.0,Salary Increases & Fixed Expenses Remain Stable,152336,45375.0,108496,153871.0,-1535.0,-1.01,-0.05,High Risk
U131,2024,10,232060.0,Salary Increases & Fixed Expenses Remain Stable,152336,45375.0,117587,162962.0,-10626.0,-6.98,0.01,High Risk
U131,2024,11,221434.0,Salary Increases & Fixed Expenses Remain Stable,152336,45375.0,119217,164592.0,-12256.0,-8.05,-0.02,High Risk
U131,2024,12,209178.0,Salary Increases & Fixed Expenses Remain Stable,152336,45375.0,114447,159822.0,-7486.0,-4.91,-0.02,High Risk
U132,2024,1,201031.0,Stable Salary & Increasing Fixed Expenses,85126,29279.0,40411,69690.0,15436.0,18.13,-0.04,Medium Risk
U132,2024,2,216467.0,Stable Salary & Increasing Fixed Expenses,85126,29279.0,49961,79240.0,5886.0,6.91,0.03,High Risk
U132,2024,3,222353.0,Stable Salary & Increasing Fixed Expenses,85126,29279.0,59469,88748.0,-3622.0,-4.25,0.04,High Risk
U132,2024,4,218731.0,Stable Salary & Increasing Fixed Expenses,85126,29279.0,43856,73135.0,11991.0,14.09,0.01,High Risk
U132,2024,5,230722.0,Stable Salary & Increasing Fixed Expenses,85126,29279.0,50836,80115.0,5011.0,5.89,-0.04,High Risk
U132,2024,6,235733.0,Stable Salary & Increasing Fixed Expenses,85126,29279.0,43843,73122.0,12004.0,14.1,-0.0,High Risk
U132,2024,7,247737.0,Stable Salary & Increasing Fixed Expenses,85126,30684.0,46258,76942.0,8184.0,9.61,0.02,High Risk
U132,2024,8,255921.0,Stable Salary & Increasing Fixed Expenses,85126,30684.0,35651,66335.0,18791.0,22.07,-0.02,Medium Risk
U132,2024,9,274712.0,Stable Salary & Increasing Fixed Expenses,85126,30684.0,34980,65664.0,19462.0,22.86,0.01,Medium Risk
U132,2024,10,294174.0,Stable Salary & Increasing Fixed Expenses,85126,30684.0,50199,80883.0,4243.0,4.98,-0.05,High Risk
U132,2024,11,298417.0,Stable Salary & Increasing Fixed Expenses,85126,30684.0,36863,67547.0,17579.0,20.65,0.02,Medium Risk
U132,2024,12,315996.0,Stable Salary & Increasing Fixed Expenses,85126,30684.0,47045,77729.0,7397.0,8.69,-0.0,High Risk
U133,2024,1,215613.0,Salary Increases & Fixed Expenses Remain Stable,140660,41741.0,82823,124564.0,16096.0,11.44,-0.03,High Risk
U133,2024,2,231709.0,Salary Increases & Fixed Expenses Remain Stable,140660,41741.0,77584,119325.0,21335.0,15.17,-0.01,Medium Risk
U133,2024,3,253044.0,Salary Increases & Fixed Expenses Remain Stable,140660,41741.0,73829,115570.0,25090.0,17.84,-0.04,Medium Risk
U133,2024,4,278134.0,Salary Increases & Fixed Expenses Remain Stable,140660,41741.0,82898,124639.0,16021.0,11.39,0.05,High Risk
U133,2024,5,294155.0,Salary Increases & Fixed Expenses Remain Stable,154145,41741.0,83542,125283.0,28862.0,18.72,-0.02,Medium Risk
U133,2024,6,323017.0,Salary Increases & Fixed Expenses Remain Stable,154145,41741.0,72291,114032.0,40113.0,26.02,0.03,Low Risk
U133,2024,7,363130.0,Salary Increases & Fixed Expenses Remain Stable,154145,41741.0,74771,116512.0,37633.0,24.41,0.03,Medium Risk
U133,2024,8,400763.0,Salary Increases & Fixed Expenses Remain Stable,154145,41741.0,85717,127458.0,26687.0,17.31,0.03,Medium Risk
U133,2024,9,427450.0,Salary Increases & Fixed Expenses Remain Stable,154145,41741.0,65998,107739.0,46406.0,30.11,-0.04,Low Risk
U133,2024,10,473856.0,Salary Increases & Fixed Expenses Remain Stable,154145,41741.0,93386,135127.0,19018.0,12.34,-0.03,High Risk
U133,2024,11,492874.0,Salary Increases & Fixed Expenses Remain Stable,154145,41741.0,82357,124098.0,30047.0,19.49,0.02,Medium Risk
U133,2024,12,522921.0,Salary Increases & Fixed Expenses Remain Stable,154145,41741.0,86370,128111.0,26034.0,16.89,-0.03,Medium Risk
U134,2024,1,226508.0,Salary Increases & Fixed Expenses Remain Stable,294820,115336.0,220720,336056.0,-41236.0,-13.99,0.02,High Risk
U134,2024,2,185272.0,Salary Increases & Fixed Expenses Remain Stable,294820,115336.0,231152,346488.0,-51668.0,-17.53,0.02,High Risk
U134,2024,3,133604.0,Salary Increases & Fixed Expenses Remain Stable,294820,115336.0,208739,324075.0,-29255.0,-9.92,0.05,High Risk
U134,2024,4,104349.0,Salary Increases & Fixed Expenses Remain Stable,294820,115336.0,196863,312199.0,-17379.0,-5.89,0.02,High Risk
U134,2024,5,86970.0,Salary Increases & Fixed Expenses Remain Stable,318503,115336.0,242690,358026.0,-39523.0,-12.41,-0.04,High Risk
U134,2024,6,47447.0,Salary Increases & Fixed Expenses Remain Stable,318503,115336.0,208128,323464.0,-4961.0,-1.56,0.01,High Risk
U134,2024,7,42486.0,Salary Increases & Fixed Expenses Remain Stable,318503,115336.0,232518,347854.0,-29351.0,-9.22,-0.04,High Risk
U134,2024,8,13135.0,Salary Increases & Fixed Expenses Remain Stable,318503,115336.0,231003,346339.0,-27836.0,-8.74,0.01,High Risk
U134,2024,9,-14701.0,Salary Increases & Fixed Expenses Remain Stable,318503,115336.0,223383,338719.0,-20216.0,-6.35,-0.0,High Risk
U134,2024,10,-34917.0,Salary Increases & Fixed Expenses Remain Stable,318503,115336.0,237646,352982.0,-34479.0,-10.83,0.01,High Risk
U134,2024,11,-69396.0,Salary Increases & Fixed Expenses Remain Stable,318503,115336.0,239045,354381.0,-35878.0,-11.26,-0.01,High Risk
U134,2024,12,-105274.0,Salary Increases & Fixed Expenses Remain Stable,318503,115336.0,224002,339338.0,-20835.0,-6.54,0.04,High Risk
U135,2024,1,200475.0,Salary Increases & Fixed Expenses Remain Stable,174416,79229.0,107884,187113.0,-12697.0,-7.28,-0.01,High Risk
U135,2024,2,187778.0,Salary Increases & Fixed Expenses Remain Stable,174416,79229.0,136314,215543.0,-41127.0,-23.58,-0.04,High Risk
U135,2024,3,146651.0,Salary Increases & Fixed Expenses Remain Stable,174416,79229.0,135501,214730.0,-40314.0,-23.11,-0.05,High Risk
U135,2024,4,106337.0,Salary Increases & Fixed Expenses Remain Stable,174416,79229.0,117282,196511.0,-22095.0,-12.67,-0.04,High Risk
U135,2024,5,84242.0,Salary Increases & Fixed Expenses Remain Stable,174416,79229.0,134233,213462.0,-39046.0,-22.39,0.0,High Risk
U135,2024,6,45196.0,Salary Increases & Fixed Expenses Remain Stable,189102,79229.0,142762,221991.0,-32889.0,-17.39,0.04,High Risk
U135,2024,7,12307.0,Salary Increases & Fixed Expenses Remain Stable,189102,79229.0,118187,197416.0,-8314.0,-4.4,-0.04,High Risk
U135,2024,8,3993.0,Salary Increases & Fixed Expenses Remain Stable,189102,79229.0,144977,224206.0,-35104.0,-18.56,-0.03,High Risk
U135,2024,9,-31111.0,Salary Increases & Fixed Expenses Remain Stable,189102,79229.0,126738,205967.0,-16865.0,-8.92,-0.04,High Risk
U135,2024,10,-47976.0,Salary Increases & Fixed Expenses Remain Stable,189102,79229.0,143001,222230.0,-33128.0,-17.52,-0.01,High Risk
U135,2024,11,-81104.0,Salary Increases & Fixed Expenses Remain Stable,189102,79229.0,134589,213818.0,-24716.0,-13.07,-0.02,High Risk
U135,2024,12,-105820.0,Salary Increases & Fixed Expenses Remain Stable,189102,79229.0,141700,220929.0,-31827.0,-16.83,-0.04,High Risk
U136,2024,1,243820.0,Stable Salary & Increasing Fixed Expenses,276516,80190.0,138202,218392.0,58124.0,21.02,0.02,Medium Risk
U136,2024,2,301944.0,Stable Salary & Increasing Fixed Expenses,276516,80190.0,161707,241897.0,34619.0,12.52,-0.02,High Risk
U136,2024,3,336563.0,Stable Salary & Increasing Fixed Expenses,276516,81878.0,160896,242774.0,33742.0,12.2,-0.02,High Risk
U136,2024,4,370305.0,Stable Salary & Increasing Fixed Expenses,276516,81878.0,111348,193226.0,83290.0,30.12,0.05,Low Risk
U136,2024,5,453595.0,Stable Salary & Increasing Fixed Expenses,276516,81878.0,120045,201923.0,74593.0,26.98,0.03,Low Risk
U136,2024,6,528188.0,Stable Salary & Increasing Fixed Expenses,276516,82650.0,144018,226668.0,49848.0,18.03,0.01,Medium Risk
U136,2024,7,578036.0,Stable Salary & Increasing Fixed Expenses,276516,82650.0,117116,199766.0,76750.0,27.76,-0.0,Low Risk
U136,2024,8,654786.0,Stable Salary & Increasing Fixed Expenses,276516,82650.0,112801,195451.0,81065.0,29.32,-0.03,Low Risk
U136,2024,9,735851.0,Stable Salary & Increasing Fixed Expenses,276516,82650.0,152336,234986.0,41530.0,15.02,-0.03,Medium Risk
U136,2024,10,777381.0,Stable Salary & Increasing Fixed Expenses,276516,82650.0,152593,235243.0,41273.0,14.93,-0.02,High Risk
U136,2024,11,818654.0,Stable Salary & Increasing Fixed Expenses,276516,82650.0,159022,241672.0,34844.0,12.6,-0.01,High Risk
U136,2024,12,853498.0,Stable Salary & Increasing Fixed Expenses,276516,82650.0,195032,277682.0,-1166.0,-0.42,-0.05,High Risk
U137,2024,1,239858.0,Stable Salary & Stable Fixed Expenses,131388,40163.0,67540,107703.0,23685.0,18.03,0.04,Medium Risk
U137,2024,2,263543.0,Stable Salary & Stable Fixed Expenses,131388,40163.0,56160,96323.0,35065.0,26.69,-0.01,Low Risk
U137,2024,3,298608.0,Stable Salary & Stable Fixed Expenses,131388,40163.0,88582,128745.0,2643.0,2.01,0.0,High Risk
U137,2024,4,301251.0,Stable Salary & Stable Fixed Expenses,131388,40163.0,63845,104008.0,27380.0,20.84,-0.01,Medium Risk
U137,2024,5,328631.0,Stable Salary & Stable Fixed Expenses,131388,40163.0,65837,106000.0,25388.0,19.32,-0.05,Medium Risk
U137,2024,6,354019.0,Stable Salary & Stable Fixed Expenses,131388,40163.0,63367,103530.0,27858.0,21.2,-0.0,Medium Risk
U137,2024,7,381877.0,Stable Salary & Stable Fixed Expenses,131388,40163.0,56312,96475.0,34913.0,26.57,-0.03,Low Risk
U137,2024,8,416790.0,Stable Salary & Stable Fixed Expenses,131388,40163.0,58028,98191.0,33197.0,25.27,0.05,Low Risk
U137,2024,9,449987.0,Stable Salary & Stable Fixed Expenses,131388,40163.0,81749,121912.0,9476.0,7.21,-0.04,High Risk
U137,2024,10,459463.0,Stable Salary & Stable Fixed Expenses,131388,40163.0,79489,119652.0,11736.0,8.93,0.03,High Risk
U137,2024,11,471199.0,Stable Salary & Stable Fixed Expenses,131388,40163.0,79357,119520.0,11868.0,9.03,0.03,High Risk
U137,2024,12,483067.0,Stable Salary & Stable Fixed Expenses,131388,40163.0,63939,104102.0,27286.0,20.77,0.01,Medium Risk
U138,2024,1,224151.0,Salary Increases & Fixed Expenses Decrease,131661,51327.0,74840,126167.0,5494.0,4.17,0.04,High Risk
U138,2024,2,229645.0,Salary Increases & Fixed Expenses Decrease,131661,51327.0,77235,128562.0,3099.0,2.35,0.01,High Risk
U138,2024,3,232744.0,Salary Increases & Fixed Expenses Decrease,131661,51327.0,93385,144712.0,-13051.0,-9.91,0.01,High Risk
U138,2024,4,219693.0,Salary Increases & Fixed Expenses Decrease,131661,51327.0,56482,107809.0,23852.0,18.12,-0.02,Medium Risk
U138,2024,5,243545.0,Salary Increases & Fixed Expenses Decrease,131661,51327.0,64872,116199.0,15462.0,11.74,-0.03,High Risk
U138,2024,6,259007.0,Salary Increases & Fixed Expenses Decrease,131661,51327.0,70651,121978.0,9683.0,7.35,-0.05,High Risk
U138,2024,7,268690.0,Salary Increases & Fixed Expenses Decrease,131661,51327.0,74173,125500.0,6161.0,4.68,0.05,High Risk
U138,2024,8,274851.0,Salary Increases & Fixed Expenses Decrease,149704,51327.0,81241,132568.0,17136.0,11.45,-0.02,High Risk
U138,2024,9,291987.0,Salary Increases & Fixed Expenses Decrease,149704,51327.0,88749,140076.0,9628.0,6.43,-0.0,High Risk
U138,2024,10,301615.0,Salary Increases & Fixed Expenses Decrease,149704,51327.0,85216,136543.0,13161.0,8.79,0.02,High Risk
U138,2024,11,314776.0,Salary Increases & Fixed Expenses Decrease,149704,51327.0,73982,125309.0,24395.0,16.3,-0.02,Medium Risk
U138,2024,12,339171.0,Salary Increases & Fixed Expenses Decrease,149704,51327.0,93855,145182.0,4522.0,3.02,0.01,High Risk
U139,2024,1,206143.0,Salary Increases & Fixed Expenses Remain Stable,259902,97643.0,111915,209558.0,50344.0,19.37,-0.02,Medium Risk
U139,2024,2,256487.0,Salary Increases & Fixed Expenses Remain Stable,259902,97643.0,114477,212120.0,47782.0,18.38,0.0,Medium Risk
U139,2024,3,304269.0,Salary Increases & Fixed Expenses Remain Stable,259902,97643.0,143951,241594.0,18308.0,7.04,-0.03,High Risk
U139,2024,4,322577.0,Salary Increases & Fixed Expenses Remain Stable,265463,97643.0,107087,204730.0,60733.0,22.88,-0.04,Medium Risk
U139,2024,5,383310.0,Salary Increases & Fixed Expenses Remain Stable,265463,97643.0,153007,250650.0,14813.0,5.58,-0.0,High Risk
U139,2024,6,398123.0,Salary Increases & Fixed Expenses Remain Stable,265463,97643.0,147402,245045.0,20418.0,7.69,-0.03,High Risk
U139,2024,7,418541.0,Salary Increases & Fixed Expenses Remain Stable,265463,97643.0,139309,236952.0,28511.0,10.74,-0.04,High Risk
U139,2024,8,447052.0,Salary Increases & Fixed Expenses Remain Stable,265463,97643.0,117464,215107.0,50356.0,18.97,-0.04,Medium Risk
U139,2024,9,497408.0,Salary Increases & Fixed Expenses Remain Stable,265463,97643.0,128491,226134.0,39329.0,14.82,0.01,High Risk
U139,2024,10,536737.0,Salary Increases & Fixed Expenses Remain Stable,265463,97643.0,130451,228094.0,37369.0,14.08,-0.0,High Risk
U139,2024,11,574106.0,Salary Increases & Fixed Expenses Remain Stable,265463,97643.0,108906,206549.0,58914.0,22.19,0.04,Medium Risk
U139,2024,12,633020.0,Salary Increases & Fixed Expenses Remain Stable,265463,97643.0,154183,251826.0,13637.0,5.14,-0.02,High Risk
U140,2024,1,200085.0,Salary Increases & Fixed Expenses Increase,108753,41831.0,75804,117635.0,-8882.0,-8.17,0.01,High Risk
U140,2024,2,191203.0,Salary Increases & Fixed Expenses Increase,108753,41831.0,81541,123372.0,-14619.0,-13.44,0.02,High Risk
U140,2024,3,176584.0,Salary Increases & Fixed Expenses Increase,121072,41831.0,104520,146351.0,-25279.0,-20.88,-0.0,High Risk
U140,2024,4,151305.0,Salary Increases & Fixed Expenses Increase,121072,42936.0,91418,134354.0,-13282.0,-10.97,0.01,High Risk
U140,2024,5,138023.0,Salary Increases & Fixed Expenses Increase,121072,42936.0,89916,132852.0,-11780.0,-9.73,-0.03,High Risk
U140,2024,6,126243.0,Salary Increases & Fixed Expenses Increase,121072,43973.0,83773,127746.0,-6674.0,-5.51,0.01,High Risk
U140,2024,7,119569.0,Salary Increases & Fixed Expenses Increase,121072,43973.0,77245,121218.0,-146.0,-0.12,0.05,High Risk
U140,2024,8,119423.0,Salary Increases & Fixed Expenses Increase,121072,43973.0,78081,122054.0,-982.0,-0.81,-0.03,High Risk
U140,2024,9,118441.0,Salary Increases & Fixed Expenses Increase,121072,43973.0,77821,121794.0,-722.0,-0.6,-0.03,High Risk
U140,2024,10,117719.0,Salary Increases & Fixed Expenses Increase,121072,43973.0,108531,152504.0,-31432.0,-25.96,-0.04,High Risk
U140,2024,11,86287.0,Salary Increases & Fixed Expenses Increase,121072,43973.0,90405,134378.0,-13306.0,-10.99,0.03,High Risk
U140,2024,12,72981.0,Salary Increases & Fixed Expenses Increase,121072,43973.0,80040,124013.0,-2941.0,-2.43,-0.0,High Risk
U141,2024,1,248428.0,Salary Increases & Fixed Expenses Remain Stable,239534,84692.0,93798,178490.0,61044.0,25.48,-0.02,Low Risk
U141,2024,2,309472.0,Salary Increases & Fixed Expenses Remain Stable,239534,84692.0,94499,179191.0,60343.0,25.19,0.05,Low Risk
U141,2024,3,369815.0,Salary Increases & Fixed Expenses Remain Stable,239534,84692.0,94909,179601.0,59933.0,25.02,-0.04,Low Risk
U141,2024,4,429748.0,Salary Increases & Fixed Expenses Remain Stable,239534,84692.0,91565,176257.0,63277.0,26.42,-0.01,Low Risk
U141,2024,5,493025.0,Salary Increases & Fixed Expenses Remain Stable,246830,84692.0,93727,178419.0,68411.0,27.72,-0.02,Low Risk
U141,2024,6,561436.0,Salary Increases & Fixed Expenses Remain Stable,246830,84692.0,95643,180335.0,66495.0,26.94,-0.0,Low Risk
U141,2024,7,627931.0,Salary Increases & Fixed Expenses Remain Stable,246830,84692.0,81070,165762.0,81068.0,32.84,-0.02,Low Risk
U141,2024,8,708999.0,Salary Increases & Fixed Expenses Remain Stable,246830,84692.0,92234,176926.0,69904.0,28.32,0.04,Low Risk
U141,2024,9,778903.0,Salary Increases & Fixed Expenses Remain Stable,246830,84692.0,98723,183415.0,63415.0,25.69,0.04,Low Risk
U141,2024,10,842318.0,Salary Increases & Fixed Expenses Remain Stable,246830,84692.0,83337,168029.0,78801.0,31.93,-0.02,Low Risk
U141,2024,11,921119.0,Salary Increases & Fixed Expenses Remain Stable,246830,84692.0,87812,172504.0,74326.0,30.11,0.03,Low Risk
U141,2024,12,995445.0,Salary Increases & Fixed Expenses Remain Stable,246830,84692.0,94490,179182.0,67648.0,27.41,-0.02,Low Risk
U142,2024,1,203087.0,Salary Increases & Fixed Expenses Increase,267594,107200.0,110524,217724.0,49870.0,18.64,-0.03,Medium Risk
U142,2024,2,252957.0,Salary Increases & Fixed Expenses Increase,267594,107200.0,141784,248984.0,18610.0,6.95,-0.02,High Risk
U142,2024,3,271567.0,Salary Increases & Fixed Expenses Increase,267594,107200.0,156909,264109.0,3485.0,1.3,-0.0,High Risk
U142,2024,4,275052.0,Salary Increases & Fixed Expenses Increase,273813,107200.0,121200,228400.0,45413.0,16.59,0.02,Medium Risk
U142,2024,5,320465.0,Salary Increases & Fixed Expenses Increase,273813,108753.0,158298,267051.0,6762.0,2.47,0.01,High Risk
U142,2024,6,327227.0,Salary Increases & Fixed Expenses Increase,273813,108753.0,123585,232338.0,41475.0,15.15,-0.03,Medium Risk
U142,2024,7,368702.0,Salary Increases & Fixed Expenses Increase,273813,109366.0,159519,268885.0,4928.0,1.8,-0.02,High Risk
U142,2024,8,373630.0,Salary Increases & Fixed Expenses Increase,273813,110305.0,149964,260269.0,13544.0,4.95,0.05,High Risk
U142,2024,9,387174.0,Salary Increases & Fixed Expenses Increase,273813,112167.0,179979,292146.0,-18333.0,-6.7,0.02,High Risk
U142,2024,10,368841.0,Salary Increases & Fixed Expenses Increase,273813,113097.0,160060,273157.0,656.0,0.24,-0.03,High Risk
U142,2024,11,369497.0,Salary Increases & Fixed Expenses Increase,273813,114921.0,145642,260563.0,13250.0,4.84,0.02,High Risk
U142,2024,12,382747.0,Salary Increases & Fixed Expenses Increase,273813,114921.0,185517,300438.0,-26625.0,-9.72,0.03,High Risk
U143,2024,1,220190.0,Stable Salary & Stable Fixed Expenses,287770,75040.0,116793,191833.0,95937.0,33.34,0.02,Low Risk
U143,2024,2,316127.0,Stable Salary & Stable Fixed Expenses,287770,75040.0,133511,208551.0,79219.0,27.53,0.05,Low Risk
U143,2024,3,395346.0,Stable Salary & Stable Fixed Expenses,287770,75040.0,159810,234850.0,52920.0,18.39,-0.05,Medium Risk
U143,2024,4,448266.0,Stable Salary & Stable Fixed Expenses,287770,75040.0,164391,239431.0,48339.0,16.8,-0.05,Medium Risk
U143,2024,5,496605.0,Stable Salary & Stable Fixed Expenses,287770,75040.0,171907,246947.0,40823.0,14.19,-0.03,High Risk
U143,2024,6,537428.0,Stable Salary & Stable Fixed Expenses,287770,75040.0,139612,214652.0,73118.0,25.41,0.01,Low Risk
U143,2024,7,610546.0,Stable Salary & Stable Fixed Expenses,287770,75040.0,137214,212254.0,75516.0,26.24,-0.0,Low Risk
U143,2024,8,686062.0,Stable Salary & Stable Fixed Expenses,287770,75040.0,147594,222634.0,65136.0,22.63,0.04,Medium Risk
U143,2024,9,751198.0,Stable Salary & Stable Fixed Expenses,287770,75040.0,162020,237060.0,50710.0,17.62,-0.02,Medium Risk
U143,2024,10,801908.0,Stable Salary & Stable Fixed Expenses,287770,75040.0,183418,258458.0,29312.0,10.19,0.05,High Risk
U143,2024,11,831220.0,Stable Salary & Stable Fixed Expenses,287770,75040.0,144500,219540.0,68230.0,23.71,0.01,Medium Risk
U143,2024,12,899450.0,Stable Salary & Stable Fixed Expenses,287770,75040.0,172548,247588.0,40182.0,13.96,0.04,High Risk
U144,2024,1,219943.0,Salary Increases & Fixed Expenses Remain Stable,217594,68060.0,158178,226238.0,-8644.0,-3.97,-0.01,High Risk
U144,2024,2,211299.0,Salary Increases & Fixed Expenses Remain Stable,217594,68060.0,142406,210466.0,7128.0,3.28,-0.03,High Risk
U144,2024,3,218427.0,Salary Increases & Fixed Expenses Remain Stable,224143,68060.0,164178,232238.0,-8095.0,-3.61,0.03,High Risk
U144,2024,4,210332.0,Salary Increases & Fixed Expenses Remain Stable,224143,68060.0,158215,226275.0,-2132.0,-0.95,0.04,High Risk
U144,2024,5,208200.0,Salary Increases & Fixed Expenses Remain Stable,224143,68060.0,148449,216509.0,7634.0,3.41,0.04,High Risk
U144,2024,6,215834.0,Salary Increases & Fixed Expenses Remain Stable,224143,68060.0,144069,212129.0,12014.0,5.36,-0.03,High Risk
U144,2024,7,227848.0,Salary Increases & Fixed Expenses Remain Stable,224143,68060.0,172871,240931.0,-16788.0,-7.49,-0.03,High Risk
U144,2024,8,211060.0,Salary Increases & Fixed Expenses Remain Stable,224143,68060.0,178253,246313.0,-22170.0,-9.89,0.03,High Risk
U144,2024,9,188890.0,Salary Increases & Fixed Expenses Remain Stable,224143,68060.0,156378,224438.0,-295.0,-0.13,0.03,High Risk
U144,2024,10,188595.0,Salary Increases & Fixed Expenses Remain Stable,224143,68060.0,190465,258525.0,-34382.0,-15.34,0.04,High Risk
U144,2024,11,154213.0,Salary Increases & Fixed Expenses Remain Stable,224143,68060.0,153538,221598.0,2545.0,1.14,-0.01,High Risk
U144,2024,12,156758.0,Salary Increases & Fixed Expenses Remain Stable,224143,68060.0,188767,256827.0,-32684.0,-14.58,-0.01,High Risk
U145,2024,1,216456.0,Salary Increases & Fixed Expenses Remain Stable,264191,75155.0,150362,225517.0,38674.0,14.64,-0.02,High Risk
U145,2024,2,255130.0,Salary Increases & Fixed Expenses Remain Stable,264191,75155.0,115229,190384.0,73807.0,27.94,-0.03,Low Risk
U145,2024,3,328937.0,Salary Increases & Fixed Expenses Remain Stable,264191,75155.0,132930,208085.0,56106.0,21.24,0.02,Medium Risk
U145,2024,4,385043.0,Salary Increases & Fixed Expenses Remain Stable,271800,75155.0,141372,216527.0,55273.0,20.34,-0.01,Medium Risk
U145,2024,5,440316.0,Salary Increases & Fixed Expenses Remain Stable,271800,75155.0,153199,228354.0,43446.0,15.98,0.02,Medium Risk
U145,2024,6,483762.0,Salary Increases & Fixed Expenses Remain Stable,271800,75155.0,150666,225821.0,45979.0,16.92,-0.0,Medium Risk
U145,2024,7,529741.0,Salary Increases & Fixed Expenses Remain Stable,271800,75155.0,124003,199158.0,72642.0,26.73,0.04,Low Risk
U145,2024,8,602383.0,Salary Increases & Fixed Expenses Remain Stable,271800,75155.0,159606,234761.0,37039.0,13.63,-0.05,High Risk
U145,2024,9,639422.0,Salary Increases & Fixed Expenses Remain Stable,271800,75155.0,183755,258910.0,12890.0,4.74,0.01,High Risk
U145,2024,10,652312.0,Salary Increases & Fixed Expenses Remain Stable,271800,75155.0,178333,253488.0,18312.0,6.74,0.04,High Risk
U145,2024,11,670624.0,Salary Increases & Fixed Expenses Remain Stable,271800,75155.0,132671,207826.0,63974.0,23.54,-0.05,Medium Risk
U145,2024,12,734598.0,Salary Increases & Fixed Expenses Remain Stable,271800,75155.0,136214,211369.0,60431.0,22.23,-0.01,Medium Risk
U146,2024,1,237202.0,Salary Increases & Fixed Expenses Decrease,83386,25877.0,25758,51635.0,31751.0,38.08,-0.04,Low Risk
U146,2024,2,268953.0,Salary Increases & Fixed Expenses Decrease,83386,25877.0,29243,55120.0,28266.0,33.9,0.01,Low Risk
U146,2024,3,297219.0,Salary Increases & Fixed Expenses Decrease,83386,25877.0,37581,63458.0,19928.0,23.9,-0.02,Medium Risk
U146,2024,4,317147.0,Salary Increases & Fixed Expenses Decrease,83386,25877.0,31901,57778.0,25608.0,30.71,-0.02,Low Risk
U146,2024,5,342755.0,Salary Increases & Fixed Expenses Decrease,105501,25877.0,37284,63161.0,42340.0,40.13,-0.0,Low Risk
U146,2024,6,385095.0,Salary Increases & Fixed Expenses Decrease,105501,25877.0,41472,67349.0,38152.0,36.16,-0.05,Low Risk
U146,2024,7,423247.0,Salary Increases & Fixed Expenses Decrease,105501,25877.0,41005,66882.0,38619.0,36.61,-0.0,Low Risk
U146,2024,8,461866.0,Salary Increases & Fixed Expenses Decrease,105501,25877.0,40814,66691.0,38810.0,36.79,0.02,Low Risk
U146,2024,9,500676.0,Salary Increases & Fixed Expenses Decrease,105501,25877.0,41083,66960.0,38541.0,36.53,0.04,Low Risk
U146,2024,10,539217.0,Salary Increases & Fixed Expenses Decrease,105501,25877.0,41031,66908.0,38593.0,36.58,0.03,Low Risk
U146,2024,11,577810.0,Salary Increases & Fixed Expenses Decrease,105501,25877.0,31821,57698.0,47803.0,45.31,0.03,Low Risk
U146,2024,12,625613.0,Salary Increases & Fixed Expenses Decrease,105501,25877.0,35244,61121.0,44380.0,42.07,-0.02,Low Risk
U147,2024,1,219837.0,Salary Increases & Fixed Expenses Remain Stable,178954,60096.0,85990,146086.0,32868.0,18.37,0.02,Medium Risk
U147,2024,2,252705.0,Salary Increases & Fixed Expenses Remain Stable,178954,60096.0,97384,157480.0,21474.0,12.0,-0.02,High Risk
U147,2024,3,274179.0,Salary Increases & Fixed Expenses Remain Stable,178954,60096.0,116171,176267.0,2687.0,1.5,0.03,High Risk
U147,2024,4,276866.0,Salary Increases & Fixed Expenses Remain Stable,178954,60096.0,80717,140813.0,38141.0,21.31,0.05,Medium Risk
U147,2024,5,315007.0,Salary Increases & Fixed Expenses Remain Stable,178954,60096.0,99591,159687.0,19267.0,10.77,-0.04,High Risk
U147,2024,6,334274.0,Salary Increases & Fixed Expenses Remain Stable,197969,60096.0,84973,145069.0,52900.0,26.72,-0.04,Low Risk
U147,2024,7,387174.0,Salary Increases & Fixed Expenses Remain Stable,197969,60096.0,82786,142882.0,55087.0,27.83,-0.04,Low Risk
U147,2024,8,442261.0,Salary Increases & Fixed Expenses Remain Stable,197969,60096.0,103694,163790.0,34179.0,17.26,-0.01,Medium Risk
U147,2024,9,476440.0,Salary Increases & Fixed Expenses Remain Stable,197969,60096.0,86518,146614.0,51355.0,25.94,0.03,Low Risk
U147,2024,10,527795.0,Salary Increases & Fixed Expenses Remain Stable,197969,60096.0,104759,164855.0,33114.0,16.73,-0.05,Medium Risk
U147,2024,11,560909.0,Salary Increases & Fixed Expenses Remain Stable,197969,60096.0,100048,160144.0,37825.0,19.11,-0.01,Medium Risk
U147,2024,12,598734.0,Salary Increases & Fixed Expenses Remain Stable,197969,60096.0,113468,173564.0,24405.0,12.33,0.01,High Risk
U148,2024,1,200305.0,Salary Increases & Fixed Expenses Increase,36296,12228.0,17357,29585.0,6711.0,18.49,0.03,Medium Risk
U148,2024,2,207016.0,Salary Increases & Fixed Expenses Increase,36296,12228.0,20030,32258.0,4038.0,11.13,0.01,High Risk
U148,2024,3,211054.0,Salary Increases & Fixed Expenses Increase,36296,12228.0,15037,27265.0,9031.0,24.88,0.04,Medium Risk
U148,2024,4,220085.0,Salary Increases & Fixed Expenses Increase,36296,12228.0,15601,27829.0,8467.0,23.33,-0.01,Medium Risk
U148,2024,5,228552.0,Salary Increases & Fixed Expenses Increase,36296,12228.0,15566,27794.0,8502.0,23.42,0.02,Medium Risk
U148,2024,6,237054.0,Salary Increases & Fixed Expenses Increase,36296,12228.0,21484,33712.0,2584.0,7.12,0.04,High Risk
U148,2024,7,239638.0,Salary Increases & Fixed Expenses Increase,36296,13419.0,21350,34769.0,1527.0,4.21,0.02,High Risk
U148,2024,8,241165.0,Salary Increases & Fixed Expenses Increase,57028,13419.0,28608,42027.0,15001.0,26.3,-0.0,Low Risk
U148,2024,9,256166.0,Salary Increases & Fixed Expenses Increase,57028,13419.0,27171,40590.0,16438.0,28.82,-0.02,Low Risk
U148,2024,10,272604.0,Salary Increases & Fixed Expenses Increase,57028,13419.0,31363,44782.0,12246.0,21.47,-0.03,Medium Risk
U148,2024,11,284850.0,Salary Increases & Fixed Expenses Increase,57028,13419.0,33854,47273.0,9755.0,17.11,0.05,Medium Risk
U148,2024,12,294605.0,Salary Increases & Fixed Expenses Increase,57028,13419.0,33997,47416.0,9612.0,16.85,-0.01,Medium Risk
U149,2024,1,210509.0,Salary Increases & Fixed Expenses Increase,157648,61274.0,69637,130911.0,26737.0,16.96,-0.02,Medium Risk
U149,2024,2,237246.0,Salary Increases & Fixed Expenses Increase,157648,61274.0,80259,141533.0,16115.0,10.22,-0.05,High Risk
U149,2024,3,253361.0,Salary Increases & Fixed Expenses Increase,172103,61274.0,88555,149829.0,22274.0,12.94,0.02,High Risk
U149,2024,4,275635.0,Salary Increases & Fixed Expenses Increase,172103,61274.0,75297,136571.0,35532.0,20.65,0.01,Medium Risk
U149,2024,5,311167.0,Salary Increases & Fixed Expenses Increase,172103,61274.0,72379,133653.0,38450.0,22.34,0.02,Medium Risk
U149,2024,6,349617.0,Salary Increases & Fixed Expenses Increase,172103,61274.0,102841,164115.0,7988.0,4.64,0.05,High Risk
U149,2024,7,357605.0,Salary Increases & Fixed Expenses Increase,172103,61274.0,79909,141183.0,30920.0,17.97,-0.04,Medium Risk
U149,2024,8,388525.0,Salary Increases & Fixed Expenses Increase,172103,61274.0,90031,151305.0,20798.0,12.08,0.04,High Risk
U149,2024,9,409323.0,Salary Increases & Fixed Expenses Increase,172103,61274.0,78695,139969.0,32134.0,18.67,0.02,Medium Risk
U149,2024,10,441457.0,Salary Increases & Fixed Expenses Increase,172103,62282.0,90326,152608.0,19495.0,11.33,-0.02,High Risk
U149,2024,11,460952.0,Salary Increases & Fixed Expenses Increase,172103,62282.0,107848,170130.0,1973.0,1.15,0.03,High Risk
U149,2024,12,462925.0,Salary Increases & Fixed Expenses Increase,172103,62282.0,109610,171892.0,211.0,0.12,-0.0,High Risk
U150,2024,1,248009.0,Stable Salary & Increasing Fixed Expenses,277806,87954.0,182151,270105.0,7701.0,2.77,0.01,High Risk
U150,2024,2,255710.0,Stable Salary & Increasing Fixed Expenses,277806,87954.0,188836,276790.0,1016.0,0.37,0.0,High Risk
U150,2024,3,256726.0,Stable Salary & Increasing Fixed Expenses,277806,87954.0,222701,310655.0,-32849.0,-11.82,0.02,High Risk
U150,2024,4,223877.0,Stable Salary & Increasing Fixed Expenses,277806,87954.0,191651,279605.0,-1799.0,-0.65,0.02,High Risk
U150,2024,5,222078.0,Stable Salary & Increasing Fixed Expenses,277806,87954.0,212616,300570.0,-22764.0,-8.19,-0.01,High Risk
U150,2024,6,199314.0,Stable Salary & Increasing Fixed Expenses,277806,87954.0,175423,263377.0,14429.0,5.19,0.05,High Risk
U150,2024,7,213743.0,Stable Salary & Increasing Fixed Expenses,277806,87954.0,192673,280627.0,-2821.0,-1.02,0.05,High Risk
U150,2024,8,210922.0,Stable Salary & Increasing Fixed Expenses,277806,87954.0,199091,287045.0,-9239.0,-3.33,-0.01,High Risk
U150,2024,9,201683.0,Stable Salary & Increasing Fixed Expenses,277806,87954.0,190220,278174.0,-368.0,-0.13,-0.01,High Risk
U150,2024,10,201315.0,Stable Salary & Increasing Fixed Expenses,277806,87954.0,275974,363928.0,-86122.0,-31.0,0.04,High Risk
U150,2024,11,115193.0,Stable Salary & Increasing Fixed Expenses,277806,87954.0,225680,313634.0,-35828.0,-12.9,0.03,High Risk
U150,2024,12,79365.0,Stable Salary & Increasing Fixed Expenses,277806,87954.0,278430,366384.0,-88578.0,-31.88,0.04,High Risk
U151,2024,1,212130.0,Stable Salary & Stable Fixed Expenses,160195,64039.0,83178,147217.0,12978.0,8.1,-0.05,High Risk
U151,2024,2,225108.0,Stable Salary & Stable Fixed Expenses,160195,64039.0,72744,136783.0,23412.0,14.61,0.01,High Risk
U151,2024,3,248520.0,Stable Salary & Stable Fixed Expenses,160195,64039.0,66203,130242.0,29953.0,18.7,-0.05,Medium Risk
U151,2024,4,278473.0,Stable Salary & Stable Fixed Expenses,160195,64039.0,65741,129780.0,30415.0,18.99,-0.01,Medium Risk
U151,2024,5,308888.0,Stable Salary & Stable Fixed Expenses,160195,64039.0,85025,149064.0,11131.0,6.95,-0.0,High Risk
U151,2024,6,320019.0,Stable Salary & Stable Fixed Expenses,160195,64039.0,80496,144535.0,15660.0,9.78,0.01,High Risk
U151,2024,7,335679.0,Stable Salary & Stable Fixed Expenses,160195,64039.0,80811,144850.0,15345.0,9.58,0.04,High Risk
U151,2024,8,351024.0,Stable Salary & Stable Fixed Expenses,160195,64039.0,91929,155968.0,4227.0,2.64,0.03,High Risk
U151,2024,9,355251.0,Stable Salary & Stable Fixed Expenses,160195,64039.0,82486,146525.0,13670.0,8.53,-0.02,High Risk
U151,2024,10,368921.0,Stable Salary & Stable Fixed Expenses,160195,64039.0,90359,154398.0,5797.0,3.62,0.03,High Risk
U151,2024,11,374718.0,Stable Salary & Stable Fixed Expenses,160195,64039.0,80211,144250.0,15945.0,9.95,-0.01,High Risk
U151,2024,12,390663.0,Stable Salary & Stable Fixed Expenses,160195,64039.0,74537,138576.0,21619.0,13.5,0.03,High Risk
U152,2024,1,228793.0,Salary Increases & Fixed Expenses Remain Stable,130619,78322.0,57309,135631.0,-5012.0,-3.84,-0.04,High Risk
U152,2024,2,223781.0,Salary Increases & Fixed Expenses Remain Stable,130619,78322.0,57676,135998.0,-5379.0,-4.12,0.04,High Risk
U152,2024,3,218402.0,Salary Increases & Fixed Expenses Remain Stable,130619,78322.0,76460,154782.0,-24163.0,-18.5,0.05,High Risk
U152,2024,4,194239.0,Salary Increases & Fixed Expenses Remain Stable,130619,78322.0,55513,133835.0,-3216.0,-2.46,0.05,High Risk
U152,2024,5,191023.0,Salary Increases & Fixed Expenses Remain Stable,130619,78322.0,75620,153942.0,-23323.0,-17.86,-0.05,High Risk
U152,2024,6,167700.0,Salary Increases & Fixed Expenses Remain Stable,138381,78322.0,57839,136161.0,2220.0,1.6,-0.01,High Risk
U152,2024,7,169920.0,Salary Increases & Fixed Expenses Remain Stable,138381,78322.0,63264,141586.0,-3205.0,-2.32,0.03,High Risk
U152,2024,8,166715.0,Salary Increases & Fixed Expenses Remain Stable,138381,78322.0,64847,143169.0,-4788.0,-3.46,-0.01,High Risk
U152,2024,9,161927.0,Salary Increases & Fixed Expenses Remain Stable,138381,78322.0,87906,166228.0,-27847.0,-20.12,0.0,High Risk
U152,2024,10,134080.0,Salary Increases & Fixed Expenses Remain Stable,138381,78322.0,84600,162922.0,-24541.0,-17.73,-0.0,High Risk
U152,2024,11,109539.0,Salary Increases & Fixed Expenses Remain Stable,138381,78322.0,72695,151017.0,-12636.0,-9.13,0.02,High Risk
U152,2024,12,96903.0,Salary Increases & Fixed Expenses Remain Stable,138381,78322.0,85920,164242.0,-25861.0,-18.69,-0.02,High Risk
U153,2024,1,226755.0,Stable Salary & Decreasing Fixed Expenses,38409,10290.0,20511,30801.0,7608.0,19.81,0.05,Medium Risk
U153,2024,2,234363.0,Stable Salary & Decreasing Fixed Expenses,38409,10290.0,16275,26565.0,11844.0,30.84,0.04,Low Risk
U153,2024,3,246207.0,Stable Salary & Decreasing Fixed Expenses,38409,10290.0,16724,27014.0,11395.0,29.67,-0.02,Low Risk
U153,2024,4,257602.0,Stable Salary & Decreasing Fixed Expenses,38409,9261.0,15434,24695.0,13714.0,35.71,-0.02,Low Risk
U153,2024,5,271316.0,Stable Salary & Decreasing Fixed Expenses,38409,9261.0,17990,27251.0,11158.0,29.05,0.05,Low Risk
U153,2024,6,282474.0,Stable Salary & Decreasing Fixed Expenses,38409,9261.0,20445,29706.0,8703.0,22.66,0.04,Medium Risk
U153,2024,7,291177.0,Stable Salary & Decreasing Fixed Expenses,38409,9261.0,20124,29385.0,9024.0,23.49,0.0,Medium Risk
U153,2024,8,300201.0,Stable Salary & Decreasing Fixed Expenses,38409,9261.0,18614,27875.0,10534.0,27.43,0.04,Low Risk
U153,2024,9,310735.0,Stable Salary & Decreasing Fixed Expenses,38409,9261.0,17574,26835.0,11574.0,30.13,-0.05,Low Risk
U153,2024,10,322309.0,Stable Salary & Decreasing Fixed Expenses,38409,9261.0,15949,25210.0,13199.0,34.36,0.0,Low Risk
U153,2024,11,335508.0,Stable Salary & Decreasing Fixed Expenses,38409,9261.0,20428,29689.0,8720.0,22.7,-0.01,Medium Risk
U153,2024,12,344228.0,Stable Salary & Decreasing Fixed Expenses,38409,9261.0,18146,27407.0,11002.0,28.64,-0.01,Low Risk
U154,2024,1,208937.0,Salary Increases & Fixed Expenses Remain Stable,250091,104645.0,94694,199339.0,50752.0,20.29,0.0,Medium Risk
U154,2024,2,259689.0,Salary Increases & Fixed Expenses Remain Stable,250091,104645.0,94775,199420.0,50671.0,20.26,0.03,Medium Risk
U154,2024,3,310360.0,Salary Increases & Fixed Expenses Remain Stable,250091,104645.0,107979,212624.0,37467.0,14.98,0.04,High Risk
U154,2024,4,347827.0,Salary Increases & Fixed Expenses Remain Stable,250091,104645.0,87273,191918.0,58173.0,23.26,0.01,Medium Risk
U154,2024,5,406000.0,Salary Increases & Fixed Expenses Remain Stable,250091,104645.0,76896,181541.0,68550.0,27.41,-0.01,Low Risk
U154,2024,6,474550.0,Salary Increases & Fixed Expenses Remain Stable,270600,104645.0,93919,198564.0,72036.0,26.62,-0.05,Low Risk
U154,2024,7,546586.0,Salary Increases & Fixed Expenses Remain Stable,270600,104645.0,89917,194562.0,76038.0,28.1,-0.05,Low Risk
U154,2024,8,622624.0,Salary Increases & Fixed Expenses Remain Stable,270600,104645.0,104812,209457.0,61143.0,22.6,-0.03,Medium Risk
U154,2024,9,683767.0,Salary Increases & Fixed Expenses Remain Stable,270600,104645.0,102298,206943.0,63657.0,23.52,-0.03,Medium Risk
U154,2024,10,747424.0,Salary Increases & Fixed Expenses Remain Stable,270600,104645.0,106822,211467.0,59133.0,21.85,-0.03,Medium Risk
U154,2024,11,806557.0,Salary Increases & Fixed Expenses Remain Stable,270600,104645.0,96630,201275.0,69325.0,25.62,-0.05,Low Risk
U154,2024,12,875882.0,Salary Increases & Fixed Expenses Remain Stable,270600,104645.0,90298,194943.0,75657.0,27.96,-0.01,Low Risk
U155,2024,1,223893.0,Stable Salary & Stable Fixed Expenses,135014,70019.0,60612,130631.0,4383.0,3.25,-0.04,High Risk
U155,2024,2,228276.0,Stable Salary & Stable Fixed Expenses,135014,70019.0,72112,142131.0,-7117.0,-5.27,0.04,High Risk
U155,2024,3,221159.0,Stable Salary & Stable Fixed Expenses,135014,70019.0,67649,137668.0,-2654.0,-1.97,0.02,High Risk
U155,2024,4,218505.0,Stable Salary & Stable Fixed Expenses,135014,70019.0,67652,137671.0,-2657.0,-1.97,-0.01,High Risk
U155,2024,5,215848.0,Stable Salary & Stable Fixed Expenses,135014,70019.0,81004,151023.0,-16009.0,-11.86,-0.03,High Risk
U155,2024,6,199839.0,Stable Salary & Stable Fixed Expenses,135014,70019.0,70606,140625.0,-5611.0,-4.16,0.02,High Risk
U155,2024,7,194228.0,Stable Salary & Stable Fixed Expenses,135014,70019.0,56827,126846.0,8168.0,6.05,0.02,High Risk
U155,2024,8,202396.0,Stable Salary & Stable Fixed Expenses,135014,70019.0,67431,137450.0,-2436.0,-1.8,0.04,High Risk
U155,2024,9,199960.0,Stable Salary & Stable Fixed Expenses,135014,70019.0,62285,132304.0,2710.0,2.01,0.03,High Risk
U155,2024,10,202670.0,Stable Salary & Stable Fixed Expenses,135014,70019.0,66358,136377.0,-1363.0,-1.01,-0.03,High Risk
U155,2024,11,201307.0,Stable Salary & Stable Fixed Expenses,135014,70019.0,79895,149914.0,-14900.0,-11.04,0.04,High Risk
U155,2024,12,186407.0,Stable Salary & Stable Fixed Expenses,135014,70019.0,94657,164676.0,-29662.0,-21.97,-0.04,High Risk
U156,2024,1,202337.0,Salary Increases & Fixed Expenses Increase,160769,66834.0,63637,130471.0,30298.0,18.85,-0.03,Medium Risk
U156,2024,2,232635.0,Salary Increases & Fixed Expenses Increase,160769,66834.0,49332,116166.0,44603.0,27.74,-0.0,Low Risk
U156,2024,3,277238.0,Salary Increases & Fixed Expenses Increase,174026,66834.0,66747,133581.0,40445.0,23.24,-0.02,Medium Risk
U156,2024,4,317683.0,Salary Increases & Fixed Expenses Increase,174026,66834.0,60045,126879.0,47147.0,27.09,-0.05,Low Risk
U156,2024,5,364830.0,Salary Increases & Fixed Expenses Increase,174026,66834.0,58838,125672.0,48354.0,27.79,-0.04,Low Risk
U156,2024,6,413184.0,Salary Increases & Fixed Expenses Increase,174026,66834.0,59186,126020.0,48006.0,27.59,-0.05,Low Risk
U156,2024,7,461190.0,Salary Increases & Fixed Expenses Increase,174026,68753.0,68667,137420.0,36606.0,21.03,-0.03,Medium Risk
U156,2024,8,497796.0,Salary Increases & Fixed Expenses Increase,174026,68753.0,66349,135102.0,38924.0,22.37,-0.04,Medium Risk
U156,2024,9,536720.0,Salary Increases & Fixed Expenses Increase,174026,68753.0,74626,143379.0,30647.0,17.61,-0.04,Medium Risk
U156,2024,10,567367.0,Salary Increases & Fixed Expenses Increase,174026,68753.0,75090,143843.0,30183.0,17.34,-0.01,Medium Risk
U156,2024,11,597550.0,Salary Increases & Fixed Expenses Increase,174026,69625.0,60113,129738.0,44288.0,25.45,0.03,Low Risk
U156,2024,12,641838.0,Salary Increases & Fixed Expenses Increase,174026,69625.0,74319,143944.0,30082.0,17.29,0.0,Medium Risk
U157,2024,1,216287.0,Stable Salary & Increasing Fixed Expenses,21469,21059.0,16811,37870.0,-16401.0,-76.39,0.02,High Risk
U157,2024,2,199886.0,Stable Salary & Increasing Fixed Expenses,21469,21059.0,16608,37667.0,-16198.0,-75.45,-0.0,High Risk
U157,2024,3,183688.0,Stable Salary & Increasing Fixed Expenses,21469,21059.0,16895,37954.0,-16485.0,-76.79,-0.05,High Risk
U157,2024,4,167203.0,Stable Salary & Increasing Fixed Expenses,21469,21059.0,13100,34159.0,-12690.0,-59.11,-0.01,High Risk
U157,2024,5,154513.0,Stable Salary & Increasing Fixed Expenses,21469,22996.0,14697,37693.0,-16224.0,-75.57,-0.03,High Risk
U157,2024,6,138289.0,Stable Salary & Increasing Fixed Expenses,21469,22996.0,15201,38197.0,-16728.0,-77.92,-0.05,High Risk
U157,2024,7,121561.0,Stable Salary & Increasing Fixed Expenses,21469,24618.0,15589,40207.0,-18738.0,-87.28,0.01,High Risk
U157,2024,8,102823.0,Stable Salary & Increasing Fixed Expenses,21469,24618.0,16592,41210.0,-19741.0,-91.95,0.01,High Risk
U157,2024,9,83082.0,Stable Salary & Increasing Fixed Expenses,21469,24618.0,14405,39023.0,-17554.0,-81.76,0.0,High Risk
U157,2024,10,65528.0,Stable Salary & Increasing Fixed Expenses,21469,24618.0,16113,40731.0,-19262.0,-89.72,0.01,High Risk
U157,2024,11,46266.0,Stable Salary & Increasing Fixed Expenses,21469,26047.0,16036,42083.0,-20614.0,-96.02,-0.01,High Risk
U157,2024,12,25652.0,Stable Salary & Increasing Fixed Expenses,21469,26047.0,12966,39013.0,-17544.0,-81.72,0.04,High Risk
U158,2024,1,215258.0,Salary Increases & Fixed Expenses Remain Stable,186931,43999.0,61297,105296.0,81635.0,43.67,-0.02,Low Risk
U158,2024,2,296893.0,Salary Increases & Fixed Expenses Remain Stable,186931,43999.0,68878,112877.0,74054.0,39.62,-0.0,Low Risk
U158,2024,3,370947.0,Salary Increases & Fixed Expenses Remain Stable,186931,43999.0,76778,120777.0,66154.0,35.39,0.03,Low Risk
U158,2024,4,437101.0,Salary Increases & Fixed Expenses Remain Stable,196689,43999.0,77786,121785.0,74904.0,38.08,-0.05,Low Risk
U158,2024,5,512005.0,Salary Increases & Fixed Expenses Remain Stable,196689,43999.0,66199,110198.0,86491.0,43.97,-0.05,Low Risk
U158,2024,6,598496.0,Salary Increases & Fixed Expenses Remain Stable,196689,43999.0,71059,115058.0,81631.0,41.5,-0.02,Low Risk
U158,2024,7,680127.0,Salary Increases & Fixed Expenses Remain Stable,196689,43999.0,71429,115428.0,81261.0,41.31,0.01,Low Risk
U158,2024,8,761388.0,Salary Increases & Fixed Expenses Remain Stable,196689,43999.0,75755,119754.0,76935.0,39.12,-0.01,Low Risk
U158,2024,9,838323.0,Salary Increases & Fixed Expenses Remain Stable,196689,43999.0,69580,113579.0,83110.0,42.25,0.01,Low Risk
U158,2024,10,921433.0,Salary Increases & Fixed Expenses Remain Stable,196689,43999.0,86569,130568.0,66121.0,33.62,0.03,Low Risk
U158,2024,11,987554.0,Salary Increases & Fixed Expenses Remain Stable,196689,43999.0,66863,110862.0,85827.0,43.64,0.01,Low Risk
U158,2024,12,1073381.0,Salary Increases & Fixed Expenses Remain Stable,196689,43999.0,76342,120341.0,76348.0,38.82,-0.02,Low Risk
U159,2024,1,212907.0,Salary Increases & Fixed Expenses Remain Stable,148174,51444.0,49557,101001.0,47173.0,31.84,-0.0,Low Risk
U159,2024,2,260080.0,Salary Increases & Fixed Expenses Remain Stable,148174,51444.0,52913,104357.0,43817.0,29.57,0.04,Low Risk
U159,2024,3,303897.0,Salary Increases & Fixed Expenses Remain Stable,148174,51444.0,70818,122262.0,25912.0,17.49,0.04,Medium Risk
U159,2024,4,329809.0,Salary Increases & Fixed Expenses Remain Stable,148174,51444.0,58943,110387.0,37787.0,25.5,0.03,Low Risk
U159,2024,5,367596.0,Salary Increases & Fixed Expenses Remain Stable,148174,51444.0,57585,109029.0,39145.0,26.42,-0.02,Low Risk
U159,2024,6,406741.0,Salary Increases & Fixed Expenses Remain Stable,148174,51444.0,59074,110518.0,37656.0,25.41,0.05,Low Risk
U159,2024,7,444397.0,Salary Increases & Fixed Expenses Remain Stable,173145,51444.0,54625,106069.0,67076.0,38.74,0.01,Low Risk
U159,2024,8,511473.0,Salary Increases & Fixed Expenses Remain Stable,173145,51444.0,52523,103967.0,69178.0,39.95,0.0,Low Risk
U159,2024,9,580651.0,Salary Increases & Fixed Expenses Remain Stable,173145,51444.0,57670,109114.0,64031.0,36.98,-0.0,Low Risk
U159,2024,10,644682.0,Salary Increases & Fixed Expenses Remain Stable,173145,51444.0,74323,125767.0,47378.0,27.36,-0.03,Low Risk
U159,2024,11,692060.0,Salary Increases & Fixed Expenses Remain Stable,173145,51444.0,55388,106832.0,66313.0,38.3,-0.01,Low Risk
U159,2024,12,758373.0,Salary Increases & Fixed Expenses Remain Stable,173145,51444.0,73568,125012.0,48133.0,27.8,0.03,Low Risk
U160,2024,1,202528.0,Stable Salary & Stable Fixed Expenses,253036,119807.0,106473,226280.0,26756.0,10.57,0.03,High Risk
U160,2024,2,229284.0,Stable Salary & Stable Fixed Expenses,253036,119807.0,101802,221609.0,31427.0,12.42,0.04,High Risk
U160,2024,3,260711.0,Stable Salary & Stable Fixed Expenses,253036,119807.0,143981,263788.0,-10752.0,-4.25,-0.0,High Risk
U160,2024,4,249959.0,Stable Salary & Stable Fixed Expenses,253036,119807.0,110562,230369.0,22667.0,8.96,0.05,High Risk
U160,2024,5,272626.0,Stable Salary & Stable Fixed Expenses,253036,119807.0,129220,249027.0,4009.0,1.58,0.03,High Risk
U160,2024,6,276635.0,Stable Salary & Stable Fixed Expenses,253036,119807.0,118220,238027.0,15009.0,5.93,-0.03,High Risk
U160,2024,7,291644.0,Stable Salary & Stable Fixed Expenses,253036,119807.0,116850,236657.0,16379.0,6.47,0.0,High Risk
U160,2024,8,308023.0,Stable Salary & Stable Fixed Expenses,253036,119807.0,122527,242334.0,10702.0,4.23,-0.0,High Risk
U160,2024,9,318725.0,Stable Salary & Stable Fixed Expenses,253036,119807.0,168960,288767.0,-35731.0,-14.12,0.03,High Risk
U160,2024,10,282994.0,Stable Salary & Stable Fixed Expenses,253036,119807.0,156098,275905.0,-22869.0,-9.04,-0.01,High Risk
U160,2024,11,260125.0,Stable Salary & Stable Fixed Expenses,253036,119807.0,139676,259483.0,-6447.0,-2.55,0.03,High Risk
U160,2024,12,253678.0,Stable Salary & Stable Fixed Expenses,253036,119807.0,126941,246748.0,6288.0,2.49,0.02,High Risk
U161,2024,1,211755.0,Stable Salary & Increasing Fixed Expenses,280925,63276.0,125163,188439.0,92486.0,32.92,0.0,Low Risk
U161,2024,2,304241.0,Stable Salary & Increasing Fixed Expenses,280925,63276.0,112767,176043.0,104882.0,37.33,0.04,Low Risk
U161,2024,3,409123.0,Stable Salary & Increasing Fixed Expenses,280925,63276.0,188964,252240.0,28685.0,10.21,0.05,High Risk
U161,2024,4,437808.0,Stable Salary & Increasing Fixed Expenses,280925,63276.0,120940,184216.0,96709.0,34.43,0.0,Low Risk
U161,2024,5,534517.0,Stable Salary & Increasing Fixed Expenses,280925,63276.0,145168,208444.0,72481.0,25.8,0.02,Low Risk
U161,2024,6,606998.0,Stable Salary & Increasing Fixed Expenses,280925,63276.0,156773,220049.0,60876.0,21.67,-0.04,Medium Risk
U161,2024,7,667874.0,Stable Salary & Increasing Fixed Expenses,280925,63276.0,135175,198451.0,82474.0,29.36,0.01,Low Risk
U161,2024,8,750348.0,Stable Salary & Increasing Fixed Expenses,280925,63276.0,134115,197391.0,83534.0,29.74,0.02,Low Risk
U161,2024,9,833882.0,Stable Salary & Increasing Fixed Expenses,280925,63276.0,148070,211346.0,69579.0,24.77,-0.0,Medium Risk
U161,2024,10,903461.0,Stable Salary & Increasing Fixed Expenses,280925,64911.0,151863,216774.0,64151.0,22.84,-0.02,Medium Risk
U161,2024,11,967612.0,Stable Salary & Increasing Fixed Expenses,280925,65954.0,159954,225908.0,55017.0,19.58,0.03,Medium Risk
U161,2024,12,1022629.0,Stable Salary & Increasing Fixed Expenses,280925,65954.0,125504,191458.0,89467.0,31.85,0.03,Low Risk
U162,2024,1,238686.0,Stable Salary & Stable Fixed Expenses,233427,74251.0,134014,208265.0,25162.0,10.78,-0.03,High Risk
U162,2024,2,263848.0,Stable Salary & Stable Fixed Expenses,233427,74251.0,129281,203532.0,29895.0,12.81,0.01,High Risk
U162,2024,3,293743.0,Stable Salary & Stable Fixed Expenses,233427,74251.0,125513,199764.0,33663.0,14.42,-0.01,High Risk
U162,2024,4,327406.0,Stable Salary & Stable Fixed Expenses,233427,74251.0,104980,179231.0,54196.0,23.22,-0.01,Medium Risk
U162,2024,5,381602.0,Stable Salary & Stable Fixed Expenses,233427,74251.0,116711,190962.0,42465.0,18.19,-0.05,Medium Risk
U162,2024,6,424067.0,Stable Salary & Stable Fixed Expenses,233427,74251.0,137654,211905.0,21522.0,9.22,-0.02,High Risk
U162,2024,7,445589.0,Stable Salary & Stable Fixed Expenses,233427,74251.0,93575,167826.0,65601.0,28.1,-0.02,Low Risk
U162,2024,8,511190.0,Stable Salary & Stable Fixed Expenses,233427,74251.0,120524,194775.0,38652.0,16.56,0.03,Medium Risk
U162,2024,9,549842.0,Stable Salary & Stable Fixed Expenses,233427,74251.0,124499,198750.0,34677.0,14.86,-0.03,High Risk
U162,2024,10,584519.0,Stable Salary & Stable Fixed Expenses,233427,74251.0,114109,188360.0,45067.0,19.31,0.02,Medium Risk
U162,2024,11,629586.0,Stable Salary & Stable Fixed Expenses,233427,74251.0,118807,193058.0,40369.0,17.29,-0.03,Medium Risk
U162,2024,12,669955.0,Stable Salary & Stable Fixed Expenses,233427,74251.0,102626,176877.0,56550.0,24.23,-0.03,Medium Risk
U163,2024,1,224463.0,Salary Increases & Fixed Expenses Increase,107823,62722.0,62244,124966.0,-17143.0,-15.9,-0.05,High Risk
U163,2024,2,207320.0,Salary Increases & Fixed Expenses Increase,107823,62722.0,46759,109481.0,-1658.0,-1.54,0.02,High Risk
U163,2024,3,205662.0,Salary Increases & Fixed Expenses Increase,132130,62722.0,70172,132894.0,-764.0,-0.58,-0.01,High Risk
U163,2024,4,204898.0,Salary Increases & Fixed Expenses Increase,132130,62722.0,74229,136951.0,-4821.0,-3.65,-0.02,High Risk
U163,2024,5,200077.0,Salary Increases & Fixed Expenses Increase,132130,62722.0,57226,119948.0,12182.0,9.22,-0.01,High Risk
U163,2024,6,212259.0,Salary Increases & Fixed Expenses Increase,132130,62722.0,69069,131791.0,339.0,0.26,0.03,High Risk
U163,2024,7,212598.0,Salary Increases & Fixed Expenses Increase,132130,62722.0,64033,126755.0,5375.0,4.07,0.04,High Risk
U163,2024,8,217973.0,Salary Increases & Fixed Expenses Increase,132130,63858.0,75852,139710.0,-7580.0,-5.74,0.03,High Risk
U163,2024,9,210393.0,Salary Increases & Fixed Expenses Increase,132130,63858.0,77103,140961.0,-8831.0,-6.68,-0.0,High Risk
U163,2024,10,201562.0,Salary Increases & Fixed Expenses Increase,132130,63858.0,86517,150375.0,-18245.0,-13.81,0.03,High Risk
U163,2024,11,183317.0,Salary Increases & Fixed Expenses Increase,132130,63858.0,55811,119669.0,12461.0,9.43,0.01,High Risk
U163,2024,12,195778.0,Salary Increases & Fixed Expenses Increase,132130,63858.0,53450,117308.0,14822.0,11.22,-0.05,High Risk
U164,2024,1,246812.0,Stable Salary & Stable Fixed Expenses,35460,10374.0,19943,30317.0,5143.0,14.5,-0.01,High Risk
U164,2024,2,251955.0,Stable Salary & Stable Fixed Expenses,35460,10374.0,17778,28152.0,7308.0,20.61,-0.03,Medium Risk
U164,2024,3,259263.0,Stable Salary & Stable Fixed Expenses,35460,10374.0,19067,29441.0,6019.0,16.97,0.04,Medium Risk
U164,2024,4,265282.0,Stable Salary & Stable Fixed Expenses,35460,10374.0,20646,31020.0,4440.0,12.52,0.0,High Risk
U164,2024,5,269722.0,Stable Salary & Stable Fixed Expenses,35460,10374.0,15436,25810.0,9650.0,27.21,0.02,Low Risk
U164,2024,6,279372.0,Stable Salary & Stable Fixed Expenses,35460,10374.0,21272,31646.0,3814.0,10.76,0.0,High Risk
U164,2024,7,283186.0,Stable Salary & Stable Fixed Expenses,35460,10374.0,19057,29431.0,6029.0,17.0,-0.05,Medium Risk
U164,2024,8,289215.0,Stable Salary & Stable Fixed Expenses,35460,10374.0,20283,30657.0,4803.0,13.54,0.03,High Risk
U164,2024,9,294018.0,Stable Salary & Stable Fixed Expenses,35460,10374.0,18351,28725.0,6735.0,18.99,0.03,Medium Risk
U164,2024,10,300753.0,Stable Salary & Stable Fixed Expenses,35460,10374.0,21267,31641.0,3819.0,10.77,-0.04,High Risk
U164,2024,11,304572.0,Stable Salary & Stable Fixed Expenses,35460,10374.0,14813,25187.0,10273.0,28.97,0.03,Low Risk
U164,2024,12,314845.0,Stable Salary & Stable Fixed Expenses,35460,10374.0,19116,29490.0,5970.0,16.84,0.02,Medium Risk
U165,2024,1,247052.0,Stable Salary & Stable Fixed Expenses,123052,56703.0,73222,129925.0,-6873.0,-5.59,0.02,High Risk
U165,2024,2,240179.0,Stable Salary & Stable Fixed Expenses,123052,56703.0,62755,119458.0,3594.0,2.92,-0.05,High Risk
U165,2024,3,243773.0,Stable Salary & Stable Fixed Expenses,123052,56703.0,73083,129786.0,-6734.0,-5.47,-0.01,High Risk
U165,2024,4,237039.0,Stable Salary & Stable Fixed Expenses,123052,56703.0,63838,120541.0,2511.0,2.04,-0.0,High Risk
U165,2024,5,239550.0,Stable Salary & Stable Fixed Expenses,123052,56703.0,61178,117881.0,5171.0,4.2,0.01,High Risk
U165,2024,6,244721.0,Stable Salary & Stable Fixed Expenses,123052,56703.0,62049,118752.0,4300.0,3.49,-0.01,High Risk
U165,2024,7,249021.0,Stable Salary & Stable Fixed Expenses,123052,56703.0,69155,125858.0,-2806.0,-2.28,0.02,High Risk
U165,2024,8,246215.0,Stable Salary & Stable Fixed Expenses,123052,56703.0,51904,108607.0,14445.0,11.74,-0.03,High Risk
U165,2024,9,260660.0,Stable Salary & Stable Fixed Expenses,123052,56703.0,64292,120995.0,2057.0,1.67,-0.05,High Risk
U165,2024,10,262717.0,Stable Salary & Stable Fixed Expenses,123052,56703.0,64180,120883.0,2169.0,1.76,-0.04,High Risk
U165,2024,11,264886.0,Stable Salary & Stable Fixed Expenses,123052,56703.0,57758,114461.0,8591.0,6.98,0.02,High Risk
U165,2024,12,273477.0,Stable Salary & Stable Fixed Expenses,123052,56703.0,76215,132918.0,-9866.0,-8.02,-0.04,High Risk
U166,2024,1,221570.0,Stable Salary & Increasing Fixed Expenses,53119,28970.0,28514,57484.0,-4365.0,-8.22,0.02,High Risk
U166,2024,2,217205.0,Stable Salary & Increasing Fixed Expenses,53119,28970.0,26005,54975.0,-1856.0,-3.49,0.01,High Risk
U166,2024,3,215349.0,Stable Salary & Increasing Fixed Expenses,53119,28970.0,26646,55616.0,-2497.0,-4.7,-0.05,High Risk
U166,2024,4,212852.0,Stable Salary & Increasing Fixed Expenses,53119,28970.0,23802,52772.0,347.0,0.65,-0.05,High Risk
U166,2024,5,213199.0,Stable Salary & Increasing Fixed Expenses,53119,28970.0,28621,57591.0,-4472.0,-8.42,-0.01,High Risk
U166,2024,6,208727.0,Stable Salary & Increasing Fixed Expenses,53119,28970.0,25685,54655.0,-1536.0,-2.89,-0.04,High Risk
U166,2024,7,207191.0,Stable Salary & Increasing Fixed Expenses,53119,28970.0,22677,51647.0,1472.0,2.77,-0.02,High Risk
U166,2024,8,208663.0,Stable Salary & Increasing Fixed Expenses,53119,28970.0,22782,51752.0,1367.0,2.57,0.01,High Risk
U166,2024,9,210030.0,Stable Salary & Increasing Fixed Expenses,53119,30673.0,24968,55641.0,-2522.0,-4.75,-0.03,High Risk
U166,2024,10,207508.0,Stable Salary & Increasing Fixed Expenses,53119,30673.0,35784,66457.0,-13338.0,-25.11,-0.02,High Risk
U166,2024,11,194170.0,Stable Salary & Increasing Fixed Expenses,53119,30673.0,30642,61315.0,-8196.0,-15.43,-0.03,High Risk
U166,2024,12,185974.0,Stable Salary & Increasing Fixed Expenses,53119,31698.0,29700,61398.0,-8279.0,-15.59,-0.02,High Risk
U167,2024,1,227991.0,Salary Increases & Fixed Expenses Remain Stable,114251,68298.0,50367,118665.0,-4414.0,-3.86,0.01,High Risk
U167,2024,2,223577.0,Salary Increases & Fixed Expenses Remain Stable,114251,68298.0,53137,121435.0,-7184.0,-6.29,-0.04,High Risk
U167,2024,3,216393.0,Salary Increases & Fixed Expenses Remain Stable,114251,68298.0,72761,141059.0,-26808.0,-23.46,-0.04,High Risk
U167,2024,4,189585.0,Salary Increases & Fixed Expenses Remain Stable,114251,68298.0,54891,123189.0,-8938.0,-7.82,0.01,High Risk
U167,2024,5,180647.0,Salary Increases & Fixed Expenses Remain Stable,114251,68298.0,59512,127810.0,-13559.0,-11.87,0.02,High Risk
U167,2024,6,167088.0,Salary Increases & Fixed Expenses Remain Stable,114251,68298.0,63603,131901.0,-17650.0,-15.45,-0.02,High Risk
U167,2024,7,149438.0,Salary Increases & Fixed Expenses Remain Stable,114251,68298.0,64661,132959.0,-18708.0,-16.37,-0.04,High Risk
U167,2024,8,130730.0,Salary Increases & Fixed Expenses Remain Stable,143024,68298.0,84339,152637.0,-9613.0,-6.72,0.04,High Risk
U167,2024,9,121117.0,Salary Increases & Fixed Expenses Remain Stable,143024,68298.0,87468,155766.0,-12742.0,-8.91,0.04,High Risk
U167,2024,10,108375.0,Salary Increases & Fixed Expenses Remain Stable,143024,68298.0,96730,165028.0,-22004.0,-15.38,-0.03,High Risk
U167,2024,11,86371.0,Salary Increases & Fixed Expenses Remain Stable,143024,68298.0,69573,137871.0,5153.0,3.6,-0.05,High Risk
U167,2024,12,91524.0,Salary Increases & Fixed Expenses Remain Stable,143024,68298.0,71041,139339.0,3685.0,2.58,-0.01,High Risk
U168,2024,1,220073.0,Salary Increases & Fixed Expenses Decrease,38460,18786.0,11776,30562.0,7898.0,20.54,0.0,Medium Risk
U168,2024,2,227971.0,Salary Increases & Fixed Expenses Decrease,38460,18786.0,13077,31863.0,6597.0,17.15,0.04,Medium Risk
U168,2024,3,234568.0,Salary Increases & Fixed Expenses Decrease,38460,18786.0,15146,33932.0,4528.0,11.77,0.03,High Risk
U168,2024,4,239096.0,Salary Increases & Fixed Expenses Decrease,38460,18786.0,14193,32979.0,5481.0,14.25,0.01,High Risk
U168,2024,5,244577.0,Salary Increases & Fixed Expenses Decrease,65629,18786.0,26021,44807.0,20822.0,31.73,-0.03,Low Risk
U168,2024,6,265399.0,Salary Increases & Fixed Expenses Decrease,65629,18786.0,20888,39674.0,25955.0,39.55,0.04,Low Risk
U168,2024,7,291354.0,Salary Increases & Fixed Expenses Decrease,65629,18786.0,23023,41809.0,23820.0,36.29,0.01,Low Risk
U168,2024,8,315174.0,Salary Increases & Fixed Expenses Decrease,65629,16907.4,23947,40854.4,24774.6,37.75,0.03,Low Risk
U168,2024,9,339948.6,Salary Increases & Fixed Expenses Decrease,65629,16907.4,26185,43092.4,22536.6,34.34,0.02,Low Risk
U168,2024,10,362485.19999999995,Salary Increases & Fixed Expenses Decrease,65629,16907.4,26796,43703.4,21925.6,33.41,-0.04,Low Risk
U168,2024,11,384410.79999999993,Salary Increases & Fixed Expenses Decrease,65629,16907.4,25498,42405.4,23223.6,35.39,-0.03,Low Risk
U168,2024,12,407634.3999999999,Salary Increases & Fixed Expenses Decrease,65629,16907.4,27256,44163.4,21465.6,32.71,0.04,Low Risk
U169,2024,1,228470.0,Stable Salary & Decreasing Fixed Expenses,281893,71895.0,103716,175611.0,106282.0,37.7,0.01,Low Risk
U169,2024,2,334752.0,Stable Salary & Decreasing Fixed Expenses,281893,71895.0,100691,172586.0,109307.0,38.78,0.04,Low Risk
U169,2024,3,444059.0,Stable Salary & Decreasing Fixed Expenses,281893,71895.0,91631,163526.0,118367.0,41.99,-0.05,Low Risk
U169,2024,4,562426.0,Stable Salary & Decreasing Fixed Expenses,281893,71895.0,108085,179980.0,101913.0,36.15,-0.05,Low Risk
U169,2024,5,664339.0,Stable Salary & Decreasing Fixed Expenses,281893,71895.0,90981,162876.0,119017.0,42.22,-0.05,Low Risk
U169,2024,6,783356.0,Stable Salary & Decreasing Fixed Expenses,281893,71895.0,91625,163520.0,118373.0,41.99,-0.01,Low Risk
U169,2024,7,901729.0,Stable Salary & Decreasing Fixed Expenses,281893,70846.0,86918,157764.0,124129.0,44.03,0.04,Low Risk
U169,2024,8,1025858.0,Stable Salary & Decreasing Fixed Expenses,281893,70846.0,112273,183119.0,98774.0,35.04,-0.05,Low Risk
U169,2024,9,1124632.0,Stable Salary & Decreasing Fixed Expenses,281893,70846.0,89013,159859.0,122034.0,43.29,0.0,Low Risk
U169,2024,10,1246666.0,Stable Salary & Decreasing Fixed Expenses,281893,70846.0,90967,161813.0,120080.0,42.6,0.02,Low Risk
U169,2024,11,1366746.0,Stable Salary & Decreasing Fixed Expenses,281893,70846.0,105248,176094.0,105799.0,37.53,-0.05,Low Risk
U169,2024,12,1472545.0,Stable Salary & Decreasing Fixed Expenses,281893,70846.0,93301,164147.0,117746.0,41.77,0.04,Low Risk
U170,2024,1,248243.0,Salary Increases & Fixed Expenses Remain Stable,85692,25920.0,49081,75001.0,10691.0,12.48,-0.03,High Risk
U170,2024,2,258934.0,Salary Increases & Fixed Expenses Remain Stable,85692,25920.0,39804,65724.0,19968.0,23.3,0.04,Medium Risk
U170,2024,3,278902.0,Salary Increases & Fixed Expenses Remain Stable,85692,25920.0,60996,86916.0,-1224.0,-1.43,-0.03,High Risk
U170,2024,4,277678.0,Salary Increases & Fixed Expenses Remain Stable,85692,25920.0,38862,64782.0,20910.0,24.4,-0.02,Medium Risk
U170,2024,5,298588.0,Salary Increases & Fixed Expenses Remain Stable,110611,25920.0,52280,78200.0,32411.0,29.3,-0.02,Low Risk
U170,2024,6,330999.0,Salary Increases & Fixed Expenses Remain Stable,110611,25920.0,55301,81221.0,29390.0,26.57,0.03,Low Risk
U170,2024,7,360389.0,Salary Increases & Fixed Expenses Remain Stable,110611,25920.0,52054,77974.0,32637.0,29.51,-0.0,Low Risk
U170,2024,8,393026.0,Salary Increases & Fixed Expenses Remain Stable,110611,25920.0,60643,86563.0,24048.0,21.74,-0.01,Medium Risk
U170,2024,9,417074.0,Salary Increases & Fixed Expenses Remain Stable,110611,25920.0,57948,83868.0,26743.0,24.18,0.01,Medium Risk
U170,2024,10,443817.0,Salary Increases & Fixed Expenses Remain Stable,110611,25920.0,60970,86890.0,23721.0,21.45,-0.04,Medium Risk
U170,2024,11,467538.0,Salary Increases & Fixed Expenses Remain Stable,110611,25920.0,49105,75025.0,35586.0,32.17,-0.04,Low Risk
U170,2024,12,503124.0,Salary Increases & Fixed Expenses Remain Stable,110611,25920.0,55173,81093.0,29518.0,26.69,-0.05,Low Risk
U171,2024,1,242557.0,Salary Increases & Fixed Expenses Increase,289608,68455.0,120485,188940.0,100668.0,34.76,0.02,Low Risk
U171,2024,2,343225.0,Salary Increases & Fixed Expenses Increase,289608,68970.0,153691,222661.0,66947.0,23.12,0.03,Medium Risk
U171,2024,3,410172.0,Salary Increases & Fixed Expenses Increase,289608,68970.0,169214,238184.0,51424.0,17.76,0.02,Medium Risk
U171,2024,4,461596.0,Salary Increases & Fixed Expenses Increase,289608,68970.0,137275,206245.0,83363.0,28.78,-0.04,Low Risk
U171,2024,5,544959.0,Salary Increases & Fixed Expenses Increase,311132,70733.0,175297,246030.0,65102.0,20.92,0.02,Medium Risk
U171,2024,6,610061.0,Salary Increases & Fixed Expenses Increase,311132,70733.0,174031,244764.0,66368.0,21.33,0.02,Medium Risk
U171,2024,7,676429.0,Salary Increases & Fixed Expenses Increase,311132,71727.0,140333,212060.0,99072.0,31.84,-0.04,Low Risk
U171,2024,8,775501.0,Salary Increases & Fixed Expenses Increase,311132,71727.0,184364,256091.0,55041.0,17.69,0.03,Medium Risk
U171,2024,9,830542.0,Salary Increases & Fixed Expenses Increase,311132,71727.0,159574,231301.0,79831.0,25.66,-0.03,Low Risk
U171,2024,10,910373.0,Salary Increases & Fixed Expenses Increase,311132,71727.0,196296,268023.0,43109.0,13.86,-0.01,High Risk
U171,2024,11,953482.0,Salary Increases & Fixed Expenses Increase,311132,71727.0,142028,213755.0,97377.0,31.3,-0.04,Low Risk
U171,2024,12,1050859.0,Salary Increases & Fixed Expenses Increase,311132,71727.0,152695,224422.0,86710.0,27.87,-0.04,Low Risk
U172,2024,1,212618.0,Stable Salary & Increasing Fixed Expenses,108608,71679.0,81628,153307.0,-44699.0,-41.16,0.03,High Risk
U172,2024,2,167919.0,Stable Salary & Increasing Fixed Expenses,108608,71679.0,86445,158124.0,-49516.0,-45.59,-0.02,High Risk
U172,2024,3,118403.0,Stable Salary & Increasing Fixed Expenses,108608,71679.0,94583,166262.0,-57654.0,-53.08,0.05,High Risk
U172,2024,4,60749.0,Stable Salary & Increasing Fixed Expenses,108608,71679.0,73762,145441.0,-36833.0,-33.91,0.02,High Risk
U172,2024,5,23916.0,Stable Salary & Increasing Fixed Expenses,108608,71679.0,81911,153590.0,-44982.0,-41.42,-0.01,High Risk
U172,2024,6,-21066.0,Stable Salary & Increasing Fixed Expenses,108608,71679.0,76572,148251.0,-39643.0,-36.5,0.04,High Risk
U172,2024,7,-60709.0,Stable Salary & Increasing Fixed Expenses,108608,71679.0,81840,153519.0,-44911.0,-41.35,0.03,High Risk
U172,2024,8,-105620.0,Stable Salary & Increasing Fixed Expenses,108608,71679.0,69366,141045.0,-32437.0,-29.87,-0.03,High Risk
U172,2024,9,-138057.0,Stable Salary & Increasing Fixed Expenses,108608,72378.0,90910,163288.0,-54680.0,-50.35,0.03,High Risk
U172,2024,10,-192737.0,Stable Salary & Increasing Fixed Expenses,108608,72378.0,99420,171798.0,-63190.0,-58.18,-0.02,High Risk
U172,2024,11,-255927.0,Stable Salary & Increasing Fixed Expenses,108608,73447.0,92591,166038.0,-57430.0,-52.88,0.05,High Risk
U172,2024,12,-313357.0,Stable Salary & Increasing Fixed Expenses,108608,73447.0,75326,148773.0,-40165.0,-36.98,-0.03,High Risk
U173,2024,1,227050.0,Salary Increases & Fixed Expenses Remain Stable,290783,75696.0,199823,275519.0,15264.0,5.25,0.05,High Risk
U173,2024,2,242314.0,Salary Increases & Fixed Expenses Remain Stable,290783,75696.0,207725,283421.0,7362.0,2.53,-0.0,High Risk
U173,2024,3,249676.0,Salary Increases & Fixed Expenses Remain Stable,290783,75696.0,252431,328127.0,-37344.0,-12.84,-0.02,High Risk
U173,2024,4,212332.0,Salary Increases & Fixed Expenses Remain Stable,290783,75696.0,176938,252634.0,38149.0,13.12,-0.02,High Risk
U173,2024,5,250481.0,Salary Increases & Fixed Expenses Remain Stable,290783,75696.0,211123,286819.0,3964.0,1.36,-0.05,High Risk
U173,2024,6,254445.0,Salary Increases & Fixed Expenses Remain Stable,301820,75696.0,198626,274322.0,27498.0,9.11,0.02,High Risk
U173,2024,7,281943.0,Salary Increases & Fixed Expenses Remain Stable,301820,75696.0,219917,295613.0,6207.0,2.06,0.0,High Risk
U173,2024,8,288150.0,Salary Increases & Fixed Expenses Remain Stable,301820,75696.0,235390,311086.0,-9266.0,-3.07,0.01,High Risk
U173,2024,9,278884.0,Salary Increases & Fixed Expenses Remain Stable,301820,75696.0,260052,335748.0,-33928.0,-11.24,0.02,High Risk
U173,2024,10,244956.0,Salary Increases & Fixed Expenses Remain Stable,301820,75696.0,210873,286569.0,15251.0,5.05,0.03,High Risk
U173,2024,11,260207.0,Salary Increases & Fixed Expenses Remain Stable,301820,75696.0,242859,318555.0,-16735.0,-5.54,0.02,High Risk
U173,2024,12,243472.0,Salary Increases & Fixed Expenses Remain Stable,301820,75696.0,278035,353731.0,-51911.0,-17.2,0.03,High Risk
U174,2024,1,224139.0,Stable Salary & Stable Fixed Expenses,131634,74683.0,54040,128723.0,2911.0,2.21,0.03,High Risk
U174,2024,2,227050.0,Stable Salary & Stable Fixed Expenses,131634,74683.0,61410,136093.0,-4459.0,-3.39,-0.03,High Risk
U174,2024,3,222591.0,Stable Salary & Stable Fixed Expenses,131634,74683.0,67712,142395.0,-10761.0,-8.17,-0.03,High Risk
U174,2024,4,211830.0,Stable Salary & Stable Fixed Expenses,131634,74683.0,71698,146381.0,-14747.0,-11.2,0.05,High Risk
U174,2024,5,197083.0,Stable Salary & Stable Fixed Expenses,131634,74683.0,67822,142505.0,-10871.0,-8.26,0.01,High Risk
U174,2024,6,186212.0,Stable Salary & Stable Fixed Expenses,131634,74683.0,59151,133834.0,-2200.0,-1.67,-0.02,High Risk
U174,2024,7,184012.0,Stable Salary & Stable Fixed Expenses,131634,74683.0,56576,131259.0,375.0,0.28,0.04,High Risk
U174,2024,8,184387.0,Stable Salary & Stable Fixed Expenses,131634,74683.0,75889,150572.0,-18938.0,-14.39,-0.02,High Risk
U174,2024,9,165449.0,Stable Salary & Stable Fixed Expenses,131634,74683.0,71090,145773.0,-14139.0,-10.74,0.05,High Risk
U174,2024,10,151310.0,Stable Salary & Stable Fixed Expenses,131634,74683.0,59830,134513.0,-2879.0,-2.19,-0.05,High Risk
U174,2024,11,148431.0,Stable Salary & Stable Fixed Expenses,131634,74683.0,70738,145421.0,-13787.0,-10.47,-0.02,High Risk
U174,2024,12,134644.0,Stable Salary & Stable Fixed Expenses,131634,74683.0,75351,150034.0,-18400.0,-13.98,0.04,High Risk
U175,2024,1,208768.0,Salary Increases & Fixed Expenses Increase,85417,33631.0,57322,90953.0,-5536.0,-6.48,-0.03,High Risk
U175,2024,2,203232.0,Salary Increases & Fixed Expenses Increase,85417,33631.0,62315,95946.0,-10529.0,-12.33,0.04,High Risk
U175,2024,3,192703.0,Salary Increases & Fixed Expenses Increase,85417,33631.0,76815,110446.0,-25029.0,-29.3,0.01,High Risk
U175,2024,4,167674.0,Salary Increases & Fixed Expenses Increase,95846,33631.0,61002,94633.0,1213.0,1.27,-0.03,High Risk
U175,2024,5,168887.0,Salary Increases & Fixed Expenses Increase,95846,33631.0,62300,95931.0,-85.0,-0.09,-0.01,High Risk
U175,2024,6,168802.0,Salary Increases & Fixed Expenses Increase,95846,33631.0,69637,103268.0,-7422.0,-7.74,-0.04,High Risk
U175,2024,7,161380.0,Salary Increases & Fixed Expenses Increase,95846,33631.0,73953,107584.0,-11738.0,-12.25,-0.03,High Risk
U175,2024,8,149642.0,Salary Increases & Fixed Expenses Increase,95846,33631.0,59891,93522.0,2324.0,2.42,0.03,High Risk
U175,2024,9,151966.0,Salary Increases & Fixed Expenses Increase,95846,33631.0,77788,111419.0,-15573.0,-16.25,0.03,High Risk
U175,2024,10,136393.0,Salary Increases & Fixed Expenses Increase,95846,33631.0,84383,118014.0,-22168.0,-23.13,-0.01,High Risk
U175,2024,11,114225.0,Salary Increases & Fixed Expenses Increase,95846,33631.0,83982,117613.0,-21767.0,-22.71,0.02,High Risk
U175,2024,12,92458.0,Salary Increases & Fixed Expenses Increase,95846,33631.0,77813,111444.0,-15598.0,-16.27,0.03,High Risk
U176,2024,1,242415.0,Salary Increases & Fixed Expenses Increase,159772,67092.0,67656,134748.0,25024.0,15.66,-0.01,Medium Risk
U176,2024,2,267439.0,Salary Increases & Fixed Expenses Increase,159772,67735.0,73470,141205.0,18567.0,11.62,0.0,High Risk
U176,2024,3,286006.0,Salary Increases & Fixed Expenses Increase,159772,67735.0,92446,160181.0,-409.0,-0.26,0.02,High Risk
U176,2024,4,285597.0,Salary Increases & Fixed Expenses Increase,159772,67735.0,82240,149975.0,9797.0,6.13,-0.0,High Risk
U176,2024,5,295394.0,Salary Increases & Fixed Expenses Increase,159772,67735.0,75596,143331.0,16441.0,10.29,-0.03,High Risk
U176,2024,6,311835.0,Salary Increases & Fixed Expenses Increase,159772,69283.0,73166,142449.0,17323.0,10.84,0.03,High Risk
U176,2024,7,329158.0,Salary Increases & Fixed Expenses Increase,159772,69283.0,78098,147381.0,12391.0,7.76,-0.05,High Risk
U176,2024,8,341549.0,Salary Increases & Fixed Expenses Increase,179115,69283.0,103526,172809.0,6306.0,3.52,0.01,High Risk
U176,2024,9,347855.0,Salary Increases & Fixed Expenses Increase,179115,69283.0,78516,147799.0,31316.0,17.48,0.01,Medium Risk
U176,2024,10,379171.0,Salary Increases & Fixed Expenses Increase,179115,69283.0,96228,165511.0,13604.0,7.6,-0.02,High Risk
U176,2024,11,392775.0,Salary Increases & Fixed Expenses Increase,179115,69283.0,75697,144980.0,34135.0,19.06,0.05,Medium Risk
U176,2024,12,426910.0,Salary Increases & Fixed Expenses Increase,179115,69283.0,94070,163353.0,15762.0,8.8,0.05,High Risk
U177,2024,1,221633.0,Salary Increases & Fixed Expenses Remain Stable,114143,49313.0,40586,89899.0,24244.0,21.24,0.0,Medium Risk
U177,2024,2,245877.0,Salary Increases & Fixed Expenses Remain Stable,114143,49313.0,36454,85767.0,28376.0,24.86,0.03,Medium Risk
U177,2024,3,274253.0,Salary Increases & Fixed Expenses Remain Stable,114143,49313.0,51170,100483.0,13660.0,11.97,-0.04,High Risk
U177,2024,4,287913.0,Salary Increases & Fixed Expenses Remain Stable,114143,49313.0,36353,85666.0,28477.0,24.95,0.01,Medium Risk
U177,2024,5,316390.0,Salary Increases & Fixed Expenses Remain Stable,124484,49313.0,44200,93513.0,30971.0,24.88,0.02,Medium Risk
U177,2024,6,347361.0,Salary Increases & Fixed Expenses Remain Stable,124484,49313.0,41291,90604.0,33880.0,27.22,0.01,Low Risk
U177,2024,7,381241.0,Salary Increases & Fixed Expenses Remain Stable,124484,49313.0,47996,97309.0,27175.0,21.83,-0.01,Medium Risk
U177,2024,8,408416.0,Salary Increases & Fixed Expenses Remain Stable,124484,49313.0,47020,96333.0,28151.0,22.61,-0.03,Medium Risk
U177,2024,9,436567.0,Salary Increases & Fixed Expenses Remain Stable,124484,49313.0,48056,97369.0,27115.0,21.78,0.02,Medium Risk
U177,2024,10,463682.0,Salary Increases & Fixed Expenses Remain Stable,124484,49313.0,57738,107051.0,17433.0,14.0,-0.05,High Risk
U177,2024,11,481115.0,Salary Increases & Fixed Expenses Remain Stable,124484,49313.0,43563,92876.0,31608.0,25.39,0.04,Low Risk
U177,2024,12,512723.0,Salary Increases & Fixed Expenses Remain Stable,124484,49313.0,45794,95107.0,29377.0,23.6,0.01,Medium Risk
U178,2024,1,225008.0,Salary Increases & Fixed Expenses Increase,152600,41163.0,90083,131246.0,21354.0,13.99,0.02,High Risk
U178,2024,2,246362.0,Salary Increases & Fixed Expenses Increase,152600,41163.0,65809,106972.0,45628.0,29.9,0.04,Low Risk
U178,2024,3,291990.0,Salary Increases & Fixed Expenses Increase,152600,41163.0,91545,132708.0,19892.0,13.04,0.03,High Risk
U178,2024,4,311882.0,Salary Increases & Fixed Expenses Increase,152600,41163.0,62529,103692.0,48908.0,32.05,0.02,Low Risk
U178,2024,5,360790.0,Salary Increases & Fixed Expenses Increase,152600,41163.0,62048,103211.0,49389.0,32.37,0.02,Low Risk
U178,2024,6,410179.0,Salary Increases & Fixed Expenses Increase,152600,41163.0,62380,103543.0,49057.0,32.15,-0.01,Low Risk
U178,2024,7,459236.0,Salary Increases & Fixed Expenses Increase,177264,41163.0,94417,135580.0,41684.0,23.52,-0.01,Medium Risk
U178,2024,8,500920.0,Salary Increases & Fixed Expenses Increase,177264,41163.0,96088,137251.0,40013.0,22.57,-0.02,Medium Risk
U178,2024,9,540933.0,Salary Increases & Fixed Expenses Increase,177264,41163.0,89333,130496.0,46768.0,26.38,-0.03,Low Risk
U178,2024,10,587701.0,Salary Increases & Fixed Expenses Increase,177264,41163.0,89044,130207.0,47057.0,26.55,0.0,Low Risk
U178,2024,11,634758.0,Salary Increases & Fixed Expenses Increase,177264,43012.0,90037,133049.0,44215.0,24.94,0.0,Medium Risk
U178,2024,12,678973.0,Salary Increases & Fixed Expenses Increase,177264,43012.0,97419,140431.0,36833.0,20.78,0.01,Medium Risk
U179,2024,1,212834.0,Stable Salary & Stable Fixed Expenses,193604,47942.0,93165,141107.0,52497.0,27.12,-0.05,Low Risk
U179,2024,2,265331.0,Stable Salary & Stable Fixed Expenses,193604,47942.0,111273,159215.0,34389.0,17.76,-0.02,Medium Risk
U179,2024,3,299720.0,Stable Salary & Stable Fixed Expenses,193604,47942.0,99460,147402.0,46202.0,23.86,-0.03,Medium Risk
U179,2024,4,345922.0,Stable Salary & Stable Fixed Expenses,193604,47942.0,96324,144266.0,49338.0,25.48,0.02,Low Risk
U179,2024,5,395260.0,Stable Salary & Stable Fixed Expenses,193604,47942.0,94695,142637.0,50967.0,26.33,0.03,Low Risk
U179,2024,6,446227.0,Stable Salary & Stable Fixed Expenses,193604,47942.0,82189,130131.0,63473.0,32.78,-0.01,Low Risk
U179,2024,7,509700.0,Stable Salary & Stable Fixed Expenses,193604,47942.0,83417,131359.0,62245.0,32.15,0.02,Low Risk
U179,2024,8,571945.0,Stable Salary & Stable Fixed Expenses,193604,47942.0,77757,125699.0,67905.0,35.07,-0.02,Low Risk
U179,2024,9,639850.0,Stable Salary & Stable Fixed Expenses,193604,47942.0,98446,146388.0,47216.0,24.39,0.04,Medium Risk
U179,2024,10,687066.0,Stable Salary & Stable Fixed Expenses,193604,47942.0,88519,136461.0,57143.0,29.52,0.05,Low Risk
U179,2024,11,744209.0,Stable Salary & Stable Fixed Expenses,193604,47942.0,97212,145154.0,48450.0,25.03,-0.01,Low Risk
U179,2024,12,792659.0,Stable Salary & Stable Fixed Expenses,193604,47942.0,101513,149455.0,44149.0,22.8,0.02,Medium Risk
U180,2024,1,214957.0,Stable Salary & Stable Fixed Expenses,236908,107454.0,74717,182171.0,54737.0,23.1,-0.03,Medium Risk
U180,2024,2,269694.0,Stable Salary & Stable Fixed Expenses,236908,107454.0,92353,199807.0,37101.0,15.66,0.01,Medium Risk
U180,2024,3,306795.0,Stable Salary & Stable Fixed Expenses,236908,107454.0,82404,189858.0,47050.0,19.86,-0.04,Medium Risk
U180,2024,4,353845.0,Stable Salary & Stable Fixed Expenses,236908,107454.0,85667,193121.0,43787.0,18.48,-0.04,Medium Risk
U180,2024,5,397632.0,Stable Salary & Stable Fixed Expenses,236908,107454.0,73597,181051.0,55857.0,23.58,0.03,Medium Risk
U180,2024,6,453489.0,Stable Salary & Stable Fixed Expenses,236908,107454.0,73073,180527.0,56381.0,23.8,-0.03,Medium Risk
U180,2024,7,509870.0,Stable Salary & Stable Fixed Expenses,236908,107454.0,82468,189922.0,46986.0,19.83,0.0,Medium Risk
U180,2024,8,556856.0,Stable Salary & Stable Fixed Expenses,236908,107454.0,82823,190277.0,46631.0,19.68,-0.05,Medium Risk
U180,2024,9,603487.0,Stable Salary & Stable Fixed Expenses,236908,107454.0,83436,190890.0,46018.0,19.42,-0.05,Medium Risk
U180,2024,10,649505.0,Stable Salary & Stable Fixed Expenses,236908,107454.0,82295,189749.0,47159.0,19.91,-0.02,Medium Risk
U180,2024,11,696664.0,Stable Salary & Stable Fixed Expenses,236908,107454.0,91825,199279.0,37629.0,15.88,0.02,Medium Risk
U180,2024,12,734293.0,Stable Salary & Stable Fixed Expenses,236908,107454.0,82900,190354.0,46554.0,19.65,-0.01,Medium Risk
U181,2024,1,232006.0,Salary Increases & Fixed Expenses Increase,192883,71250.0,71368,142618.0,50265.0,26.06,-0.04,Low Risk
U181,2024,2,282271.0,Salary Increases & Fixed Expenses Increase,192883,71250.0,65328,136578.0,56305.0,29.19,0.02,Low Risk
U181,2024,3,338576.0,Salary Increases & Fixed Expenses Increase,192883,71250.0,71212,142462.0,50421.0,26.14,-0.01,Low Risk
U181,2024,4,388997.0,Salary Increases & Fixed Expenses Increase,192883,73096.0,67417,140513.0,52370.0,27.15,-0.02,Low Risk
U181,2024,5,441367.0,Salary Increases & Fixed Expenses Increase,192883,73096.0,61906,135002.0,57881.0,30.01,0.01,Low Risk
U181,2024,6,499248.0,Salary Increases & Fixed Expenses Increase,192883,73096.0,62778,135874.0,57009.0,29.56,-0.01,Low Risk
U181,2024,7,556257.0,Salary Increases & Fixed Expenses Increase,213018,73096.0,71827,144923.0,68095.0,31.97,-0.02,Low Risk
U181,2024,8,624352.0,Salary Increases & Fixed Expenses Increase,213018,73096.0,74835,147931.0,65087.0,30.55,-0.03,Low Risk
U181,2024,9,689439.0,Salary Increases & Fixed Expenses Increase,213018,73096.0,74357,147453.0,65565.0,30.78,-0.0,Low Risk
U181,2024,10,755004.0,Salary Increases & Fixed Expenses Increase,213018,73096.0,104736,177832.0,35186.0,16.52,0.03,Medium Risk
U181,2024,11,790190.0,Salary Increases & Fixed Expenses Increase,213018,73096.0,78705,151801.0,61217.0,28.74,0.01,Low Risk
U181,2024,12,851407.0,Salary Increases & Fixed Expenses Increase,213018,73096.0,67010,140106.0,72912.0,34.23,0.04,Low Risk
U182,2024,1,247078.0,Salary Increases & Fixed Expenses Increase,236801,113923.0,89444,203367.0,33434.0,14.12,0.02,High Risk
U182,2024,2,280512.0,Salary Increases & Fixed Expenses Increase,236801,113923.0,87098,201021.0,35780.0,15.11,-0.02,Medium Risk
U182,2024,3,316292.0,Salary Increases & Fixed Expenses Increase,236801,114562.0,96783,211345.0,25456.0,10.75,0.02,High Risk
U182,2024,4,341748.0,Salary Increases & Fixed Expenses Increase,236801,114562.0,88182,202744.0,34057.0,14.38,-0.05,High Risk
U182,2024,5,375805.0,Salary Increases & Fixed Expenses Increase,236801,114562.0,91198,205760.0,31041.0,13.11,0.01,High Risk
U182,2024,6,406846.0,Salary Increases & Fixed Expenses Increase,261328,114562.0,88767,203329.0,57999.0,22.19,-0.03,Medium Risk
U182,2024,7,464845.0,Salary Increases & Fixed Expenses Increase,261328,115835.0,93619,209454.0,51874.0,19.85,-0.03,Medium Risk
U182,2024,8,516719.0,Salary Increases & Fixed Expenses Increase,261328,115835.0,103218,219053.0,42275.0,16.18,0.0,Medium Risk
U182,2024,9,558994.0,Salary Increases & Fixed Expenses Increase,261328,117668.0,87980,205648.0,55680.0,21.31,0.04,Medium Risk
U182,2024,10,614674.0,Salary Increases & Fixed Expenses Increase,261328,117668.0,105212,222880.0,38448.0,14.71,-0.01,High Risk
U182,2024,11,653122.0,Salary Increases & Fixed Expenses Increase,261328,117668.0,79888,197556.0,63772.0,24.4,0.04,Medium Risk
U182,2024,12,716894.0,Salary Increases & Fixed Expenses Increase,261328,117668.0,93301,210969.0,50359.0,19.27,-0.02,Medium Risk
U183,2024,1,247624.0,Stable Salary & Increasing Fixed Expenses,148451,52809.0,91788,144597.0,3854.0,2.6,-0.04,High Risk
U183,2024,2,251478.0,Stable Salary & Increasing Fixed Expenses,148451,52809.0,96484,149293.0,-842.0,-0.57,0.01,High Risk
U183,2024,3,250636.0,Stable Salary & Increasing Fixed Expenses,148451,54783.0,113447,168230.0,-19779.0,-13.32,-0.01,High Risk
U183,2024,4,230857.0,Stable Salary & Increasing Fixed Expenses,148451,54783.0,97246,152029.0,-3578.0,-2.41,-0.04,High Risk
U183,2024,5,227279.0,Stable Salary & Increasing Fixed Expenses,148451,54783.0,105811,160594.0,-12143.0,-8.18,-0.02,High Risk
U183,2024,6,215136.0,Stable Salary & Increasing Fixed Expenses,148451,54783.0,111669,166452.0,-18001.0,-12.13,-0.0,High Risk
U183,2024,7,197135.0,Stable Salary & Increasing Fixed Expenses,148451,54783.0,115036,169819.0,-21368.0,-14.39,-0.03,High Risk
U183,2024,8,175767.0,Stable Salary & Increasing Fixed Expenses,148451,54783.0,108677,163460.0,-15009.0,-10.11,-0.01,High Risk
U183,2024,9,160758.0,Stable Salary & Increasing Fixed Expenses,148451,54783.0,108365,163148.0,-14697.0,-9.9,-0.03,High Risk
U183,2024,10,146061.0,Stable Salary & Increasing Fixed Expenses,148451,54783.0,118283,173066.0,-24615.0,-16.58,-0.01,High Risk
U183,2024,11,121446.0,Stable Salary & Increasing Fixed Expenses,148451,54783.0,105295,160078.0,-11627.0,-7.83,-0.01,High Risk
U183,2024,12,109819.0,Stable Salary & Increasing Fixed Expenses,148451,56540.0,116415,172955.0,-24504.0,-16.51,0.05,High Risk
U184,2024,1,208790.0,Salary Increases & Fixed Expenses Remain Stable,131319,54402.0,41791,96193.0,35126.0,26.75,-0.03,Low Risk
U184,2024,2,243916.0,Salary Increases & Fixed Expenses Remain Stable,131319,54402.0,51376,105778.0,25541.0,19.45,0.03,Medium Risk
U184,2024,3,269457.0,Salary Increases & Fixed Expenses Remain Stable,131319,54402.0,53484,107886.0,23433.0,17.84,0.01,Medium Risk
U184,2024,4,292890.0,Salary Increases & Fixed Expenses Remain Stable,131319,54402.0,51853,106255.0,25064.0,19.09,-0.02,Medium Risk
U184,2024,5,317954.0,Salary Increases & Fixed Expenses Remain Stable,131319,54402.0,46635,101037.0,30282.0,23.06,-0.03,Medium Risk
U184,2024,6,348236.0,Salary Increases & Fixed Expenses Remain Stable,131319,54402.0,43414,97816.0,33503.0,25.51,-0.02,Low Risk
U184,2024,7,381739.0,Salary Increases & Fixed Expenses Remain Stable,152951,54402.0,56346,110748.0,42203.0,27.59,-0.03,Low Risk
U184,2024,8,423942.0,Salary Increases & Fixed Expenses Remain Stable,152951,54402.0,48112,102514.0,50437.0,32.98,0.04,Low Risk
U184,2024,9,474379.0,Salary Increases & Fixed Expenses Remain Stable,152951,54402.0,62486,116888.0,36063.0,23.58,0.03,Medium Risk
U184,2024,10,510442.0,Salary Increases & Fixed Expenses Remain Stable,152951,54402.0,65369,119771.0,33180.0,21.69,0.04,Medium Risk
U184,2024,11,543622.0,Salary Increases & Fixed Expenses Remain Stable,152951,54402.0,53978,108380.0,44571.0,29.14,-0.01,Low Risk
U184,2024,12,588193.0,Salary Increases & Fixed Expenses Remain Stable,152951,54402.0,65262,119664.0,33287.0,21.76,0.03,Medium Risk
U185,2024,1,229552.0,Salary Increases & Fixed Expenses Remain Stable,176939,60657.0,61348,122005.0,54934.0,31.05,-0.01,Low Risk
U185,2024,2,284486.0,Salary Increases & Fixed Expenses Remain Stable,176939,60657.0,65105,125762.0,51177.0,28.92,-0.02,Low Risk
U185,2024,3,335663.0,Salary Increases & Fixed Expenses Remain Stable,176939,60657.0,70311,130968.0,45971.0,25.98,-0.0,Low Risk
U185,2024,4,381634.0,Salary Increases & Fixed Expenses Remain Stable,176939,60657.0,67439,128096.0,48843.0,27.6,-0.04,Low Risk
U185,2024,5,430477.0,Salary Increases & Fixed Expenses Remain Stable,176939,60657.0,69529,130186.0,46753.0,26.42,0.01,Low Risk
U185,2024,6,477230.0,Salary Increases & Fixed Expenses Remain Stable,176939,60657.0,66715,127372.0,49567.0,28.01,0.01,Low Risk
U185,2024,7,526797.0,Salary Increases & Fixed Expenses Remain Stable,176939,60657.0,62805,123462.0,53477.0,30.22,-0.04,Low Risk
U185,2024,8,580274.0,Salary Increases & Fixed Expenses Remain Stable,204698,60657.0,73024,133681.0,71017.0,34.69,0.02,Low Risk
U185,2024,9,651291.0,Salary Increases & Fixed Expenses Remain Stable,204698,60657.0,70067,130724.0,73974.0,36.14,-0.04,Low Risk
U185,2024,10,725265.0,Salary Increases & Fixed Expenses Remain Stable,204698,60657.0,70362,131019.0,73679.0,35.99,0.05,Low Risk
U185,2024,11,798944.0,Salary Increases & Fixed Expenses Remain Stable,204698,60657.0,80884,141541.0,63157.0,30.85,-0.02,Low Risk
U185,2024,12,862101.0,Salary Increases & Fixed Expenses Remain Stable,204698,60657.0,75817,136474.0,68224.0,33.33,0.01,Low Risk
U186,2024,1,205459.0,Salary Increases & Fixed Expenses Increase,95290,38076.0,42135,80211.0,15079.0,15.82,-0.02,Medium Risk
U186,2024,2,220538.0,Salary Increases & Fixed Expenses Increase,95290,39530.0,40806,80336.0,14954.0,15.69,-0.03,Medium Risk
U186,2024,3,235492.0,Salary Increases & Fixed Expenses Increase,95290,40206.0,60915,101121.0,-5831.0,-6.12,0.03,High Risk
U186,2024,4,229661.0,Salary Increases & Fixed Expenses Increase,124799,40206.0,56847,97053.0,27746.0,22.23,0.0,Medium Risk
U186,2024,5,257407.0,Salary Increases & Fixed Expenses Increase,124799,41220.0,57554,98774.0,26025.0,20.85,-0.05,Medium Risk
U186,2024,6,283432.0,Salary Increases & Fixed Expenses Increase,124799,41220.0,58447,99667.0,25132.0,20.14,-0.03,Medium Risk
U186,2024,7,308564.0,Salary Increases & Fixed Expenses Increase,124799,41220.0,62346,103566.0,21233.0,17.01,-0.03,Medium Risk
U186,2024,8,329797.0,Salary Increases & Fixed Expenses Increase,124799,41220.0,72415,113635.0,11164.0,8.95,-0.04,High Risk
U186,2024,9,340961.0,Salary Increases & Fixed Expenses Increase,124799,41761.0,66172,107933.0,16866.0,13.51,-0.05,High Risk
U186,2024,10,357827.0,Salary Increases & Fixed Expenses Increase,124799,41761.0,71970,113731.0,11068.0,8.87,-0.04,High Risk
U186,2024,11,368895.0,Salary Increases & Fixed Expenses Increase,124799,41761.0,63360,105121.0,19678.0,15.77,-0.01,Medium Risk
U186,2024,12,388573.0,Salary Increases & Fixed Expenses Increase,124799,41761.0,73385,115146.0,9653.0,7.73,-0.04,High Risk
U187,2024,1,246409.0,Stable Salary & Stable Fixed Expenses,149933,49574.0,71984,121558.0,28375.0,18.93,-0.03,Medium Risk
U187,2024,2,274784.0,Stable Salary & Stable Fixed Expenses,149933,49574.0,76824,126398.0,23535.0,15.7,-0.04,Medium Risk
U187,2024,3,298319.0,Stable Salary & Stable Fixed Expenses,149933,49574.0,97172,146746.0,3187.0,2.13,-0.01,High Risk
U187,2024,4,301506.0,Stable Salary & Stable Fixed Expenses,149933,49574.0,65869,115443.0,34490.0,23.0,0.01,Medium Risk
U187,2024,5,335996.0,Stable Salary & Stable Fixed Expenses,149933,49574.0,87433,137007.0,12926.0,8.62,0.05,High Risk
U187,2024,6,348922.0,Stable Salary & Stable Fixed Expenses,149933,49574.0,79108,128682.0,21251.0,14.17,0.02,High Risk
U187,2024,7,370173.0,Stable Salary & Stable Fixed Expenses,149933,49574.0,82301,131875.0,18058.0,12.04,0.01,High Risk
U187,2024,8,388231.0,Stable Salary & Stable Fixed Expenses,149933,49574.0,77747,127321.0,22612.0,15.08,-0.01,Medium Risk
U187,2024,9,410843.0,Stable Salary & Stable Fixed Expenses,149933,49574.0,98975,148549.0,1384.0,0.92,0.05,High Risk
U187,2024,10,412227.0,Stable Salary & Stable Fixed Expenses,149933,49574.0,77934,127508.0,22425.0,14.96,0.0,High Risk
U187,2024,11,434652.0,Stable Salary & Stable Fixed Expenses,149933,49574.0,82465,132039.0,17894.0,11.93,-0.03,High Risk
U187,2024,12,452546.0,Stable Salary & Stable Fixed Expenses,149933,49574.0,76071,125645.0,24288.0,16.2,-0.05,Medium Risk
U188,2024,1,242690.0,Stable Salary & Stable Fixed Expenses,71072,34111.0,23923,58034.0,13038.0,18.34,0.01,Medium Risk
U188,2024,2,255728.0,Stable Salary & Stable Fixed Expenses,71072,34111.0,27890,62001.0,9071.0,12.76,0.04,High Risk
U188,2024,3,264799.0,Stable Salary & Stable Fixed Expenses,71072,34111.0,27481,61592.0,9480.0,13.34,0.05,High Risk
U188,2024,4,274279.0,Stable Salary & Stable Fixed Expenses,71072,34111.0,24388,58499.0,12573.0,17.69,-0.03,Medium Risk
U188,2024,5,286852.0,Stable Salary & Stable Fixed Expenses,71072,34111.0,25626,59737.0,11335.0,15.95,0.02,Medium Risk
U188,2024,6,298187.0,Stable Salary & Stable Fixed Expenses,71072,34111.0,22702,56813.0,14259.0,20.06,0.01,Medium Risk
U188,2024,7,312446.0,Stable Salary & Stable Fixed Expenses,71072,34111.0,27303,61414.0,9658.0,13.59,-0.04,High Risk
U188,2024,8,322104.0,Stable Salary & Stable Fixed Expenses,71072,34111.0,27119,61230.0,9842.0,13.85,0.05,High Risk
U188,2024,9,331946.0,Stable Salary & Stable Fixed Expenses,71072,34111.0,29242,63353.0,7719.0,10.86,0.02,High Risk
U188,2024,10,339665.0,Stable Salary & Stable Fixed Expenses,71072,34111.0,32064,66175.0,4897.0,6.89,0.04,High Risk
U188,2024,11,344562.0,Stable Salary & Stable Fixed Expenses,71072,34111.0,29684,63795.0,7277.0,10.24,0.03,High Risk
U188,2024,12,351839.0,Stable Salary & Stable Fixed Expenses,71072,34111.0,31750,65861.0,5211.0,7.33,-0.02,High Risk
U189,2024,1,245357.0,Salary Increases & Fixed Expenses Increase,73979,26423.0,39571,65994.0,7985.0,10.79,-0.04,High Risk
U189,2024,2,253342.0,Salary Increases & Fixed Expenses Increase,73979,26423.0,39933,66356.0,7623.0,10.3,0.03,High Risk
U189,2024,3,260965.0,Salary Increases & Fixed Expenses Increase,98833,26423.0,56617,83040.0,15793.0,15.98,-0.02,Medium Risk
U189,2024,4,276758.0,Salary Increases & Fixed Expenses Increase,98833,26423.0,45021,71444.0,27389.0,27.71,0.04,Low Risk
U189,2024,5,304147.0,Salary Increases & Fixed Expenses Increase,98833,26423.0,49494,75917.0,22916.0,23.19,-0.02,Medium Risk
U189,2024,6,327063.0,Salary Increases & Fixed Expenses Increase,98833,26423.0,40734,67157.0,31676.0,32.05,0.01,Low Risk
U189,2024,7,358739.0,Salary Increases & Fixed Expenses Increase,98833,28018.0,46947,74965.0,23868.0,24.15,0.02,Medium Risk
U189,2024,8,382607.0,Salary Increases & Fixed Expenses Increase,98833,28018.0,58618,86636.0,12197.0,12.34,0.03,High Risk
U189,2024,9,394804.0,Salary Increases & Fixed Expenses Increase,98833,28018.0,44196,72214.0,26619.0,26.93,0.02,Low Risk
U189,2024,10,421423.0,Salary Increases & Fixed Expenses Increase,98833,28018.0,70958,98976.0,-143.0,-0.14,0.04,High Risk
U189,2024,11,421280.0,Salary Increases & Fixed Expenses Increase,98833,28018.0,53351,81369.0,17464.0,17.67,-0.03,Medium Risk
U189,2024,12,438744.0,Salary Increases & Fixed Expenses Increase,98833,28018.0,54203,82221.0,16612.0,16.81,0.03,Medium Risk
U190,2024,1,224877.0,Salary Increases & Fixed Expenses Remain Stable,169369,59515.0,96473,155988.0,13381.0,7.9,0.05,High Risk
U190,2024,2,238258.0,Salary Increases & Fixed Expenses Remain Stable,169369,59515.0,92158,151673.0,17696.0,10.45,-0.02,High Risk
U190,2024,3,255954.0,Salary Increases & Fixed Expenses Remain Stable,169369,59515.0,93966,153481.0,15888.0,9.38,0.01,High Risk
U190,2024,4,271842.0,Salary Increases & Fixed Expenses Remain Stable,169369,59515.0,97791,157306.0,12063.0,7.12,0.01,High Risk
U190,2024,5,283905.0,Salary Increases & Fixed Expenses Remain Stable,190852,59515.0,91533,151048.0,39804.0,20.86,-0.04,Medium Risk
U190,2024,6,323709.0,Salary Increases & Fixed Expenses Remain Stable,190852,59515.0,100606,160121.0,30731.0,16.1,-0.01,Medium Risk
U190,2024,7,354440.0,Salary Increases & Fixed Expenses Remain Stable,190852,59515.0,92323,151838.0,39014.0,20.44,-0.04,Medium Risk
U190,2024,8,393454.0,Salary Increases & Fixed Expenses Remain Stable,190852,59515.0,97868,157383.0,33469.0,17.54,-0.04,Medium Risk
U190,2024,9,426923.0,Salary Increases & Fixed Expenses Remain Stable,190852,59515.0,97882,157397.0,33455.0,17.53,-0.03,Medium Risk
U190,2024,10,460378.0,Salary Increases & Fixed Expenses Remain Stable,190852,59515.0,95189,154704.0,36148.0,18.94,0.01,Medium Risk
U190,2024,11,496526.0,Salary Increases & Fixed Expenses Remain Stable,190852,59515.0,100999,160514.0,30338.0,15.9,0.04,Medium Risk
U190,2024,12,526864.0,Salary Increases & Fixed Expenses Remain Stable,190852,59515.0,89183,148698.0,42154.0,22.09,0.04,Medium Risk
U191,2024,1,216014.0,Salary Increases & Fixed Expenses Increase,289948,111315.0,132343,243658.0,46290.0,15.96,-0.02,Medium Risk
U191,2024,2,262304.0,Salary Increases & Fixed Expenses Increase,289948,112978.0,158483,271461.0,18487.0,6.38,-0.04,High Risk
U191,2024,3,280791.0,Salary Increases & Fixed Expenses Increase,289948,113631.0,120254,233885.0,56063.0,19.34,-0.02,Medium Risk
U191,2024,4,336854.0,Salary Increases & Fixed Expenses Increase,289948,113631.0,151917,265548.0,24400.0,8.42,0.02,High Risk
U191,2024,5,361254.0,Salary Increases & Fixed Expenses Increase,289948,114269.0,124450,238719.0,51229.0,17.67,-0.03,Medium Risk
U191,2024,6,412483.0,Salary Increases & Fixed Expenses Increase,315153,114269.0,172539,286808.0,28345.0,8.99,-0.03,High Risk
U191,2024,7,440828.0,Salary Increases & Fixed Expenses Increase,315153,114269.0,178397,292666.0,22487.0,7.14,0.05,High Risk
U191,2024,8,463315.0,Salary Increases & Fixed Expenses Increase,315153,115674.0,154510,270184.0,44969.0,14.27,0.04,High Risk
U191,2024,9,508284.0,Salary Increases & Fixed Expenses Increase,315153,117200.0,185233,302433.0,12720.0,4.04,-0.01,High Risk
U191,2024,10,521004.0,Salary Increases & Fixed Expenses Increase,315153,117200.0,138375,255575.0,59578.0,18.9,0.03,Medium Risk
U191,2024,11,580582.0,Salary Increases & Fixed Expenses Increase,315153,117200.0,168426,285626.0,29527.0,9.37,-0.04,High Risk
U191,2024,12,610109.0,Salary Increases & Fixed Expenses Increase,315153,117200.0,153868,271068.0,44085.0,13.99,0.01,High Risk
U192,2024,1,201300.0,Salary Increases & Fixed Expenses Remain Stable,78664,34750.0,43780,78530.0,134.0,0.17,0.02,High Risk
U192,2024,2,201434.0,Salary Increases & Fixed Expenses Remain Stable,78664,34750.0,31990,66740.0,11924.0,15.16,-0.04,Medium Risk
U192,2024,3,213358.0,Salary Increases & Fixed Expenses Remain Stable,78664,34750.0,39404,74154.0,4510.0,5.73,0.05,High Risk
U192,2024,4,217868.0,Salary Increases & Fixed Expenses Remain Stable,78664,34750.0,46847,81597.0,-2933.0,-3.73,-0.03,High Risk
U192,2024,5,214935.0,Salary Increases & Fixed Expenses Remain Stable,78664,34750.0,42037,76787.0,1877.0,2.39,-0.03,High Risk
U192,2024,6,216812.0,Salary Increases & Fixed Expenses Remain Stable,78664,34750.0,43697,78447.0,217.0,0.28,0.04,High Risk
U192,2024,7,217029.0,Salary Increases & Fixed Expenses Remain Stable,78664,34750.0,37221,71971.0,6693.0,8.51,0.01,High Risk
U192,2024,8,223722.0,Salary Increases & Fixed Expenses Remain Stable,92328,34750.0,45594,80344.0,11984.0,12.98,0.02,High Risk
U192,2024,9,235706.0,Salary Increases & Fixed Expenses Remain Stable,92328,34750.0,55503,90253.0,2075.0,2.25,-0.03,High Risk
U192,2024,10,237781.0,Salary Increases & Fixed Expenses Remain Stable,92328,34750.0,56806,91556.0,772.0,0.84,0.02,High Risk
U192,2024,11,238553.0,Salary Increases & Fixed Expenses Remain Stable,92328,34750.0,49397,84147.0,8181.0,8.86,-0.04,High Risk
U192,2024,12,246734.0,Salary Increases & Fixed Expenses Remain Stable,92328,34750.0,44889,79639.0,12689.0,13.74,-0.0,High Risk
U193,2024,1,229691.0,Stable Salary & Increasing Fixed Expenses,126253,53646.0,79819,133465.0,-7212.0,-5.71,0.04,High Risk
U193,2024,2,222479.0,Stable Salary & Increasing Fixed Expenses,126253,53646.0,88228,141874.0,-15621.0,-12.37,-0.03,High Risk
U193,2024,3,206858.0,Stable Salary & Increasing Fixed Expenses,126253,53646.0,98420,152066.0,-25813.0,-20.45,0.02,High Risk
U193,2024,4,181045.0,Stable Salary & Increasing Fixed Expenses,126253,53646.0,95763,149409.0,-23156.0,-18.34,0.0,High Risk
U193,2024,5,157889.0,Stable Salary & Increasing Fixed Expenses,126253,53646.0,82307,135953.0,-9700.0,-7.68,0.0,High Risk
U193,2024,6,148189.0,Stable Salary & Increasing Fixed Expenses,126253,53646.0,75890,129536.0,-3283.0,-2.6,0.02,High Risk
U193,2024,7,144906.0,Stable Salary & Increasing Fixed Expenses,126253,53646.0,84019,137665.0,-11412.0,-9.04,-0.05,High Risk
U193,2024,8,133494.0,Stable Salary & Increasing Fixed Expenses,126253,53646.0,79562,133208.0,-6955.0,-5.51,0.04,High Risk
U193,2024,9,126539.0,Stable Salary & Increasing Fixed Expenses,126253,53646.0,113792,167438.0,-41185.0,-32.62,-0.02,High Risk
U193,2024,10,85354.0,Stable Salary & Increasing Fixed Expenses,126253,53646.0,95734,149380.0,-23127.0,-18.32,-0.05,High Risk
U193,2024,11,62227.0,Stable Salary & Increasing Fixed Expenses,126253,55008.0,106425,161433.0,-35180.0,-27.86,-0.02,High Risk
U193,2024,12,27047.0,Stable Salary & Increasing Fixed Expenses,126253,55008.0,95985,150993.0,-24740.0,-19.6,-0.04,High Risk
U194,2024,1,202694.0,Salary Increases & Fixed Expenses Increase,25415,14821.0,15328,30149.0,-4734.0,-18.63,-0.01,High Risk
U194,2024,2,197960.0,Salary Increases & Fixed Expenses Increase,25415,14821.0,15506,30327.0,-4912.0,-19.33,-0.01,High Risk
U194,2024,3,193048.0,Salary Increases & Fixed Expenses Increase,25415,14821.0,22549,37370.0,-11955.0,-47.04,0.04,High Risk
U194,2024,4,181093.0,Salary Increases & Fixed Expenses Increase,25415,14821.0,20253,35074.0,-9659.0,-38.01,-0.01,High Risk
U194,2024,5,171434.0,Salary Increases & Fixed Expenses Increase,25415,14821.0,20248,35069.0,-9654.0,-37.99,0.01,High Risk
U194,2024,6,161780.0,Salary Increases & Fixed Expenses Increase,25415,14821.0,17037,31858.0,-6443.0,-25.35,-0.02,High Risk
U194,2024,7,155337.0,Salary Increases & Fixed Expenses Increase,45565,14821.0,29108,43929.0,1636.0,3.59,-0.01,High Risk
U194,2024,8,156973.0,Salary Increases & Fixed Expenses Increase,45565,14821.0,32061,46882.0,-1317.0,-2.89,0.05,High Risk
U194,2024,9,155656.0,Salary Increases & Fixed Expenses Increase,45565,14821.0,30555,45376.0,189.0,0.41,0.05,High Risk
U194,2024,10,155845.0,Salary Increases & Fixed Expenses Increase,45565,14821.0,34794,49615.0,-4050.0,-8.89,-0.03,High Risk
U194,2024,11,151795.0,Salary Increases & Fixed Expenses Increase,45565,14821.0,33483,48304.0,-2739.0,-6.01,-0.02,High Risk
U194,2024,12,149056.0,Salary Increases & Fixed Expenses Increase,45565,14821.0,33705,48526.0,-2961.0,-6.5,0.05,High Risk
U195,2024,1,220719.0,Stable Salary & Increasing Fixed Expenses,175999,54136.0,77484,131620.0,44379.0,25.22,0.02,Low Risk
U195,2024,2,265098.0,Stable Salary & Increasing Fixed Expenses,175999,54136.0,91732,145868.0,30131.0,17.12,-0.04,Medium Risk
U195,2024,3,295229.0,Stable Salary & Increasing Fixed Expenses,175999,54136.0,82300,136436.0,39563.0,22.48,-0.01,Medium Risk
U195,2024,4,334792.0,Stable Salary & Increasing Fixed Expenses,175999,55538.0,96316,151854.0,24145.0,13.72,-0.02,High Risk
U195,2024,5,358937.0,Stable Salary & Increasing Fixed Expenses,175999,55538.0,99420,154958.0,21041.0,11.96,0.05,High Risk
U195,2024,6,379978.0,Stable Salary & Increasing Fixed Expenses,175999,56500.0,89412,145912.0,30087.0,17.09,0.05,Medium Risk
U195,2024,7,410065.0,Stable Salary & Increasing Fixed Expenses,175999,56500.0,104058,160558.0,15441.0,8.77,-0.03,High Risk
U195,2024,8,425506.0,Stable Salary & Increasing Fixed Expenses,175999,56500.0,75202,131702.0,44297.0,25.17,0.02,Low Risk
U195,2024,9,469803.0,Stable Salary & Increasing Fixed Expenses,175999,57948.0,87848,145796.0,30203.0,17.16,-0.02,Medium Risk
U195,2024,10,500006.0,Stable Salary & Increasing Fixed Expenses,175999,57948.0,76431,134379.0,41620.0,23.65,-0.01,Medium Risk
U195,2024,11,541626.0,Stable Salary & Increasing Fixed Expenses,175999,57948.0,89224,147172.0,28827.0,16.38,-0.01,Medium Risk
U195,2024,12,570453.0,Stable Salary & Increasing Fixed Expenses,175999,58737.0,101359,160096.0,15903.0,9.04,0.0,High Risk
U196,2024,1,215338.0,Salary Increases & Fixed Expenses Increase,139005,50393.0,47090,97483.0,41522.0,29.87,0.02,Low Risk
U196,2024,2,256860.0,Salary Increases & Fixed Expenses Increase,139005,50393.0,43429,93822.0,45183.0,32.5,-0.01,Low Risk
U196,2024,3,302043.0,Salary Increases & Fixed Expenses Increase,166615,50393.0,57053,107446.0,59169.0,35.51,-0.02,Low Risk
U196,2024,4,361212.0,Salary Increases & Fixed Expenses Increase,166615,50393.0,62019,112412.0,54203.0,32.53,-0.05,Low Risk
U196,2024,5,415415.0,Salary Increases & Fixed Expenses Increase,166615,50393.0,58331,108724.0,57891.0,34.75,0.01,Low Risk
U196,2024,6,473306.0,Salary Increases & Fixed Expenses Increase,166615,50393.0,56881,107274.0,59341.0,35.62,0.01,Low Risk
U196,2024,7,532647.0,Salary Increases & Fixed Expenses Increase,166615,50393.0,65580,115973.0,50642.0,30.39,-0.01,Low Risk
U196,2024,8,583289.0,Salary Increases & Fixed Expenses Increase,166615,50393.0,50663,101056.0,65559.0,39.35,-0.0,Low Risk
U196,2024,9,648848.0,Salary Increases & Fixed Expenses Increase,166615,50393.0,59428,109821.0,56794.0,34.09,-0.02,Low Risk
U196,2024,10,705642.0,Salary Increases & Fixed Expenses Increase,166615,50393.0,53982,104375.0,62240.0,37.36,0.02,Low Risk
U196,2024,11,767882.0,Salary Increases & Fixed Expenses Increase,166615,50393.0,50446,100839.0,65776.0,39.48,-0.03,Low Risk
U196,2024,12,833658.0,Salary Increases & Fixed Expenses Increase,166615,51891.0,63393,115284.0,51331.0,30.81,0.04,Low Risk
U197,2024,1,249458.0,Salary Increases & Fixed Expenses Remain Stable,84340,26794.0,44447,71241.0,13099.0,15.53,0.05,Medium Risk
U197,2024,2,262557.0,Salary Increases & Fixed Expenses Remain Stable,84340,26794.0,36392,63186.0,21154.0,25.08,-0.01,Low Risk
U197,2024,3,283711.0,Salary Increases & Fixed Expenses Remain Stable,84340,26794.0,56276,83070.0,1270.0,1.51,-0.02,High Risk
U197,2024,4,284981.0,Salary Increases & Fixed Expenses Remain Stable,84340,26794.0,37417,64211.0,20129.0,23.87,-0.03,Medium Risk
U197,2024,5,305110.0,Salary Increases & Fixed Expenses Remain Stable,84340,26794.0,37625,64419.0,19921.0,23.62,-0.02,Medium Risk
U197,2024,6,325031.0,Salary Increases & Fixed Expenses Remain Stable,108478,26794.0,47296,74090.0,34388.0,31.7,-0.0,Low Risk
U197,2024,7,359419.0,Salary Increases & Fixed Expenses Remain Stable,108478,26794.0,52235,79029.0,29449.0,27.15,0.02,Low Risk
U197,2024,8,388868.0,Salary Increases & Fixed Expenses Remain Stable,108478,26794.0,58797,85591.0,22887.0,21.1,-0.01,Medium Risk
U197,2024,9,411755.0,Salary Increases & Fixed Expenses Remain Stable,108478,26794.0,48806,75600.0,32878.0,30.31,0.04,Low Risk
U197,2024,10,444633.0,Salary Increases & Fixed Expenses Remain Stable,108478,26794.0,56612,83406.0,25072.0,23.11,-0.05,Medium Risk
U197,2024,11,469705.0,Salary Increases & Fixed Expenses Remain Stable,108478,26794.0,52923,79717.0,28761.0,26.51,0.0,Low Risk
U197,2024,12,498466.0,Salary Increases & Fixed Expenses Remain Stable,108478,26794.0,52875,79669.0,28809.0,26.56,0.0,Low Risk
U198,2024,1,206322.0,Stable Salary & Stable Fixed Expenses,188818,60164.0,95574,155738.0,33080.0,17.52,0.03,Medium Risk
U198,2024,2,239402.0,Stable Salary & Stable Fixed Expenses,188818,60164.0,98225,158389.0,30429.0,16.12,-0.04,Medium Risk
U198,2024,3,269831.0,Stable Salary & Stable Fixed Expenses,188818,60164.0,111469,171633.0,17185.0,9.1,0.03,High Risk
U198,2024,4,287016.0,Stable Salary & Stable Fixed Expenses,188818,60164.0,97590,157754.0,31064.0,16.45,0.05,Medium Risk
U198,2024,5,318080.0,Stable Salary & Stable Fixed Expenses,188818,60164.0,104123,164287.0,24531.0,12.99,0.04,High Risk
U198,2024,6,342611.0,Stable Salary & Stable Fixed Expenses,188818,60164.0,106663,166827.0,21991.0,11.65,0.05,High Risk
U198,2024,7,364602.0,Stable Salary & Stable Fixed Expenses,188818,60164.0,89231,149395.0,39423.0,20.88,-0.02,Medium Risk
U198,2024,8,404025.0,Stable Salary & Stable Fixed Expenses,188818,60164.0,81075,141239.0,47579.0,25.2,0.02,Low Risk
U198,2024,9,451604.0,Stable Salary & Stable Fixed Expenses,188818,60164.0,83270,143434.0,45384.0,24.04,-0.02,Medium Risk
U198,2024,10,496988.0,Stable Salary & Stable Fixed Expenses,188818,60164.0,116102,176266.0,12552.0,6.65,0.02,High Risk
U198,2024,11,509540.0,Stable Salary & Stable Fixed Expenses,188818,60164.0,81385,141549.0,47269.0,25.03,0.03,Low Risk
U198,2024,12,556809.0,Stable Salary & Stable Fixed Expenses,188818,60164.0,88972,149136.0,39682.0,21.02,0.03,Medium Risk
U199,2024,1,201345.0,Stable Salary & Increasing Fixed Expenses,151996,45367.0,72832,118199.0,33797.0,22.24,0.01,Medium Risk
U199,2024,2,235142.0,Stable Salary & Increasing Fixed Expenses,151996,45367.0,80835,126202.0,25794.0,16.97,0.04,Medium Risk
U199,2024,3,260936.0,Stable Salary & Increasing Fixed Expenses,151996,45367.0,77617,122984.0,29012.0,19.09,-0.01,Medium Risk
U199,2024,4,289948.0,Stable Salary & Increasing Fixed Expenses,151996,46072.0,74120,120192.0,31804.0,20.92,0.03,Medium Risk
U199,2024,5,321752.0,Stable Salary & Increasing Fixed Expenses,151996,46072.0,80525,126597.0,25399.0,16.71,-0.02,Medium Risk
U199,2024,6,347151.0,Stable Salary & Increasing Fixed Expenses,151996,47775.0,67542,115317.0,36679.0,24.13,-0.04,Medium Risk
U199,2024,7,383830.0,Stable Salary & Increasing Fixed Expenses,151996,47775.0,89429,137204.0,14792.0,9.73,-0.02,High Risk
U199,2024,8,398622.0,Stable Salary & Increasing Fixed Expenses,151996,47775.0,88140,135915.0,16081.0,10.58,-0.04,High Risk
U199,2024,9,414703.0,Stable Salary & Increasing Fixed Expenses,151996,47775.0,70358,118133.0,33863.0,22.28,0.03,Medium Risk
U199,2024,10,448566.0,Stable Salary & Increasing Fixed Expenses,151996,47775.0,66554,114329.0,37667.0,24.78,-0.02,Medium Risk
U199,2024,11,486233.0,Stable Salary & Increasing Fixed Expenses,151996,47775.0,89161,136936.0,15060.0,9.91,0.05,High Risk
U199,2024,12,501293.0,Stable Salary & Increasing Fixed Expenses,151996,47775.0,71209,118984.0,33012.0,21.72,0.02,Medium Risk
U200,2024,1,231970.0,Salary Increases & Fixed Expenses Remain Stable,172099,75706.0,76673,152379.0,19720.0,11.46,-0.04,High Risk
U200,2024,2,251690.0,Salary Increases & Fixed Expenses Remain Stable,172099,75706.0,87934,163640.0,8459.0,4.92,-0.01,High Risk
U200,2024,3,260149.0,Salary Increases & Fixed Expenses Remain Stable,198522,75706.0,99093,174799.0,23723.0,11.95,0.02,High Risk
U200,2024,4,283872.0,Salary Increases & Fixed Expenses Remain Stable,198522,75706.0,89101,164807.0,33715.0,16.98,0.0,Medium Risk
U200,2024,5,317587.0,Salary Increases & Fixed Expenses Remain Stable,198522,75706.0,106428,182134.0,16388.0,8.26,0.01,High Risk
U200,2024,6,333975.0,Salary Increases & Fixed Expenses Remain Stable,198522,75706.0,105188,180894.0,17628.0,8.88,0.01,High Risk
U200,2024,7,351603.0,Salary Increases & Fixed Expenses Remain Stable,198522,75706.0,85445,161151.0,37371.0,18.82,-0.01,Medium Risk
U200,2024,8,388974.0,Salary Increases & Fixed Expenses Remain Stable,198522,75706.0,104490,180196.0,18326.0,9.23,0.03,High Risk
U200,2024,9,407300.0,Salary Increases & Fixed Expenses Remain Stable,198522,75706.0,96244,171950.0,26572.0,13.38,0.03,High Risk
U200,2024,10,433872.0,Salary Increases & Fixed Expenses Remain Stable,198522,75706.0,112130,187836.0,10686.0,5.38,-0.03,High Risk
U200,2024,11,444558.0,Salary Increases & Fixed Expenses Remain Stable,198522,75706.0,88806,164512.0,34010.0,17.13,0.03,Medium Risk
U200,2024,12,478568.0,Salary Increases & Fixed Expenses Remain Stable,198522,75706.0,145192,220898.0,-22376.0,-11.27,-0.01,High Risk
U201,2024,1,243017.0,Salary Increases & Fixed Expenses Remain Stable,273206,71682.0,184249,255931.0,17275.0,6.32,-0.02,High Risk
U201,2024,2,260292.0,Salary Increases & Fixed Expenses Remain Stable,273206,71682.0,170608,242290.0,30916.0,11.32,0.05,High Risk
U201,2024,3,291208.0,Salary Increases & Fixed Expenses Remain Stable,273206,71682.0,243522,315204.0,-41998.0,-15.37,-0.01,High Risk
U201,2024,4,249210.0,Salary Increases & Fixed Expenses Remain Stable,273206,71682.0,217093,288775.0,-15569.0,-5.7,0.0,High Risk
U201,2024,5,233641.0,Salary Increases & Fixed Expenses Remain Stable,297042,71682.0,188419,260101.0,36941.0,12.44,0.03,High Risk
U201,2024,6,270582.0,Salary Increases & Fixed Expenses Remain Stable,297042,71682.0,213366,285048.0,11994.0,4.04,0.0,High Risk
U201,2024,7,282576.0,Salary Increases & Fixed Expenses Remain Stable,297042,71682.0,211410,283092.0,13950.0,4.7,0.04,High Risk
U201,2024,8,296526.0,Salary Increases & Fixed Expenses Remain Stable,297042,71682.0,228766,300448.0,-3406.0,-1.15,0.03,High Risk
U201,2024,9,293120.0,Salary Increases & Fixed Expenses Remain Stable,297042,71682.0,201034,272716.0,24326.0,8.19,0.03,High Risk
U201,2024,10,317446.0,Salary Increases & Fixed Expenses Remain Stable,297042,71682.0,251997,323679.0,-26637.0,-8.97,-0.01,High Risk
U201,2024,11,290809.0,Salary Increases & Fixed Expenses Remain Stable,297042,71682.0,193804,265486.0,31556.0,10.62,0.03,High Risk
U201,2024,12,322365.0,Salary Increases & Fixed Expenses Remain Stable,297042,71682.0,178613,250295.0,46747.0,15.74,0.01,Medium Risk
U202,2024,1,224259.0,Salary Increases & Fixed Expenses Remain Stable,77285,30241.0,25891,56132.0,21153.0,27.37,0.04,Low Risk
U202,2024,2,245412.0,Salary Increases & Fixed Expenses Remain Stable,77285,30241.0,28254,58495.0,18790.0,24.31,0.02,Medium Risk
U202,2024,3,264202.0,Salary Increases & Fixed Expenses Remain Stable,77285,30241.0,29661,59902.0,17383.0,22.49,0.01,Medium Risk
U202,2024,4,281585.0,Salary Increases & Fixed Expenses Remain Stable,77285,30241.0,28789,59030.0,18255.0,23.62,-0.03,Medium Risk
U202,2024,5,299840.0,Salary Increases & Fixed Expenses Remain Stable,77285,30241.0,28124,58365.0,18920.0,24.48,0.03,Medium Risk
U202,2024,6,318760.0,Salary Increases & Fixed Expenses Remain Stable,85082,30241.0,31507,61748.0,23334.0,27.43,0.03,Low Risk
U202,2024,7,342094.0,Salary Increases & Fixed Expenses Remain Stable,85082,30241.0,26776,57017.0,28065.0,32.99,0.0,Low Risk
U202,2024,8,370159.0,Salary Increases & Fixed Expenses Remain Stable,85082,30241.0,28331,58572.0,26510.0,31.16,-0.01,Low Risk
U202,2024,9,396669.0,Salary Increases & Fixed Expenses Remain Stable,85082,30241.0,34983,65224.0,19858.0,23.34,0.04,Medium Risk
U202,2024,10,416527.0,Salary Increases & Fixed Expenses Remain Stable,85082,30241.0,31777,62018.0,23064.0,27.11,-0.05,Low Risk
U202,2024,11,439591.0,Salary Increases & Fixed Expenses Remain Stable,85082,30241.0,36038,66279.0,18803.0,22.1,-0.02,Medium Risk
U202,2024,12,458394.0,Salary Increases & Fixed Expenses Remain Stable,85082,30241.0,37131,67372.0,17710.0,20.82,-0.04,Medium Risk
U203,2024,1,240922.0,Salary Increases & Fixed Expenses Increase,168057,68989.0,97867,166856.0,1201.0,0.71,0.04,High Risk
U203,2024,2,242123.0,Salary Increases & Fixed Expenses Increase,168057,69536.0,97800,167336.0,721.0,0.43,-0.02,High Risk
U203,2024,3,242844.0,Salary Increases & Fixed Expenses Increase,168057,69536.0,84656,154192.0,13865.0,8.25,-0.05,High Risk
U203,2024,4,256709.0,Salary Increases & Fixed Expenses Increase,187834,69536.0,105380,174916.0,12918.0,6.88,0.03,High Risk
U203,2024,5,269627.0,Salary Increases & Fixed Expenses Increase,187834,70599.0,100743,171342.0,16492.0,8.78,0.03,High Risk
U203,2024,6,286119.0,Salary Increases & Fixed Expenses Increase,187834,70599.0,108119,178718.0,9116.0,4.85,0.0,High Risk
U203,2024,7,295235.0,Salary Increases & Fixed Expenses Increase,187834,70599.0,75735,146334.0,41500.0,22.09,0.02,Medium Risk
U203,2024,8,336735.0,Salary Increases & Fixed Expenses Increase,187834,70599.0,105024,175623.0,12211.0,6.5,-0.03,High Risk
U203,2024,9,348946.0,Salary Increases & Fixed Expenses Increase,187834,70599.0,86564,157163.0,30671.0,16.33,0.01,Medium Risk
U203,2024,10,379617.0,Salary Increases & Fixed Expenses Increase,187834,71239.0,110362,181601.0,6233.0,3.32,0.05,High Risk
U203,2024,11,385850.0,Salary Increases & Fixed Expenses Increase,187834,71239.0,109029,180268.0,7566.0,4.03,0.03,High Risk
U203,2024,12,393416.0,Salary Increases & Fixed Expenses Increase,187834,71239.0,81314,152553.0,35281.0,18.78,-0.02,Medium Risk
U204,2024,1,231204.0,Salary Increases & Fixed Expenses Remain Stable,285163,60370.0,108411,168781.0,116382.0,40.81,0.01,Low Risk
U204,2024,2,347586.0,Salary Increases & Fixed Expenses Remain Stable,285163,60370.0,102465,162835.0,122328.0,42.9,-0.01,Low Risk
U204,2024,3,469914.0,Salary Increases & Fixed Expenses Remain Stable,285163,60370.0,108324,168694.0,116469.0,40.84,0.0,Low Risk
U204,2024,4,586383.0,Salary Increases & Fixed Expenses Remain Stable,285163,60370.0,92762,153132.0,132031.0,46.3,-0.0,Low Risk
U204,2024,5,718414.0,Salary Increases & Fixed Expenses Remain Stable,300538,60370.0,92310,152680.0,147858.0,49.2,-0.03,Low Risk
U204,2024,6,866272.0,Salary Increases & Fixed Expenses Remain Stable,300538,60370.0,100438,160808.0,139730.0,46.49,-0.02,Low Risk
U204,2024,7,1006002.0,Salary Increases & Fixed Expenses Remain Stable,300538,60370.0,100397,160767.0,139771.0,46.51,-0.02,Low Risk
U204,2024,8,1145773.0,Salary Increases & Fixed Expenses Remain Stable,300538,60370.0,90205,150575.0,149963.0,49.9,0.04,Low Risk
U204,2024,9,1295736.0,Salary Increases & Fixed Expenses Remain Stable,300538,60370.0,112334,172704.0,127834.0,42.54,0.02,Low Risk
U204,2024,10,1423570.0,Salary Increases & Fixed Expenses Remain Stable,300538,60370.0,95721,156091.0,144447.0,48.06,-0.04,Low Risk
U204,2024,11,1568017.0,Salary Increases & Fixed Expenses Remain Stable,300538,60370.0,110993,171363.0,129175.0,42.98,0.04,Low Risk
U204,2024,12,1697192.0,Salary Increases & Fixed Expenses Remain Stable,300538,60370.0,107997,168367.0,132171.0,43.98,-0.02,Low Risk
U205,2024,1,229635.0,Stable Salary & Stable Fixed Expenses,62098,26145.0,22717,48862.0,13236.0,21.31,0.02,Medium Risk
U205,2024,2,242871.0,Stable Salary & Stable Fixed Expenses,62098,26145.0,22150,48295.0,13803.0,22.23,0.04,Medium Risk
U205,2024,3,256674.0,Stable Salary & Stable Fixed Expenses,62098,26145.0,27173,53318.0,8780.0,14.14,0.02,High Risk
U205,2024,4,265454.0,Stable Salary & Stable Fixed Expenses,62098,26145.0,24399,50544.0,11554.0,18.61,-0.04,Medium Risk
U205,2024,5,277008.0,Stable Salary & Stable Fixed Expenses,62098,26145.0,21477,47622.0,14476.0,23.31,0.02,Medium Risk
U205,2024,6,291484.0,Stable Salary & Stable Fixed Expenses,62098,26145.0,23994,50139.0,11959.0,19.26,-0.03,Medium Risk
U205,2024,7,303443.0,Stable Salary & Stable Fixed Expenses,62098,26145.0,22750,48895.0,13203.0,21.26,0.02,Medium Risk
U205,2024,8,316646.0,Stable Salary & Stable Fixed Expenses,62098,26145.0,19655,45800.0,16298.0,26.25,-0.04,Low Risk
U205,2024,9,332944.0,Stable Salary & Stable Fixed Expenses,62098,26145.0,20838,46983.0,15115.0,24.34,0.03,Medium Risk
U205,2024,10,348059.0,Stable Salary & Stable Fixed Expenses,62098,26145.0,24419,50564.0,11534.0,18.57,0.01,Medium Risk
U205,2024,11,359593.0,Stable Salary & Stable Fixed Expenses,62098,26145.0,21948,48093.0,14005.0,22.55,0.01,Medium Risk
U205,2024,12,373598.0,Stable Salary & Stable Fixed Expenses,62098,26145.0,24017,50162.0,11936.0,19.22,0.01,Medium Risk
U206,2024,1,209754.0,Salary Increases & Fixed Expenses Remain Stable,65967,28560.0,23942,52502.0,13465.0,20.41,0.04,Medium Risk
U206,2024,2,223219.0,Salary Increases & Fixed Expenses Remain Stable,65967,28560.0,26107,54667.0,11300.0,17.13,-0.03,Medium Risk
U206,2024,3,234519.0,Salary Increases & Fixed Expenses Remain Stable,65967,28560.0,26448,55008.0,10959.0,16.61,-0.01,Medium Risk
U206,2024,4,245478.0,Salary Increases & Fixed Expenses Remain Stable,65967,28560.0,21942,50502.0,15465.0,23.44,-0.01,Medium Risk
U206,2024,5,260943.0,Salary Increases & Fixed Expenses Remain Stable,65967,28560.0,20769,49329.0,16638.0,25.22,-0.03,Low Risk
U206,2024,6,277581.0,Salary Increases & Fixed Expenses Remain Stable,65967,28560.0,21755,50315.0,15652.0,23.73,-0.0,Medium Risk
U206,2024,7,293233.0,Salary Increases & Fixed Expenses Remain Stable,83223,28560.0,32519,61079.0,22144.0,26.61,-0.02,Low Risk
U206,2024,8,315377.0,Salary Increases & Fixed Expenses Remain Stable,83223,28560.0,32654,61214.0,22009.0,26.45,-0.01,Low Risk
U206,2024,9,337386.0,Salary Increases & Fixed Expenses Remain Stable,83223,28560.0,30891,59451.0,23772.0,28.56,0.03,Low Risk
U206,2024,10,361158.0,Salary Increases & Fixed Expenses Remain Stable,83223,28560.0,33259,61819.0,21404.0,25.72,0.03,Low Risk
U206,2024,11,382562.0,Salary Increases & Fixed Expenses Remain Stable,83223,28560.0,30023,58583.0,24640.0,29.61,0.03,Low Risk
U206,2024,12,407202.0,Salary Increases & Fixed Expenses Remain Stable,83223,28560.0,29424,57984.0,25239.0,30.33,-0.04,Low Risk
U207,2024,1,218631.0,Salary Increases & Fixed Expenses Remain Stable,275550,82702.0,139016,221718.0,53832.0,19.54,-0.02,Medium Risk
U207,2024,2,272463.0,Salary Increases & Fixed Expenses Remain Stable,275550,82702.0,154991,237693.0,37857.0,13.74,-0.04,High Risk
U207,2024,3,310320.0,Salary Increases & Fixed Expenses Remain Stable,275550,82702.0,129896,212598.0,62952.0,22.85,0.04,Medium Risk
U207,2024,4,373272.0,Salary Increases & Fixed Expenses Remain Stable,289236,82702.0,164537,247239.0,41997.0,14.52,-0.03,High Risk
U207,2024,5,415269.0,Salary Increases & Fixed Expenses Remain Stable,289236,82702.0,172528,255230.0,34006.0,11.76,-0.03,High Risk
U207,2024,6,449275.0,Salary Increases & Fixed Expenses Remain Stable,289236,82702.0,151036,233738.0,55498.0,19.19,-0.03,Medium Risk
U207,2024,7,504773.0,Salary Increases & Fixed Expenses Remain Stable,289236,82702.0,139896,222598.0,66638.0,23.04,0.05,Medium Risk
U207,2024,8,571411.0,Salary Increases & Fixed Expenses Remain Stable,289236,82702.0,141155,223857.0,65379.0,22.6,-0.03,Medium Risk
U207,2024,9,636790.0,Salary Increases & Fixed Expenses Remain Stable,289236,82702.0,154676,237378.0,51858.0,17.93,0.05,Medium Risk
U207,2024,10,688648.0,Salary Increases & Fixed Expenses Remain Stable,289236,82702.0,130256,212958.0,76278.0,26.37,-0.01,Low Risk
U207,2024,11,764926.0,Salary Increases & Fixed Expenses Remain Stable,289236,82702.0,171953,254655.0,34581.0,11.96,-0.04,High Risk
U207,2024,12,799507.0,Salary Increases & Fixed Expenses Remain Stable,289236,82702.0,159436,242138.0,47098.0,16.28,0.03,Medium Risk
U208,2024,1,243897.0,Stable Salary & Stable Fixed Expenses,231082,95462.0,127045,222507.0,8575.0,3.71,-0.05,High Risk
U208,2024,2,252472.0,Stable Salary & Stable Fixed Expenses,231082,95462.0,134940,230402.0,680.0,0.29,-0.03,High Risk
U208,2024,3,253152.0,Stable Salary & Stable Fixed Expenses,231082,95462.0,141991,237453.0,-6371.0,-2.76,0.02,High Risk
U208,2024,4,246781.0,Stable Salary & Stable Fixed Expenses,231082,95462.0,137705,233167.0,-2085.0,-0.9,0.04,High Risk
U208,2024,5,244696.0,Stable Salary & Stable Fixed Expenses,231082,95462.0,110061,205523.0,25559.0,11.06,0.03,High Risk
U208,2024,6,270255.0,Stable Salary & Stable Fixed Expenses,231082,95462.0,112204,207666.0,23416.0,10.13,0.03,High Risk
U208,2024,7,293671.0,Stable Salary & Stable Fixed Expenses,231082,95462.0,96508,191970.0,39112.0,16.93,0.04,Medium Risk
U208,2024,8,332783.0,Stable Salary & Stable Fixed Expenses,231082,95462.0,123392,218854.0,12228.0,5.29,-0.01,High Risk
U208,2024,9,345011.0,Stable Salary & Stable Fixed Expenses,231082,95462.0,101826,197288.0,33794.0,14.62,0.04,High Risk
U208,2024,10,378805.0,Stable Salary & Stable Fixed Expenses,231082,95462.0,148760,244222.0,-13140.0,-5.69,0.05,High Risk
U208,2024,11,365665.0,Stable Salary & Stable Fixed Expenses,231082,95462.0,109708,205170.0,25912.0,11.21,0.04,High Risk
U208,2024,12,391577.0,Stable Salary & Stable Fixed Expenses,231082,95462.0,101158,196620.0,34462.0,14.91,0.05,High Risk
U209,2024,1,249757.0,Stable Salary & Increasing Fixed Expenses,137088,67140.0,69760,136900.0,188.0,0.14,0.0,High Risk
U209,2024,2,249945.0,Stable Salary & Increasing Fixed Expenses,137088,67140.0,56190,123330.0,13758.0,10.04,0.04,High Risk
U209,2024,3,263703.0,Stable Salary & Increasing Fixed Expenses,137088,68782.0,104331,173113.0,-36025.0,-26.28,-0.02,High Risk
U209,2024,4,227678.0,Stable Salary & Increasing Fixed Expenses,137088,68782.0,80078,148860.0,-11772.0,-8.59,0.05,High Risk
U209,2024,5,215906.0,Stable Salary & Increasing Fixed Expenses,137088,68782.0,67718,136500.0,588.0,0.43,-0.02,High Risk
U209,2024,6,216494.0,Stable Salary & Increasing Fixed Expenses,137088,68782.0,62388,131170.0,5918.0,4.32,-0.05,High Risk
U209,2024,7,222412.0,Stable Salary & Increasing Fixed Expenses,137088,68782.0,58200,126982.0,10106.0,7.37,0.0,High Risk
U209,2024,8,232518.0,Stable Salary & Increasing Fixed Expenses,137088,68782.0,76038,144820.0,-7732.0,-5.64,-0.03,High Risk
U209,2024,9,224786.0,Stable Salary & Increasing Fixed Expenses,137088,68782.0,78199,146981.0,-9893.0,-7.22,0.01,High Risk
U209,2024,10,214893.0,Stable Salary & Increasing Fixed Expenses,137088,68782.0,72477,141259.0,-4171.0,-3.04,-0.02,High Risk
U209,2024,11,210722.0,Stable Salary & Increasing Fixed Expenses,137088,68782.0,56559,125341.0,11747.0,8.57,-0.01,High Risk
U209,2024,12,222469.0,Stable Salary & Increasing Fixed Expenses,137088,68782.0,80609,149391.0,-12303.0,-8.97,-0.03,High Risk
U210,2024,1,230778.0,Salary Increases & Fixed Expenses Remain Stable,153467,48808.0,60093,108901.0,44566.0,29.04,-0.04,Low Risk
U210,2024,2,275344.0,Salary Increases & Fixed Expenses Remain Stable,153467,48808.0,49091,97899.0,55568.0,36.21,-0.02,Low Risk
U210,2024,3,330912.0,Salary Increases & Fixed Expenses Remain Stable,153467,48808.0,56397,105205.0,48262.0,31.45,0.04,Low Risk
U210,2024,4,379174.0,Salary Increases & Fixed Expenses Remain Stable,153467,48808.0,57567,106375.0,47092.0,30.69,0.03,Low Risk
U210,2024,5,426266.0,Salary Increases & Fixed Expenses Remain Stable,153467,48808.0,54841,103649.0,49818.0,32.46,-0.02,Low Risk
U210,2024,6,476084.0,Salary Increases & Fixed Expenses Remain Stable,153467,48808.0,59669,108477.0,44990.0,29.32,-0.04,Low Risk
U210,2024,7,521074.0,Salary Increases & Fixed Expenses Remain Stable,153467,48808.0,56082,104890.0,48577.0,31.65,0.04,Low Risk
U210,2024,8,569651.0,Salary Increases & Fixed Expenses Remain Stable,160757,48808.0,55853,104661.0,56096.0,34.89,-0.0,Low Risk
U210,2024,9,625747.0,Salary Increases & Fixed Expenses Remain Stable,160757,48808.0,61555,110363.0,50394.0,31.35,-0.04,Low Risk
U210,2024,10,676141.0,Salary Increases & Fixed Expenses Remain Stable,160757,48808.0,59803,108611.0,52146.0,32.44,-0.03,Low Risk
U210,2024,11,728287.0,Salary Increases & Fixed Expenses Remain Stable,160757,48808.0,53532,102340.0,58417.0,36.34,-0.01,Low Risk
U210,2024,12,786704.0,Salary Increases & Fixed Expenses Remain Stable,160757,48808.0,50333,99141.0,61616.0,38.33,0.04,Low Risk
U211,2024,1,245641.0,Stable Salary & Increasing Fixed Expenses,142474,47227.0,64096,111323.0,31151.0,21.86,-0.05,Medium Risk
U211,2024,2,276792.0,Stable Salary & Increasing Fixed Expenses,142474,47227.0,81937,129164.0,13310.0,9.34,-0.01,High Risk
U211,2024,3,290102.0,Stable Salary & Increasing Fixed Expenses,142474,47904.0,99192,147096.0,-4622.0,-3.24,0.02,High Risk
U211,2024,4,285480.0,Stable Salary & Increasing Fixed Expenses,142474,47904.0,75286,123190.0,19284.0,13.54,-0.04,High Risk
U211,2024,5,304764.0,Stable Salary & Increasing Fixed Expenses,142474,47904.0,77184,125088.0,17386.0,12.2,-0.05,High Risk
U211,2024,6,322150.0,Stable Salary & Increasing Fixed Expenses,142474,47904.0,60174,108078.0,34396.0,24.14,-0.01,Medium Risk
U211,2024,7,356546.0,Stable Salary & Increasing Fixed Expenses,142474,48644.0,64472,113116.0,29358.0,20.61,-0.03,Medium Risk
U211,2024,8,385904.0,Stable Salary & Increasing Fixed Expenses,142474,48644.0,83939,132583.0,9891.0,6.94,-0.03,High Risk
U211,2024,9,395795.0,Stable Salary & Increasing Fixed Expenses,142474,48644.0,65188,113832.0,28642.0,20.1,-0.04,Medium Risk
U211,2024,10,424437.0,Stable Salary & Increasing Fixed Expenses,142474,48644.0,92270,140914.0,1560.0,1.09,0.01,High Risk
U211,2024,11,425997.0,Stable Salary & Increasing Fixed Expenses,142474,48644.0,69162,117806.0,24668.0,17.31,-0.02,Medium Risk
U211,2024,12,450665.0,Stable Salary & Increasing Fixed Expenses,142474,48644.0,73904,122548.0,19926.0,13.99,-0.05,High Risk
U212,2024,1,206463.0,Stable Salary & Stable Fixed Expenses,170148,57820.0,91437,149257.0,20891.0,12.28,0.02,High Risk
U212,2024,2,227354.0,Stable Salary & Stable Fixed Expenses,170148,57820.0,81161,138981.0,31167.0,18.32,0.04,Medium Risk
U212,2024,3,258521.0,Stable Salary & Stable Fixed Expenses,170148,57820.0,114659,172479.0,-2331.0,-1.37,0.02,High Risk
U212,2024,4,256190.0,Stable Salary & Stable Fixed Expenses,170148,57820.0,91637,149457.0,20691.0,12.16,0.01,High Risk
U212,2024,5,276881.0,Stable Salary & Stable Fixed Expenses,170148,57820.0,79203,137023.0,33125.0,19.47,-0.04,Medium Risk
U212,2024,6,310006.0,Stable Salary & Stable Fixed Expenses,170148,57820.0,82841,140661.0,29487.0,17.33,0.01,Medium Risk
U212,2024,7,339493.0,Stable Salary & Stable Fixed Expenses,170148,57820.0,73526,131346.0,38802.0,22.8,-0.03,Medium Risk
U212,2024,8,378295.0,Stable Salary & Stable Fixed Expenses,170148,57820.0,98850,156670.0,13478.0,7.92,0.01,High Risk
U212,2024,9,391773.0,Stable Salary & Stable Fixed Expenses,170148,57820.0,80585,138405.0,31743.0,18.66,-0.03,Medium Risk
U212,2024,10,423516.0,Stable Salary & Stable Fixed Expenses,170148,57820.0,82645,140465.0,29683.0,17.45,0.03,Medium Risk
U212,2024,11,453199.0,Stable Salary & Stable Fixed Expenses,170148,57820.0,100182,158002.0,12146.0,7.14,0.01,High Risk
U212,2024,12,465345.0,Stable Salary & Stable Fixed Expenses,170148,57820.0,70406,128226.0,41922.0,24.64,0.03,Medium Risk
U213,2024,1,209941.0,Stable Salary & Increasing Fixed Expenses,147918,58644.0,59528,118172.0,29746.0,20.11,0.05,Medium Risk
U213,2024,2,239687.0,Stable Salary & Increasing Fixed Expenses,147918,58644.0,76209,134853.0,13065.0,8.83,-0.01,High Risk
U213,2024,3,252752.0,Stable Salary & Increasing Fixed Expenses,147918,58644.0,80896,139540.0,8378.0,5.66,-0.03,High Risk
U213,2024,4,261130.0,Stable Salary & Increasing Fixed Expenses,147918,58644.0,69510,128154.0,19764.0,13.36,-0.05,High Risk
U213,2024,5,280894.0,Stable Salary & Increasing Fixed Expenses,147918,58644.0,86675,145319.0,2599.0,1.76,0.05,High Risk
U213,2024,6,283493.0,Stable Salary & Increasing Fixed Expenses,147918,58644.0,79303,137947.0,9971.0,6.74,-0.01,High Risk
U213,2024,7,293464.0,Stable Salary & Increasing Fixed Expenses,147918,58644.0,72322,130966.0,16952.0,11.46,-0.0,High Risk
U213,2024,8,310416.0,Stable Salary & Increasing Fixed Expenses,147918,58644.0,84437,143081.0,4837.0,3.27,0.02,High Risk
U213,2024,9,315253.0,Stable Salary & Increasing Fixed Expenses,147918,58644.0,62821,121465.0,26453.0,17.88,-0.01,Medium Risk
U213,2024,10,341706.0,Stable Salary & Increasing Fixed Expenses,147918,58644.0,79762,138406.0,9512.0,6.43,0.03,High Risk
U213,2024,11,351218.0,Stable Salary & Increasing Fixed Expenses,147918,58644.0,87066,145710.0,2208.0,1.49,0.03,High Risk
U213,2024,12,353426.0,Stable Salary & Increasing Fixed Expenses,147918,58644.0,75455,134099.0,13819.0,9.34,0.01,High Risk
U214,2024,1,214184.0,Stable Salary & Increasing Fixed Expenses,184448,64657.0,90318,154975.0,29473.0,15.98,-0.04,Medium Risk
U214,2024,2,243657.0,Stable Salary & Increasing Fixed Expenses,184448,64657.0,95510,160167.0,24281.0,13.16,-0.04,High Risk
U214,2024,3,267938.0,Stable Salary & Increasing Fixed Expenses,184448,66555.0,123761,190316.0,-5868.0,-3.18,-0.01,High Risk
U214,2024,4,262070.0,Stable Salary & Increasing Fixed Expenses,184448,66555.0,88256,154811.0,29637.0,16.07,-0.02,Medium Risk
U214,2024,5,291707.0,Stable Salary & Increasing Fixed Expenses,184448,66555.0,84632,151187.0,33261.0,18.03,-0.04,Medium Risk
U214,2024,6,324968.0,Stable Salary & Increasing Fixed Expenses,184448,66555.0,80426,146981.0,37467.0,20.31,0.05,Medium Risk
U214,2024,7,362435.0,Stable Salary & Increasing Fixed Expenses,184448,66555.0,100102,166657.0,17791.0,9.65,-0.05,High Risk
U214,2024,8,380226.0,Stable Salary & Increasing Fixed Expenses,184448,66555.0,88641,155196.0,29252.0,15.86,0.04,Medium Risk
U214,2024,9,409478.0,Stable Salary & Increasing Fixed Expenses,184448,66555.0,91354,157909.0,26539.0,14.39,0.04,High Risk
U214,2024,10,436017.0,Stable Salary & Increasing Fixed Expenses,184448,66555.0,120187,186742.0,-2294.0,-1.24,0.05,High Risk
U214,2024,11,433723.0,Stable Salary & Increasing Fixed Expenses,184448,67081.0,79526,146607.0,37841.0,20.52,-0.04,Medium Risk
U214,2024,12,471564.0,Stable Salary & Increasing Fixed Expenses,184448,67081.0,93023,160104.0,24344.0,13.2,-0.02,High Risk
U215,2024,1,219255.0,Salary Increases & Fixed Expenses Remain Stable,45964,10425.0,19896,30321.0,15643.0,34.03,-0.05,Low Risk
U215,2024,2,234898.0,Salary Increases & Fixed Expenses Remain Stable,45964,10425.0,21096,31521.0,14443.0,31.42,0.02,Low Risk
U215,2024,3,249341.0,Salary Increases & Fixed Expenses Remain Stable,45964,10425.0,28055,38480.0,7484.0,16.28,-0.02,Medium Risk
U215,2024,4,256825.0,Salary Increases & Fixed Expenses Remain Stable,45964,10425.0,22857,33282.0,12682.0,27.59,0.02,Low Risk
U215,2024,5,269507.0,Salary Increases & Fixed Expenses Remain Stable,45964,10425.0,18564,28989.0,16975.0,36.93,-0.05,Low Risk
U215,2024,6,286482.0,Salary Increases & Fixed Expenses Remain Stable,45964,10425.0,21021,31446.0,14518.0,31.59,0.0,Low Risk
U215,2024,7,301000.0,Salary Increases & Fixed Expenses Remain Stable,45964,10425.0,20268,30693.0,15271.0,33.22,-0.03,Low Risk
U215,2024,8,316271.0,Salary Increases & Fixed Expenses Remain Stable,75326,10425.0,44817,55242.0,20084.0,26.66,-0.05,Low Risk
U215,2024,9,336355.0,Salary Increases & Fixed Expenses Remain Stable,75326,10425.0,35640,46065.0,29261.0,38.85,0.03,Low Risk
U215,2024,10,365616.0,Salary Increases & Fixed Expenses Remain Stable,75326,10425.0,38258,48683.0,26643.0,35.37,-0.04,Low Risk
U215,2024,11,392259.0,Salary Increases & Fixed Expenses Remain Stable,75326,10425.0,38583,49008.0,26318.0,34.94,0.02,Low Risk
U215,2024,12,418577.0,Salary Increases & Fixed Expenses Remain Stable,75326,10425.0,34650,45075.0,30251.0,40.16,0.05,Low Risk
U216,2024,1,210110.0,Stable Salary & Stable Fixed Expenses,275444,89319.0,156263,245582.0,29862.0,10.84,-0.02,High Risk
U216,2024,2,239972.0,Stable Salary & Stable Fixed Expenses,275444,89319.0,165068,254387.0,21057.0,7.64,-0.04,High Risk
U216,2024,3,261029.0,Stable Salary & Stable Fixed Expenses,275444,89319.0,139729,229048.0,46396.0,16.84,0.05,Medium Risk
U216,2024,4,307425.0,Stable Salary & Stable Fixed Expenses,275444,89319.0,150164,239483.0,35961.0,13.06,-0.01,High Risk
U216,2024,5,343386.0,Stable Salary & Stable Fixed Expenses,275444,89319.0,119937,209256.0,66188.0,24.03,-0.01,Medium Risk
U216,2024,6,409574.0,Stable Salary & Stable Fixed Expenses,275444,89319.0,126637,215956.0,59488.0,21.6,0.03,Medium Risk
U216,2024,7,469062.0,Stable Salary & Stable Fixed Expenses,275444,89319.0,151541,240860.0,34584.0,12.56,0.04,High Risk
U216,2024,8,503646.0,Stable Salary & Stable Fixed Expenses,275444,89319.0,122102,211421.0,64023.0,23.24,0.0,Medium Risk
U216,2024,9,567669.0,Stable Salary & Stable Fixed Expenses,275444,89319.0,152985,242304.0,33140.0,12.03,0.01,High Risk
U216,2024,10,600809.0,Stable Salary & Stable Fixed Expenses,275444,89319.0,128451,217770.0,57674.0,20.94,-0.01,Medium Risk
U216,2024,11,658483.0,Stable Salary & Stable Fixed Expenses,275444,89319.0,116543,205862.0,69582.0,25.26,-0.02,Low Risk
U216,2024,12,728065.0,Stable Salary & Stable Fixed Expenses,275444,89319.0,163560,252879.0,22565.0,8.19,0.02,High Risk
U217,2024,1,235843.0,Salary Increases & Fixed Expenses Increase,107933,54623.0,84287,138910.0,-30977.0,-28.7,0.04,High Risk
U217,2024,2,204866.0,Salary Increases & Fixed Expenses Increase,107933,54623.0,64979,119602.0,-11669.0,-10.81,0.01,High Risk
U217,2024,3,193197.0,Salary Increases & Fixed Expenses Increase,107933,54623.0,92222,146845.0,-38912.0,-36.05,-0.02,High Risk
U217,2024,4,154285.0,Salary Increases & Fixed Expenses Increase,107933,54623.0,70666,125289.0,-17356.0,-16.08,0.04,High Risk
U217,2024,5,136929.0,Salary Increases & Fixed Expenses Increase,107933,54623.0,79300,133923.0,-25990.0,-24.08,0.03,High Risk
U217,2024,6,110939.0,Salary Increases & Fixed Expenses Increase,107933,55706.0,82971,138677.0,-30744.0,-28.48,0.02,High Risk
U217,2024,7,80195.0,Salary Increases & Fixed Expenses Increase,107933,55706.0,67117,122823.0,-14890.0,-13.8,-0.0,High Risk
U217,2024,8,65305.0,Salary Increases & Fixed Expenses Increase,132645,55706.0,90628,146334.0,-13689.0,-10.32,0.05,High Risk
U217,2024,9,51616.0,Salary Increases & Fixed Expenses Increase,132645,57392.0,87727,145119.0,-12474.0,-9.4,0.0,High Risk
U217,2024,10,39142.0,Salary Increases & Fixed Expenses Increase,132645,57392.0,120257,177649.0,-45004.0,-33.93,-0.01,High Risk
U217,2024,11,-5862.0,Salary Increases & Fixed Expenses Increase,132645,57392.0,85273,142665.0,-10020.0,-7.55,0.05,High Risk
U217,2024,12,-15882.0,Salary Increases & Fixed Expenses Increase,132645,57392.0,97725,155117.0,-22472.0,-16.94,-0.02,High Risk
U218,2024,1,207983.0,Stable Salary & Stable Fixed Expenses,48176,15095.0,22591,37686.0,10490.0,21.77,0.03,Medium Risk
U218,2024,2,218473.0,Stable Salary & Stable Fixed Expenses,48176,15095.0,19271,34366.0,13810.0,28.67,-0.02,Low Risk
U218,2024,3,232283.0,Stable Salary & Stable Fixed Expenses,48176,15095.0,36063,51158.0,-2982.0,-6.19,-0.0,High Risk
U218,2024,4,229301.0,Stable Salary & Stable Fixed Expenses,48176,15095.0,23880,38975.0,9201.0,19.1,-0.01,Medium Risk
U218,2024,5,238502.0,Stable Salary & Stable Fixed Expenses,48176,15095.0,24109,39204.0,8972.0,18.62,-0.03,Medium Risk
U218,2024,6,247474.0,Stable Salary & Stable Fixed Expenses,48176,15095.0,22114,37209.0,10967.0,22.76,0.03,Medium Risk
U218,2024,7,258441.0,Stable Salary & Stable Fixed Expenses,48176,15095.0,19885,34980.0,13196.0,27.39,0.05,Low Risk
U218,2024,8,271637.0,Stable Salary & Stable Fixed Expenses,48176,15095.0,22012,37107.0,11069.0,22.98,-0.05,Medium Risk
U218,2024,9,282706.0,Stable Salary & Stable Fixed Expenses,48176,15095.0,22080,37175.0,11001.0,22.84,0.0,Medium Risk
U218,2024,10,293707.0,Stable Salary & Stable Fixed Expenses,48176,15095.0,24077,39172.0,9004.0,18.69,0.05,Medium Risk
U218,2024,11,302711.0,Stable Salary & Stable Fixed Expenses,48176,15095.0,21593,36688.0,11488.0,23.85,-0.0,Medium Risk
U218,2024,12,314199.0,Stable Salary & Stable Fixed Expenses,48176,15095.0,20518,35613.0,12563.0,26.08,0.01,Low Risk
U219,2024,1,206029.0,Salary Increases & Fixed Expenses Increase,216839,66415.0,168260,234675.0,-17836.0,-8.23,-0.0,High Risk
U219,2024,2,188193.0,Salary Increases & Fixed Expenses Increase,216839,67723.0,167499,235222.0,-18383.0,-8.48,-0.01,High Risk
U219,2024,3,169810.0,Salary Increases & Fixed Expenses Increase,216839,67723.0,178449,246172.0,-29333.0,-13.53,0.05,High Risk
U219,2024,4,140477.0,Salary Increases & Fixed Expenses Increase,216839,67723.0,132268,199991.0,16848.0,7.77,0.04,High Risk
U219,2024,5,157325.0,Salary Increases & Fixed Expenses Increase,216839,67723.0,168133,235856.0,-19017.0,-8.77,-0.0,High Risk
U219,2024,6,138308.0,Salary Increases & Fixed Expenses Increase,216839,67723.0,144686,212409.0,4430.0,2.04,0.01,High Risk
U219,2024,7,142738.0,Salary Increases & Fixed Expenses Increase,228082,67723.0,164290,232013.0,-3931.0,-1.72,0.02,High Risk
U219,2024,8,138807.0,Salary Increases & Fixed Expenses Increase,228082,67723.0,180290,248013.0,-19931.0,-8.74,-0.01,High Risk
U219,2024,9,118876.0,Salary Increases & Fixed Expenses Increase,228082,67723.0,164097,231820.0,-3738.0,-1.64,0.04,High Risk
U219,2024,10,115138.0,Salary Increases & Fixed Expenses Increase,228082,67723.0,194555,262278.0,-34196.0,-14.99,-0.04,High Risk
U219,2024,11,80942.0,Salary Increases & Fixed Expenses Increase,228082,67723.0,152399,220122.0,7960.0,3.49,0.01,High Risk
U219,2024,12,88902.0,Salary Increases & Fixed Expenses Increase,228082,67723.0,195126,262849.0,-34767.0,-15.24,-0.05,High Risk
U220,2024,1,200004.0,Salary Increases & Fixed Expenses Increase,120944,66786.0,72626,139412.0,-18468.0,-15.27,0.02,High Risk
U220,2024,2,181536.0,Salary Increases & Fixed Expenses Increase,120944,68055.0,84817,152872.0,-31928.0,-26.4,-0.0,High Risk
U220,2024,3,149608.0,Salary Increases & Fixed Expenses Increase,120944,68055.0,107257,175312.0,-54368.0,-44.95,-0.02,High Risk
U220,2024,4,95240.0,Salary Increases & Fixed Expenses Increase,138029,68055.0,94742,162797.0,-24768.0,-17.94,-0.05,High Risk
U220,2024,5,70472.0,Salary Increases & Fixed Expenses Increase,138029,68055.0,102231,170286.0,-32257.0,-23.37,-0.02,High Risk
U220,2024,6,38215.0,Salary Increases & Fixed Expenses Increase,138029,69045.0,103161,172206.0,-34177.0,-24.76,0.03,High Risk
U220,2024,7,4038.0,Salary Increases & Fixed Expenses Increase,138029,69045.0,96456,165501.0,-27472.0,-19.9,0.05,High Risk
U220,2024,8,-23434.0,Salary Increases & Fixed Expenses Increase,138029,69045.0,102777,171822.0,-33793.0,-24.48,-0.04,High Risk
U220,2024,9,-57227.0,Salary Increases & Fixed Expenses Increase,138029,70246.0,89940,160186.0,-22157.0,-16.05,-0.04,High Risk
U220,2024,10,-79384.0,Salary Increases & Fixed Expenses Increase,138029,71787.0,127401,199188.0,-61159.0,-44.31,0.04,High Risk
U220,2024,11,-140543.0,Salary Increases & Fixed Expenses Increase,138029,71787.0,83807,155594.0,-17565.0,-12.73,-0.03,High Risk
U220,2024,12,-158108.0,Salary Increases & Fixed Expenses Increase,138029,71787.0,91506,163293.0,-25264.0,-18.3,-0.02,High Risk
U221,2024,1,226138.0,Salary Increases & Fixed Expenses Remain Stable,33418,15333.0,11483,26816.0,6602.0,19.76,-0.03,Medium Risk
U221,2024,2,232740.0,Salary Increases & Fixed Expenses Remain Stable,33418,15333.0,11370,26703.0,6715.0,20.09,-0.03,Medium Risk
U221,2024,3,239455.0,Salary Increases & Fixed Expenses Remain Stable,33418,15333.0,11370,26703.0,6715.0,20.09,0.05,Medium Risk
U221,2024,4,246170.0,Salary Increases & Fixed Expenses Remain Stable,33418,15333.0,10487,25820.0,7598.0,22.74,-0.03,Medium Risk
U221,2024,5,253768.0,Salary Increases & Fixed Expenses Remain Stable,33418,15333.0,13021,28354.0,5064.0,15.15,0.0,Medium Risk
U221,2024,6,258832.0,Salary Increases & Fixed Expenses Remain Stable,33418,15333.0,11298,26631.0,6787.0,20.31,-0.01,Medium Risk
U221,2024,7,265619.0,Salary Increases & Fixed Expenses Remain Stable,50748,15333.0,16812,32145.0,18603.0,36.66,0.02,Low Risk
U221,2024,8,284222.0,Salary Increases & Fixed Expenses Remain Stable,50748,15333.0,17906,33239.0,17509.0,34.5,-0.01,Low Risk
U221,2024,9,301731.0,Salary Increases & Fixed Expenses Remain Stable,50748,15333.0,17575,32908.0,17840.0,35.15,0.01,Low Risk
U221,2024,10,319571.0,Salary Increases & Fixed Expenses Remain Stable,50748,15333.0,19739,35072.0,15676.0,30.89,-0.05,Low Risk
U221,2024,11,335247.0,Salary Increases & Fixed Expenses Remain Stable,50748,15333.0,16234,31567.0,19181.0,37.8,-0.03,Low Risk
U221,2024,12,354428.0,Salary Increases & Fixed Expenses Remain Stable,50748,15333.0,20271,35604.0,15144.0,29.84,-0.0,Low Risk
U222,2024,1,200885.0,Stable Salary & Stable Fixed Expenses,294526,108304.0,112449,220753.0,73773.0,25.05,0.0,Low Risk
U222,2024,2,274658.0,Stable Salary & Stable Fixed Expenses,294526,108304.0,97248,205552.0,88974.0,30.21,0.01,Low Risk
U222,2024,3,363632.0,Stable Salary & Stable Fixed Expenses,294526,108304.0,109590,217894.0,76632.0,26.02,-0.04,Low Risk
U222,2024,4,440264.0,Stable Salary & Stable Fixed Expenses,294526,108304.0,102320,210624.0,83902.0,28.49,-0.01,Low Risk
U222,2024,5,524166.0,Stable Salary & Stable Fixed Expenses,294526,108304.0,93831,202135.0,92391.0,31.37,0.03,Low Risk
U222,2024,6,616557.0,Stable Salary & Stable Fixed Expenses,294526,108304.0,114161,222465.0,72061.0,24.47,0.0,Medium Risk
U222,2024,7,688618.0,Stable Salary & Stable Fixed Expenses,294526,108304.0,90100,198404.0,96122.0,32.64,-0.04,Low Risk
U222,2024,8,784740.0,Stable Salary & Stable Fixed Expenses,294526,108304.0,108438,216742.0,77784.0,26.41,-0.05,Low Risk
U222,2024,9,862524.0,Stable Salary & Stable Fixed Expenses,294526,108304.0,92202,200506.0,94020.0,31.92,-0.03,Low Risk
U222,2024,10,956544.0,Stable Salary & Stable Fixed Expenses,294526,108304.0,130545,238849.0,55677.0,18.9,-0.04,Medium Risk
U222,2024,11,1012221.0,Stable Salary & Stable Fixed Expenses,294526,108304.0,116812,225116.0,69410.0,23.57,-0.05,Medium Risk
U222,2024,12,1081631.0,Stable Salary & Stable Fixed Expenses,294526,108304.0,99708,208012.0,86514.0,29.37,-0.01,Low Risk
U223,2024,1,247877.0,Salary Increases & Fixed Expenses Decrease,46313,18270.0,28481,46751.0,-438.0,-0.95,-0.01,High Risk
U223,2024,2,247439.0,Salary Increases & Fixed Expenses Decrease,46313,18270.0,29533,47803.0,-1490.0,-3.22,0.02,High Risk
U223,2024,3,245949.0,Salary Increases & Fixed Expenses Decrease,57723,18270.0,53408,71678.0,-13955.0,-24.18,-0.02,High Risk
U223,2024,4,231994.0,Salary Increases & Fixed Expenses Decrease,57723,18270.0,35592,53862.0,3861.0,6.69,0.04,High Risk
U223,2024,5,235855.0,Salary Increases & Fixed Expenses Decrease,57723,18270.0,41069,59339.0,-1616.0,-2.8,0.03,High Risk
U223,2024,6,234239.0,Salary Increases & Fixed Expenses Decrease,57723,18270.0,42511,60781.0,-3058.0,-5.3,-0.01,High Risk
U223,2024,7,231181.0,Salary Increases & Fixed Expenses Decrease,57723,18270.0,40584,58854.0,-1131.0,-1.96,0.03,High Risk
U223,2024,8,230050.0,Salary Increases & Fixed Expenses Decrease,57723,18270.0,42681,60951.0,-3228.0,-5.59,-0.02,High Risk
U223,2024,9,226822.0,Salary Increases & Fixed Expenses Decrease,57723,18270.0,49433,67703.0,-9980.0,-17.29,0.0,High Risk
U223,2024,10,216842.0,Salary Increases & Fixed Expenses Decrease,57723,18270.0,53993,72263.0,-14540.0,-25.19,-0.03,High Risk
U223,2024,11,202302.0,Salary Increases & Fixed Expenses Decrease,57723,18270.0,39978,58248.0,-525.0,-0.91,-0.04,High Risk
U223,2024,12,201777.0,Salary Increases & Fixed Expenses Decrease,57723,18270.0,49859,68129.0,-10406.0,-18.03,0.04,High Risk
U224,2024,1,211729.0,Stable Salary & Stable Fixed Expenses,232613,66823.0,149097,215920.0,16693.0,7.18,0.04,High Risk
U224,2024,2,228422.0,Stable Salary & Stable Fixed Expenses,232613,66823.0,176050,242873.0,-10260.0,-4.41,0.05,High Risk
U224,2024,3,218162.0,Stable Salary & Stable Fixed Expenses,232613,66823.0,189242,256065.0,-23452.0,-10.08,-0.0,High Risk
U224,2024,4,194710.0,Stable Salary & Stable Fixed Expenses,232613,66823.0,184170,250993.0,-18380.0,-7.9,0.04,High Risk
U224,2024,5,176330.0,Stable Salary & Stable Fixed Expenses,232613,66823.0,174746,241569.0,-8956.0,-3.85,0.0,High Risk
U224,2024,6,167374.0,Stable Salary & Stable Fixed Expenses,232613,66823.0,139587,206410.0,26203.0,11.26,0.02,High Risk
U224,2024,7,193577.0,Stable Salary & Stable Fixed Expenses,232613,66823.0,171460,238283.0,-5670.0,-2.44,-0.02,High Risk
U224,2024,8,187907.0,Stable Salary & Stable Fixed Expenses,232613,66823.0,180949,247772.0,-15159.0,-6.52,-0.01,High Risk
U224,2024,9,172748.0,Stable Salary & Stable Fixed Expenses,232613,66823.0,149600,216423.0,16190.0,6.96,-0.01,High Risk
U224,2024,10,188938.0,Stable Salary & Stable Fixed Expenses,232613,66823.0,191603,258426.0,-25813.0,-11.1,0.02,High Risk
U224,2024,11,163125.0,Stable Salary & Stable Fixed Expenses,232613,66823.0,177421,244244.0,-11631.0,-5.0,0.02,High Risk
U224,2024,12,151494.0,Stable Salary & Stable Fixed Expenses,232613,66823.0,141082,207905.0,24708.0,10.62,-0.04,High Risk
U225,2024,1,236630.0,Stable Salary & Stable Fixed Expenses,281644,95812.0,102342,198154.0,83490.0,29.64,0.03,Low Risk
U225,2024,2,320120.0,Stable Salary & Stable Fixed Expenses,281644,95812.0,94069,189881.0,91763.0,32.58,-0.04,Low Risk
U225,2024,3,411883.0,Stable Salary & Stable Fixed Expenses,281644,95812.0,109214,205026.0,76618.0,27.2,-0.04,Low Risk
U225,2024,4,488501.0,Stable Salary & Stable Fixed Expenses,281644,95812.0,108649,204461.0,77183.0,27.4,0.0,Low Risk
U225,2024,5,565684.0,Stable Salary & Stable Fixed Expenses,281644,95812.0,101491,197303.0,84341.0,29.95,0.03,Low Risk
U225,2024,6,650025.0,Stable Salary & Stable Fixed Expenses,281644,95812.0,90044,185856.0,95788.0,34.01,0.02,Low Risk
U225,2024,7,745813.0,Stable Salary & Stable Fixed Expenses,281644,95812.0,98557,194369.0,87275.0,30.99,-0.02,Low Risk
U225,2024,8,833088.0,Stable Salary & Stable Fixed Expenses,281644,95812.0,106159,201971.0,79673.0,28.29,-0.0,Low Risk
U225,2024,9,912761.0,Stable Salary & Stable Fixed Expenses,281644,95812.0,108433,204245.0,77399.0,27.48,-0.04,Low Risk
U225,2024,10,990160.0,Stable Salary & Stable Fixed Expenses,281644,95812.0,94491,190303.0,91341.0,32.43,-0.01,Low Risk
U225,2024,11,1081501.0,Stable Salary & Stable Fixed Expenses,281644,95812.0,95957,191769.0,89875.0,31.91,0.01,Low Risk
U225,2024,12,1171376.0,Stable Salary & Stable Fixed Expenses,281644,95812.0,97130,192942.0,88702.0,31.49,0.01,Low Risk
U226,2024,1,204145.0,Stable Salary & Stable Fixed Expenses,158499,51730.0,89216,140946.0,17553.0,11.07,-0.04,High Risk
U226,2024,2,221698.0,Stable Salary & Stable Fixed Expenses,158499,51730.0,64321,116051.0,42448.0,26.78,0.02,Low Risk
U226,2024,3,264146.0,Stable Salary & Stable Fixed Expenses,158499,51730.0,82087,133817.0,24682.0,15.57,-0.01,Medium Risk
U226,2024,4,288828.0,Stable Salary & Stable Fixed Expenses,158499,51730.0,67299,119029.0,39470.0,24.9,0.01,Medium Risk
U226,2024,5,328298.0,Stable Salary & Stable Fixed Expenses,158499,51730.0,69378,121108.0,37391.0,23.59,-0.03,Medium Risk
U226,2024,6,365689.0,Stable Salary & Stable Fixed Expenses,158499,51730.0,92070,143800.0,14699.0,9.27,-0.0,High Risk
U226,2024,7,380388.0,Stable Salary & Stable Fixed Expenses,158499,51730.0,93654,145384.0,13115.0,8.27,-0.05,High Risk
U226,2024,8,393503.0,Stable Salary & Stable Fixed Expenses,158499,51730.0,65639,117369.0,41130.0,25.95,-0.04,Low Risk
U226,2024,9,434633.0,Stable Salary & Stable Fixed Expenses,158499,51730.0,79428,131158.0,27341.0,17.25,0.03,Medium Risk
U226,2024,10,461974.0,Stable Salary & Stable Fixed Expenses,158499,51730.0,83431,135161.0,23338.0,14.72,-0.01,High Risk
U226,2024,11,485312.0,Stable Salary & Stable Fixed Expenses,158499,51730.0,71445,123175.0,35324.0,22.29,-0.0,Medium Risk
U226,2024,12,520636.0,Stable Salary & Stable Fixed Expenses,158499,51730.0,89099,140829.0,17670.0,11.15,-0.03,High Risk
U227,2024,1,209565.0,Salary Increases & Fixed Expenses Remain Stable,222766,112549.0,98469,211018.0,11748.0,5.27,0.05,High Risk
U227,2024,2,221313.0,Salary Increases & Fixed Expenses Remain Stable,222766,112549.0,126476,239025.0,-16259.0,-7.3,0.01,High Risk
U227,2024,3,205054.0,Salary Increases & Fixed Expenses Remain Stable,222766,112549.0,161551,274100.0,-51334.0,-23.04,-0.0,High Risk
U227,2024,4,153720.0,Salary Increases & Fixed Expenses Remain Stable,222766,112549.0,118363,230912.0,-8146.0,-3.66,0.04,High Risk
U227,2024,5,145574.0,Salary Increases & Fixed Expenses Remain Stable,222766,112549.0,121097,233646.0,-10880.0,-4.88,-0.04,High Risk
U227,2024,6,134694.0,Salary Increases & Fixed Expenses Remain Stable,222766,112549.0,133583,246132.0,-23366.0,-10.49,0.02,High Risk
U227,2024,7,111328.0,Salary Increases & Fixed Expenses Remain Stable,245384,112549.0,135044,247593.0,-2209.0,-0.9,0.03,High Risk
U227,2024,8,109119.0,Salary Increases & Fixed Expenses Remain Stable,245384,112549.0,111680,224229.0,21155.0,8.62,0.04,High Risk
U227,2024,9,130274.0,Salary Increases & Fixed Expenses Remain Stable,245384,112549.0,127495,240044.0,5340.0,2.18,0.02,High Risk
U227,2024,10,135614.0,Salary Increases & Fixed Expenses Remain Stable,245384,112549.0,167475,280024.0,-34640.0,-14.12,-0.03,High Risk
U227,2024,11,100974.0,Salary Increases & Fixed Expenses Remain Stable,245384,112549.0,137865,250414.0,-5030.0,-2.05,-0.02,High Risk
U227,2024,12,95944.0,Salary Increases & Fixed Expenses Remain Stable,245384,112549.0,133663,246212.0,-828.0,-0.34,0.04,High Risk
U228,2024,1,208837.0,Stable Salary & Increasing Fixed Expenses,226512,83309.0,178789,262098.0,-35586.0,-15.71,-0.01,High Risk
U228,2024,2,173251.0,Stable Salary & Increasing Fixed Expenses,226512,83309.0,137449,220758.0,5754.0,2.54,0.05,High Risk
U228,2024,3,179005.0,Stable Salary & Increasing Fixed Expenses,226512,83309.0,188460,271769.0,-45257.0,-19.98,0.0,High Risk
U228,2024,4,133748.0,Stable Salary & Increasing Fixed Expenses,226512,83309.0,158648,241957.0,-15445.0,-6.82,-0.05,High Risk
U228,2024,5,118303.0,Stable Salary & Increasing Fixed Expenses,226512,83309.0,140289,223598.0,2914.0,1.29,0.04,High Risk
U228,2024,6,121217.0,Stable Salary & Increasing Fixed Expenses,226512,83309.0,169155,252464.0,-25952.0,-11.46,-0.01,High Risk
U228,2024,7,95265.0,Stable Salary & Increasing Fixed Expenses,226512,83309.0,149516,232825.0,-6313.0,-2.79,-0.01,High Risk
U228,2024,8,88952.0,Stable Salary & Increasing Fixed Expenses,226512,83309.0,138238,221547.0,4965.0,2.19,0.03,High Risk
U228,2024,9,93917.0,Stable Salary & Increasing Fixed Expenses,226512,83309.0,180098,263407.0,-36895.0,-16.29,-0.02,High Risk
U228,2024,10,57022.0,Stable Salary & Increasing Fixed Expenses,226512,83309.0,200555,283864.0,-57352.0,-25.32,-0.03,High Risk
U228,2024,11,-330.0,Stable Salary & Increasing Fixed Expenses,226512,83309.0,163457,246766.0,-20254.0,-8.94,-0.04,High Risk
U228,2024,12,-20584.0,Stable Salary & Increasing Fixed Expenses,226512,83309.0,159651,242960.0,-16448.0,-7.26,0.03,High Risk
U229,2024,1,216399.0,Salary Increases & Fixed Expenses Decrease,243999,77529.0,117090,194619.0,49380.0,20.24,-0.04,Medium Risk
U229,2024,2,265779.0,Salary Increases & Fixed Expenses Decrease,243999,77529.0,126022,203551.0,40448.0,16.58,0.01,Medium Risk
U229,2024,3,306227.0,Salary Increases & Fixed Expenses Decrease,243999,77529.0,168072,245601.0,-1602.0,-0.66,-0.04,High Risk
U229,2024,4,304625.0,Salary Increases & Fixed Expenses Decrease,252959,76141.0,110867,187008.0,65951.0,26.07,0.02,Low Risk
U229,2024,5,370576.0,Salary Increases & Fixed Expenses Decrease,252959,76141.0,103725,179866.0,73093.0,28.9,0.03,Low Risk
U229,2024,6,443669.0,Salary Increases & Fixed Expenses Decrease,252959,76141.0,120773,196914.0,56045.0,22.16,-0.04,Medium Risk
U229,2024,7,499714.0,Salary Increases & Fixed Expenses Decrease,252959,76141.0,126205,202346.0,50613.0,20.01,0.01,Medium Risk
U229,2024,8,550327.0,Salary Increases & Fixed Expenses Decrease,252959,76141.0,145297,221438.0,31521.0,12.46,-0.01,High Risk
U229,2024,9,581848.0,Salary Increases & Fixed Expenses Decrease,252959,76141.0,149245,225386.0,27573.0,10.9,-0.0,High Risk
U229,2024,10,609421.0,Salary Increases & Fixed Expenses Decrease,252959,76141.0,175409,251550.0,1409.0,0.56,-0.03,High Risk
U229,2024,11,610830.0,Salary Increases & Fixed Expenses Decrease,252959,76141.0,106529,182670.0,70289.0,27.79,0.01,Low Risk
U229,2024,12,681119.0,Salary Increases & Fixed Expenses Decrease,252959,76141.0,106903,183044.0,69915.0,27.64,0.03,Low Risk
U230,2024,1,206805.0,Salary Increases & Fixed Expenses Remain Stable,161808,51874.0,64694,116568.0,45240.0,27.96,-0.0,Low Risk
U230,2024,2,252045.0,Salary Increases & Fixed Expenses Remain Stable,161808,51874.0,57536,109410.0,52398.0,32.38,0.01,Low Risk
U230,2024,3,304443.0,Salary Increases & Fixed Expenses Remain Stable,161808,51874.0,60608,112482.0,49326.0,30.48,0.05,Low Risk
U230,2024,4,353769.0,Salary Increases & Fixed Expenses Remain Stable,161808,51874.0,64222,116096.0,45712.0,28.25,-0.04,Low Risk
U230,2024,5,399481.0,Salary Increases & Fixed Expenses Remain Stable,161808,51874.0,64086,115960.0,45848.0,28.33,0.03,Low Risk
U230,2024,6,445329.0,Salary Increases & Fixed Expenses Remain Stable,161808,51874.0,53203,105077.0,56731.0,35.06,-0.04,Low Risk
U230,2024,7,502060.0,Salary Increases & Fixed Expenses Remain Stable,188505,51874.0,65436,117310.0,71195.0,37.77,0.03,Low Risk
U230,2024,8,573255.0,Salary Increases & Fixed Expenses Remain Stable,188505,51874.0,65745,117619.0,70886.0,37.6,0.0,Low Risk
U230,2024,9,644141.0,Salary Increases & Fixed Expenses Remain Stable,188505,51874.0,60456,112330.0,76175.0,40.41,-0.01,Low Risk
U230,2024,10,720316.0,Salary Increases & Fixed Expenses Remain Stable,188505,51874.0,81085,132959.0,55546.0,29.47,-0.0,Low Risk
U230,2024,11,775862.0,Salary Increases & Fixed Expenses Remain Stable,188505,51874.0,67941,119815.0,68690.0,36.44,0.05,Low Risk
U230,2024,12,844552.0,Salary Increases & Fixed Expenses Remain Stable,188505,51874.0,62969,114843.0,73662.0,39.08,-0.0,Low Risk
U231,2024,1,228719.0,Stable Salary & Stable Fixed Expenses,38002,18418.0,15803,34221.0,3781.0,9.95,0.04,High Risk
U231,2024,2,232500.0,Stable Salary & Stable Fixed Expenses,38002,18418.0,16399,34817.0,3185.0,8.38,0.02,High Risk
U231,2024,3,235685.0,Stable Salary & Stable Fixed Expenses,38002,18418.0,15355,33773.0,4229.0,11.13,0.03,High Risk
U231,2024,4,239914.0,Stable Salary & Stable Fixed Expenses,38002,18418.0,21193,39611.0,-1609.0,-4.23,0.04,High Risk
U231,2024,5,238305.0,Stable Salary & Stable Fixed Expenses,38002,18418.0,22081,40499.0,-2497.0,-6.57,0.01,High Risk
U231,2024,6,235808.0,Stable Salary & Stable Fixed Expenses,38002,18418.0,20784,39202.0,-1200.0,-3.16,0.02,High Risk
U231,2024,7,234608.0,Stable Salary & Stable Fixed Expenses,38002,18418.0,21268,39686.0,-1684.0,-4.43,0.01,High Risk
U231,2024,8,232924.0,Stable Salary & Stable Fixed Expenses,38002,18418.0,19630,38048.0,-46.0,-0.12,-0.01,High Risk
U231,2024,9,232878.0,Stable Salary & Stable Fixed Expenses,38002,18418.0,18916,37334.0,668.0,1.76,-0.05,High Risk
U231,2024,10,233546.0,Stable Salary & Stable Fixed Expenses,38002,18418.0,21373,39791.0,-1789.0,-4.71,0.02,High Risk
U231,2024,11,231757.0,Stable Salary & Stable Fixed Expenses,38002,18418.0,19913,38331.0,-329.0,-0.87,-0.01,High Risk
U231,2024,12,231428.0,Stable Salary & Stable Fixed Expenses,38002,18418.0,17085,35503.0,2499.0,6.58,-0.01,High Risk
U232,2024,1,229087.0,Stable Salary & Stable Fixed Expenses,291063,80801.0,226998,307799.0,-16736.0,-5.75,-0.04,High Risk
U232,2024,2,212351.0,Stable Salary & Stable Fixed Expenses,291063,80801.0,199464,280265.0,10798.0,3.71,0.02,High Risk
U232,2024,3,223149.0,Stable Salary & Stable Fixed Expenses,291063,80801.0,209978,290779.0,284.0,0.1,-0.01,High Risk
U232,2024,4,223433.0,Stable Salary & Stable Fixed Expenses,291063,80801.0,182700,263501.0,27562.0,9.47,0.02,High Risk
U232,2024,5,250995.0,Stable Salary & Stable Fixed Expenses,291063,80801.0,198916,279717.0,11346.0,3.9,0.02,High Risk
U232,2024,6,262341.0,Stable Salary & Stable Fixed Expenses,291063,80801.0,198971,279772.0,11291.0,3.88,0.02,High Risk
U232,2024,7,273632.0,Stable Salary & Stable Fixed Expenses,291063,80801.0,187847,268648.0,22415.0,7.7,-0.05,High Risk
U232,2024,8,296047.0,Stable Salary & Stable Fixed Expenses,291063,80801.0,222453,303254.0,-12191.0,-4.19,0.0,High Risk
U232,2024,9,283856.0,Stable Salary & Stable Fixed Expenses,291063,80801.0,209686,290487.0,576.0,0.2,-0.0,High Risk
U232,2024,10,284432.0,Stable Salary & Stable Fixed Expenses,291063,80801.0,204844,285645.0,5418.0,1.86,-0.01,High Risk
U232,2024,11,289850.0,Stable Salary & Stable Fixed Expenses,291063,80801.0,219642,300443.0,-9380.0,-3.22,0.02,High Risk
U232,2024,12,280470.0,Stable Salary & Stable Fixed Expenses,291063,80801.0,182532,263333.0,27730.0,9.53,-0.02,High Risk
U233,2024,1,244731.0,Stable Salary & Increasing Fixed Expenses,190908,48885.0,73549,122434.0,68474.0,35.87,0.02,Low Risk
U233,2024,2,313205.0,Stable Salary & Increasing Fixed Expenses,190908,48885.0,68039,116924.0,73984.0,38.75,-0.03,Low Risk
U233,2024,3,387189.0,Stable Salary & Increasing Fixed Expenses,190908,49525.0,80484,130009.0,60899.0,31.9,0.02,Low Risk
U233,2024,4,448088.0,Stable Salary & Increasing Fixed Expenses,190908,49525.0,73793,123318.0,67590.0,35.4,-0.0,Low Risk
U233,2024,5,515678.0,Stable Salary & Increasing Fixed Expenses,190908,49525.0,64029,113554.0,77354.0,40.52,-0.01,Low Risk
U233,2024,6,593032.0,Stable Salary & Increasing Fixed Expenses,190908,49525.0,62141,111666.0,79242.0,41.51,-0.05,Low Risk
U233,2024,7,672274.0,Stable Salary & Increasing Fixed Expenses,190908,49525.0,60270,109795.0,81113.0,42.49,0.02,Low Risk
U233,2024,8,753387.0,Stable Salary & Increasing Fixed Expenses,190908,50428.0,64401,114829.0,76079.0,39.85,-0.0,Low Risk
U233,2024,9,829466.0,Stable Salary & Increasing Fixed Expenses,190908,50428.0,63525,113953.0,76955.0,40.31,0.04,Low Risk
U233,2024,10,906421.0,Stable Salary & Increasing Fixed Expenses,190908,50428.0,67437,117865.0,73043.0,38.26,0.01,Low Risk
U233,2024,11,979464.0,Stable Salary & Increasing Fixed Expenses,190908,51002.0,68511,119513.0,71395.0,37.4,0.05,Low Risk
U233,2024,12,1050859.0,Stable Salary & Increasing Fixed Expenses,190908,51002.0,72734,123736.0,67172.0,35.19,-0.01,Low Risk
U234,2024,1,224935.0,Stable Salary & Increasing Fixed Expenses,279830,67797.0,115524,183321.0,96509.0,34.49,-0.03,Low Risk
U234,2024,2,321444.0,Stable Salary & Increasing Fixed Expenses,279830,67797.0,152165,219962.0,59868.0,21.39,-0.02,Medium Risk
U234,2024,3,381312.0,Stable Salary & Increasing Fixed Expenses,279830,67797.0,169367,237164.0,42666.0,15.25,-0.02,Medium Risk
U234,2024,4,423978.0,Stable Salary & Increasing Fixed Expenses,279830,67797.0,163775,231572.0,48258.0,17.25,0.05,Medium Risk
U234,2024,5,472236.0,Stable Salary & Increasing Fixed Expenses,279830,67797.0,130711,198508.0,81322.0,29.06,0.04,Low Risk
U234,2024,6,553558.0,Stable Salary & Increasing Fixed Expenses,279830,67797.0,116444,184241.0,95589.0,34.16,-0.03,Low Risk
U234,2024,7,649147.0,Stable Salary & Increasing Fixed Expenses,279830,67797.0,136579,204376.0,75454.0,26.96,0.04,Low Risk
U234,2024,8,724601.0,Stable Salary & Increasing Fixed Expenses,279830,67797.0,116688,184485.0,95345.0,34.07,0.04,Low Risk
U234,2024,9,819946.0,Stable Salary & Increasing Fixed Expenses,279830,68762.0,127502,196264.0,83566.0,29.86,0.03,Low Risk
U234,2024,10,903512.0,Stable Salary & Increasing Fixed Expenses,279830,70558.0,172487,243045.0,36785.0,13.15,0.03,High Risk
U234,2024,11,940297.0,Stable Salary & Increasing Fixed Expenses,279830,70558.0,130452,201010.0,78820.0,28.17,0.04,Low Risk
U234,2024,12,1019117.0,Stable Salary & Increasing Fixed Expenses,279830,70558.0,121724,192282.0,87548.0,31.29,0.03,Low Risk
U235,2024,1,227052.0,Salary Increases & Fixed Expenses Remain Stable,293255,83339.0,144954,228293.0,64962.0,22.15,-0.01,Medium Risk
U235,2024,2,292014.0,Salary Increases & Fixed Expenses Remain Stable,293255,83339.0,150380,233719.0,59536.0,20.3,0.05,Medium Risk
U235,2024,3,351550.0,Salary Increases & Fixed Expenses Remain Stable,293255,83339.0,190365,273704.0,19551.0,6.67,-0.04,High Risk
U235,2024,4,371101.0,Salary Increases & Fixed Expenses Remain Stable,293255,83339.0,122083,205422.0,87833.0,29.95,0.05,Low Risk
U235,2024,5,458934.0,Salary Increases & Fixed Expenses Remain Stable,293255,83339.0,170899,254238.0,39017.0,13.3,0.01,High Risk
U235,2024,6,497951.0,Salary Increases & Fixed Expenses Remain Stable,293255,83339.0,150729,234068.0,59187.0,20.18,-0.01,Medium Risk
U235,2024,7,557138.0,Salary Increases & Fixed Expenses Remain Stable,303365,83339.0,122174,205513.0,97852.0,32.26,-0.04,Low Risk
U235,2024,8,654990.0,Salary Increases & Fixed Expenses Remain Stable,303365,83339.0,122827,206166.0,97199.0,32.04,-0.03,Low Risk
U235,2024,9,752189.0,Salary Increases & Fixed Expenses Remain Stable,303365,83339.0,159776,243115.0,60250.0,19.86,-0.02,Medium Risk
U235,2024,10,812439.0,Salary Increases & Fixed Expenses Remain Stable,303365,83339.0,220766,304105.0,-740.0,-0.24,-0.04,High Risk
U235,2024,11,811699.0,Salary Increases & Fixed Expenses Remain Stable,303365,83339.0,185251,268590.0,34775.0,11.46,-0.03,High Risk
U235,2024,12,846474.0,Salary Increases & Fixed Expenses Remain Stable,303365,83339.0,196049,279388.0,23977.0,7.9,0.04,High Risk
U236,2024,1,223764.0,Salary Increases & Fixed Expenses Remain Stable,41113,12356.0,13750,26106.0,15007.0,36.5,0.04,Low Risk
U236,2024,2,238771.0,Salary Increases & Fixed Expenses Remain Stable,41113,12356.0,14507,26863.0,14250.0,34.66,0.01,Low Risk
U236,2024,3,253021.0,Salary Increases & Fixed Expenses Remain Stable,41113,12356.0,18699,31055.0,10058.0,24.46,-0.0,Medium Risk
U236,2024,4,263079.0,Salary Increases & Fixed Expenses Remain Stable,41113,12356.0,12703,25059.0,16054.0,39.05,0.0,Low Risk
U236,2024,5,279133.0,Salary Increases & Fixed Expenses Remain Stable,46708,12356.0,15778,28134.0,18574.0,39.77,0.05,Low Risk
U236,2024,6,297707.0,Salary Increases & Fixed Expenses Remain Stable,46708,12356.0,14866,27222.0,19486.0,41.72,0.02,Low Risk
U236,2024,7,317193.0,Salary Increases & Fixed Expenses Remain Stable,46708,12356.0,18291,30647.0,16061.0,34.39,-0.01,Low Risk
U236,2024,8,333254.0,Salary Increases & Fixed Expenses Remain Stable,46708,12356.0,14930,27286.0,19422.0,41.58,-0.02,Low Risk
U236,2024,9,352676.0,Salary Increases & Fixed Expenses Remain Stable,46708,12356.0,15407,27763.0,18945.0,40.56,-0.01,Low Risk
U236,2024,10,371621.0,Salary Increases & Fixed Expenses Remain Stable,46708,12356.0,21058,33414.0,13294.0,28.46,0.05,Low Risk
U236,2024,11,384915.0,Salary Increases & Fixed Expenses Remain Stable,46708,12356.0,15876,28232.0,18476.0,39.56,-0.02,Low Risk
U236,2024,12,403391.0,Salary Increases & Fixed Expenses Remain Stable,46708,12356.0,16613,28969.0,17739.0,37.98,0.02,Low Risk
U237,2024,1,249353.0,Stable Salary & Decreasing Fixed Expenses,23828,18940.0,7254,26194.0,-2366.0,-9.93,-0.02,High Risk
U237,2024,2,246987.0,Stable Salary & Decreasing Fixed Expenses,23828,18940.0,8265,27205.0,-3377.0,-14.17,-0.02,High Risk
U237,2024,3,243610.0,Stable Salary & Decreasing Fixed Expenses,23828,18211.0,10389,28600.0,-4772.0,-20.03,-0.02,High Risk
U237,2024,4,238838.0,Stable Salary & Decreasing Fixed Expenses,23828,18211.0,7992,26203.0,-2375.0,-9.97,-0.04,High Risk
U237,2024,5,236463.0,Stable Salary & Decreasing Fixed Expenses,23828,18211.0,7722,25933.0,-2105.0,-8.83,-0.03,High Risk
U237,2024,6,234358.0,Stable Salary & Decreasing Fixed Expenses,23828,18211.0,7617,25828.0,-2000.0,-8.39,-0.01,High Risk
U237,2024,7,232358.0,Stable Salary & Decreasing Fixed Expenses,23828,18211.0,8643,26854.0,-3026.0,-12.7,-0.01,High Risk
U237,2024,8,229332.0,Stable Salary & Decreasing Fixed Expenses,23828,18211.0,9418,27629.0,-3801.0,-15.95,-0.04,High Risk
U237,2024,9,225531.0,Stable Salary & Decreasing Fixed Expenses,23828,18211.0,7358,25569.0,-1741.0,-7.31,0.03,High Risk
U237,2024,10,223790.0,Stable Salary & Decreasing Fixed Expenses,23828,18211.0,10537,28748.0,-4920.0,-20.65,0.03,High Risk
U237,2024,11,218870.0,Stable Salary & Decreasing Fixed Expenses,23828,18211.0,8937,27148.0,-3320.0,-13.93,-0.02,High Risk
U237,2024,12,215550.0,Stable Salary & Decreasing Fixed Expenses,23828,18211.0,9499,27710.0,-3882.0,-16.29,0.0,High Risk
U238,2024,1,219055.0,Stable Salary & Stable Fixed Expenses,201597,110045.0,97986,208031.0,-6434.0,-3.19,0.02,High Risk
U238,2024,2,212621.0,Stable Salary & Stable Fixed Expenses,201597,110045.0,93535,203580.0,-1983.0,-0.98,0.02,High Risk
U238,2024,3,210638.0,Stable Salary & Stable Fixed Expenses,201597,110045.0,118131,228176.0,-26579.0,-13.18,-0.01,High Risk
U238,2024,4,184059.0,Stable Salary & Stable Fixed Expenses,201597,110045.0,84316,194361.0,7236.0,3.59,-0.04,High Risk
U238,2024,5,191295.0,Stable Salary & Stable Fixed Expenses,201597,110045.0,96491,206536.0,-4939.0,-2.45,0.03,High Risk
U238,2024,6,186356.0,Stable Salary & Stable Fixed Expenses,201597,110045.0,94998,205043.0,-3446.0,-1.71,-0.01,High Risk
U238,2024,7,182910.0,Stable Salary & Stable Fixed Expenses,201597,110045.0,106079,216124.0,-14527.0,-7.21,-0.02,High Risk
U238,2024,8,168383.0,Stable Salary & Stable Fixed Expenses,201597,110045.0,101152,211197.0,-9600.0,-4.76,0.02,High Risk
U238,2024,9,158783.0,Stable Salary & Stable Fixed Expenses,201597,110045.0,84475,194520.0,7077.0,3.51,-0.01,High Risk
U238,2024,10,165860.0,Stable Salary & Stable Fixed Expenses,201597,110045.0,102073,212118.0,-10521.0,-5.22,0.05,High Risk
U238,2024,11,155339.0,Stable Salary & Stable Fixed Expenses,201597,110045.0,104661,214706.0,-13109.0,-6.5,-0.04,High Risk
U238,2024,12,142230.0,Stable Salary & Stable Fixed Expenses,201597,110045.0,118582,228627.0,-27030.0,-13.41,0.03,High Risk
U239,2024,1,220994.0,Salary Increases & Fixed Expenses Increase,55787,30212.0,28214,58426.0,-2639.0,-4.73,-0.03,High Risk
U239,2024,2,218355.0,Salary Increases & Fixed Expenses Increase,55787,30212.0,23590,53802.0,1985.0,3.56,-0.01,High Risk
U239,2024,3,220340.0,Salary Increases & Fixed Expenses Increase,55787,31497.0,34338,65835.0,-10048.0,-18.01,-0.05,High Risk
U239,2024,4,210292.0,Salary Increases & Fixed Expenses Increase,55787,31497.0,26740,58237.0,-2450.0,-4.39,0.04,High Risk
U239,2024,5,207842.0,Salary Increases & Fixed Expenses Increase,55787,32545.0,28572,61117.0,-5330.0,-9.55,0.02,High Risk
U239,2024,6,202512.0,Salary Increases & Fixed Expenses Increase,55787,32545.0,27632,60177.0,-4390.0,-7.87,0.03,High Risk
U239,2024,7,198122.0,Salary Increases & Fixed Expenses Increase,83636,32545.0,49116,81661.0,1975.0,2.36,-0.0,High Risk
U239,2024,8,200097.0,Salary Increases & Fixed Expenses Increase,83636,33579.0,38778,72357.0,11279.0,13.49,-0.0,High Risk
U239,2024,9,211376.0,Salary Increases & Fixed Expenses Increase,83636,33579.0,39666,73245.0,10391.0,12.42,0.01,High Risk
U239,2024,10,221767.0,Salary Increases & Fixed Expenses Increase,83636,33579.0,56672,90251.0,-6615.0,-7.91,-0.05,High Risk
U239,2024,11,215152.0,Salary Increases & Fixed Expenses Increase,83636,33579.0,49453,83032.0,604.0,0.72,0.02,High Risk
U239,2024,12,215756.0,Salary Increases & Fixed Expenses Increase,83636,33579.0,61425,95004.0,-11368.0,-13.59,0.03,High Risk
U240,2024,1,245886.0,Salary Increases & Fixed Expenses Remain Stable,31647,21290.0,23480,44770.0,-13123.0,-41.47,0.02,High Risk
U240,2024,2,232763.0,Salary Increases & Fixed Expenses Remain Stable,31647,21290.0,24598,45888.0,-14241.0,-45.0,0.04,High Risk
U240,2024,3,218522.0,Salary Increases & Fixed Expenses Remain Stable,40262,21290.0,33186,54476.0,-14214.0,-35.3,-0.03,High Risk
U240,2024,4,204308.0,Salary Increases & Fixed Expenses Remain Stable,40262,21290.0,31757,53047.0,-12785.0,-31.75,0.01,High Risk
U240,2024,5,191523.0,Salary Increases & Fixed Expenses Remain Stable,40262,21290.0,32024,53314.0,-13052.0,-32.42,-0.0,High Risk
U240,2024,6,178471.0,Salary Increases & Fixed Expenses Remain Stable,40262,21290.0,26931,48221.0,-7959.0,-19.77,0.01,High Risk
U240,2024,7,170512.0,Salary Increases & Fixed Expenses Remain Stable,40262,21290.0,24751,46041.0,-5779.0,-14.35,-0.02,High Risk
U240,2024,8,164733.0,Salary Increases & Fixed Expenses Remain Stable,40262,21290.0,29900,51190.0,-10928.0,-27.14,-0.02,High Risk
U240,2024,9,153805.0,Salary Increases & Fixed Expenses Remain Stable,40262,21290.0,24903,46193.0,-5931.0,-14.73,0.05,High Risk
U240,2024,10,147874.0,Salary Increases & Fixed Expenses Remain Stable,40262,21290.0,34240,55530.0,-15268.0,-37.92,0.03,High Risk
U240,2024,11,132606.0,Salary Increases & Fixed Expenses Remain Stable,40262,21290.0,25300,46590.0,-6328.0,-15.72,-0.01,High Risk
U240,2024,12,126278.0,Salary Increases & Fixed Expenses Remain Stable,40262,21290.0,31360,52650.0,-12388.0,-30.77,-0.01,High Risk
U241,2024,1,245984.0,Stable Salary & Stable Fixed Expenses,240066,107288.0,104931,212219.0,27847.0,11.6,-0.05,High Risk
U241,2024,2,273831.0,Stable Salary & Stable Fixed Expenses,240066,107288.0,98653,205941.0,34125.0,14.21,-0.03,High Risk
U241,2024,3,307956.0,Stable Salary & Stable Fixed Expenses,240066,107288.0,182417,289705.0,-49639.0,-20.68,-0.02,High Risk
U241,2024,4,258317.0,Stable Salary & Stable Fixed Expenses,240066,107288.0,121316,228604.0,11462.0,4.77,-0.01,High Risk
U241,2024,5,269779.0,Stable Salary & Stable Fixed Expenses,240066,107288.0,114760,222048.0,18018.0,7.51,0.03,High Risk
U241,2024,6,287797.0,Stable Salary & Stable Fixed Expenses,240066,107288.0,118105,225393.0,14673.0,6.11,-0.04,High Risk
U241,2024,7,302470.0,Stable Salary & Stable Fixed Expenses,240066,107288.0,125147,232435.0,7631.0,3.18,-0.01,High Risk
U241,2024,8,310101.0,Stable Salary & Stable Fixed Expenses,240066,107288.0,118149,225437.0,14629.0,6.09,0.03,High Risk
U241,2024,9,324730.0,Stable Salary & Stable Fixed Expenses,240066,107288.0,137385,244673.0,-4607.0,-1.92,-0.02,High Risk
U241,2024,10,320123.0,Stable Salary & Stable Fixed Expenses,240066,107288.0,117661,224949.0,15117.0,6.3,0.01,High Risk
U241,2024,11,335240.0,Stable Salary & Stable Fixed Expenses,240066,107288.0,152033,259321.0,-19255.0,-8.02,-0.04,High Risk
U241,2024,12,315985.0,Stable Salary & Stable Fixed Expenses,240066,107288.0,162908,270196.0,-30130.0,-12.55,0.03,High Risk
U242,2024,1,215723.0,Salary Increases & Fixed Expenses Increase,150930,56023.0,88069,144092.0,6838.0,4.53,-0.05,High Risk
U242,2024,2,222561.0,Salary Increases & Fixed Expenses Increase,150930,56023.0,82203,138226.0,12704.0,8.42,-0.03,High Risk
U242,2024,3,235265.0,Salary Increases & Fixed Expenses Increase,150930,56023.0,73680,129703.0,21227.0,14.06,0.03,High Risk
U242,2024,4,256492.0,Salary Increases & Fixed Expenses Increase,150930,56023.0,61512,117535.0,33395.0,22.13,-0.04,Medium Risk
U242,2024,5,289887.0,Salary Increases & Fixed Expenses Increase,150930,57839.0,83832,141671.0,9259.0,6.13,0.02,High Risk
U242,2024,6,299146.0,Salary Increases & Fixed Expenses Increase,150930,57839.0,79513,137352.0,13578.0,9.0,-0.04,High Risk
U242,2024,7,312724.0,Salary Increases & Fixed Expenses Increase,180615,57839.0,108188,166027.0,14588.0,8.08,0.04,High Risk
U242,2024,8,327312.0,Salary Increases & Fixed Expenses Increase,180615,59834.0,95843,155677.0,24938.0,13.81,-0.03,High Risk
U242,2024,9,352250.0,Salary Increases & Fixed Expenses Increase,180615,59834.0,98622,158456.0,22159.0,12.27,0.04,High Risk
U242,2024,10,374409.0,Salary Increases & Fixed Expenses Increase,180615,59834.0,97115,156949.0,23666.0,13.1,0.02,High Risk
U242,2024,11,398075.0,Salary Increases & Fixed Expenses Increase,180615,59834.0,101069,160903.0,19712.0,10.91,0.02,High Risk
U242,2024,12,417787.0,Salary Increases & Fixed Expenses Increase,180615,59834.0,103205,163039.0,17576.0,9.73,-0.01,High Risk
U243,2024,1,222792.0,Salary Increases & Fixed Expenses Increase,123062,63895.0,42041,105936.0,17126.0,13.92,0.0,High Risk
U243,2024,2,239918.0,Salary Increases & Fixed Expenses Increase,123062,63895.0,44347,108242.0,14820.0,12.04,-0.01,High Risk
U243,2024,3,254738.0,Salary Increases & Fixed Expenses Increase,123062,64955.0,57209,122164.0,898.0,0.73,0.02,High Risk
U243,2024,4,255636.0,Salary Increases & Fixed Expenses Increase,123062,64955.0,42340,107295.0,15767.0,12.81,0.0,High Risk
U243,2024,5,271403.0,Salary Increases & Fixed Expenses Increase,133349,64955.0,41999,106954.0,26395.0,19.79,0.03,Medium Risk
U243,2024,6,297798.0,Salary Increases & Fixed Expenses Increase,133349,64955.0,41192,106147.0,27202.0,20.4,0.04,Medium Risk
U243,2024,7,325000.0,Salary Increases & Fixed Expenses Increase,133349,64955.0,42650,107605.0,25744.0,19.31,-0.04,Medium Risk
U243,2024,8,350744.0,Salary Increases & Fixed Expenses Increase,133349,64955.0,47257,112212.0,21137.0,15.85,0.02,Medium Risk
U243,2024,9,371881.0,Salary Increases & Fixed Expenses Increase,133349,66248.0,53904,120152.0,13197.0,9.9,-0.05,High Risk
U243,2024,10,385078.0,Salary Increases & Fixed Expenses Increase,133349,67992.0,48312,116304.0,17045.0,12.78,-0.02,High Risk
U243,2024,11,402123.0,Salary Increases & Fixed Expenses Increase,133349,67992.0,45914,113906.0,19443.0,14.58,-0.04,High Risk
U243,2024,12,421566.0,Salary Increases & Fixed Expenses Increase,133349,67992.0,52477,120469.0,12880.0,9.66,-0.03,High Risk
U244,2024,1,208516.0,Stable Salary & Stable Fixed Expenses,262689,60739.0,143755,204494.0,58195.0,22.15,0.01,Medium Risk
U244,2024,2,266711.0,Stable Salary & Stable Fixed Expenses,262689,60739.0,134864,195603.0,67086.0,25.54,-0.04,Low Risk
U244,2024,3,333797.0,Stable Salary & Stable Fixed Expenses,262689,60739.0,174002,234741.0,27948.0,10.64,-0.04,High Risk
U244,2024,4,361745.0,Stable Salary & Stable Fixed Expenses,262689,60739.0,146493,207232.0,55457.0,21.11,-0.02,Medium Risk
U244,2024,5,417202.0,Stable Salary & Stable Fixed Expenses,262689,60739.0,153217,213956.0,48733.0,18.55,0.03,Medium Risk
U244,2024,6,465935.0,Stable Salary & Stable Fixed Expenses,262689,60739.0,137380,198119.0,64570.0,24.58,-0.02,Medium Risk
U244,2024,7,530505.0,Stable Salary & Stable Fixed Expenses,262689,60739.0,136773,197512.0,65177.0,24.81,-0.02,Medium Risk
U244,2024,8,595682.0,Stable Salary & Stable Fixed Expenses,262689,60739.0,130901,191640.0,71049.0,27.05,0.05,Low Risk
U244,2024,9,666731.0,Stable Salary & Stable Fixed Expenses,262689,60739.0,139292,200031.0,62658.0,23.85,-0.04,Medium Risk
U244,2024,10,729389.0,Stable Salary & Stable Fixed Expenses,262689,60739.0,140415,201154.0,61535.0,23.43,-0.03,Medium Risk
U244,2024,11,790924.0,Stable Salary & Stable Fixed Expenses,262689,60739.0,109405,170144.0,92545.0,35.23,0.04,Low Risk
U244,2024,12,883469.0,Stable Salary & Stable Fixed Expenses,262689,60739.0,134607,195346.0,67343.0,25.64,0.0,Low Risk
U245,2024,1,223787.0,Salary Increases & Fixed Expenses Increase,46382,16091.0,23667,39758.0,6624.0,14.28,-0.02,High Risk
U245,2024,2,230411.0,Salary Increases & Fixed Expenses Increase,46382,17890.0,24595,42485.0,3897.0,8.4,0.01,High Risk
U245,2024,3,234308.0,Salary Increases & Fixed Expenses Increase,46382,17890.0,27795,45685.0,697.0,1.5,-0.01,High Risk
U245,2024,4,235005.0,Salary Increases & Fixed Expenses Increase,46382,17890.0,27037,44927.0,1455.0,3.14,0.04,High Risk
U245,2024,5,236460.0,Salary Increases & Fixed Expenses Increase,63994,17890.0,37712,55602.0,8392.0,13.11,-0.02,High Risk
U245,2024,6,244852.0,Salary Increases & Fixed Expenses Increase,63994,17890.0,32314,50204.0,13790.0,21.55,0.05,Medium Risk
U245,2024,7,258642.0,Salary Increases & Fixed Expenses Increase,63994,17890.0,33794,51684.0,12310.0,19.24,-0.03,Medium Risk
U245,2024,8,270952.0,Salary Increases & Fixed Expenses Increase,63994,17890.0,36067,53957.0,10037.0,15.68,-0.0,Medium Risk
U245,2024,9,280989.0,Salary Increases & Fixed Expenses Increase,63994,17890.0,31263,49153.0,14841.0,23.19,0.05,Medium Risk
U245,2024,10,295830.0,Salary Increases & Fixed Expenses Increase,63994,17890.0,34409,52299.0,11695.0,18.28,0.04,Medium Risk
U245,2024,11,307525.0,Salary Increases & Fixed Expenses Increase,63994,17890.0,34688,52578.0,11416.0,17.84,0.05,Medium Risk
U245,2024,12,318941.0,Salary Increases & Fixed Expenses Increase,63994,18402.0,32446,50848.0,13146.0,20.54,-0.05,Medium Risk
U246,2024,1,225597.0,Stable Salary & Stable Fixed Expenses,208795,106919.0,125273,232192.0,-23397.0,-11.21,0.02,High Risk
U246,2024,2,202200.0,Stable Salary & Stable Fixed Expenses,208795,106919.0,94456,201375.0,7420.0,3.55,-0.05,High Risk
U246,2024,3,209620.0,Stable Salary & Stable Fixed Expenses,208795,106919.0,108688,215607.0,-6812.0,-3.26,-0.05,High Risk
U246,2024,4,202808.0,Stable Salary & Stable Fixed Expenses,208795,106919.0,114211,221130.0,-12335.0,-5.91,-0.01,High Risk
U246,2024,5,190473.0,Stable Salary & Stable Fixed Expenses,208795,106919.0,91383,198302.0,10493.0,5.03,-0.0,High Risk
U246,2024,6,200966.0,Stable Salary & Stable Fixed Expenses,208795,106919.0,115532,222451.0,-13656.0,-6.54,0.01,High Risk
U246,2024,7,187310.0,Stable Salary & Stable Fixed Expenses,208795,106919.0,107484,214403.0,-5608.0,-2.69,-0.02,High Risk
U246,2024,8,181702.0,Stable Salary & Stable Fixed Expenses,208795,106919.0,107817,214736.0,-5941.0,-2.85,0.05,High Risk
U246,2024,9,175761.0,Stable Salary & Stable Fixed Expenses,208795,106919.0,106791,213710.0,-4915.0,-2.35,-0.03,High Risk
U246,2024,10,170846.0,Stable Salary & Stable Fixed Expenses,208795,106919.0,133057,239976.0,-31181.0,-14.93,-0.04,High Risk
U246,2024,11,139665.0,Stable Salary & Stable Fixed Expenses,208795,106919.0,124004,230923.0,-22128.0,-10.6,0.04,High Risk
U246,2024,12,117537.0,Stable Salary & Stable Fixed Expenses,208795,106919.0,120988,227907.0,-19112.0,-9.15,-0.05,High Risk
U247,2024,1,240851.0,Salary Increases & Fixed Expenses Remain Stable,186653,76983.0,69919,146902.0,39751.0,21.3,-0.03,Medium Risk
U247,2024,2,280602.0,Salary Increases & Fixed Expenses Remain Stable,186653,76983.0,58970,135953.0,50700.0,27.16,0.04,Low Risk
U247,2024,3,331302.0,Salary Increases & Fixed Expenses Remain Stable,186653,76983.0,74590,151573.0,35080.0,18.79,0.02,Medium Risk
U247,2024,4,366382.0,Salary Increases & Fixed Expenses Remain Stable,186653,76983.0,60142,137125.0,49528.0,26.53,-0.01,Low Risk
U247,2024,5,415910.0,Salary Increases & Fixed Expenses Remain Stable,186653,76983.0,67443,144426.0,42227.0,22.62,0.03,Medium Risk
U247,2024,6,458137.0,Salary Increases & Fixed Expenses Remain Stable,186653,76983.0,63150,140133.0,46520.0,24.92,-0.05,Medium Risk
U247,2024,7,504657.0,Salary Increases & Fixed Expenses Remain Stable,186653,76983.0,64752,141735.0,44918.0,24.06,0.03,Medium Risk
U247,2024,8,549575.0,Salary Increases & Fixed Expenses Remain Stable,202770,76983.0,71098,148081.0,54689.0,26.97,-0.05,Low Risk
U247,2024,9,604264.0,Salary Increases & Fixed Expenses Remain Stable,202770,76983.0,75746,152729.0,50041.0,24.68,-0.03,Medium Risk
U247,2024,10,654305.0,Salary Increases & Fixed Expenses Remain Stable,202770,76983.0,63698,140681.0,62089.0,30.62,0.03,Low Risk
U247,2024,11,716394.0,Salary Increases & Fixed Expenses Remain Stable,202770,76983.0,72208,149191.0,53579.0,26.42,-0.05,Low Risk
U247,2024,12,769973.0,Salary Increases & Fixed Expenses Remain Stable,202770,76983.0,73739,150722.0,52048.0,25.67,0.02,Low Risk
U248,2024,1,239704.0,Salary Increases & Fixed Expenses Increase,129190,57399.0,62281,119680.0,9510.0,7.36,0.01,High Risk
U248,2024,2,249214.0,Salary Increases & Fixed Expenses Increase,129190,58799.0,76440,135239.0,-6049.0,-4.68,0.01,High Risk
U248,2024,3,243165.0,Salary Increases & Fixed Expenses Increase,129190,58799.0,83617,142416.0,-13226.0,-10.24,-0.03,High Risk
U248,2024,4,229939.0,Salary Increases & Fixed Expenses Increase,129190,58799.0,72791,131590.0,-2400.0,-1.86,-0.05,High Risk
U248,2024,5,227539.0,Salary Increases & Fixed Expenses Increase,150751,60075.0,81743,141818.0,8933.0,5.93,0.02,High Risk
U248,2024,6,236472.0,Salary Increases & Fixed Expenses Increase,150751,60075.0,75381,135456.0,15295.0,10.15,-0.0,High Risk
U248,2024,7,251767.0,Salary Increases & Fixed Expenses Increase,150751,60592.0,80003,140595.0,10156.0,6.74,-0.01,High Risk
U248,2024,8,261923.0,Salary Increases & Fixed Expenses Increase,150751,60592.0,66373,126965.0,23786.0,15.78,0.03,Medium Risk
U248,2024,9,285709.0,Salary Increases & Fixed Expenses Increase,150751,60592.0,62362,122954.0,27797.0,18.44,0.0,Medium Risk
U248,2024,10,313506.0,Salary Increases & Fixed Expenses Increase,150751,60592.0,94947,155539.0,-4788.0,-3.18,-0.04,High Risk
U248,2024,11,308718.0,Salary Increases & Fixed Expenses Increase,150751,60592.0,60927,121519.0,29232.0,19.39,-0.02,Medium Risk
U248,2024,12,337950.0,Salary Increases & Fixed Expenses Increase,150751,60592.0,71643,132235.0,18516.0,12.28,-0.03,High Risk
U249,2024,1,233381.0,Salary Increases & Fixed Expenses Increase,46579,15588.0,17767,33355.0,13224.0,28.39,0.0,Low Risk
U249,2024,2,246605.0,Salary Increases & Fixed Expenses Increase,46579,15588.0,16165,31753.0,14826.0,31.83,0.02,Low Risk
U249,2024,3,261431.0,Salary Increases & Fixed Expenses Increase,46579,15588.0,22526,38114.0,8465.0,18.17,0.0,Medium Risk
U249,2024,4,269896.0,Salary Increases & Fixed Expenses Increase,46579,15588.0,14161,29749.0,16830.0,36.13,-0.03,Low Risk
U249,2024,5,286726.0,Salary Increases & Fixed Expenses Increase,46579,15588.0,14578,30166.0,16413.0,35.24,0.0,Low Risk
U249,2024,6,303139.0,Salary Increases & Fixed Expenses Increase,62713,15588.0,24748,40336.0,22377.0,35.68,0.02,Low Risk
U249,2024,7,325516.0,Salary Increases & Fixed Expenses Increase,62713,15588.0,19742,35330.0,27383.0,43.66,-0.05,Low Risk
U249,2024,8,352899.0,Salary Increases & Fixed Expenses Increase,62713,15588.0,21886,37474.0,25239.0,40.25,-0.0,Low Risk
U249,2024,9,378138.0,Salary Increases & Fixed Expenses Increase,62713,15588.0,21697,37285.0,25428.0,40.55,-0.03,Low Risk
U249,2024,10,403566.0,Salary Increases & Fixed Expenses Increase,62713,16944.0,23352,40296.0,22417.0,35.75,0.04,Low Risk
U249,2024,11,425983.0,Salary Increases & Fixed Expenses Increase,62713,16944.0,18943,35887.0,26826.0,42.78,0.01,Low Risk
U249,2024,12,452809.0,Salary Increases & Fixed Expenses Increase,62713,16944.0,23842,40786.0,21927.0,34.96,0.04,Low Risk
U250,2024,1,227635.0,Salary Increases & Fixed Expenses Remain Stable,116688,74973.0,65970,140943.0,-24255.0,-20.79,0.02,High Risk
U250,2024,2,203380.0,Salary Increases & Fixed Expenses Remain Stable,116688,74973.0,66578,141551.0,-24863.0,-21.31,-0.01,High Risk
U250,2024,3,178517.0,Salary Increases & Fixed Expenses Remain Stable,116688,74973.0,73091,148064.0,-31376.0,-26.89,-0.04,High Risk
U250,2024,4,147141.0,Salary Increases & Fixed Expenses Remain Stable,116688,74973.0,57772,132745.0,-16057.0,-13.76,-0.04,High Risk
U250,2024,5,131084.0,Salary Increases & Fixed Expenses Remain Stable,122394,74973.0,58634,133607.0,-11213.0,-9.16,-0.03,High Risk
U250,2024,6,119871.0,Salary Increases & Fixed Expenses Remain Stable,122394,74973.0,50443,125416.0,-3022.0,-2.47,-0.01,High Risk
U250,2024,7,116849.0,Salary Increases & Fixed Expenses Remain Stable,122394,74973.0,61036,136009.0,-13615.0,-11.12,0.01,High Risk
U250,2024,8,103234.0,Salary Increases & Fixed Expenses Remain Stable,122394,74973.0,65672,140645.0,-18251.0,-14.91,0.03,High Risk
U250,2024,9,84983.0,Salary Increases & Fixed Expenses Remain Stable,122394,74973.0,60763,135736.0,-13342.0,-10.9,0.04,High Risk
U250,2024,10,71641.0,Salary Increases & Fixed Expenses Remain Stable,122394,74973.0,68697,143670.0,-21276.0,-17.38,-0.05,High Risk
U250,2024,11,50365.0,Salary Increases & Fixed Expenses Remain Stable,122394,74973.0,57411,132384.0,-9990.0,-8.16,0.04,High Risk
U250,2024,12,40375.0,Salary Increases & Fixed Expenses Remain Stable,122394,74973.0,70057,145030.0,-22636.0,-18.49,-0.02,High Risk
U251,2024,1,242900.0,Stable Salary & Stable Fixed Expenses,197576,64508.0,142122,206630.0,-9054.0,-4.58,0.01,High Risk
U251,2024,2,233846.0,Stable Salary & Stable Fixed Expenses,197576,64508.0,135773,200281.0,-2705.0,-1.37,0.04,High Risk
U251,2024,3,231141.0,Stable Salary & Stable Fixed Expenses,197576,64508.0,119065,183573.0,14003.0,7.09,-0.01,High Risk
U251,2024,4,245144.0,Stable Salary & Stable Fixed Expenses,197576,64508.0,138110,202618.0,-5042.0,-2.55,0.01,High Risk
U251,2024,5,240102.0,Stable Salary & Stable Fixed Expenses,197576,64508.0,150638,215146.0,-17570.0,-8.89,-0.01,High Risk
U251,2024,6,222532.0,Stable Salary & Stable Fixed Expenses,197576,64508.0,141685,206193.0,-8617.0,-4.36,-0.02,High Risk
U251,2024,7,213915.0,Stable Salary & Stable Fixed Expenses,197576,64508.0,134609,199117.0,-1541.0,-0.78,-0.0,High Risk
U251,2024,8,212374.0,Stable Salary & Stable Fixed Expenses,197576,64508.0,156052,220560.0,-22984.0,-11.63,0.02,High Risk
U251,2024,9,189390.0,Stable Salary & Stable Fixed Expenses,197576,64508.0,131238,195746.0,1830.0,0.93,-0.04,High Risk
U251,2024,10,191220.0,Stable Salary & Stable Fixed Expenses,197576,64508.0,123480,187988.0,9588.0,4.85,0.0,High Risk
U251,2024,11,200808.0,Stable Salary & Stable Fixed Expenses,197576,64508.0,138533,203041.0,-5465.0,-2.77,0.04,High Risk
U251,2024,12,195343.0,Stable Salary & Stable Fixed Expenses,197576,64508.0,123018,187526.0,10050.0,5.09,0.01,High Risk
U252,2024,1,242919.0,Salary Increases & Fixed Expenses Remain Stable,192938,46422.0,117465,163887.0,29051.0,15.06,-0.02,Medium Risk
U252,2024,2,271970.0,Salary Increases & Fixed Expenses Remain Stable,192938,46422.0,143559,189981.0,2957.0,1.53,0.03,High Risk
U252,2024,3,274927.0,Salary Increases & Fixed Expenses Remain Stable,192938,46422.0,145355,191777.0,1161.0,0.6,0.02,High Risk
U252,2024,4,276088.0,Salary Increases & Fixed Expenses Remain Stable,192938,46422.0,135851,182273.0,10665.0,5.53,-0.01,High Risk
U252,2024,5,286753.0,Salary Increases & Fixed Expenses Remain Stable,192938,46422.0,120140,166562.0,26376.0,13.67,-0.01,High Risk
U252,2024,6,313129.0,Salary Increases & Fixed Expenses Remain Stable,199284,46422.0,137524,183946.0,15338.0,7.7,0.02,High Risk
U252,2024,7,328467.0,Salary Increases & Fixed Expenses Remain Stable,199284,46422.0,149139,195561.0,3723.0,1.87,0.05,High Risk
U252,2024,8,332190.0,Salary Increases & Fixed Expenses Remain Stable,199284,46422.0,133279,179701.0,19583.0,9.83,0.03,High Risk
U252,2024,9,351773.0,Salary Increases & Fixed Expenses Remain Stable,199284,46422.0,123832,170254.0,29030.0,14.57,-0.04,High Risk
U252,2024,10,380803.0,Salary Increases & Fixed Expenses Remain Stable,199284,46422.0,130675,177097.0,22187.0,11.13,0.02,High Risk
U252,2024,11,402990.0,Salary Increases & Fixed Expenses Remain Stable,199284,46422.0,128251,174673.0,24611.0,12.35,-0.0,High Risk
U252,2024,12,427601.0,Salary Increases & Fixed Expenses Remain Stable,199284,46422.0,156051,202473.0,-3189.0,-1.6,0.02,High Risk
U253,2024,1,244630.0,Salary Increases & Fixed Expenses Remain Stable,263283,72083.0,126508,198591.0,64692.0,24.57,-0.01,Medium Risk
U253,2024,2,309322.0,Salary Increases & Fixed Expenses Remain Stable,263283,72083.0,146197,218280.0,45003.0,17.09,0.04,Medium Risk
U253,2024,3,354325.0,Salary Increases & Fixed Expenses Remain Stable,263283,72083.0,141130,213213.0,50070.0,19.02,0.03,Medium Risk
U253,2024,4,404395.0,Salary Increases & Fixed Expenses Remain Stable,263283,72083.0,111450,183533.0,79750.0,30.29,0.02,Low Risk
U253,2024,5,484145.0,Salary Increases & Fixed Expenses Remain Stable,263283,72083.0,110384,182467.0,80816.0,30.7,-0.03,Low Risk
U253,2024,6,564961.0,Salary Increases & Fixed Expenses Remain Stable,263283,72083.0,115772,187855.0,75428.0,28.65,-0.02,Low Risk
U253,2024,7,640389.0,Salary Increases & Fixed Expenses Remain Stable,273414,72083.0,129954,202037.0,71377.0,26.11,0.02,Low Risk
U253,2024,8,711766.0,Salary Increases & Fixed Expenses Remain Stable,273414,72083.0,135927,208010.0,65404.0,23.92,-0.05,Medium Risk
U253,2024,9,777170.0,Salary Increases & Fixed Expenses Remain Stable,273414,72083.0,133340,205423.0,67991.0,24.87,-0.02,Medium Risk
U253,2024,10,845161.0,Salary Increases & Fixed Expenses Remain Stable,273414,72083.0,136886,208969.0,64445.0,23.57,0.05,Medium Risk
U253,2024,11,909606.0,Salary Increases & Fixed Expenses Remain Stable,273414,72083.0,117186,189269.0,84145.0,30.78,0.03,Low Risk
U253,2024,12,993751.0,Salary Increases & Fixed Expenses Remain Stable,273414,72083.0,114503,186586.0,86828.0,31.76,-0.02,Low Risk
U254,2024,1,219092.0,Salary Increases & Fixed Expenses Remain Stable,222165,81339.0,106918,188257.0,33908.0,15.26,0.02,Medium Risk
U254,2024,2,253000.0,Salary Increases & Fixed Expenses Remain Stable,222165,81339.0,104680,186019.0,36146.0,16.27,0.05,Medium Risk
U254,2024,3,289146.0,Salary Increases & Fixed Expenses Remain Stable,222165,81339.0,108531,189870.0,32295.0,14.54,0.01,High Risk
U254,2024,4,321441.0,Salary Increases & Fixed Expenses Remain Stable,229304,81339.0,104214,185553.0,43751.0,19.08,0.03,Medium Risk
U254,2024,5,365192.0,Salary Increases & Fixed Expenses Remain Stable,229304,81339.0,93835,175174.0,54130.0,23.61,-0.0,Medium Risk
U254,2024,6,419322.0,Salary Increases & Fixed Expenses Remain Stable,229304,81339.0,107904,189243.0,40061.0,17.47,0.0,Medium Risk
U254,2024,7,459383.0,Salary Increases & Fixed Expenses Remain Stable,229304,81339.0,121249,202588.0,26716.0,11.65,-0.05,High Risk
U254,2024,8,486099.0,Salary Increases & Fixed Expenses Remain Stable,229304,81339.0,100609,181948.0,47356.0,20.65,0.01,Medium Risk
U254,2024,9,533455.0,Salary Increases & Fixed Expenses Remain Stable,229304,81339.0,123963,205302.0,24002.0,10.47,-0.01,High Risk
U254,2024,10,557457.0,Salary Increases & Fixed Expenses Remain Stable,229304,81339.0,105578,186917.0,42387.0,18.49,-0.02,Medium Risk
U254,2024,11,599844.0,Salary Increases & Fixed Expenses Remain Stable,229304,81339.0,123176,204515.0,24789.0,10.81,-0.05,High Risk
U254,2024,12,624633.0,Salary Increases & Fixed Expenses Remain Stable,229304,81339.0,117250,198589.0,30715.0,13.39,-0.03,High Risk
U255,2024,1,225205.0,Stable Salary & Increasing Fixed Expenses,144978,48911.0,110886,159797.0,-14819.0,-10.22,-0.02,High Risk
U255,2024,2,210386.0,Stable Salary & Increasing Fixed Expenses,144978,48911.0,95406,144317.0,661.0,0.46,-0.05,High Risk
U255,2024,3,211047.0,Stable Salary & Increasing Fixed Expenses,144978,48911.0,108656,157567.0,-12589.0,-8.68,-0.01,High Risk
U255,2024,4,198458.0,Stable Salary & Increasing Fixed Expenses,144978,48911.0,112654,161565.0,-16587.0,-11.44,-0.02,High Risk
U255,2024,5,181871.0,Stable Salary & Increasing Fixed Expenses,144978,48911.0,97376,146287.0,-1309.0,-0.9,-0.01,High Risk
U255,2024,6,180562.0,Stable Salary & Increasing Fixed Expenses,144978,48911.0,88578,137489.0,7489.0,5.17,-0.03,High Risk
U255,2024,7,188051.0,Stable Salary & Increasing Fixed Expenses,144978,48911.0,96748,145659.0,-681.0,-0.47,-0.05,High Risk
U255,2024,8,187370.0,Stable Salary & Increasing Fixed Expenses,144978,48911.0,101323,150234.0,-5256.0,-3.63,-0.0,High Risk
U255,2024,9,182114.0,Stable Salary & Increasing Fixed Expenses,144978,50413.0,104401,154814.0,-9836.0,-6.78,0.04,High Risk
U255,2024,10,172278.0,Stable Salary & Increasing Fixed Expenses,144978,50413.0,107120,157533.0,-12555.0,-8.66,-0.04,High Risk
U255,2024,11,159723.0,Stable Salary & Increasing Fixed Expenses,144978,52116.0,92216,144332.0,646.0,0.45,0.03,High Risk
U255,2024,12,160369.0,Stable Salary & Increasing Fixed Expenses,144978,52116.0,101436,153552.0,-8574.0,-5.91,0.04,High Risk
U256,2024,1,218301.0,Salary Increases & Fixed Expenses Increase,181014,49064.0,89335,138399.0,42615.0,23.54,0.01,Medium Risk
U256,2024,2,260916.0,Salary Increases & Fixed Expenses Increase,181014,49064.0,104470,153534.0,27480.0,15.18,0.05,Medium Risk
U256,2024,3,288396.0,Salary Increases & Fixed Expenses Increase,181014,49064.0,112316,161380.0,19634.0,10.85,-0.03,High Risk
U256,2024,4,308030.0,Salary Increases & Fixed Expenses Increase,181014,49064.0,91857,140921.0,40093.0,22.15,-0.0,Medium Risk
U256,2024,5,348123.0,Salary Increases & Fixed Expenses Increase,181014,51028.0,94972,146000.0,35014.0,19.34,-0.03,Medium Risk
U256,2024,6,383137.0,Salary Increases & Fixed Expenses Increase,181014,51028.0,96100,147128.0,33886.0,18.72,0.04,Medium Risk
U256,2024,7,417023.0,Salary Increases & Fixed Expenses Increase,207066,51028.0,114336,165364.0,41702.0,20.14,-0.02,Medium Risk
U256,2024,8,458725.0,Salary Increases & Fixed Expenses Increase,207066,51028.0,92110,143138.0,63928.0,30.87,0.03,Low Risk
U256,2024,9,522653.0,Salary Increases & Fixed Expenses Increase,207066,51028.0,93072,144100.0,62966.0,30.41,0.03,Low Risk
U256,2024,10,585619.0,Salary Increases & Fixed Expenses Increase,207066,51028.0,126481,177509.0,29557.0,14.27,0.04,High Risk
U256,2024,11,615176.0,Salary Increases & Fixed Expenses Increase,207066,51028.0,92640,143668.0,63398.0,30.62,0.04,Low Risk
U256,2024,12,678574.0,Salary Increases & Fixed Expenses Increase,207066,51028.0,117618,168646.0,38420.0,18.55,-0.04,Medium Risk
U257,2024,1,203217.0,Salary Increases & Fixed Expenses Remain Stable,236853,115813.0,149109,264922.0,-28069.0,-11.85,0.01,High Risk
U257,2024,2,175148.0,Salary Increases & Fixed Expenses Remain Stable,236853,115813.0,155183,270996.0,-34143.0,-14.42,0.02,High Risk
U257,2024,3,141005.0,Salary Increases & Fixed Expenses Remain Stable,236853,115813.0,171910,287723.0,-50870.0,-21.48,-0.0,High Risk
U257,2024,4,90135.0,Salary Increases & Fixed Expenses Remain Stable,236853,115813.0,176043,291856.0,-55003.0,-23.22,0.02,High Risk
U257,2024,5,35132.0,Salary Increases & Fixed Expenses Remain Stable,236853,115813.0,166752,282565.0,-45712.0,-19.3,-0.04,High Risk
U257,2024,6,-10580.0,Salary Increases & Fixed Expenses Remain Stable,246876,115813.0,168158,283971.0,-37095.0,-15.03,-0.0,High Risk
U257,2024,7,-47675.0,Salary Increases & Fixed Expenses Remain Stable,246876,115813.0,152126,267939.0,-21063.0,-8.53,0.03,High Risk
U257,2024,8,-68738.0,Salary Increases & Fixed Expenses Remain Stable,246876,115813.0,152180,267993.0,-21117.0,-8.55,-0.0,High Risk
U257,2024,9,-89855.0,Salary Increases & Fixed Expenses Remain Stable,246876,115813.0,162756,278569.0,-31693.0,-12.84,-0.04,High Risk
U257,2024,10,-121548.0,Salary Increases & Fixed Expenses Remain Stable,246876,115813.0,176679,292492.0,-45616.0,-18.48,-0.05,High Risk
U257,2024,11,-167164.0,Salary Increases & Fixed Expenses Remain Stable,246876,115813.0,191260,307073.0,-60197.0,-24.38,0.0,High Risk
U257,2024,12,-227361.0,Salary Increases & Fixed Expenses Remain Stable,246876,115813.0,186968,302781.0,-55905.0,-22.64,0.02,High Risk
U258,2024,1,231642.0,Salary Increases & Fixed Expenses Increase,41858,10952.0,24007,34959.0,6899.0,16.48,-0.01,Medium Risk
U258,2024,2,238541.0,Salary Increases & Fixed Expenses Increase,41858,10952.0,18141,29093.0,12765.0,30.5,-0.02,Low Risk
U258,2024,3,251306.0,Salary Increases & Fixed Expenses Increase,63984,10952.0,44095,55047.0,8937.0,13.97,-0.0,High Risk
U258,2024,4,260243.0,Salary Increases & Fixed Expenses Increase,63984,12383.0,37309,49692.0,14292.0,22.34,0.04,Medium Risk
U258,2024,5,274535.0,Salary Increases & Fixed Expenses Increase,63984,12383.0,32755,45138.0,18846.0,29.45,-0.0,Low Risk
U258,2024,6,293381.0,Salary Increases & Fixed Expenses Increase,63984,12383.0,37115,49498.0,14486.0,22.64,-0.05,Medium Risk
U258,2024,7,307867.0,Salary Increases & Fixed Expenses Increase,63984,12383.0,32709,45092.0,18892.0,29.53,-0.05,Low Risk
U258,2024,8,326759.0,Salary Increases & Fixed Expenses Increase,63984,12383.0,34329,46712.0,17272.0,26.99,-0.01,Low Risk
U258,2024,9,344031.0,Salary Increases & Fixed Expenses Increase,63984,13213.0,35649,48862.0,15122.0,23.63,0.01,Medium Risk
U258,2024,10,359153.0,Salary Increases & Fixed Expenses Increase,63984,13213.0,34854,48067.0,15917.0,24.88,-0.0,Medium Risk
U258,2024,11,375070.0,Salary Increases & Fixed Expenses Increase,63984,13213.0,36821,50034.0,13950.0,21.8,-0.05,Medium Risk
U258,2024,12,389020.0,Salary Increases & Fixed Expenses Increase,63984,13213.0,31068,44281.0,19703.0,30.79,-0.04,Low Risk
U259,2024,1,234635.0,Stable Salary & Stable Fixed Expenses,222197,117765.0,121472,239237.0,-17040.0,-7.67,0.01,High Risk
U259,2024,2,217595.0,Stable Salary & Stable Fixed Expenses,222197,117765.0,129684,247449.0,-25252.0,-11.36,0.04,High Risk
U259,2024,3,192343.0,Stable Salary & Stable Fixed Expenses,222197,117765.0,142129,259894.0,-37697.0,-16.97,-0.03,High Risk
U259,2024,4,154646.0,Stable Salary & Stable Fixed Expenses,222197,117765.0,93104,210869.0,11328.0,5.1,-0.03,High Risk
U259,2024,5,165974.0,Stable Salary & Stable Fixed Expenses,222197,117765.0,133160,250925.0,-28728.0,-12.93,0.02,High Risk
U259,2024,6,137246.0,Stable Salary & Stable Fixed Expenses,222197,117765.0,128207,245972.0,-23775.0,-10.7,0.04,High Risk
U259,2024,7,113471.0,Stable Salary & Stable Fixed Expenses,222197,117765.0,113304,231069.0,-8872.0,-3.99,0.04,High Risk
U259,2024,8,104599.0,Stable Salary & Stable Fixed Expenses,222197,117765.0,111294,229059.0,-6862.0,-3.09,0.05,High Risk
U259,2024,9,97737.0,Stable Salary & Stable Fixed Expenses,222197,117765.0,100848,218613.0,3584.0,1.61,-0.03,High Risk
U259,2024,10,101321.0,Stable Salary & Stable Fixed Expenses,222197,117765.0,164287,282052.0,-59855.0,-26.94,0.01,High Risk
U259,2024,11,41466.0,Stable Salary & Stable Fixed Expenses,222197,117765.0,104398,222163.0,34.0,0.02,0.0,High Risk
U259,2024,12,41500.0,Stable Salary & Stable Fixed Expenses,222197,117765.0,112771,230536.0,-8339.0,-3.75,0.02,High Risk
U260,2024,1,231697.0,Salary Increases & Fixed Expenses Remain Stable,47635,16010.0,15834,31844.0,15791.0,33.15,0.04,Low Risk
U260,2024,2,247488.0,Salary Increases & Fixed Expenses Remain Stable,47635,16010.0,18396,34406.0,13229.0,27.77,0.04,Low Risk
U260,2024,3,260717.0,Salary Increases & Fixed Expenses Remain Stable,47635,16010.0,14855,30865.0,16770.0,35.21,-0.04,Low Risk
U260,2024,4,277487.0,Salary Increases & Fixed Expenses Remain Stable,47635,16010.0,14334,30344.0,17291.0,36.3,0.05,Low Risk
U260,2024,5,294778.0,Salary Increases & Fixed Expenses Remain Stable,75364,16010.0,23352,39362.0,36002.0,47.77,0.01,Low Risk
U260,2024,6,330780.0,Salary Increases & Fixed Expenses Remain Stable,75364,16010.0,29336,45346.0,30018.0,39.83,0.05,Low Risk
U260,2024,7,360798.0,Salary Increases & Fixed Expenses Remain Stable,75364,16010.0,27630,43640.0,31724.0,42.09,-0.01,Low Risk
U260,2024,8,392522.0,Salary Increases & Fixed Expenses Remain Stable,75364,16010.0,23726,39736.0,35628.0,47.27,-0.03,Low Risk
U260,2024,9,428150.0,Salary Increases & Fixed Expenses Remain Stable,75364,16010.0,23086,39096.0,36268.0,48.12,0.0,Low Risk
U260,2024,10,464418.0,Salary Increases & Fixed Expenses Remain Stable,75364,16010.0,25614,41624.0,33740.0,44.77,0.03,Low Risk
U260,2024,11,498158.0,Salary Increases & Fixed Expenses Remain Stable,75364,16010.0,24127,40137.0,35227.0,46.74,-0.01,Low Risk
U260,2024,12,533385.0,Salary Increases & Fixed Expenses Remain Stable,75364,16010.0,27946,43956.0,31408.0,41.68,-0.04,Low Risk
U261,2024,1,249599.0,Salary Increases & Fixed Expenses Decrease,99735,28756.0,67991,96747.0,2988.0,3.0,0.03,High Risk
U261,2024,2,252587.0,Salary Increases & Fixed Expenses Decrease,99735,28756.0,61804,90560.0,9175.0,9.2,0.04,High Risk
U261,2024,3,261762.0,Salary Increases & Fixed Expenses Decrease,99735,28756.0,73293,102049.0,-2314.0,-2.32,-0.03,High Risk
U261,2024,4,259448.0,Salary Increases & Fixed Expenses Decrease,99735,28756.0,68022,96778.0,2957.0,2.96,-0.01,High Risk
U261,2024,5,262405.0,Salary Increases & Fixed Expenses Decrease,99735,28756.0,60981,89737.0,9998.0,10.02,0.04,High Risk
U261,2024,6,272403.0,Salary Increases & Fixed Expenses Decrease,99735,28756.0,72480,101236.0,-1501.0,-1.5,0.05,High Risk
U261,2024,7,270902.0,Salary Increases & Fixed Expenses Decrease,99735,28756.0,73998,102754.0,-3019.0,-3.03,-0.04,High Risk
U261,2024,8,267883.0,Salary Increases & Fixed Expenses Decrease,124181,28756.0,89448,118204.0,5977.0,4.81,0.02,High Risk
U261,2024,9,273860.0,Salary Increases & Fixed Expenses Decrease,124181,28756.0,87431,116187.0,7994.0,6.44,-0.02,High Risk
U261,2024,10,281854.0,Salary Increases & Fixed Expenses Decrease,124181,28756.0,102214,130970.0,-6789.0,-5.47,-0.01,High Risk
U261,2024,11,275065.0,Salary Increases & Fixed Expenses Decrease,124181,28756.0,83581,112337.0,11844.0,9.54,-0.01,High Risk
U261,2024,12,286909.0,Salary Increases & Fixed Expenses Decrease,124181,28756.0,79689,108445.0,15736.0,12.67,-0.01,High Risk
U262,2024,1,200929.0,Salary Increases & Fixed Expenses Decrease,142000,47140.0,79987,127127.0,14873.0,10.47,-0.02,High Risk
U262,2024,2,215802.0,Salary Increases & Fixed Expenses Decrease,142000,47140.0,68620,115760.0,26240.0,18.48,0.04,Medium Risk
U262,2024,3,242042.0,Salary Increases & Fixed Expenses Decrease,142000,47140.0,85180,132320.0,9680.0,6.82,-0.02,High Risk
U262,2024,4,251722.0,Salary Increases & Fixed Expenses Decrease,142000,47140.0,82808,129948.0,12052.0,8.49,-0.04,High Risk
U262,2024,5,263774.0,Salary Increases & Fixed Expenses Decrease,142000,47140.0,57366,104506.0,37494.0,26.4,-0.03,Low Risk
U262,2024,6,301268.0,Salary Increases & Fixed Expenses Decrease,142000,47140.0,67885,115025.0,26975.0,19.0,0.02,Medium Risk
U262,2024,7,328243.0,Salary Increases & Fixed Expenses Decrease,142000,47140.0,70573,117713.0,24287.0,17.1,0.01,Medium Risk
U262,2024,8,352530.0,Salary Increases & Fixed Expenses Decrease,153585,47140.0,72232,119372.0,34213.0,22.28,0.0,Medium Risk
U262,2024,9,386743.0,Salary Increases & Fixed Expenses Decrease,153585,47140.0,87822,134962.0,18623.0,12.13,-0.01,High Risk
U262,2024,10,405366.0,Salary Increases & Fixed Expenses Decrease,153585,47140.0,93843,140983.0,12602.0,8.21,0.01,High Risk
U262,2024,11,417968.0,Salary Increases & Fixed Expenses Decrease,153585,46055.0,68686,114741.0,38844.0,25.29,0.02,Low Risk
U262,2024,12,456812.0,Salary Increases & Fixed Expenses Decrease,153585,46055.0,87890,133945.0,19640.0,12.79,-0.03,High Risk
U263,2024,1,207261.0,Salary Increases & Fixed Expenses Increase,22114,15398.0,16618,32016.0,-9902.0,-44.78,0.03,High Risk
U263,2024,2,197359.0,Salary Increases & Fixed Expenses Increase,22114,15398.0,16785,32183.0,-10069.0,-45.53,0.01,High Risk
U263,2024,3,187290.0,Salary Increases & Fixed Expenses Increase,35651,15398.0,29555,44953.0,-9302.0,-26.09,-0.03,High Risk
U263,2024,4,177988.0,Salary Increases & Fixed Expenses Increase,35651,16961.0,27823,44784.0,-9133.0,-25.62,0.02,High Risk
U263,2024,5,168855.0,Salary Increases & Fixed Expenses Increase,35651,16961.0,23547,40508.0,-4857.0,-13.62,0.05,High Risk
U263,2024,6,163998.0,Salary Increases & Fixed Expenses Increase,35651,16961.0,24120,41081.0,-5430.0,-15.23,-0.01,High Risk
U263,2024,7,158568.0,Salary Increases & Fixed Expenses Increase,35651,18283.0,26563,44846.0,-9195.0,-25.79,0.0,High Risk
U263,2024,8,149373.0,Salary Increases & Fixed Expenses Increase,35651,18283.0,21417,39700.0,-4049.0,-11.36,-0.04,High Risk
U263,2024,9,145324.0,Salary Increases & Fixed Expenses Increase,35651,18283.0,27615,45898.0,-10247.0,-28.74,-0.03,High Risk
U263,2024,10,135077.0,Salary Increases & Fixed Expenses Increase,35651,18283.0,33700,51983.0,-16332.0,-45.81,-0.02,High Risk
U263,2024,11,118745.0,Salary Increases & Fixed Expenses Increase,35651,18283.0,23928,42211.0,-6560.0,-18.4,-0.01,High Risk
U263,2024,12,112185.0,Salary Increases & Fixed Expenses Increase,35651,18283.0,25816,44099.0,-8448.0,-23.7,0.03,High Risk
U264,2024,1,248033.0,Stable Salary & Increasing Fixed Expenses,21968,17977.0,7920,25897.0,-3929.0,-17.89,-0.04,High Risk
U264,2024,2,244104.0,Stable Salary & Increasing Fixed Expenses,21968,17977.0,8363,26340.0,-4372.0,-19.9,-0.05,High Risk
U264,2024,3,239732.0,Stable Salary & Increasing Fixed Expenses,21968,17977.0,7522,25499.0,-3531.0,-16.07,0.01,High Risk
U264,2024,4,236201.0,Stable Salary & Increasing Fixed Expenses,21968,17977.0,7570,25547.0,-3579.0,-16.29,0.04,High Risk
U264,2024,5,232622.0,Stable Salary & Increasing Fixed Expenses,21968,17977.0,7706,25683.0,-3715.0,-16.91,-0.05,High Risk
U264,2024,6,228907.0,Stable Salary & Increasing Fixed Expenses,21968,17977.0,6920,24897.0,-2929.0,-13.33,0.01,High Risk
U264,2024,7,225978.0,Stable Salary & Increasing Fixed Expenses,21968,17977.0,7285,25262.0,-3294.0,-14.99,0.0,High Risk
U264,2024,8,222684.0,Stable Salary & Increasing Fixed Expenses,21968,17977.0,7700,25677.0,-3709.0,-16.88,-0.02,High Risk
U264,2024,9,218975.0,Stable Salary & Increasing Fixed Expenses,21968,17977.0,7274,25251.0,-3283.0,-14.94,0.03,High Risk
U264,2024,10,215692.0,Stable Salary & Increasing Fixed Expenses,21968,17977.0,8397,26374.0,-4406.0,-20.06,0.01,High Risk
U264,2024,11,211286.0,Stable Salary & Increasing Fixed Expenses,21968,17977.0,8599,26576.0,-4608.0,-20.98,0.02,High Risk
U264,2024,12,206678.0,Stable Salary & Increasing Fixed Expenses,21968,17977.0,8271,26248.0,-4280.0,-19.48,-0.03,High Risk
U265,2024,1,224268.0,Stable Salary & Stable Fixed Expenses,208940,95556.0,117352,212908.0,-3968.0,-1.9,-0.02,High Risk
U265,2024,2,220300.0,Stable Salary & Stable Fixed Expenses,208940,95556.0,101075,196631.0,12309.0,5.89,-0.02,High Risk
U265,2024,3,232609.0,Stable Salary & Stable Fixed Expenses,208940,95556.0,104183,199739.0,9201.0,4.4,0.03,High Risk
U265,2024,4,241810.0,Stable Salary & Stable Fixed Expenses,208940,95556.0,123381,218937.0,-9997.0,-4.78,-0.01,High Risk
U265,2024,5,231813.0,Stable Salary & Stable Fixed Expenses,208940,95556.0,124301,219857.0,-10917.0,-5.22,0.05,High Risk
U265,2024,6,220896.0,Stable Salary & Stable Fixed Expenses,208940,95556.0,113061,208617.0,323.0,0.15,-0.03,High Risk
U265,2024,7,221219.0,Stable Salary & Stable Fixed Expenses,208940,95556.0,114305,209861.0,-921.0,-0.44,-0.03,High Risk
U265,2024,8,220298.0,Stable Salary & Stable Fixed Expenses,208940,95556.0,96026,191582.0,17358.0,8.31,-0.02,High Risk
U265,2024,9,237656.0,Stable Salary & Stable Fixed Expenses,208940,95556.0,116113,211669.0,-2729.0,-1.31,0.0,High Risk
U265,2024,10,234927.0,Stable Salary & Stable Fixed Expenses,208940,95556.0,133292,228848.0,-19908.0,-9.53,-0.05,High Risk
U265,2024,11,215019.0,Stable Salary & Stable Fixed Expenses,208940,95556.0,120121,215677.0,-6737.0,-3.22,0.01,High Risk
U265,2024,12,208282.0,Stable Salary & Stable Fixed Expenses,208940,95556.0,123725,219281.0,-10341.0,-4.95,-0.05,High Risk
U266,2024,1,247972.0,Salary Increases & Fixed Expenses Remain Stable,25021,13281.0,13614,26895.0,-1874.0,-7.49,0.02,High Risk
U266,2024,2,246098.0,Salary Increases & Fixed Expenses Remain Stable,25021,13281.0,11668,24949.0,72.0,0.29,-0.02,High Risk
U266,2024,3,246170.0,Salary Increases & Fixed Expenses Remain Stable,25021,13281.0,10713,23994.0,1027.0,4.1,-0.01,High Risk
U266,2024,4,247197.0,Salary Increases & Fixed Expenses Remain Stable,25021,13281.0,13974,27255.0,-2234.0,-8.93,0.03,High Risk
U266,2024,5,244963.0,Salary Increases & Fixed Expenses Remain Stable,25021,13281.0,10918,24199.0,822.0,3.29,-0.04,High Risk
U266,2024,6,245785.0,Salary Increases & Fixed Expenses Remain Stable,25021,13281.0,12970,26251.0,-1230.0,-4.92,-0.0,High Risk
U266,2024,7,244555.0,Salary Increases & Fixed Expenses Remain Stable,25021,13281.0,10901,24182.0,839.0,3.35,-0.04,High Risk
U266,2024,8,245394.0,Salary Increases & Fixed Expenses Remain Stable,48946,13281.0,23175,36456.0,12490.0,25.52,-0.05,Low Risk
U266,2024,9,257884.0,Salary Increases & Fixed Expenses Remain Stable,48946,13281.0,21592,34873.0,14073.0,28.75,0.04,Low Risk
U266,2024,10,271957.0,Salary Increases & Fixed Expenses Remain Stable,48946,13281.0,22074,35355.0,13591.0,27.77,-0.04,Low Risk
U266,2024,11,285548.0,Salary Increases & Fixed Expenses Remain Stable,48946,13281.0,21154,34435.0,14511.0,29.65,0.02,Low Risk
U266,2024,12,300059.0,Salary Increases & Fixed Expenses Remain Stable,48946,13281.0,28349,41630.0,7316.0,14.95,0.01,High Risk
U267,2024,1,241092.0,Salary Increases & Fixed Expenses Increase,110460,73855.0,47392,121247.0,-10787.0,-9.77,-0.01,High Risk
U267,2024,2,230305.0,Salary Increases & Fixed Expenses Increase,110460,73855.0,51213,125068.0,-14608.0,-13.22,0.03,High Risk
U267,2024,3,215697.0,Salary Increases & Fixed Expenses Increase,110460,74614.0,73040,147654.0,-37194.0,-33.67,0.01,High Risk
U267,2024,4,178503.0,Salary Increases & Fixed Expenses Increase,110460,74614.0,65564,140178.0,-29718.0,-26.9,-0.02,High Risk
U267,2024,5,148785.0,Salary Increases & Fixed Expenses Increase,110460,74614.0,53343,127957.0,-17497.0,-15.84,-0.02,High Risk
U267,2024,6,131288.0,Salary Increases & Fixed Expenses Increase,110460,75598.0,53985,129583.0,-19123.0,-17.31,-0.01,High Risk
U267,2024,7,112165.0,Salary Increases & Fixed Expenses Increase,110460,75598.0,49361,124959.0,-14499.0,-13.13,0.01,High Risk
U267,2024,8,97666.0,Salary Increases & Fixed Expenses Increase,128214,75598.0,60130,135728.0,-7514.0,-5.86,0.03,High Risk
U267,2024,9,90152.0,Salary Increases & Fixed Expenses Increase,128214,75598.0,77109,152707.0,-24493.0,-19.1,0.01,High Risk
U267,2024,10,65659.0,Salary Increases & Fixed Expenses Increase,128214,75598.0,68302,143900.0,-15686.0,-12.23,0.01,High Risk
U267,2024,11,49973.0,Salary Increases & Fixed Expenses Increase,128214,75598.0,70510,146108.0,-17894.0,-13.96,0.03,High Risk
U267,2024,12,32079.0,Salary Increases & Fixed Expenses Increase,128214,76226.0,81784,158010.0,-29796.0,-23.24,-0.04,High Risk
U268,2024,1,207839.0,Stable Salary & Stable Fixed Expenses,163317,40802.0,53772,94574.0,68743.0,42.09,-0.01,Low Risk
U268,2024,2,276582.0,Stable Salary & Stable Fixed Expenses,163317,40802.0,62137,102939.0,60378.0,36.97,0.04,Low Risk
U268,2024,3,336960.0,Stable Salary & Stable Fixed Expenses,163317,40802.0,61201,102003.0,61314.0,37.54,0.05,Low Risk
U268,2024,4,398274.0,Stable Salary & Stable Fixed Expenses,163317,40802.0,63213,104015.0,59302.0,36.31,0.02,Low Risk
U268,2024,5,457576.0,Stable Salary & Stable Fixed Expenses,163317,40802.0,58354,99156.0,64161.0,39.29,0.03,Low Risk
U268,2024,6,521737.0,Stable Salary & Stable Fixed Expenses,163317,40802.0,50371,91173.0,72144.0,44.17,0.01,Low Risk
U268,2024,7,593881.0,Stable Salary & Stable Fixed Expenses,163317,40802.0,54135,94937.0,68380.0,41.87,-0.01,Low Risk
U268,2024,8,662261.0,Stable Salary & Stable Fixed Expenses,163317,40802.0,57475,98277.0,65040.0,39.82,-0.04,Low Risk
U268,2024,9,727301.0,Stable Salary & Stable Fixed Expenses,163317,40802.0,56788,97590.0,65727.0,40.25,-0.02,Low Risk
U268,2024,10,793028.0,Stable Salary & Stable Fixed Expenses,163317,40802.0,64916,105718.0,57599.0,35.27,-0.0,Low Risk
U268,2024,11,850627.0,Stable Salary & Stable Fixed Expenses,163317,40802.0,60909,101711.0,61606.0,37.72,0.04,Low Risk
U268,2024,12,912233.0,Stable Salary & Stable Fixed Expenses,163317,40802.0,60918,101720.0,61597.0,37.72,-0.02,Low Risk
U269,2024,1,237028.0,Stable Salary & Decreasing Fixed Expenses,241614,68596.0,123197,191793.0,49821.0,20.62,0.02,Medium Risk
U269,2024,2,286849.0,Stable Salary & Decreasing Fixed Expenses,241614,68596.0,101020,169616.0,71998.0,29.8,-0.03,Low Risk
U269,2024,3,358847.0,Stable Salary & Decreasing Fixed Expenses,241614,68596.0,147078,215674.0,25940.0,10.74,-0.01,High Risk
U269,2024,4,384787.0,Stable Salary & Decreasing Fixed Expenses,241614,68596.0,104272,172868.0,68746.0,28.45,-0.04,Low Risk
U269,2024,5,453533.0,Stable Salary & Decreasing Fixed Expenses,241614,68596.0,136322,204918.0,36696.0,15.19,0.04,Medium Risk
U269,2024,6,490229.0,Stable Salary & Decreasing Fixed Expenses,241614,68596.0,112892,181488.0,60126.0,24.89,0.04,Medium Risk
U269,2024,7,550355.0,Stable Salary & Decreasing Fixed Expenses,241614,68596.0,115913,184509.0,57105.0,23.63,-0.03,Medium Risk
U269,2024,8,607460.0,Stable Salary & Decreasing Fixed Expenses,241614,68596.0,99302,167898.0,73716.0,30.51,-0.01,Low Risk
U269,2024,9,681176.0,Stable Salary & Decreasing Fixed Expenses,241614,68596.0,120977,189573.0,52041.0,21.54,-0.01,Medium Risk
U269,2024,10,733217.0,Stable Salary & Decreasing Fixed Expenses,241614,68596.0,136300,204896.0,36718.0,15.2,-0.02,Medium Risk
U269,2024,11,769935.0,Stable Salary & Decreasing Fixed Expenses,241614,68596.0,150445,219041.0,22573.0,9.34,-0.03,High Risk
U269,2024,12,792508.0,Stable Salary & Decreasing Fixed Expenses,241614,68596.0,167817,236413.0,5201.0,2.15,0.01,High Risk
U270,2024,1,231637.0,Salary Increases & Fixed Expenses Remain Stable,237218,96564.0,108322,204886.0,32332.0,13.63,0.01,High Risk
U270,2024,2,263969.0,Salary Increases & Fixed Expenses Remain Stable,237218,96564.0,120267,216831.0,20387.0,8.59,0.02,High Risk
U270,2024,3,284356.0,Salary Increases & Fixed Expenses Remain Stable,244355,96564.0,143202,239766.0,4589.0,1.88,-0.02,High Risk
U270,2024,4,288945.0,Salary Increases & Fixed Expenses Remain Stable,244355,96564.0,103164,199728.0,44627.0,18.26,-0.04,Medium Risk
U270,2024,5,333572.0,Salary Increases & Fixed Expenses Remain Stable,244355,96564.0,109825,206389.0,37966.0,15.54,0.03,Medium Risk
U270,2024,6,371538.0,Salary Increases & Fixed Expenses Remain Stable,244355,96564.0,115313,211877.0,32478.0,13.29,0.01,High Risk
U270,2024,7,404016.0,Salary Increases & Fixed Expenses Remain Stable,244355,96564.0,100708,197272.0,47083.0,19.27,-0.03,Medium Risk
U270,2024,8,451099.0,Salary Increases & Fixed Expenses Remain Stable,244355,96564.0,101902,198466.0,45889.0,18.78,0.03,Medium Risk
U270,2024,9,496988.0,Salary Increases & Fixed Expenses Remain Stable,244355,96564.0,116529,213093.0,31262.0,12.79,0.04,High Risk
U270,2024,10,528250.0,Salary Increases & Fixed Expenses Remain Stable,244355,96564.0,169883,266447.0,-22092.0,-9.04,0.02,High Risk
U270,2024,11,506158.0,Salary Increases & Fixed Expenses Remain Stable,244355,96564.0,113057,209621.0,34734.0,14.21,0.02,High Risk
U270,2024,12,540892.0,Salary Increases & Fixed Expenses Remain Stable,244355,96564.0,116456,213020.0,31335.0,12.82,0.01,High Risk
U271,2024,1,218308.0,Salary Increases & Fixed Expenses Remain Stable,243967,84474.0,119396,203870.0,40097.0,16.44,-0.03,Medium Risk
U271,2024,2,258405.0,Salary Increases & Fixed Expenses Remain Stable,243967,84474.0,102731,187205.0,56762.0,23.27,-0.04,Medium Risk
U271,2024,3,315167.0,Salary Increases & Fixed Expenses Remain Stable,243967,84474.0,164084,248558.0,-4591.0,-1.88,0.03,High Risk
U271,2024,4,310576.0,Salary Increases & Fixed Expenses Remain Stable,243967,84474.0,106631,191105.0,52862.0,21.67,0.01,Medium Risk
U271,2024,5,363438.0,Salary Increases & Fixed Expenses Remain Stable,243967,84474.0,114577,199051.0,44916.0,18.41,-0.0,Medium Risk
U271,2024,6,408354.0,Salary Increases & Fixed Expenses Remain Stable,243967,84474.0,123581,208055.0,35912.0,14.72,-0.04,High Risk
U271,2024,7,444266.0,Salary Increases & Fixed Expenses Remain Stable,243967,84474.0,106603,191077.0,52890.0,21.68,-0.05,Medium Risk
U271,2024,8,497156.0,Salary Increases & Fixed Expenses Remain Stable,256972,84474.0,149613,234087.0,22885.0,8.91,-0.05,High Risk
U271,2024,9,520041.0,Salary Increases & Fixed Expenses Remain Stable,256972,84474.0,137104,221578.0,35394.0,13.77,-0.02,High Risk
U271,2024,10,555435.0,Salary Increases & Fixed Expenses Remain Stable,256972,84474.0,124580,209054.0,47918.0,18.65,-0.03,Medium Risk
U271,2024,11,603353.0,Salary Increases & Fixed Expenses Remain Stable,256972,84474.0,140241,224715.0,32257.0,12.55,0.05,High Risk
U271,2024,12,635610.0,Salary Increases & Fixed Expenses Remain Stable,256972,84474.0,175603,260077.0,-3105.0,-1.21,-0.03,High Risk
U272,2024,1,248113.0,Stable Salary & Stable Fixed Expenses,89823,37343.0,27113,64456.0,25367.0,28.24,-0.03,Low Risk
U272,2024,2,273480.0,Stable Salary & Stable Fixed Expenses,89823,37343.0,31424,68767.0,21056.0,23.44,-0.02,Medium Risk
U272,2024,3,294536.0,Stable Salary & Stable Fixed Expenses,89823,37343.0,41502,78845.0,10978.0,12.22,-0.02,High Risk
U272,2024,4,305514.0,Stable Salary & Stable Fixed Expenses,89823,37343.0,27484,64827.0,24996.0,27.83,0.01,Low Risk
U272,2024,5,330510.0,Stable Salary & Stable Fixed Expenses,89823,37343.0,34928,72271.0,17552.0,19.54,-0.01,Medium Risk
U272,2024,6,348062.0,Stable Salary & Stable Fixed Expenses,89823,37343.0,29029,66372.0,23451.0,26.11,-0.01,Low Risk
U272,2024,7,371513.0,Stable Salary & Stable Fixed Expenses,89823,37343.0,34779,72122.0,17701.0,19.71,-0.04,Medium Risk
U272,2024,8,389214.0,Stable Salary & Stable Fixed Expenses,89823,37343.0,33235,70578.0,19245.0,21.43,0.0,Medium Risk
U272,2024,9,408459.0,Stable Salary & Stable Fixed Expenses,89823,37343.0,27244,64587.0,25236.0,28.1,-0.04,Low Risk
U272,2024,10,433695.0,Stable Salary & Stable Fixed Expenses,89823,37343.0,35327,72670.0,17153.0,19.1,-0.03,Medium Risk
U272,2024,11,450848.0,Stable Salary & Stable Fixed Expenses,89823,37343.0,34625,71968.0,17855.0,19.88,-0.04,Medium Risk
U272,2024,12,468703.0,Stable Salary & Stable Fixed Expenses,89823,37343.0,29474,66817.0,23006.0,25.61,0.01,Low Risk
U273,2024,1,244601.0,Salary Increases & Fixed Expenses Increase,260370,100076.0,157713,257789.0,2581.0,0.99,-0.04,High Risk
U273,2024,2,247182.0,Salary Increases & Fixed Expenses Increase,260370,100076.0,201477,301553.0,-41183.0,-15.82,-0.02,High Risk
U273,2024,3,205999.0,Salary Increases & Fixed Expenses Increase,260370,100076.0,201409,301485.0,-41115.0,-15.79,0.04,High Risk
U273,2024,4,164884.0,Salary Increases & Fixed Expenses Increase,260370,100076.0,176643,276719.0,-16349.0,-6.28,-0.01,High Risk
U273,2024,5,148535.0,Salary Increases & Fixed Expenses Increase,265374,100922.0,176879,277801.0,-12427.0,-4.68,0.02,High Risk
U273,2024,6,136108.0,Salary Increases & Fixed Expenses Increase,265374,100922.0,195252,296174.0,-30800.0,-11.61,-0.02,High Risk
U273,2024,7,105308.0,Salary Increases & Fixed Expenses Increase,265374,100922.0,211732,312654.0,-47280.0,-17.82,-0.0,High Risk
U273,2024,8,58028.0,Salary Increases & Fixed Expenses Increase,265374,100922.0,166709,267631.0,-2257.0,-0.85,-0.03,High Risk
U273,2024,9,55771.0,Salary Increases & Fixed Expenses Increase,265374,100922.0,181231,282153.0,-16779.0,-6.32,-0.03,High Risk
U273,2024,10,38992.0,Salary Increases & Fixed Expenses Increase,265374,100922.0,251397,352319.0,-86945.0,-32.76,0.03,High Risk
U273,2024,11,-47953.0,Salary Increases & Fixed Expenses Increase,265374,100922.0,198563,299485.0,-34111.0,-12.85,-0.03,High Risk
U273,2024,12,-82064.0,Salary Increases & Fixed Expenses Increase,265374,100922.0,161286,262208.0,3166.0,1.19,-0.0,High Risk
U274,2024,1,214388.0,Salary Increases & Fixed Expenses Remain Stable,57936,31686.0,32985,64671.0,-6735.0,-11.62,-0.04,High Risk
U274,2024,2,207653.0,Salary Increases & Fixed Expenses Remain Stable,57936,31686.0,23267,54953.0,2983.0,5.15,-0.0,High Risk
U274,2024,3,210636.0,Salary Increases & Fixed Expenses Remain Stable,57936,31686.0,29003,60689.0,-2753.0,-4.75,-0.03,High Risk
U274,2024,4,207883.0,Salary Increases & Fixed Expenses Remain Stable,57936,31686.0,29974,61660.0,-3724.0,-6.43,-0.01,High Risk
U274,2024,5,204159.0,Salary Increases & Fixed Expenses Remain Stable,57936,31686.0,25244,56930.0,1006.0,1.74,-0.01,High Risk
U274,2024,6,205165.0,Salary Increases & Fixed Expenses Remain Stable,57936,31686.0,34360,66046.0,-8110.0,-14.0,-0.02,High Risk
U274,2024,7,197055.0,Salary Increases & Fixed Expenses Remain Stable,57936,31686.0,26812,58498.0,-562.0,-0.97,-0.05,High Risk
U274,2024,8,196493.0,Salary Increases & Fixed Expenses Remain Stable,79502,31686.0,36489,68175.0,11327.0,14.25,-0.04,High Risk
U274,2024,9,207820.0,Salary Increases & Fixed Expenses Remain Stable,79502,31686.0,35391,67077.0,12425.0,15.63,0.05,Medium Risk
U274,2024,10,220245.0,Salary Increases & Fixed Expenses Remain Stable,79502,31686.0,36854,68540.0,10962.0,13.79,0.02,High Risk
U274,2024,11,231207.0,Salary Increases & Fixed Expenses Remain Stable,79502,31686.0,42704,74390.0,5112.0,6.43,0.04,High Risk
U274,2024,12,236319.0,Salary Increases & Fixed Expenses Remain Stable,79502,31686.0,38939,70625.0,8877.0,11.17,0.04,High Risk
U275,2024,1,204793.0,Stable Salary & Stable Fixed Expenses,230299,62830.0,90371,153201.0,77098.0,33.48,0.01,Low Risk
U275,2024,2,281891.0,Stable Salary & Stable Fixed Expenses,230299,62830.0,73820,136650.0,93649.0,40.66,0.01,Low Risk
U275,2024,3,375540.0,Stable Salary & Stable Fixed Expenses,230299,62830.0,84984,147814.0,82485.0,35.82,-0.04,Low Risk
U275,2024,4,458025.0,Stable Salary & Stable Fixed Expenses,230299,62830.0,85246,148076.0,82223.0,35.7,0.03,Low Risk
U275,2024,5,540248.0,Stable Salary & Stable Fixed Expenses,230299,62830.0,74789,137619.0,92680.0,40.24,0.03,Low Risk
U275,2024,6,632928.0,Stable Salary & Stable Fixed Expenses,230299,62830.0,88563,151393.0,78906.0,34.26,0.05,Low Risk
U275,2024,7,711834.0,Stable Salary & Stable Fixed Expenses,230299,62830.0,77132,139962.0,90337.0,39.23,-0.04,Low Risk
U275,2024,8,802171.0,Stable Salary & Stable Fixed Expenses,230299,62830.0,79494,142324.0,87975.0,38.2,0.02,Low Risk
U275,2024,9,890146.0,Stable Salary & Stable Fixed Expenses,230299,62830.0,82558,145388.0,84911.0,36.87,-0.02,Low Risk
U275,2024,10,975057.0,Stable Salary & Stable Fixed Expenses,230299,62830.0,105612,168442.0,61857.0,26.86,-0.0,Low Risk
U275,2024,11,1036914.0,Stable Salary & Stable Fixed Expenses,230299,62830.0,69456,132286.0,98013.0,42.56,-0.04,Low Risk
U275,2024,12,1134927.0,Stable Salary & Stable Fixed Expenses,230299,62830.0,75918,138748.0,91551.0,39.75,-0.05,Low Risk
U276,2024,1,235896.0,Salary Increases & Fixed Expenses Decrease,158735,65008.0,72696,137704.0,21031.0,13.25,-0.0,High Risk
U276,2024,2,256927.0,Salary Increases & Fixed Expenses Decrease,158735,65008.0,67953,132961.0,25774.0,16.24,-0.03,Medium Risk
U276,2024,3,282701.0,Salary Increases & Fixed Expenses Decrease,158735,65008.0,88586,153594.0,5141.0,3.24,0.05,High Risk
U276,2024,4,287842.0,Salary Increases & Fixed Expenses Decrease,158735,65008.0,73485,138493.0,20242.0,12.75,0.04,High Risk
U276,2024,5,308084.0,Salary Increases & Fixed Expenses Decrease,174805,65008.0,103784,168792.0,6013.0,3.44,0.02,High Risk
U276,2024,6,314097.0,Salary Increases & Fixed Expenses Decrease,174805,65008.0,74965,139973.0,34832.0,19.93,0.03,Medium Risk
U276,2024,7,348929.0,Salary Increases & Fixed Expenses Decrease,174805,65008.0,99874,164882.0,9923.0,5.68,0.03,High Risk
U276,2024,8,358852.0,Salary Increases & Fixed Expenses Decrease,174805,65008.0,91425,156433.0,18372.0,10.51,0.01,High Risk
U276,2024,9,377224.0,Salary Increases & Fixed Expenses Decrease,174805,65008.0,77663,142671.0,32134.0,18.38,0.04,Medium Risk
U276,2024,10,409358.0,Salary Increases & Fixed Expenses Decrease,174805,65008.0,83783,148791.0,26014.0,14.88,-0.0,High Risk
U276,2024,11,435372.0,Salary Increases & Fixed Expenses Decrease,174805,65008.0,85263,150271.0,24534.0,14.04,-0.04,High Risk
U276,2024,12,459906.0,Salary Increases & Fixed Expenses Decrease,174805,65008.0,96167,161175.0,13630.0,7.8,0.02,High Risk
U277,2024,1,203925.0,Salary Increases & Fixed Expenses Increase,40720,10150.0,32324,42474.0,-1754.0,-4.31,0.02,High Risk
U277,2024,2,202171.0,Salary Increases & Fixed Expenses Increase,40720,10150.0,31329,41479.0,-759.0,-1.86,0.04,High Risk
U277,2024,3,201412.0,Salary Increases & Fixed Expenses Increase,40720,10150.0,34803,44953.0,-4233.0,-10.4,-0.02,High Risk
U277,2024,4,197179.0,Salary Increases & Fixed Expenses Increase,69992,10150.0,51816,61966.0,8026.0,11.47,-0.02,High Risk
U277,2024,5,205205.0,Salary Increases & Fixed Expenses Increase,69992,10150.0,53651,63801.0,6191.0,8.85,-0.02,High Risk
U277,2024,6,211396.0,Salary Increases & Fixed Expenses Increase,69992,11586.0,50738,62324.0,7668.0,10.96,-0.02,High Risk
U277,2024,7,219064.0,Salary Increases & Fixed Expenses Increase,69992,11586.0,48102,59688.0,10304.0,14.72,-0.01,High Risk
U277,2024,8,229368.0,Salary Increases & Fixed Expenses Increase,69992,11586.0,43872,55458.0,14534.0,20.77,0.05,Medium Risk
U277,2024,9,243902.0,Salary Increases & Fixed Expenses Increase,69992,11586.0,44459,56045.0,13947.0,19.93,0.02,Medium Risk
U277,2024,10,257849.0,Salary Increases & Fixed Expenses Increase,69992,11586.0,51513,63099.0,6893.0,9.85,0.02,High Risk
U277,2024,11,264742.0,Salary Increases & Fixed Expenses Increase,69992,12312.0,53649,65961.0,4031.0,5.76,-0.04,High Risk
U277,2024,12,268773.0,Salary Increases & Fixed Expenses Increase,69992,12312.0,46529,58841.0,11151.0,15.93,-0.02,Medium Risk
U278,2024,1,231819.0,Salary Increases & Fixed Expenses Remain Stable,161782,52384.0,54961,107345.0,54437.0,33.65,-0.03,Low Risk
U278,2024,2,286256.0,Salary Increases & Fixed Expenses Remain Stable,161782,52384.0,63608,115992.0,45790.0,28.3,0.03,Low Risk
U278,2024,3,332046.0,Salary Increases & Fixed Expenses Remain Stable,161782,52384.0,69392,121776.0,40006.0,24.73,-0.04,Medium Risk
U278,2024,4,372052.0,Salary Increases & Fixed Expenses Remain Stable,181992,52384.0,64097,116481.0,65511.0,36.0,0.03,Low Risk
U278,2024,5,437563.0,Salary Increases & Fixed Expenses Remain Stable,181992,52384.0,68895,121279.0,60713.0,33.36,-0.01,Low Risk
U278,2024,6,498276.0,Salary Increases & Fixed Expenses Remain Stable,181992,52384.0,71365,123749.0,58243.0,32.0,-0.04,Low Risk
U278,2024,7,556519.0,Salary Increases & Fixed Expenses Remain Stable,181992,52384.0,69940,122324.0,59668.0,32.79,0.04,Low Risk
U278,2024,8,616187.0,Salary Increases & Fixed Expenses Remain Stable,181992,52384.0,62331,114715.0,67277.0,36.97,0.01,Low Risk
U278,2024,9,683464.0,Salary Increases & Fixed Expenses Remain Stable,181992,52384.0,68927,121311.0,60681.0,33.34,0.05,Low Risk
U278,2024,10,744145.0,Salary Increases & Fixed Expenses Remain Stable,181992,52384.0,64171,116555.0,65437.0,35.96,0.03,Low Risk
U278,2024,11,809582.0,Salary Increases & Fixed Expenses Remain Stable,181992,52384.0,78358,130742.0,51250.0,28.16,0.02,Low Risk
U278,2024,12,860832.0,Salary Increases & Fixed Expenses Remain Stable,181992,52384.0,68508,120892.0,61100.0,33.57,0.01,Low Risk
U279,2024,1,229486.0,Stable Salary & Stable Fixed Expenses,97422,24559.0,67879,92438.0,4984.0,5.12,0.02,High Risk
U279,2024,2,234470.0,Stable Salary & Stable Fixed Expenses,97422,24559.0,62823,87382.0,10040.0,10.31,0.04,High Risk
U279,2024,3,244510.0,Stable Salary & Stable Fixed Expenses,97422,24559.0,68665,93224.0,4198.0,4.31,0.03,High Risk
U279,2024,4,248708.0,Stable Salary & Stable Fixed Expenses,97422,24559.0,64574,89133.0,8289.0,8.51,0.0,High Risk
U279,2024,5,256997.0,Stable Salary & Stable Fixed Expenses,97422,24559.0,62870,87429.0,9993.0,10.26,0.04,High Risk
U279,2024,6,266990.0,Stable Salary & Stable Fixed Expenses,97422,24559.0,61627,86186.0,11236.0,11.53,-0.04,High Risk
U279,2024,7,278226.0,Stable Salary & Stable Fixed Expenses,97422,24559.0,72079,96638.0,784.0,0.8,0.03,High Risk
U279,2024,8,279010.0,Stable Salary & Stable Fixed Expenses,97422,24559.0,77903,102462.0,-5040.0,-5.17,-0.01,High Risk
U279,2024,9,273970.0,Stable Salary & Stable Fixed Expenses,97422,24559.0,76470,101029.0,-3607.0,-3.7,-0.02,High Risk
U279,2024,10,270363.0,Stable Salary & Stable Fixed Expenses,97422,24559.0,91862,116421.0,-18999.0,-19.5,0.04,High Risk
U279,2024,11,251364.0,Stable Salary & Stable Fixed Expenses,97422,24559.0,67613,92172.0,5250.0,5.39,-0.01,High Risk
U279,2024,12,256614.0,Stable Salary & Stable Fixed Expenses,97422,24559.0,68107,92666.0,4756.0,4.88,-0.03,High Risk
U280,2024,1,244990.0,Stable Salary & Stable Fixed Expenses,150978,46588.0,103528,150116.0,862.0,0.57,-0.01,High Risk
U280,2024,2,245852.0,Stable Salary & Stable Fixed Expenses,150978,46588.0,92594,139182.0,11796.0,7.81,-0.03,High Risk
U280,2024,3,257648.0,Stable Salary & Stable Fixed Expenses,150978,46588.0,127056,173644.0,-22666.0,-15.01,0.02,High Risk
U280,2024,4,234982.0,Stable Salary & Stable Fixed Expenses,150978,46588.0,95091,141679.0,9299.0,6.16,0.05,High Risk
U280,2024,5,244281.0,Stable Salary & Stable Fixed Expenses,150978,46588.0,96448,143036.0,7942.0,5.26,-0.03,High Risk
U280,2024,6,252223.0,Stable Salary & Stable Fixed Expenses,150978,46588.0,113174,159762.0,-8784.0,-5.82,0.04,High Risk
U280,2024,7,243439.0,Stable Salary & Stable Fixed Expenses,150978,46588.0,95878,142466.0,8512.0,5.64,-0.01,High Risk
U280,2024,8,251951.0,Stable Salary & Stable Fixed Expenses,150978,46588.0,119415,166003.0,-15025.0,-9.95,-0.01,High Risk
U280,2024,9,236926.0,Stable Salary & Stable Fixed Expenses,150978,46588.0,125296,171884.0,-20906.0,-13.85,-0.03,High Risk
U280,2024,10,216020.0,Stable Salary & Stable Fixed Expenses,150978,46588.0,139512,186100.0,-35122.0,-23.26,0.04,High Risk
U280,2024,11,180898.0,Stable Salary & Stable Fixed Expenses,150978,46588.0,113146,159734.0,-8756.0,-5.8,0.02,High Risk
U280,2024,12,172142.0,Stable Salary & Stable Fixed Expenses,150978,46588.0,145118,191706.0,-40728.0,-26.98,0.03,High Risk
U281,2024,1,209149.0,Salary Increases & Fixed Expenses Increase,32505,19825.0,10580,30405.0,2100.0,6.46,-0.02,High Risk
U281,2024,2,211249.0,Salary Increases & Fixed Expenses Increase,32505,19825.0,10542,30367.0,2138.0,6.58,-0.0,High Risk
U281,2024,3,213387.0,Salary Increases & Fixed Expenses Increase,32505,19825.0,12383,32208.0,297.0,0.91,-0.01,High Risk
U281,2024,4,213684.0,Salary Increases & Fixed Expenses Increase,32505,19825.0,9903,29728.0,2777.0,8.54,-0.03,High Risk
U281,2024,5,216461.0,Salary Increases & Fixed Expenses Increase,32505,19825.0,10668,30493.0,2012.0,6.19,-0.02,High Risk
U281,2024,6,218473.0,Salary Increases & Fixed Expenses Increase,32505,19825.0,11162,30987.0,1518.0,4.67,0.01,High Risk
U281,2024,7,219991.0,Salary Increases & Fixed Expenses Increase,50895,19825.0,17023,36848.0,14047.0,27.6,0.02,Low Risk
U281,2024,8,234038.0,Salary Increases & Fixed Expenses Increase,50895,19825.0,19876,39701.0,11194.0,21.99,-0.03,Medium Risk
U281,2024,9,245232.0,Salary Increases & Fixed Expenses Increase,50895,19825.0,20160,39985.0,10910.0,21.44,0.01,Medium Risk
U281,2024,10,256142.0,Salary Increases & Fixed Expenses Increase,50895,19825.0,21755,41580.0,9315.0,18.3,-0.02,Medium Risk
U281,2024,11,265457.0,Salary Increases & Fixed Expenses Increase,50895,19825.0,17965,37790.0,13105.0,25.75,0.05,Low Risk
U281,2024,12,278562.0,Salary Increases & Fixed Expenses Increase,50895,21753.0,17721,39474.0,11421.0,22.44,0.01,Medium Risk
U282,2024,1,221830.0,Salary Increases & Fixed Expenses Decrease,122407,72105.0,63158,135263.0,-12856.0,-10.5,-0.03,High Risk
U282,2024,2,208974.0,Salary Increases & Fixed Expenses Decrease,122407,72105.0,53700,125805.0,-3398.0,-2.78,0.03,High Risk
U282,2024,3,205576.0,Salary Increases & Fixed Expenses Decrease,122407,72105.0,70940,143045.0,-20638.0,-16.86,-0.03,High Risk
U282,2024,4,184938.0,Salary Increases & Fixed Expenses Decrease,122407,72105.0,66419,138524.0,-16117.0,-13.17,-0.05,High Risk
U282,2024,5,168821.0,Salary Increases & Fixed Expenses Decrease,136202,72105.0,74354,146459.0,-10257.0,-7.53,-0.02,High Risk
U282,2024,6,158564.0,Salary Increases & Fixed Expenses Decrease,136202,72105.0,73605,145710.0,-9508.0,-6.98,0.01,High Risk
U282,2024,7,149056.0,Salary Increases & Fixed Expenses Decrease,136202,72105.0,60950,133055.0,3147.0,2.31,0.02,High Risk
U282,2024,8,152203.0,Salary Increases & Fixed Expenses Decrease,136202,72105.0,75090,147195.0,-10993.0,-8.07,-0.01,High Risk
U282,2024,9,141210.0,Salary Increases & Fixed Expenses Decrease,136202,72105.0,57176,129281.0,6921.0,5.08,0.04,High Risk
U282,2024,10,148131.0,Salary Increases & Fixed Expenses Decrease,136202,72105.0,97458,169563.0,-33361.0,-24.49,0.05,High Risk
U282,2024,11,114770.0,Salary Increases & Fixed Expenses Decrease,136202,72105.0,70468,142573.0,-6371.0,-4.68,-0.01,High Risk
U282,2024,12,108399.0,Salary Increases & Fixed Expenses Decrease,136202,72105.0,76797,148902.0,-12700.0,-9.32,-0.04,High Risk
U283,2024,1,212148.0,Stable Salary & Stable Fixed Expenses,213293,84128.0,65603,149731.0,63562.0,29.8,0.04,Low Risk
U283,2024,2,275710.0,Stable Salary & Stable Fixed Expenses,213293,84128.0,70276,154404.0,58889.0,27.61,-0.0,Low Risk
U283,2024,3,334599.0,Stable Salary & Stable Fixed Expenses,213293,84128.0,70280,154408.0,58885.0,27.61,-0.01,Low Risk
U283,2024,4,393484.0,Stable Salary & Stable Fixed Expenses,213293,84128.0,80681,164809.0,48484.0,22.73,-0.03,Medium Risk
U283,2024,5,441968.0,Stable Salary & Stable Fixed Expenses,213293,84128.0,82268,166396.0,46897.0,21.99,-0.04,Medium Risk
U283,2024,6,488865.0,Stable Salary & Stable Fixed Expenses,213293,84128.0,79164,163292.0,50001.0,23.44,-0.03,Medium Risk
U283,2024,7,538866.0,Stable Salary & Stable Fixed Expenses,213293,84128.0,73266,157394.0,55899.0,26.21,0.04,Low Risk
U283,2024,8,594765.0,Stable Salary & Stable Fixed Expenses,213293,84128.0,77860,161988.0,51305.0,24.05,-0.04,Medium Risk
U283,2024,9,646070.0,Stable Salary & Stable Fixed Expenses,213293,84128.0,85049,169177.0,44116.0,20.68,0.05,Medium Risk
U283,2024,10,690186.0,Stable Salary & Stable Fixed Expenses,213293,84128.0,66476,150604.0,62689.0,29.39,0.03,Low Risk
U283,2024,11,752875.0,Stable Salary & Stable Fixed Expenses,213293,84128.0,83291,167419.0,45874.0,21.51,-0.01,Medium Risk
U283,2024,12,798749.0,Stable Salary & Stable Fixed Expenses,213293,84128.0,75941,160069.0,53224.0,24.95,-0.05,Medium Risk
U284,2024,1,249087.0,Salary Increases & Fixed Expenses Remain Stable,40424,19474.0,13575,33049.0,7375.0,18.24,0.05,Medium Risk
U284,2024,2,256462.0,Salary Increases & Fixed Expenses Remain Stable,40424,19474.0,12718,32192.0,8232.0,20.36,-0.05,Medium Risk
U284,2024,3,264694.0,Salary Increases & Fixed Expenses Remain Stable,40424,19474.0,17984,37458.0,2966.0,7.34,0.04,High Risk
U284,2024,4,267660.0,Salary Increases & Fixed Expenses Remain Stable,40424,19474.0,14957,34431.0,5993.0,14.83,0.04,High Risk
U284,2024,5,273653.0,Salary Increases & Fixed Expenses Remain Stable,40424,19474.0,16129,35603.0,4821.0,11.93,-0.03,High Risk
U284,2024,6,278474.0,Salary Increases & Fixed Expenses Remain Stable,45951,19474.0,14726,34200.0,11751.0,25.57,0.05,Low Risk
U284,2024,7,290225.0,Salary Increases & Fixed Expenses Remain Stable,45951,19474.0,14885,34359.0,11592.0,25.23,-0.01,Low Risk
U284,2024,8,301817.0,Salary Increases & Fixed Expenses Remain Stable,45951,19474.0,18301,37775.0,8176.0,17.79,-0.01,Medium Risk
U284,2024,9,309993.0,Salary Increases & Fixed Expenses Remain Stable,45951,19474.0,18972,38446.0,7505.0,16.33,-0.03,Medium Risk
U284,2024,10,317498.0,Salary Increases & Fixed Expenses Remain Stable,45951,19474.0,16946,36420.0,9531.0,20.74,0.01,Medium Risk
U284,2024,11,327029.0,Salary Increases & Fixed Expenses Remain Stable,45951,19474.0,17372,36846.0,9105.0,19.81,-0.03,Medium Risk
U284,2024,12,336134.0,Salary Increases & Fixed Expenses Remain Stable,45951,19474.0,23145,42619.0,3332.0,7.25,0.03,High Risk
U285,2024,1,220880.0,Salary Increases & Fixed Expenses Increase,255219,85231.0,148435,233666.0,21553.0,8.44,-0.01,High Risk
U285,2024,2,242433.0,Salary Increases & Fixed Expenses Increase,255219,85231.0,125439,210670.0,44549.0,17.46,0.03,Medium Risk
U285,2024,3,286982.0,Salary Increases & Fixed Expenses Increase,255219,85231.0,182915,268146.0,-12927.0,-5.07,0.03,High Risk
U285,2024,4,274055.0,Salary Increases & Fixed Expenses Increase,255219,85231.0,129153,214384.0,40835.0,16.0,0.04,Medium Risk
U285,2024,5,314890.0,Salary Increases & Fixed Expenses Increase,255219,85231.0,122278,207509.0,47710.0,18.69,-0.02,Medium Risk
U285,2024,6,362600.0,Salary Increases & Fixed Expenses Increase,255219,85231.0,136896,222127.0,33092.0,12.97,0.04,High Risk
U285,2024,7,395692.0,Salary Increases & Fixed Expenses Increase,255219,85231.0,139885,225116.0,30103.0,11.79,0.05,High Risk
U285,2024,8,425795.0,Salary Increases & Fixed Expenses Increase,279990,85231.0,128138,213369.0,66621.0,23.79,0.0,Medium Risk
U285,2024,9,492416.0,Salary Increases & Fixed Expenses Increase,279990,85231.0,183819,269050.0,10940.0,3.91,-0.01,High Risk
U285,2024,10,503356.0,Salary Increases & Fixed Expenses Increase,279990,85231.0,152084,237315.0,42675.0,15.24,-0.04,Medium Risk
U285,2024,11,546031.0,Salary Increases & Fixed Expenses Increase,279990,85231.0,138363,223594.0,56396.0,20.14,0.04,Medium Risk
U285,2024,12,602427.0,Salary Increases & Fixed Expenses Increase,279990,85231.0,168256,253487.0,26503.0,9.47,0.04,High Risk
U286,2024,1,218312.0,Salary Increases & Fixed Expenses Remain Stable,199307,57329.0,75264,132593.0,66714.0,33.47,0.01,Low Risk
U286,2024,2,285026.0,Salary Increases & Fixed Expenses Remain Stable,199307,57329.0,70314,127643.0,71664.0,35.96,0.03,Low Risk
U286,2024,3,356690.0,Salary Increases & Fixed Expenses Remain Stable,199307,57329.0,67090,124419.0,74888.0,37.57,-0.03,Low Risk
U286,2024,4,431578.0,Salary Increases & Fixed Expenses Remain Stable,204331,57329.0,64683,122012.0,82319.0,40.29,0.04,Low Risk
U286,2024,5,513897.0,Salary Increases & Fixed Expenses Remain Stable,204331,57329.0,62423,119752.0,84579.0,41.39,-0.04,Low Risk
U286,2024,6,598476.0,Salary Increases & Fixed Expenses Remain Stable,204331,57329.0,62594,119923.0,84408.0,41.31,-0.01,Low Risk
U286,2024,7,682884.0,Salary Increases & Fixed Expenses Remain Stable,204331,57329.0,63813,121142.0,83189.0,40.71,0.04,Low Risk
U286,2024,8,766073.0,Salary Increases & Fixed Expenses Remain Stable,204331,57329.0,65441,122770.0,81561.0,39.92,-0.04,Low Risk
U286,2024,9,847634.0,Salary Increases & Fixed Expenses Remain Stable,204331,57329.0,64209,121538.0,82793.0,40.52,-0.0,Low Risk
U286,2024,10,930427.0,Salary Increases & Fixed Expenses Remain Stable,204331,57329.0,70828,128157.0,76174.0,37.28,0.03,Low Risk
U286,2024,11,1006601.0,Salary Increases & Fixed Expenses Remain Stable,204331,57329.0,78316,135645.0,68686.0,33.62,-0.02,Low Risk
U286,2024,12,1075287.0,Salary Increases & Fixed Expenses Remain Stable,204331,57329.0,75317,132646.0,71685.0,35.08,0.04,Low Risk
U287,2024,1,231700.0,Salary Increases & Fixed Expenses Increase,150572,47326.0,83297,130623.0,19949.0,13.25,-0.03,High Risk
U287,2024,2,251649.0,Salary Increases & Fixed Expenses Increase,150572,47326.0,82071,129397.0,21175.0,14.06,-0.04,High Risk
U287,2024,3,272824.0,Salary Increases & Fixed Expenses Increase,150572,47326.0,68253,115579.0,34993.0,23.24,-0.02,Medium Risk
U287,2024,4,307817.0,Salary Increases & Fixed Expenses Increase,169533,47326.0,71724,119050.0,50483.0,29.78,0.05,Low Risk
U287,2024,5,358300.0,Salary Increases & Fixed Expenses Increase,169533,47326.0,84678,132004.0,37529.0,22.14,0.04,Medium Risk
U287,2024,6,395829.0,Salary Increases & Fixed Expenses Increase,169533,47326.0,70307,117633.0,51900.0,30.61,-0.0,Low Risk
U287,2024,7,447729.0,Salary Increases & Fixed Expenses Increase,169533,47326.0,100338,147664.0,21869.0,12.9,0.04,High Risk
U287,2024,8,469598.0,Salary Increases & Fixed Expenses Increase,169533,47326.0,83551,130877.0,38656.0,22.8,0.03,Medium Risk
U287,2024,9,508254.0,Salary Increases & Fixed Expenses Increase,169533,47326.0,90847,138173.0,31360.0,18.5,0.01,Medium Risk
U287,2024,10,539614.0,Salary Increases & Fixed Expenses Increase,169533,47326.0,71014,118340.0,51193.0,30.2,-0.04,Low Risk
U287,2024,11,590807.0,Salary Increases & Fixed Expenses Increase,169533,47326.0,89534,136860.0,32673.0,19.27,-0.02,Medium Risk
U287,2024,12,623480.0,Salary Increases & Fixed Expenses Increase,169533,47326.0,91411,138737.0,30796.0,18.17,-0.04,Medium Risk
U288,2024,1,207277.0,Stable Salary & Stable Fixed Expenses,75794,29496.0,35225,64721.0,11073.0,14.61,0.03,High Risk
U288,2024,2,218350.0,Stable Salary & Stable Fixed Expenses,75794,29496.0,36532,66028.0,9766.0,12.88,0.01,High Risk
U288,2024,3,228116.0,Stable Salary & Stable Fixed Expenses,75794,29496.0,31522,61018.0,14776.0,19.49,0.03,Medium Risk
U288,2024,4,242892.0,Stable Salary & Stable Fixed Expenses,75794,29496.0,35410,64906.0,10888.0,14.37,-0.05,High Risk
U288,2024,5,253780.0,Stable Salary & Stable Fixed Expenses,75794,29496.0,38773,68269.0,7525.0,9.93,0.04,High Risk
U288,2024,6,261305.0,Stable Salary & Stable Fixed Expenses,75794,29496.0,38501,67997.0,7797.0,10.29,-0.01,High Risk
U288,2024,7,269102.0,Stable Salary & Stable Fixed Expenses,75794,29496.0,31289,60785.0,15009.0,19.8,0.03,Medium Risk
U288,2024,8,284111.0,Stable Salary & Stable Fixed Expenses,75794,29496.0,35019,64515.0,11279.0,14.88,-0.03,High Risk
U288,2024,9,295390.0,Stable Salary & Stable Fixed Expenses,75794,29496.0,31798,61294.0,14500.0,19.13,0.01,Medium Risk
U288,2024,10,309890.0,Stable Salary & Stable Fixed Expenses,75794,29496.0,34899,64395.0,11399.0,15.04,0.02,Medium Risk
U288,2024,11,321289.0,Stable Salary & Stable Fixed Expenses,75794,29496.0,39045,68541.0,7253.0,9.57,0.03,High Risk
U288,2024,12,328542.0,Stable Salary & Stable Fixed Expenses,75794,29496.0,43828,73324.0,2470.0,3.26,0.03,High Risk
U289,2024,1,213789.0,Stable Salary & Decreasing Fixed Expenses,27059,18277.0,18881,37158.0,-10099.0,-37.32,0.03,High Risk
U289,2024,2,203690.0,Stable Salary & Decreasing Fixed Expenses,27059,18277.0,21376,39653.0,-12594.0,-46.54,0.01,High Risk
U289,2024,3,191096.0,Stable Salary & Decreasing Fixed Expenses,27059,18277.0,24621,42898.0,-15839.0,-58.54,0.01,High Risk
U289,2024,4,175257.0,Stable Salary & Decreasing Fixed Expenses,27059,18277.0,18773,37050.0,-9991.0,-36.92,0.03,High Risk
U289,2024,5,165266.0,Stable Salary & Decreasing Fixed Expenses,27059,18277.0,16569,34846.0,-7787.0,-28.78,0.0,High Risk
U289,2024,6,157479.0,Stable Salary & Decreasing Fixed Expenses,27059,18277.0,18553,36830.0,-9771.0,-36.11,-0.02,High Risk
U289,2024,7,147708.0,Stable Salary & Decreasing Fixed Expenses,27059,18277.0,17274,35551.0,-8492.0,-31.38,-0.01,High Risk
U289,2024,8,139216.0,Stable Salary & Decreasing Fixed Expenses,27059,18277.0,17059,35336.0,-8277.0,-30.59,-0.03,High Risk
U289,2024,9,130939.0,Stable Salary & Decreasing Fixed Expenses,27059,18277.0,17538,35815.0,-8756.0,-32.36,-0.05,High Risk
U289,2024,10,122183.0,Stable Salary & Decreasing Fixed Expenses,27059,18277.0,20448,38725.0,-11666.0,-43.11,0.01,High Risk
U289,2024,11,110517.0,Stable Salary & Decreasing Fixed Expenses,27059,18277.0,21625,39902.0,-12843.0,-47.46,-0.0,High Risk
U289,2024,12,97674.0,Stable Salary & Decreasing Fixed Expenses,27059,18277.0,21432,39709.0,-12650.0,-46.75,-0.03,High Risk
U290,2024,1,245443.0,Stable Salary & Stable Fixed Expenses,102316,76677.0,54799,131476.0,-29160.0,-28.5,-0.03,High Risk
U290,2024,2,216283.0,Stable Salary & Stable Fixed Expenses,102316,76677.0,55167,131844.0,-29528.0,-28.86,0.01,High Risk
U290,2024,3,186755.0,Stable Salary & Stable Fixed Expenses,102316,76677.0,72905,149582.0,-47266.0,-46.2,-0.0,High Risk
U290,2024,4,139489.0,Stable Salary & Stable Fixed Expenses,102316,76677.0,47150,123827.0,-21511.0,-21.02,0.01,High Risk
U290,2024,5,117978.0,Stable Salary & Stable Fixed Expenses,102316,76677.0,49342,126019.0,-23703.0,-23.17,-0.03,High Risk
U290,2024,6,94275.0,Stable Salary & Stable Fixed Expenses,102316,76677.0,47628,124305.0,-21989.0,-21.49,-0.03,High Risk
U290,2024,7,72286.0,Stable Salary & Stable Fixed Expenses,102316,76677.0,43277,119954.0,-17638.0,-17.24,-0.04,High Risk
U290,2024,8,54648.0,Stable Salary & Stable Fixed Expenses,102316,76677.0,58355,135032.0,-32716.0,-31.98,0.0,High Risk
U290,2024,9,21932.0,Stable Salary & Stable Fixed Expenses,102316,76677.0,44291,120968.0,-18652.0,-18.23,0.05,High Risk
U290,2024,10,3280.0,Stable Salary & Stable Fixed Expenses,102316,76677.0,50327,127004.0,-24688.0,-24.13,0.03,High Risk
U290,2024,11,-21408.0,Stable Salary & Stable Fixed Expenses,102316,76677.0,54177,130854.0,-28538.0,-27.89,-0.02,High Risk
U290,2024,12,-49946.0,Stable Salary & Stable Fixed Expenses,102316,76677.0,56631,133308.0,-30992.0,-30.29,-0.03,High Risk
U291,2024,1,235481.0,Salary Increases & Fixed Expenses Remain Stable,204238,63413.0,105974,169387.0,34851.0,17.06,-0.02,Medium Risk
U291,2024,2,270332.0,Salary Increases & Fixed Expenses Remain Stable,204238,63413.0,110009,173422.0,30816.0,15.09,0.01,Medium Risk
U291,2024,3,301148.0,Salary Increases & Fixed Expenses Remain Stable,204238,63413.0,83283,146696.0,57542.0,28.17,-0.01,Low Risk
U291,2024,4,358690.0,Salary Increases & Fixed Expenses Remain Stable,229312,63413.0,130576,193989.0,35323.0,15.4,0.01,Medium Risk
U291,2024,5,394013.0,Salary Increases & Fixed Expenses Remain Stable,229312,63413.0,101268,164681.0,64631.0,28.18,-0.01,Low Risk
U291,2024,6,458644.0,Salary Increases & Fixed Expenses Remain Stable,229312,63413.0,93628,157041.0,72271.0,31.52,0.02,Low Risk
U291,2024,7,530915.0,Salary Increases & Fixed Expenses Remain Stable,229312,63413.0,129764,193177.0,36135.0,15.76,-0.0,Medium Risk
U291,2024,8,567050.0,Salary Increases & Fixed Expenses Remain Stable,229312,63413.0,98789,162202.0,67110.0,29.27,-0.01,Low Risk
U291,2024,9,634160.0,Salary Increases & Fixed Expenses Remain Stable,229312,63413.0,134207,197620.0,31692.0,13.82,-0.03,High Risk
U291,2024,10,665852.0,Salary Increases & Fixed Expenses Remain Stable,229312,63413.0,125575,188988.0,40324.0,17.58,0.0,Medium Risk
U291,2024,11,706176.0,Salary Increases & Fixed Expenses Remain Stable,229312,63413.0,132427,195840.0,33472.0,14.6,0.01,High Risk
U291,2024,12,739648.0,Salary Increases & Fixed Expenses Remain Stable,229312,63413.0,98882,162295.0,67017.0,29.23,-0.02,Low Risk
U292,2024,1,234737.0,Stable Salary & Decreasing Fixed Expenses,196673,57452.0,101541,158993.0,37680.0,19.16,0.04,Medium Risk
U292,2024,2,272417.0,Stable Salary & Decreasing Fixed Expenses,196673,57452.0,96797,154249.0,42424.0,21.57,-0.03,Medium Risk
U292,2024,3,314841.0,Stable Salary & Decreasing Fixed Expenses,196673,57452.0,135186,192638.0,4035.0,2.05,0.04,High Risk
U292,2024,4,318876.0,Stable Salary & Decreasing Fixed Expenses,196673,57452.0,79316,136768.0,59905.0,30.46,-0.04,Low Risk
U292,2024,5,378781.0,Stable Salary & Decreasing Fixed Expenses,196673,57452.0,83618,141070.0,55603.0,28.27,0.01,Low Risk
U292,2024,6,434384.0,Stable Salary & Decreasing Fixed Expenses,196673,57452.0,89919,147371.0,49302.0,25.07,-0.05,Low Risk
U292,2024,7,483686.0,Stable Salary & Decreasing Fixed Expenses,196673,57452.0,81120,138572.0,58101.0,29.54,0.04,Low Risk
U292,2024,8,541787.0,Stable Salary & Decreasing Fixed Expenses,196673,57452.0,100264,157716.0,38957.0,19.81,0.01,Medium Risk
U292,2024,9,580744.0,Stable Salary & Decreasing Fixed Expenses,196673,57452.0,124275,181727.0,14946.0,7.6,-0.02,High Risk
U292,2024,10,595690.0,Stable Salary & Decreasing Fixed Expenses,196673,57452.0,143323,200775.0,-4102.0,-2.09,0.03,High Risk
U292,2024,11,591588.0,Stable Salary & Decreasing Fixed Expenses,196673,57452.0,109810,167262.0,29411.0,14.95,0.03,High Risk
U292,2024,12,620999.0,Stable Salary & Decreasing Fixed Expenses,196673,57452.0,95757,153209.0,43464.0,22.1,0.04,Medium Risk
U293,2024,1,209152.0,Stable Salary & Stable Fixed Expenses,222140,80825.0,68011,148836.0,73304.0,33.0,-0.01,Low Risk
U293,2024,2,282456.0,Stable Salary & Stable Fixed Expenses,222140,80825.0,83267,164092.0,58048.0,26.13,-0.05,Low Risk
U293,2024,3,340504.0,Stable Salary & Stable Fixed Expenses,222140,80825.0,80370,161195.0,60945.0,27.44,0.02,Low Risk
U293,2024,4,401449.0,Stable Salary & Stable Fixed Expenses,222140,80825.0,87380,168205.0,53935.0,24.28,0.03,Medium Risk
U293,2024,5,455384.0,Stable Salary & Stable Fixed Expenses,222140,80825.0,80235,161060.0,61080.0,27.5,0.02,Low Risk
U293,2024,6,516464.0,Stable Salary & Stable Fixed Expenses,222140,80825.0,71295,152120.0,70020.0,31.52,-0.03,Low Risk
U293,2024,7,586484.0,Stable Salary & Stable Fixed Expenses,222140,80825.0,76783,157608.0,64532.0,29.05,0.05,Low Risk
U293,2024,8,651016.0,Stable Salary & Stable Fixed Expenses,222140,80825.0,87873,168698.0,53442.0,24.06,-0.04,Medium Risk
U293,2024,9,704458.0,Stable Salary & Stable Fixed Expenses,222140,80825.0,87908,168733.0,53407.0,24.04,-0.0,Medium Risk
U293,2024,10,757865.0,Stable Salary & Stable Fixed Expenses,222140,80825.0,67689,148514.0,73626.0,33.14,0.0,Low Risk
U293,2024,11,831491.0,Stable Salary & Stable Fixed Expenses,222140,80825.0,79416,160241.0,61899.0,27.86,-0.03,Low Risk
U293,2024,12,893390.0,Stable Salary & Stable Fixed Expenses,222140,80825.0,69730,150555.0,71585.0,32.23,-0.04,Low Risk
U294,2024,1,225762.0,Stable Salary & Increasing Fixed Expenses,226230,92183.0,85349,177532.0,48698.0,21.53,-0.0,Medium Risk
U294,2024,2,274460.0,Stable Salary & Increasing Fixed Expenses,226230,92183.0,72587,164770.0,61460.0,27.17,0.01,Low Risk
U294,2024,3,335920.0,Stable Salary & Increasing Fixed Expenses,226230,92183.0,76478,168661.0,57569.0,25.45,0.01,Low Risk
U294,2024,4,393489.0,Stable Salary & Increasing Fixed Expenses,226230,92183.0,82270,174453.0,51777.0,22.89,0.02,Medium Risk
U294,2024,5,445266.0,Stable Salary & Increasing Fixed Expenses,226230,92990.0,73538,166528.0,59702.0,26.39,-0.04,Low Risk
U294,2024,6,504968.0,Stable Salary & Increasing Fixed Expenses,226230,92990.0,74755,167745.0,58485.0,25.85,-0.04,Low Risk
U294,2024,7,563453.0,Stable Salary & Increasing Fixed Expenses,226230,92990.0,73171,166161.0,60069.0,26.55,0.02,Low Risk
U294,2024,8,623522.0,Stable Salary & Increasing Fixed Expenses,226230,92990.0,77307,170297.0,55933.0,24.72,0.03,Medium Risk
U294,2024,9,679455.0,Stable Salary & Increasing Fixed Expenses,226230,92990.0,73749,166739.0,59491.0,26.3,-0.05,Low Risk
U294,2024,10,738946.0,Stable Salary & Increasing Fixed Expenses,226230,92990.0,69744,162734.0,63496.0,28.07,-0.04,Low Risk
U294,2024,11,802442.0,Stable Salary & Increasing Fixed Expenses,226230,92990.0,69906,162896.0,63334.0,28.0,-0.05,Low Risk
U294,2024,12,865776.0,Stable Salary & Increasing Fixed Expenses,226230,92990.0,87103,180093.0,46137.0,20.39,-0.04,Medium Risk
U295,2024,1,240028.0,Stable Salary & Stable Fixed Expenses,56953,26724.0,29235,55959.0,994.0,1.75,-0.03,High Risk
U295,2024,2,241022.0,Stable Salary & Stable Fixed Expenses,56953,26724.0,32945,59669.0,-2716.0,-4.77,-0.03,High Risk
U295,2024,3,238306.0,Stable Salary & Stable Fixed Expenses,56953,26724.0,31563,58287.0,-1334.0,-2.34,-0.05,High Risk
U295,2024,4,236972.0,Stable Salary & Stable Fixed Expenses,56953,26724.0,24211,50935.0,6018.0,10.57,-0.04,High Risk
U295,2024,5,242990.0,Stable Salary & Stable Fixed Expenses,56953,26724.0,33409,60133.0,-3180.0,-5.58,-0.04,High Risk
U295,2024,6,239810.0,Stable Salary & Stable Fixed Expenses,56953,26724.0,32503,59227.0,-2274.0,-3.99,0.04,High Risk
U295,2024,7,237536.0,Stable Salary & Stable Fixed Expenses,56953,26724.0,23153,49877.0,7076.0,12.42,-0.04,High Risk
U295,2024,8,244612.0,Stable Salary & Stable Fixed Expenses,56953,26724.0,29275,55999.0,954.0,1.68,0.01,High Risk
U295,2024,9,245566.0,Stable Salary & Stable Fixed Expenses,56953,26724.0,33592,60316.0,-3363.0,-5.9,-0.05,High Risk
U295,2024,10,242203.0,Stable Salary & Stable Fixed Expenses,56953,26724.0,27741,54465.0,2488.0,4.37,-0.04,High Risk
U295,2024,11,244691.0,Stable Salary & Stable Fixed Expenses,56953,26724.0,27200,53924.0,3029.0,5.32,0.03,High Risk
U295,2024,12,247720.0,Stable Salary & Stable Fixed Expenses,56953,26724.0,37417,64141.0,-7188.0,-12.62,0.05,High Risk
U296,2024,1,205487.0,Stable Salary & Stable Fixed Expenses,89294,37036.0,56282,93318.0,-4024.0,-4.51,-0.01,High Risk
U296,2024,2,201463.0,Stable Salary & Stable Fixed Expenses,89294,37036.0,69877,106913.0,-17619.0,-19.73,-0.04,High Risk
U296,2024,3,183844.0,Stable Salary & Stable Fixed Expenses,89294,37036.0,55987,93023.0,-3729.0,-4.18,-0.05,High Risk
U296,2024,4,180115.0,Stable Salary & Stable Fixed Expenses,89294,37036.0,55074,92110.0,-2816.0,-3.15,-0.01,High Risk
U296,2024,5,177299.0,Stable Salary & Stable Fixed Expenses,89294,37036.0,68433,105469.0,-16175.0,-18.11,0.05,High Risk
U296,2024,6,161124.0,Stable Salary & Stable Fixed Expenses,89294,37036.0,63336,100372.0,-11078.0,-12.41,0.02,High Risk
U296,2024,7,150046.0,Stable Salary & Stable Fixed Expenses,89294,37036.0,58464,95500.0,-6206.0,-6.95,0.02,High Risk
U296,2024,8,143840.0,Stable Salary & Stable Fixed Expenses,89294,37036.0,60629,97665.0,-8371.0,-9.37,-0.01,High Risk
U296,2024,9,135469.0,Stable Salary & Stable Fixed Expenses,89294,37036.0,68534,105570.0,-16276.0,-18.23,0.0,High Risk
U296,2024,10,119193.0,Stable Salary & Stable Fixed Expenses,89294,37036.0,60238,97274.0,-7980.0,-8.94,0.02,High Risk
U296,2024,11,111213.0,Stable Salary & Stable Fixed Expenses,89294,37036.0,70307,107343.0,-18049.0,-20.21,0.04,High Risk
U296,2024,12,93164.0,Stable Salary & Stable Fixed Expenses,89294,37036.0,67306,104342.0,-15048.0,-16.85,0.01,High Risk
U297,2024,1,215736.0,Salary Increases & Fixed Expenses Remain Stable,31338,17321.0,11868,29189.0,2149.0,6.86,0.01,High Risk
U297,2024,2,217885.0,Salary Increases & Fixed Expenses Remain Stable,31338,17321.0,10937,28258.0,3080.0,9.83,-0.01,High Risk
U297,2024,3,220965.0,Salary Increases & Fixed Expenses Remain Stable,31338,17321.0,11944,29265.0,2073.0,6.61,0.01,High Risk
U297,2024,4,223038.0,Salary Increases & Fixed Expenses Remain Stable,50847,17321.0,15852,33173.0,17674.0,34.76,0.01,Low Risk
U297,2024,5,240712.0,Salary Increases & Fixed Expenses Remain Stable,50847,17321.0,18733,36054.0,14793.0,29.09,0.05,Low Risk
U297,2024,6,255505.0,Salary Increases & Fixed Expenses Remain Stable,50847,17321.0,17380,34701.0,16146.0,31.75,0.0,Low Risk
U297,2024,7,271651.0,Salary Increases & Fixed Expenses Remain Stable,50847,17321.0,16792,34113.0,16734.0,32.91,-0.0,Low Risk
U297,2024,8,288385.0,Salary Increases & Fixed Expenses Remain Stable,50847,17321.0,18644,35965.0,14882.0,29.27,-0.01,Low Risk
U297,2024,9,303267.0,Salary Increases & Fixed Expenses Remain Stable,50847,17321.0,19904,37225.0,13622.0,26.79,0.01,Low Risk
U297,2024,10,316889.0,Salary Increases & Fixed Expenses Remain Stable,50847,17321.0,22910,40231.0,10616.0,20.88,0.03,Medium Risk
U297,2024,11,327505.0,Salary Increases & Fixed Expenses Remain Stable,50847,17321.0,20251,37572.0,13275.0,26.11,-0.04,Low Risk
U297,2024,12,340780.0,Salary Increases & Fixed Expenses Remain Stable,50847,17321.0,19624,36945.0,13902.0,27.34,-0.02,Low Risk
U298,2024,1,233418.0,Salary Increases & Fixed Expenses Increase,89365,34492.0,43024,77516.0,11849.0,13.26,-0.05,High Risk
U298,2024,2,245267.0,Salary Increases & Fixed Expenses Increase,89365,35032.0,37419,72451.0,16914.0,18.93,-0.04,Medium Risk
U298,2024,3,262181.0,Salary Increases & Fixed Expenses Increase,89365,35032.0,40815,75847.0,13518.0,15.13,0.0,Medium Risk
U298,2024,4,275699.0,Salary Increases & Fixed Expenses Increase,89365,35032.0,50331,85363.0,4002.0,4.48,0.01,High Risk
U298,2024,5,279701.0,Salary Increases & Fixed Expenses Increase,89365,35032.0,43101,78133.0,11232.0,12.57,-0.04,High Risk
U298,2024,6,290933.0,Salary Increases & Fixed Expenses Increase,89365,35032.0,45037,80069.0,9296.0,10.4,-0.04,High Risk
U298,2024,7,300229.0,Salary Increases & Fixed Expenses Increase,89365,35032.0,36519,71551.0,17814.0,19.93,0.0,Medium Risk
U298,2024,8,318043.0,Salary Increases & Fixed Expenses Increase,112076,35032.0,64909,99941.0,12135.0,10.83,0.01,High Risk
U298,2024,9,330178.0,Salary Increases & Fixed Expenses Increase,112076,35032.0,53068,88100.0,23976.0,21.39,0.03,Medium Risk
U298,2024,10,354154.0,Salary Increases & Fixed Expenses Increase,112076,36382.0,55776,92158.0,19918.0,17.77,0.02,Medium Risk
U298,2024,11,374072.0,Salary Increases & Fixed Expenses Increase,112076,36382.0,63069,99451.0,12625.0,11.26,-0.05,High Risk
U298,2024,12,386697.0,Salary Increases & Fixed Expenses Increase,112076,36382.0,52715,89097.0,22979.0,20.5,0.04,Medium Risk
U299,2024,1,215370.0,Salary Increases & Fixed Expenses Increase,219562,113248.0,145864,259112.0,-39550.0,-18.01,0.04,High Risk
U299,2024,2,175820.0,Salary Increases & Fixed Expenses Increase,219562,114343.0,147763,262106.0,-42544.0,-19.38,0.05,High Risk
U299,2024,3,133276.0,Salary Increases & Fixed Expenses Increase,219562,115896.0,212843,328739.0,-109177.0,-49.72,-0.03,High Risk
U299,2024,4,24099.0,Salary Increases & Fixed Expenses Increase,219562,115896.0,148987,264883.0,-45321.0,-20.64,0.01,High Risk
U299,2024,5,-21222.0,Salary Increases & Fixed Expenses Increase,219562,115896.0,164871,280767.0,-61205.0,-27.88,-0.02,High Risk
U299,2024,6,-82427.0,Salary Increases & Fixed Expenses Increase,219562,117841.0,131987,249828.0,-30266.0,-13.78,-0.02,High Risk
U299,2024,7,-112693.0,Salary Increases & Fixed Expenses Increase,219562,117841.0,165448,283289.0,-63727.0,-29.02,-0.03,High Risk
U299,2024,8,-176420.0,Salary Increases & Fixed Expenses Increase,247901,118582.0,176630,295212.0,-47311.0,-19.08,-0.01,High Risk
U299,2024,9,-223731.0,Salary Increases & Fixed Expenses Increase,247901,118582.0,158794,277376.0,-29475.0,-11.89,0.01,High Risk
U299,2024,10,-253206.0,Salary Increases & Fixed Expenses Increase,247901,118582.0,243933,362515.0,-114614.0,-46.23,-0.02,High Risk
U299,2024,11,-367820.0,Salary Increases & Fixed Expenses Increase,247901,118582.0,164832,283414.0,-35513.0,-14.33,-0.04,High Risk
U299,2024,12,-403333.0,Salary Increases & Fixed Expenses Increase,247901,118582.0,174399,292981.0,-45080.0,-18.18,-0.04,High Risk
U300,2024,1,244357.0,Stable Salary & Increasing Fixed Expenses,233736,102772.0,111756,214528.0,19208.0,8.22,0.01,High Risk
U300,2024,2,263565.0,Stable Salary & Increasing Fixed Expenses,233736,102772.0,113278,216050.0,17686.0,7.57,-0.04,High Risk
U300,2024,3,281251.0,Stable Salary & Increasing Fixed Expenses,233736,102772.0,118282,221054.0,12682.0,5.43,-0.03,High Risk
U300,2024,4,293933.0,Stable Salary & Increasing Fixed Expenses,233736,102772.0,99832,202604.0,31132.0,13.32,-0.01,High Risk
U300,2024,5,325065.0,Stable Salary & Increasing Fixed Expenses,233736,102772.0,119235,222007.0,11729.0,5.02,-0.03,High Risk
U300,2024,6,336794.0,Stable Salary & Increasing Fixed Expenses,233736,102772.0,125292,228064.0,5672.0,2.43,-0.04,High Risk
U300,2024,7,342466.0,Stable Salary & Increasing Fixed Expenses,233736,102772.0,121948,224720.0,9016.0,3.86,0.02,High Risk
U300,2024,8,351482.0,Stable Salary & Increasing Fixed Expenses,233736,102772.0,94981,197753.0,35983.0,15.39,0.01,Medium Risk
U300,2024,9,387465.0,Stable Salary & Increasing Fixed Expenses,233736,103637.0,132857,236494.0,-2758.0,-1.18,0.04,High Risk
U300,2024,10,384707.0,Stable Salary & Increasing Fixed Expenses,233736,103637.0,132617,236254.0,-2518.0,-1.08,-0.0,High Risk
U300,2024,11,382189.0,Stable Salary & Increasing Fixed Expenses,233736,103637.0,102939,206576.0,27160.0,11.62,-0.05,High Risk
U300,2024,12,409349.0,Stable Salary & Increasing Fixed Expenses,233736,105593.0,107158,212751.0,20985.0,8.98,-0.05,High Risk
U301,2024,1,217088.0,Stable Salary & Stable Fixed Expenses,237617,102331.0,115930,218261.0,19356.0,8.15,-0.02,High Risk
U301,2024,2,236444.0,Stable Salary & Stable Fixed Expenses,237617,102331.0,112895,215226.0,22391.0,9.42,0.03,High Risk
U301,2024,3,258835.0,Stable Salary & Stable Fixed Expenses,237617,102331.0,108322,210653.0,26964.0,11.35,0.04,High Risk
U301,2024,4,285799.0,Stable Salary & Stable Fixed Expenses,237617,102331.0,109716,212047.0,25570.0,10.76,0.01,High Risk
U301,2024,5,311369.0,Stable Salary & Stable Fixed Expenses,237617,102331.0,117703,220034.0,17583.0,7.4,-0.0,High Risk
U301,2024,6,328952.0,Stable Salary & Stable Fixed Expenses,237617,102331.0,120737,223068.0,14549.0,6.12,0.02,High Risk
U301,2024,7,343501.0,Stable Salary & Stable Fixed Expenses,237617,102331.0,124602,226933.0,10684.0,4.5,0.03,High Risk
U301,2024,8,354185.0,Stable Salary & Stable Fixed Expenses,237617,102331.0,126504,228835.0,8782.0,3.7,-0.02,High Risk
U301,2024,9,362967.0,Stable Salary & Stable Fixed Expenses,237617,102331.0,134797,237128.0,489.0,0.21,-0.04,High Risk
U301,2024,10,363456.0,Stable Salary & Stable Fixed Expenses,237617,102331.0,157239,259570.0,-21953.0,-9.24,-0.0,High Risk
U301,2024,11,341503.0,Stable Salary & Stable Fixed Expenses,237617,102331.0,118359,220690.0,16927.0,7.12,-0.05,High Risk
U301,2024,12,358430.0,Stable Salary & Stable Fixed Expenses,237617,102331.0,143898,246229.0,-8612.0,-3.62,0.03,High Risk
U302,2024,1,239917.0,Salary Increases & Fixed Expenses Increase,291261,117891.0,203983,321874.0,-30613.0,-10.51,0.03,High Risk
U302,2024,2,209304.0,Salary Increases & Fixed Expenses Increase,291261,117891.0,219472,337363.0,-46102.0,-15.83,-0.03,High Risk
U302,2024,3,163202.0,Salary Increases & Fixed Expenses Increase,304293,117891.0,283941,401832.0,-97539.0,-32.05,0.04,High Risk
U302,2024,4,65663.0,Salary Increases & Fixed Expenses Increase,304293,117891.0,187023,304914.0,-621.0,-0.2,-0.02,High Risk
U302,2024,5,65042.0,Salary Increases & Fixed Expenses Increase,304293,117891.0,192405,310296.0,-6003.0,-1.97,0.0,High Risk
U302,2024,6,59039.0,Salary Increases & Fixed Expenses Increase,304293,117891.0,186301,304192.0,101.0,0.03,0.04,High Risk
U302,2024,7,59140.0,Salary Increases & Fixed Expenses Increase,304293,117891.0,228995,346886.0,-42593.0,-14.0,-0.0,High Risk
U302,2024,8,16547.0,Salary Increases & Fixed Expenses Increase,304293,117891.0,202841,320732.0,-16439.0,-5.4,-0.01,High Risk
U302,2024,9,108.0,Salary Increases & Fixed Expenses Increase,304293,117891.0,196497,314388.0,-10095.0,-3.32,0.03,High Risk
U302,2024,10,-9987.0,Salary Increases & Fixed Expenses Increase,304293,117891.0,231966,349857.0,-45564.0,-14.97,0.03,High Risk
U302,2024,11,-55551.0,Salary Increases & Fixed Expenses Increase,304293,118409.0,224686,343095.0,-38802.0,-12.75,-0.04,High Risk
U302,2024,12,-94353.0,Salary Increases & Fixed Expenses Increase,304293,118409.0,206801,325210.0,-20917.0,-6.87,-0.05,High Risk
U303,2024,1,235802.0,Salary Increases & Fixed Expenses Remain Stable,215241,84094.0,94016,178110.0,37131.0,17.25,0.02,Medium Risk
U303,2024,2,272933.0,Salary Increases & Fixed Expenses Remain Stable,215241,84094.0,96243,180337.0,34904.0,16.22,0.04,Medium Risk
U303,2024,3,307837.0,Salary Increases & Fixed Expenses Remain Stable,215241,84094.0,139360,223454.0,-8213.0,-3.82,-0.04,High Risk
U303,2024,4,299624.0,Salary Increases & Fixed Expenses Remain Stable,215241,84094.0,87908,172002.0,43239.0,20.09,-0.04,Medium Risk
U303,2024,5,342863.0,Salary Increases & Fixed Expenses Remain Stable,236627,84094.0,132623,216717.0,19910.0,8.41,-0.03,High Risk
U303,2024,6,362773.0,Salary Increases & Fixed Expenses Remain Stable,236627,84094.0,140987,225081.0,11546.0,4.88,0.03,High Risk
U303,2024,7,374319.0,Salary Increases & Fixed Expenses Remain Stable,236627,84094.0,135082,219176.0,17451.0,7.37,0.01,High Risk
U303,2024,8,391770.0,Salary Increases & Fixed Expenses Remain Stable,236627,84094.0,103164,187258.0,49369.0,20.86,0.04,Medium Risk
U303,2024,9,441139.0,Salary Increases & Fixed Expenses Remain Stable,236627,84094.0,135458,219552.0,17075.0,7.22,-0.03,High Risk
U303,2024,10,458214.0,Salary Increases & Fixed Expenses Remain Stable,236627,84094.0,119745,203839.0,32788.0,13.86,0.02,High Risk
U303,2024,11,491002.0,Salary Increases & Fixed Expenses Remain Stable,236627,84094.0,141491,225585.0,11042.0,4.67,0.01,High Risk
U303,2024,12,502044.0,Salary Increases & Fixed Expenses Remain Stable,236627,84094.0,106932,191026.0,45601.0,19.27,-0.04,Medium Risk
U304,2024,1,236255.0,Salary Increases & Fixed Expenses Remain Stable,133900,57356.0,46205,103561.0,30339.0,22.66,0.01,Medium Risk
U304,2024,2,266594.0,Salary Increases & Fixed Expenses Remain Stable,133900,57356.0,43582,100938.0,32962.0,24.62,0.01,Medium Risk
U304,2024,3,299556.0,Salary Increases & Fixed Expenses Remain Stable,133900,57356.0,54700,112056.0,21844.0,16.31,0.0,Medium Risk
U304,2024,4,321400.0,Salary Increases & Fixed Expenses Remain Stable,133900,57356.0,50464,107820.0,26080.0,19.48,0.03,Medium Risk
U304,2024,5,347480.0,Salary Increases & Fixed Expenses Remain Stable,133900,57356.0,44428,101784.0,32116.0,23.99,0.03,Medium Risk
U304,2024,6,379596.0,Salary Increases & Fixed Expenses Remain Stable,141531,57356.0,45319,102675.0,38856.0,27.45,-0.04,Low Risk
U304,2024,7,418452.0,Salary Increases & Fixed Expenses Remain Stable,141531,57356.0,46994,104350.0,37181.0,26.27,0.01,Low Risk
U304,2024,8,455633.0,Salary Increases & Fixed Expenses Remain Stable,141531,57356.0,53968,111324.0,30207.0,21.34,0.05,Medium Risk
U304,2024,9,485840.0,Salary Increases & Fixed Expenses Remain Stable,141531,57356.0,53747,111103.0,30428.0,21.5,-0.0,Medium Risk
U304,2024,10,516268.0,Salary Increases & Fixed Expenses Remain Stable,141531,57356.0,65624,122980.0,18551.0,13.11,0.02,High Risk
U304,2024,11,534819.0,Salary Increases & Fixed Expenses Remain Stable,141531,57356.0,64316,121672.0,19859.0,14.03,-0.03,High Risk
U304,2024,12,554678.0,Salary Increases & Fixed Expenses Remain Stable,141531,57356.0,66732,124088.0,17443.0,12.32,0.01,High Risk
U305,2024,1,220241.0,Salary Increases & Fixed Expenses Increase,45680,12592.0,34566,47158.0,-1478.0,-3.24,-0.02,High Risk
U305,2024,2,218763.0,Salary Increases & Fixed Expenses Increase,45680,12592.0,33523,46115.0,-435.0,-0.95,0.01,High Risk
U305,2024,3,218328.0,Salary Increases & Fixed Expenses Increase,74593,12592.0,48922,61514.0,13079.0,17.53,0.0,Medium Risk
U305,2024,4,231407.0,Salary Increases & Fixed Expenses Increase,74593,12592.0,58065,70657.0,3936.0,5.28,-0.03,High Risk
U305,2024,5,235343.0,Salary Increases & Fixed Expenses Increase,74593,12592.0,48173,60765.0,13828.0,18.54,-0.0,Medium Risk
U305,2024,6,249171.0,Salary Increases & Fixed Expenses Increase,74593,12592.0,54603,67195.0,7398.0,9.92,-0.04,High Risk
U305,2024,7,256569.0,Salary Increases & Fixed Expenses Increase,74593,12592.0,47179,59771.0,14822.0,19.87,-0.02,Medium Risk
U305,2024,8,271391.0,Salary Increases & Fixed Expenses Increase,74593,13628.0,59154,72782.0,1811.0,2.43,0.01,High Risk
U305,2024,9,273202.0,Salary Increases & Fixed Expenses Increase,74593,14861.0,47403,62264.0,12329.0,16.53,0.01,Medium Risk
U305,2024,10,285531.0,Salary Increases & Fixed Expenses Increase,74593,15369.0,48618,63987.0,10606.0,14.22,0.04,High Risk
U305,2024,11,296137.0,Salary Increases & Fixed Expenses Increase,74593,15369.0,44796,60165.0,14428.0,19.34,-0.02,Medium Risk
U305,2024,12,310565.0,Salary Increases & Fixed Expenses Increase,74593,16515.0,46895,63410.0,11183.0,14.99,-0.02,High Risk
U306,2024,1,249357.0,Stable Salary & Increasing Fixed Expenses,297217,61176.0,167062,228238.0,68979.0,23.21,-0.0,Medium Risk
U306,2024,2,318336.0,Stable Salary & Increasing Fixed Expenses,297217,61176.0,147679,208855.0,88362.0,29.73,-0.01,Low Risk
U306,2024,3,406698.0,Stable Salary & Increasing Fixed Expenses,297217,61176.0,229277,290453.0,6764.0,2.28,-0.02,High Risk
U306,2024,4,413462.0,Stable Salary & Increasing Fixed Expenses,297217,61176.0,176981,238157.0,59060.0,19.87,-0.05,Medium Risk
U306,2024,5,472522.0,Stable Salary & Increasing Fixed Expenses,297217,61176.0,151035,212211.0,85006.0,28.6,-0.01,Low Risk
U306,2024,6,557528.0,Stable Salary & Increasing Fixed Expenses,297217,61176.0,130047,191223.0,105994.0,35.66,0.03,Low Risk
U306,2024,7,663522.0,Stable Salary & Increasing Fixed Expenses,297217,61176.0,176168,237344.0,59873.0,20.14,-0.04,Medium Risk
U306,2024,8,723395.0,Stable Salary & Increasing Fixed Expenses,297217,62884.0,136986,199870.0,97347.0,32.75,0.05,Low Risk
U306,2024,9,820742.0,Stable Salary & Increasing Fixed Expenses,297217,62884.0,131543,194427.0,102790.0,34.58,0.04,Low Risk
U306,2024,10,923532.0,Stable Salary & Increasing Fixed Expenses,297217,62884.0,186688,249572.0,47645.0,16.03,-0.04,Medium Risk
U306,2024,11,971177.0,Stable Salary & Increasing Fixed Expenses,297217,64367.0,123545,187912.0,109305.0,36.78,0.02,Low Risk
U306,2024,12,1080482.0,Stable Salary & Increasing Fixed Expenses,297217,64367.0,138162,202529.0,94688.0,31.86,0.0,Low Risk
U307,2024,1,221038.0,Salary Increases & Fixed Expenses Decrease,271875,69338.0,97737,167075.0,104800.0,38.55,-0.02,Low Risk
U307,2024,2,325838.0,Salary Increases & Fixed Expenses Decrease,271875,69338.0,96716,166054.0,105821.0,38.92,0.03,Low Risk
U307,2024,3,431659.0,Salary Increases & Fixed Expenses Decrease,271875,69338.0,122309,191647.0,80228.0,29.51,-0.01,Low Risk
U307,2024,4,511887.0,Salary Increases & Fixed Expenses Decrease,271875,69338.0,105517,174855.0,97020.0,35.69,0.03,Low Risk
U307,2024,5,608907.0,Salary Increases & Fixed Expenses Decrease,299718,69338.0,119682,189020.0,110698.0,36.93,0.05,Low Risk
U307,2024,6,719605.0,Salary Increases & Fixed Expenses Decrease,299718,69338.0,106061,175399.0,124319.0,41.48,-0.03,Low Risk
U307,2024,7,843924.0,Salary Increases & Fixed Expenses Decrease,299718,69338.0,111978,181316.0,118402.0,39.5,0.01,Low Risk
U307,2024,8,962326.0,Salary Increases & Fixed Expenses Decrease,299718,69338.0,111603,180941.0,118777.0,39.63,0.03,Low Risk
U307,2024,9,1081103.0,Salary Increases & Fixed Expenses Decrease,299718,69338.0,109993,179331.0,120387.0,40.17,0.04,Low Risk
U307,2024,10,1201490.0,Salary Increases & Fixed Expenses Decrease,299718,69338.0,138138,207476.0,92242.0,30.78,0.01,Low Risk
U307,2024,11,1293732.0,Salary Increases & Fixed Expenses Decrease,299718,69338.0,94349,163687.0,136031.0,45.39,-0.0,Low Risk
U307,2024,12,1429763.0,Salary Increases & Fixed Expenses Decrease,299718,69338.0,110580,179918.0,119800.0,39.97,0.03,Low Risk
U308,2024,1,229062.0,Salary Increases & Fixed Expenses Increase,138546,65241.0,73916,139157.0,-611.0,-0.44,-0.03,High Risk
U308,2024,2,228451.0,Salary Increases & Fixed Expenses Increase,138546,65241.0,78696,143937.0,-5391.0,-3.89,-0.03,High Risk
U308,2024,3,223060.0,Salary Increases & Fixed Expenses Increase,138546,65241.0,76412,141653.0,-3107.0,-2.24,0.03,High Risk
U308,2024,4,219953.0,Salary Increases & Fixed Expenses Increase,138546,65241.0,60628,125869.0,12677.0,9.15,-0.03,High Risk
U308,2024,5,232630.0,Salary Increases & Fixed Expenses Increase,138546,65241.0,69873,135114.0,3432.0,2.48,-0.02,High Risk
U308,2024,6,236062.0,Salary Increases & Fixed Expenses Increase,138546,65241.0,78473,143714.0,-5168.0,-3.73,-0.05,High Risk
U308,2024,7,230894.0,Salary Increases & Fixed Expenses Increase,138546,65962.0,82731,148693.0,-10147.0,-7.32,-0.0,High Risk
U308,2024,8,220747.0,Salary Increases & Fixed Expenses Increase,150578,65962.0,84208,150170.0,408.0,0.27,-0.02,High Risk
U308,2024,9,221155.0,Salary Increases & Fixed Expenses Increase,150578,67345.0,78044,145389.0,5189.0,3.45,-0.02,High Risk
U308,2024,10,226344.0,Salary Increases & Fixed Expenses Increase,150578,67345.0,78502,145847.0,4731.0,3.14,0.03,High Risk
U308,2024,11,231075.0,Salary Increases & Fixed Expenses Increase,150578,69272.0,69287,138559.0,12019.0,7.98,-0.0,High Risk
U308,2024,12,243094.0,Salary Increases & Fixed Expenses Increase,150578,69272.0,78942,148214.0,2364.0,1.57,0.03,High Risk
U309,2024,1,215982.0,Salary Increases & Fixed Expenses Remain Stable,276792,62365.0,176286,238651.0,38141.0,13.78,0.02,High Risk
U309,2024,2,254123.0,Salary Increases & Fixed Expenses Remain Stable,276792,62365.0,219658,282023.0,-5231.0,-1.89,0.03,High Risk
U309,2024,3,248892.0,Salary Increases & Fixed Expenses Remain Stable,276792,62365.0,235883,298248.0,-21456.0,-7.75,-0.03,High Risk
U309,2024,4,227436.0,Salary Increases & Fixed Expenses Remain Stable,276792,62365.0,178507,240872.0,35920.0,12.98,0.05,High Risk
U309,2024,5,263356.0,Salary Increases & Fixed Expenses Remain Stable,276792,62365.0,201115,263480.0,13312.0,4.81,-0.02,High Risk
U309,2024,6,276668.0,Salary Increases & Fixed Expenses Remain Stable,276792,62365.0,195332,257697.0,19095.0,6.9,0.03,High Risk
U309,2024,7,295763.0,Salary Increases & Fixed Expenses Remain Stable,276792,62365.0,215129,277494.0,-702.0,-0.25,0.03,High Risk
U309,2024,8,295061.0,Salary Increases & Fixed Expenses Remain Stable,302373,62365.0,231917,294282.0,8091.0,2.68,-0.02,High Risk
U309,2024,9,303152.0,Salary Increases & Fixed Expenses Remain Stable,302373,62365.0,190817,253182.0,49191.0,16.27,-0.01,Medium Risk
U309,2024,10,352343.0,Salary Increases & Fixed Expenses Remain Stable,302373,62365.0,263683,326048.0,-23675.0,-7.83,0.05,High Risk
U309,2024,11,328668.0,Salary Increases & Fixed Expenses Remain Stable,302373,62365.0,215339,277704.0,24669.0,8.16,-0.04,High Risk
U309,2024,12,353337.0,Salary Increases & Fixed Expenses Remain Stable,302373,62365.0,221186,283551.0,18822.0,6.22,0.05,High Risk
U310,2024,1,233232.0,Stable Salary & Increasing Fixed Expenses,236407,91477.0,136015,227492.0,8915.0,3.77,-0.03,High Risk
U310,2024,2,242147.0,Stable Salary & Increasing Fixed Expenses,236407,91477.0,125506,216983.0,19424.0,8.22,0.02,High Risk
U310,2024,3,261571.0,Stable Salary & Increasing Fixed Expenses,236407,91477.0,152661,244138.0,-7731.0,-3.27,0.04,High Risk
U310,2024,4,253840.0,Stable Salary & Increasing Fixed Expenses,236407,91477.0,126752,218229.0,18178.0,7.69,0.03,High Risk
U310,2024,5,272018.0,Stable Salary & Increasing Fixed Expenses,236407,91477.0,96744,188221.0,48186.0,20.38,0.01,Medium Risk
U310,2024,6,320204.0,Stable Salary & Increasing Fixed Expenses,236407,91477.0,104690,196167.0,40240.0,17.02,0.04,Medium Risk
U310,2024,7,360444.0,Stable Salary & Increasing Fixed Expenses,236407,91477.0,104586,196063.0,40344.0,17.07,0.01,Medium Risk
U310,2024,8,400788.0,Stable Salary & Increasing Fixed Expenses,236407,93423.0,129599,223022.0,13385.0,5.66,-0.01,High Risk
U310,2024,9,414173.0,Stable Salary & Increasing Fixed Expenses,236407,93423.0,104159,197582.0,38825.0,16.42,-0.04,Medium Risk
U310,2024,10,452998.0,Stable Salary & Increasing Fixed Expenses,236407,93423.0,128654,222077.0,14330.0,6.06,0.02,High Risk
U310,2024,11,467328.0,Stable Salary & Increasing Fixed Expenses,236407,93423.0,129287,222710.0,13697.0,5.79,-0.02,High Risk
U310,2024,12,481025.0,Stable Salary & Increasing Fixed Expenses,236407,93423.0,107132,200555.0,35852.0,15.17,-0.02,Medium Risk
U311,2024,1,228545.0,Salary Increases & Fixed Expenses Remain Stable,166686,78428.0,83334,161762.0,4924.0,2.95,-0.01,High Risk
U311,2024,2,233469.0,Salary Increases & Fixed Expenses Remain Stable,166686,78428.0,68181,146609.0,20077.0,12.04,0.03,High Risk
U311,2024,3,253546.0,Salary Increases & Fixed Expenses Remain Stable,166686,78428.0,106170,184598.0,-17912.0,-10.75,0.01,High Risk
U311,2024,4,235634.0,Salary Increases & Fixed Expenses Remain Stable,166686,78428.0,77872,156300.0,10386.0,6.23,0.02,High Risk
U311,2024,5,246020.0,Salary Increases & Fixed Expenses Remain Stable,188592,78428.0,91139,169567.0,19025.0,10.09,-0.0,High Risk
U311,2024,6,265045.0,Salary Increases & Fixed Expenses Remain Stable,188592,78428.0,98854,177282.0,11310.0,6.0,0.04,High Risk
U311,2024,7,276355.0,Salary Increases & Fixed Expenses Remain Stable,188592,78428.0,104247,182675.0,5917.0,3.14,-0.02,High Risk
U311,2024,8,282272.0,Salary Increases & Fixed Expenses Remain Stable,188592,78428.0,96425,174853.0,13739.0,7.29,0.03,High Risk
U311,2024,9,296011.0,Salary Increases & Fixed Expenses Remain Stable,188592,78428.0,114196,192624.0,-4032.0,-2.14,-0.04,High Risk
U311,2024,10,291979.0,Salary Increases & Fixed Expenses Remain Stable,188592,78428.0,113925,192353.0,-3761.0,-1.99,0.02,High Risk
U311,2024,11,288218.0,Salary Increases & Fixed Expenses Remain Stable,188592,78428.0,99462,177890.0,10702.0,5.67,0.02,High Risk
U311,2024,12,298920.0,Salary Increases & Fixed Expenses Remain Stable,188592,78428.0,120294,198722.0,-10130.0,-5.37,-0.0,High Risk
U312,2024,1,245083.0,Stable Salary & Increasing Fixed Expenses,132252,69810.0,56052,125862.0,6390.0,4.83,-0.05,High Risk
U312,2024,2,251473.0,Stable Salary & Increasing Fixed Expenses,132252,69810.0,60744,130554.0,1698.0,1.28,0.03,High Risk
U312,2024,3,253171.0,Stable Salary & Increasing Fixed Expenses,132252,69810.0,60868,130678.0,1574.0,1.19,0.05,High Risk
U312,2024,4,254745.0,Stable Salary & Increasing Fixed Expenses,132252,69810.0,56961,126771.0,5481.0,4.14,0.04,High Risk
U312,2024,5,260226.0,Stable Salary & Increasing Fixed Expenses,132252,69810.0,64614,134424.0,-2172.0,-1.64,-0.04,High Risk
U312,2024,6,258054.0,Stable Salary & Increasing Fixed Expenses,132252,69810.0,77191,147001.0,-14749.0,-11.15,0.05,High Risk
U312,2024,7,243305.0,Stable Salary & Increasing Fixed Expenses,132252,69810.0,75227,145037.0,-12785.0,-9.67,0.03,High Risk
U312,2024,8,230520.0,Stable Salary & Increasing Fixed Expenses,132252,69810.0,69757,139567.0,-7315.0,-5.53,-0.02,High Risk
U312,2024,9,223205.0,Stable Salary & Increasing Fixed Expenses,132252,69810.0,56026,125836.0,6416.0,4.85,0.03,High Risk
U312,2024,10,229621.0,Stable Salary & Increasing Fixed Expenses,132252,69810.0,66798,136608.0,-4356.0,-3.29,-0.0,High Risk
U312,2024,11,225265.0,Stable Salary & Increasing Fixed Expenses,132252,69810.0,66496,136306.0,-4054.0,-3.07,-0.02,High Risk
U312,2024,12,221211.0,Stable Salary & Increasing Fixed Expenses,132252,71683.0,75439,147122.0,-14870.0,-11.24,0.0,High Risk
U313,2024,1,222336.0,Salary Increases & Fixed Expenses Remain Stable,245275,96080.0,112533,208613.0,36662.0,14.95,0.02,High Risk
U313,2024,2,258998.0,Salary Increases & Fixed Expenses Remain Stable,245275,96080.0,123296,219376.0,25899.0,10.56,0.04,High Risk
U313,2024,3,284897.0,Salary Increases & Fixed Expenses Remain Stable,245275,96080.0,139000,235080.0,10195.0,4.16,-0.02,High Risk
U313,2024,4,295092.0,Salary Increases & Fixed Expenses Remain Stable,245275,96080.0,125302,221382.0,23893.0,9.74,-0.05,High Risk
U313,2024,5,318985.0,Salary Increases & Fixed Expenses Remain Stable,245275,96080.0,136953,233033.0,12242.0,4.99,-0.03,High Risk
U313,2024,6,331227.0,Salary Increases & Fixed Expenses Remain Stable,245275,96080.0,119029,215109.0,30166.0,12.3,0.05,High Risk
U313,2024,7,361393.0,Salary Increases & Fixed Expenses Remain Stable,245275,96080.0,137006,233086.0,12189.0,4.97,0.03,High Risk
U313,2024,8,373582.0,Salary Increases & Fixed Expenses Remain Stable,274405,96080.0,142417,238497.0,35908.0,13.09,0.02,High Risk
U313,2024,9,409490.0,Salary Increases & Fixed Expenses Remain Stable,274405,96080.0,142606,238686.0,35719.0,13.02,0.04,High Risk
U313,2024,10,445209.0,Salary Increases & Fixed Expenses Remain Stable,274405,96080.0,160295,256375.0,18030.0,6.57,-0.04,High Risk
U313,2024,11,463239.0,Salary Increases & Fixed Expenses Remain Stable,274405,96080.0,147410,243490.0,30915.0,11.27,0.04,High Risk
U313,2024,12,494154.0,Salary Increases & Fixed Expenses Remain Stable,274405,96080.0,141066,237146.0,37259.0,13.58,0.0,High Risk
U314,2024,1,246746.0,Salary Increases & Fixed Expenses Remain Stable,168734,72504.0,55849,128353.0,40381.0,23.93,-0.03,Medium Risk
U314,2024,2,287127.0,Salary Increases & Fixed Expenses Remain Stable,168734,72504.0,67151,139655.0,29079.0,17.23,0.03,Medium Risk
U314,2024,3,316206.0,Salary Increases & Fixed Expenses Remain Stable,168734,72504.0,77650,150154.0,18580.0,11.01,-0.02,High Risk
U314,2024,4,334786.0,Salary Increases & Fixed Expenses Remain Stable,168734,72504.0,63307,135811.0,32923.0,19.51,-0.0,Medium Risk
U314,2024,5,367709.0,Salary Increases & Fixed Expenses Remain Stable,168734,72504.0,63842,136346.0,32388.0,19.19,0.03,Medium Risk
U314,2024,6,400097.0,Salary Increases & Fixed Expenses Remain Stable,168734,72504.0,55222,127726.0,41008.0,24.3,0.04,Medium Risk
U314,2024,7,441105.0,Salary Increases & Fixed Expenses Remain Stable,177009,72504.0,67375,139879.0,37130.0,20.98,-0.04,Medium Risk
U314,2024,8,478235.0,Salary Increases & Fixed Expenses Remain Stable,177009,72504.0,57229,129733.0,47276.0,26.71,0.04,Low Risk
U314,2024,9,525511.0,Salary Increases & Fixed Expenses Remain Stable,177009,72504.0,68293,140797.0,36212.0,20.46,-0.01,Medium Risk
U314,2024,10,561723.0,Salary Increases & Fixed Expenses Remain Stable,177009,72504.0,62956,135460.0,41549.0,23.47,0.02,Medium Risk
U314,2024,11,603272.0,Salary Increases & Fixed Expenses Remain Stable,177009,72504.0,68266,140770.0,36239.0,20.47,-0.02,Medium Risk
U314,2024,12,639511.0,Salary Increases & Fixed Expenses Remain Stable,177009,72504.0,86616,159120.0,17889.0,10.11,-0.02,High Risk
U315,2024,1,230327.0,Salary Increases & Fixed Expenses Remain Stable,47443,17192.0,36937,54129.0,-6686.0,-14.09,0.0,High Risk
U315,2024,2,223641.0,Salary Increases & Fixed Expenses Remain Stable,47443,17192.0,34562,51754.0,-4311.0,-9.09,0.01,High Risk
U315,2024,3,219330.0,Salary Increases & Fixed Expenses Remain Stable,47443,17192.0,38911,56103.0,-8660.0,-18.25,0.05,High Risk
U315,2024,4,210670.0,Salary Increases & Fixed Expenses Remain Stable,47443,17192.0,29046,46238.0,1205.0,2.54,0.04,High Risk
U315,2024,5,211875.0,Salary Increases & Fixed Expenses Remain Stable,47443,17192.0,34650,51842.0,-4399.0,-9.27,-0.03,High Risk
U315,2024,6,207476.0,Salary Increases & Fixed Expenses Remain Stable,47443,17192.0,32628,49820.0,-2377.0,-5.01,-0.04,High Risk
U315,2024,7,205099.0,Salary Increases & Fixed Expenses Remain Stable,47443,17192.0,33676,50868.0,-3425.0,-7.22,-0.02,High Risk
U315,2024,8,201674.0,Salary Increases & Fixed Expenses Remain Stable,70698,17192.0,56459,73651.0,-2953.0,-4.18,0.01,High Risk
U315,2024,9,198721.0,Salary Increases & Fixed Expenses Remain Stable,70698,17192.0,52198,69390.0,1308.0,1.85,0.01,High Risk
U315,2024,10,200029.0,Salary Increases & Fixed Expenses Remain Stable,70698,17192.0,55655,72847.0,-2149.0,-3.04,0.05,High Risk
U315,2024,11,197880.0,Salary Increases & Fixed Expenses Remain Stable,70698,17192.0,44248,61440.0,9258.0,13.1,-0.0,High Risk
U315,2024,12,207138.0,Salary Increases & Fixed Expenses Remain Stable,70698,17192.0,49842,67034.0,3664.0,5.18,-0.03,High Risk
U316,2024,1,231687.0,Stable Salary & Stable Fixed Expenses,94946,32434.0,47158,79592.0,15354.0,16.17,0.03,Medium Risk
U316,2024,2,247041.0,Stable Salary & Stable Fixed Expenses,94946,32434.0,49794,82228.0,12718.0,13.39,-0.03,High Risk
U316,2024,3,259759.0,Stable Salary & Stable Fixed Expenses,94946,32434.0,58493,90927.0,4019.0,4.23,0.04,High Risk
U316,2024,4,263778.0,Stable Salary & Stable Fixed Expenses,94946,32434.0,47452,79886.0,15060.0,15.86,-0.01,Medium Risk
U316,2024,5,278838.0,Stable Salary & Stable Fixed Expenses,94946,32434.0,39526,71960.0,22986.0,24.21,-0.04,Medium Risk
U316,2024,6,301824.0,Stable Salary & Stable Fixed Expenses,94946,32434.0,55776,88210.0,6736.0,7.09,-0.03,High Risk
U316,2024,7,308560.0,Stable Salary & Stable Fixed Expenses,94946,32434.0,54265,86699.0,8247.0,8.69,-0.02,High Risk
U316,2024,8,316807.0,Stable Salary & Stable Fixed Expenses,94946,32434.0,52233,84667.0,10279.0,10.83,0.01,High Risk
U316,2024,9,327086.0,Stable Salary & Stable Fixed Expenses,94946,32434.0,48000,80434.0,14512.0,15.28,-0.03,Medium Risk
U316,2024,10,341598.0,Stable Salary & Stable Fixed Expenses,94946,32434.0,56722,89156.0,5790.0,6.1,-0.02,High Risk
U316,2024,11,347388.0,Stable Salary & Stable Fixed Expenses,94946,32434.0,56482,88916.0,6030.0,6.35,-0.03,High Risk
U316,2024,12,353418.0,Stable Salary & Stable Fixed Expenses,94946,32434.0,46614,79048.0,15898.0,16.74,-0.03,Medium Risk
U317,2024,1,203125.0,Salary Increases & Fixed Expenses Remain Stable,246265,102316.0,185407,287723.0,-41458.0,-16.83,0.01,High Risk
U317,2024,2,161667.0,Salary Increases & Fixed Expenses Remain Stable,246265,102316.0,156798,259114.0,-12849.0,-5.22,-0.0,High Risk
U317,2024,3,148818.0,Salary Increases & Fixed Expenses Remain Stable,246265,102316.0,189002,291318.0,-45053.0,-18.29,-0.04,High Risk
U317,2024,4,103765.0,Salary Increases & Fixed Expenses Remain Stable,246265,102316.0,173813,276129.0,-29864.0,-12.13,0.01,High Risk
U317,2024,5,73901.0,Salary Increases & Fixed Expenses Remain Stable,246265,102316.0,163421,265737.0,-19472.0,-7.91,-0.01,High Risk
U317,2024,6,54429.0,Salary Increases & Fixed Expenses Remain Stable,265232,102316.0,212120,314436.0,-49204.0,-18.55,0.04,High Risk
U317,2024,7,5225.0,Salary Increases & Fixed Expenses Remain Stable,265232,102316.0,169972,272288.0,-7056.0,-2.66,-0.04,High Risk
U317,2024,8,-1831.0,Salary Increases & Fixed Expenses Remain Stable,265232,102316.0,162969,265285.0,-53.0,-0.02,-0.02,High Risk
U317,2024,9,-1884.0,Salary Increases & Fixed Expenses Remain Stable,265232,102316.0,162997,265313.0,-81.0,-0.03,-0.04,High Risk
U317,2024,10,-1965.0,Salary Increases & Fixed Expenses Remain Stable,265232,102316.0,210756,313072.0,-47840.0,-18.04,-0.02,High Risk
U317,2024,11,-49805.0,Salary Increases & Fixed Expenses Remain Stable,265232,102316.0,186395,288711.0,-23479.0,-8.85,-0.01,High Risk
U317,2024,12,-73284.0,Salary Increases & Fixed Expenses Remain Stable,265232,102316.0,204801,307117.0,-41885.0,-15.79,0.04,High Risk
U318,2024,1,206056.0,Salary Increases & Fixed Expenses Remain Stable,152763,40945.0,55926,96871.0,55892.0,36.59,-0.02,Low Risk
U318,2024,2,261948.0,Salary Increases & Fixed Expenses Remain Stable,152763,40945.0,61035,101980.0,50783.0,33.24,-0.01,Low Risk
U318,2024,3,312731.0,Salary Increases & Fixed Expenses Remain Stable,152763,40945.0,64905,105850.0,46913.0,30.71,0.01,Low Risk
U318,2024,4,359644.0,Salary Increases & Fixed Expenses Remain Stable,152763,40945.0,52785,93730.0,59033.0,38.64,-0.05,Low Risk
U318,2024,5,418677.0,Salary Increases & Fixed Expenses Remain Stable,152763,40945.0,53283,94228.0,58535.0,38.32,-0.04,Low Risk
U318,2024,6,477212.0,Salary Increases & Fixed Expenses Remain Stable,152763,40945.0,49366,90311.0,62452.0,40.88,-0.04,Low Risk
U318,2024,7,539664.0,Salary Increases & Fixed Expenses Remain Stable,181593,40945.0,57028,97973.0,83620.0,46.05,-0.02,Low Risk
U318,2024,8,623284.0,Salary Increases & Fixed Expenses Remain Stable,181593,40945.0,66151,107096.0,74497.0,41.02,-0.05,Low Risk
U318,2024,9,697781.0,Salary Increases & Fixed Expenses Remain Stable,181593,40945.0,60914,101859.0,79734.0,43.91,-0.02,Low Risk
U318,2024,10,777515.0,Salary Increases & Fixed Expenses Remain Stable,181593,40945.0,67476,108421.0,73172.0,40.29,0.03,Low Risk
U318,2024,11,850687.0,Salary Increases & Fixed Expenses Remain Stable,181593,40945.0,64677,105622.0,75971.0,41.84,-0.02,Low Risk
U318,2024,12,926658.0,Salary Increases & Fixed Expenses Remain Stable,181593,40945.0,57291,98236.0,83357.0,45.9,-0.04,Low Risk
U319,2024,1,223000.0,Salary Increases & Fixed Expenses Remain Stable,77350,31733.0,34593,66326.0,11024.0,14.25,-0.01,High Risk
U319,2024,2,234024.0,Salary Increases & Fixed Expenses Remain Stable,77350,31733.0,38092,69825.0,7525.0,9.73,0.03,High Risk
U319,2024,3,241549.0,Salary Increases & Fixed Expenses Remain Stable,100525,31733.0,52385,84118.0,16407.0,16.32,-0.03,Medium Risk
U319,2024,4,257956.0,Salary Increases & Fixed Expenses Remain Stable,100525,31733.0,47424,79157.0,21368.0,21.26,-0.04,Medium Risk
U319,2024,5,279324.0,Salary Increases & Fixed Expenses Remain Stable,100525,31733.0,58088,89821.0,10704.0,10.65,0.01,High Risk
U319,2024,6,290028.0,Salary Increases & Fixed Expenses Remain Stable,100525,31733.0,51292,83025.0,17500.0,17.41,-0.03,Medium Risk
U319,2024,7,307528.0,Salary Increases & Fixed Expenses Remain Stable,100525,31733.0,57276,89009.0,11516.0,11.46,0.01,High Risk
U319,2024,8,319044.0,Salary Increases & Fixed Expenses Remain Stable,100525,31733.0,51969,83702.0,16823.0,16.74,-0.05,Medium Risk
U319,2024,9,335867.0,Salary Increases & Fixed Expenses Remain Stable,100525,31733.0,52304,84037.0,16488.0,16.4,0.0,Medium Risk
U319,2024,10,352355.0,Salary Increases & Fixed Expenses Remain Stable,100525,31733.0,58485,90218.0,10307.0,10.25,-0.04,High Risk
U319,2024,11,362662.0,Salary Increases & Fixed Expenses Remain Stable,100525,31733.0,41731,73464.0,27061.0,26.92,-0.04,Low Risk
U319,2024,12,389723.0,Salary Increases & Fixed Expenses Remain Stable,100525,31733.0,42733,74466.0,26059.0,25.92,0.04,Low Risk
U320,2024,1,204637.0,Salary Increases & Fixed Expenses Remain Stable,275107,112495.0,142076,254571.0,20536.0,7.46,0.02,High Risk
U320,2024,2,225173.0,Salary Increases & Fixed Expenses Remain Stable,275107,112495.0,122940,235435.0,39672.0,14.42,-0.05,High Risk
U320,2024,3,264845.0,Salary Increases & Fixed Expenses Remain Stable,287416,112495.0,119236,231731.0,55685.0,19.37,-0.02,Medium Risk
U320,2024,4,320530.0,Salary Increases & Fixed Expenses Remain Stable,287416,112495.0,163309,275804.0,11612.0,4.04,0.04,High Risk
U320,2024,5,332142.0,Salary Increases & Fixed Expenses Remain Stable,287416,112495.0,144421,256916.0,30500.0,10.61,-0.04,High Risk
U320,2024,6,362642.0,Salary Increases & Fixed Expenses Remain Stable,287416,112495.0,154535,267030.0,20386.0,7.09,0.0,High Risk
U320,2024,7,383028.0,Salary Increases & Fixed Expenses Remain Stable,287416,112495.0,125886,238381.0,49035.0,17.06,0.02,Medium Risk
U320,2024,8,432063.0,Salary Increases & Fixed Expenses Remain Stable,287416,112495.0,124981,237476.0,49940.0,17.38,-0.02,Medium Risk
U320,2024,9,482003.0,Salary Increases & Fixed Expenses Remain Stable,287416,112495.0,150147,262642.0,24774.0,8.62,0.03,High Risk
U320,2024,10,506777.0,Salary Increases & Fixed Expenses Remain Stable,287416,112495.0,123247,235742.0,51674.0,17.98,-0.03,Medium Risk
U320,2024,11,558451.0,Salary Increases & Fixed Expenses Remain Stable,287416,112495.0,154417,266912.0,20504.0,7.13,0.04,High Risk
U320,2024,12,578955.0,Salary Increases & Fixed Expenses Remain Stable,287416,112495.0,168573,281068.0,6348.0,2.21,-0.02,High Risk
U321,2024,1,249169.0,Salary Increases & Fixed Expenses Remain Stable,181579,40452.0,83773,124225.0,57354.0,31.59,0.0,Low Risk
U321,2024,2,306523.0,Salary Increases & Fixed Expenses Remain Stable,181579,40452.0,93686,134138.0,47441.0,26.13,-0.01,Low Risk
U321,2024,3,353964.0,Salary Increases & Fixed Expenses Remain Stable,181579,40452.0,96930,137382.0,44197.0,24.34,0.02,Medium Risk
U321,2024,4,398161.0,Salary Increases & Fixed Expenses Remain Stable,181579,40452.0,104044,144496.0,37083.0,20.42,-0.03,Medium Risk
U321,2024,5,435244.0,Salary Increases & Fixed Expenses Remain Stable,181579,40452.0,91068,131520.0,50059.0,27.57,0.05,Low Risk
U321,2024,6,485303.0,Salary Increases & Fixed Expenses Remain Stable,181579,40452.0,88687,129139.0,52440.0,28.88,0.05,Low Risk
U321,2024,7,537743.0,Salary Increases & Fixed Expenses Remain Stable,181579,40452.0,93680,134132.0,47447.0,26.13,0.0,Low Risk
U321,2024,8,585190.0,Salary Increases & Fixed Expenses Remain Stable,188434,40452.0,96199,136651.0,51783.0,27.48,0.03,Low Risk
U321,2024,9,636973.0,Salary Increases & Fixed Expenses Remain Stable,188434,40452.0,91009,131461.0,56973.0,30.23,0.04,Low Risk
U321,2024,10,693946.0,Salary Increases & Fixed Expenses Remain Stable,188434,40452.0,97767,138219.0,50215.0,26.65,0.01,Low Risk
U321,2024,11,744161.0,Salary Increases & Fixed Expenses Remain Stable,188434,40452.0,103324,143776.0,44658.0,23.7,-0.05,Medium Risk
U321,2024,12,788819.0,Salary Increases & Fixed Expenses Remain Stable,188434,40452.0,86197,126649.0,61785.0,32.79,-0.01,Low Risk
U322,2024,1,218703.0,Stable Salary & Decreasing Fixed Expenses,174539,55993.0,78861,134854.0,39685.0,22.74,0.03,Medium Risk
U322,2024,2,258388.0,Stable Salary & Decreasing Fixed Expenses,174539,55993.0,75281,131274.0,43265.0,24.79,-0.01,Medium Risk
U322,2024,3,301653.0,Stable Salary & Decreasing Fixed Expenses,174539,55993.0,124715,180708.0,-6169.0,-3.53,0.0,High Risk
U322,2024,4,295484.0,Stable Salary & Decreasing Fixed Expenses,174539,55993.0,90781,146774.0,27765.0,15.91,0.02,Medium Risk
U322,2024,5,323249.0,Stable Salary & Decreasing Fixed Expenses,174539,55993.0,102434,158427.0,16112.0,9.23,0.01,High Risk
U322,2024,6,339361.0,Stable Salary & Decreasing Fixed Expenses,174539,55993.0,80416,136409.0,38130.0,21.85,0.01,Medium Risk
U322,2024,7,377491.0,Stable Salary & Decreasing Fixed Expenses,174539,55993.0,86318,142311.0,32228.0,18.46,0.02,Medium Risk
U322,2024,8,409719.0,Stable Salary & Decreasing Fixed Expenses,174539,55993.0,74221,130214.0,44325.0,25.4,-0.01,Low Risk
U322,2024,9,454044.0,Stable Salary & Decreasing Fixed Expenses,174539,55993.0,77830,133823.0,40716.0,23.33,0.02,Medium Risk
U322,2024,10,494760.0,Stable Salary & Decreasing Fixed Expenses,174539,55993.0,121420,177413.0,-2874.0,-1.65,0.03,High Risk
U322,2024,11,491886.0,Stable Salary & Decreasing Fixed Expenses,174539,54891.0,92153,147044.0,27495.0,15.75,0.03,Medium Risk
U322,2024,12,519381.0,Stable Salary & Decreasing Fixed Expenses,174539,54891.0,73802,128693.0,45846.0,26.27,0.01,Low Risk
U323,2024,1,236220.0,Salary Increases & Fixed Expenses Remain Stable,249694,101491.0,122893,224384.0,25310.0,10.14,-0.02,High Risk
U323,2024,2,261530.0,Salary Increases & Fixed Expenses Remain Stable,249694,101491.0,149725,251216.0,-1522.0,-0.61,0.02,High Risk
U323,2024,3,260008.0,Salary Increases & Fixed Expenses Remain Stable,249694,101491.0,130069,231560.0,18134.0,7.26,0.02,High Risk
U323,2024,4,278142.0,Salary Increases & Fixed Expenses Remain Stable,249694,101491.0,101884,203375.0,46319.0,18.55,0.02,Medium Risk
U323,2024,5,324461.0,Salary Increases & Fixed Expenses Remain Stable,249694,101491.0,136690,238181.0,11513.0,4.61,-0.0,High Risk
U323,2024,6,335974.0,Salary Increases & Fixed Expenses Remain Stable,264051,101491.0,147636,249127.0,14924.0,5.65,0.01,High Risk
U323,2024,7,350898.0,Salary Increases & Fixed Expenses Remain Stable,264051,101491.0,107177,208668.0,55383.0,20.97,-0.01,Medium Risk
U323,2024,8,406281.0,Salary Increases & Fixed Expenses Remain Stable,264051,101491.0,135974,237465.0,26586.0,10.07,-0.03,High Risk
U323,2024,9,432867.0,Salary Increases & Fixed Expenses Remain Stable,264051,101491.0,153469,254960.0,9091.0,3.44,-0.04,High Risk
U323,2024,10,441958.0,Salary Increases & Fixed Expenses Remain Stable,264051,101491.0,155177,256668.0,7383.0,2.8,-0.03,High Risk
U323,2024,11,449341.0,Salary Increases & Fixed Expenses Remain Stable,264051,101491.0,154846,256337.0,7714.0,2.92,0.05,High Risk
U323,2024,12,457055.0,Salary Increases & Fixed Expenses Remain Stable,264051,101491.0,155830,257321.0,6730.0,2.55,0.03,High Risk
U324,2024,1,206320.0,Stable Salary & Increasing Fixed Expenses,85117,32346.0,47656,80002.0,5115.0,6.01,-0.04,High Risk
U324,2024,2,211435.0,Stable Salary & Increasing Fixed Expenses,85117,32346.0,49899,82245.0,2872.0,3.37,-0.0,High Risk
U324,2024,3,214307.0,Stable Salary & Increasing Fixed Expenses,85117,32346.0,53066,85412.0,-295.0,-0.35,-0.05,High Risk
U324,2024,4,214012.0,Stable Salary & Increasing Fixed Expenses,85117,32346.0,47451,79797.0,5320.0,6.25,0.05,High Risk
U324,2024,5,219332.0,Stable Salary & Increasing Fixed Expenses,85117,32346.0,46956,79302.0,5815.0,6.83,-0.0,High Risk
U324,2024,6,225147.0,Stable Salary & Increasing Fixed Expenses,85117,33706.0,41876,75582.0,9535.0,11.2,-0.04,High Risk
U324,2024,7,234682.0,Stable Salary & Increasing Fixed Expenses,85117,33706.0,49478,83184.0,1933.0,2.27,0.02,High Risk
U324,2024,8,236615.0,Stable Salary & Increasing Fixed Expenses,85117,33706.0,41227,74933.0,10184.0,11.96,0.04,High Risk
U324,2024,9,246799.0,Stable Salary & Increasing Fixed Expenses,85117,33706.0,47663,81369.0,3748.0,4.4,-0.04,High Risk
U324,2024,10,250547.0,Stable Salary & Increasing Fixed Expenses,85117,34664.0,42448,77112.0,8005.0,9.4,0.02,High Risk
U324,2024,11,258552.0,Stable Salary & Increasing Fixed Expenses,85117,34664.0,40290,74954.0,10163.0,11.94,0.03,High Risk
U324,2024,12,268715.0,Stable Salary & Increasing Fixed Expenses,85117,34664.0,39078,73742.0,11375.0,13.36,-0.03,High Risk
U325,2024,1,223059.0,Salary Increases & Fixed Expenses Remain Stable,251318,86810.0,143163,229973.0,21345.0,8.49,-0.05,High Risk
U325,2024,2,244404.0,Salary Increases & Fixed Expenses Remain Stable,251318,86810.0,140829,227639.0,23679.0,9.42,-0.01,High Risk
U325,2024,3,268083.0,Salary Increases & Fixed Expenses Remain Stable,251318,86810.0,144815,231625.0,19693.0,7.84,0.01,High Risk
U325,2024,4,287776.0,Salary Increases & Fixed Expenses Remain Stable,260061,86810.0,109938,196748.0,63313.0,24.35,-0.01,Medium Risk
U325,2024,5,351089.0,Salary Increases & Fixed Expenses Remain Stable,260061,86810.0,117323,204133.0,55928.0,21.51,-0.03,Medium Risk
U325,2024,6,407017.0,Salary Increases & Fixed Expenses Remain Stable,260061,86810.0,117605,204415.0,55646.0,21.4,0.05,Medium Risk
U325,2024,7,462663.0,Salary Increases & Fixed Expenses Remain Stable,260061,86810.0,115882,202692.0,57369.0,22.06,-0.01,Medium Risk
U325,2024,8,520032.0,Salary Increases & Fixed Expenses Remain Stable,260061,86810.0,117335,204145.0,55916.0,21.5,-0.01,Medium Risk
U325,2024,9,575948.0,Salary Increases & Fixed Expenses Remain Stable,260061,86810.0,117717,204527.0,55534.0,21.35,-0.03,Medium Risk
U325,2024,10,631482.0,Salary Increases & Fixed Expenses Remain Stable,260061,86810.0,141562,228372.0,31689.0,12.19,-0.01,High Risk
U325,2024,11,663171.0,Salary Increases & Fixed Expenses Remain Stable,260061,86810.0,130963,217773.0,42288.0,16.26,-0.01,Medium Risk
U325,2024,12,705459.0,Salary Increases & Fixed Expenses Remain Stable,260061,86810.0,110221,197031.0,63030.0,24.24,-0.02,Medium Risk
U326,2024,1,242237.0,Stable Salary & Stable Fixed Expenses,20100,12150.0,12657,24807.0,-4707.0,-23.42,-0.01,High Risk
U326,2024,2,237530.0,Stable Salary & Stable Fixed Expenses,20100,12150.0,13663,25813.0,-5713.0,-28.42,0.05,High Risk
U326,2024,3,231817.0,Stable Salary & Stable Fixed Expenses,20100,12150.0,15193,27343.0,-7243.0,-36.03,0.04,High Risk
U326,2024,4,224574.0,Stable Salary & Stable Fixed Expenses,20100,12150.0,15449,27599.0,-7499.0,-37.31,0.01,High Risk
U326,2024,5,217075.0,Stable Salary & Stable Fixed Expenses,20100,12150.0,14655,26805.0,-6705.0,-33.36,0.01,High Risk
U326,2024,6,210370.0,Stable Salary & Stable Fixed Expenses,20100,12150.0,12970,25120.0,-5020.0,-24.98,0.03,High Risk
U326,2024,7,205350.0,Stable Salary & Stable Fixed Expenses,20100,12150.0,12865,25015.0,-4915.0,-24.45,-0.02,High Risk
U326,2024,8,200435.0,Stable Salary & Stable Fixed Expenses,20100,12150.0,15057,27207.0,-7107.0,-35.36,-0.01,High Risk
U326,2024,9,193328.0,Stable Salary & Stable Fixed Expenses,20100,12150.0,15338,27488.0,-7388.0,-36.76,0.01,High Risk
U326,2024,10,185940.0,Stable Salary & Stable Fixed Expenses,20100,12150.0,13618,25768.0,-5668.0,-28.2,-0.04,High Risk
U326,2024,11,180272.0,Stable Salary & Stable Fixed Expenses,20100,12150.0,14244,26394.0,-6294.0,-31.31,0.03,High Risk
U326,2024,12,173978.0,Stable Salary & Stable Fixed Expenses,20100,12150.0,14695,26845.0,-6745.0,-33.56,-0.0,High Risk
U327,2024,1,246526.0,Salary Increases & Fixed Expenses Remain Stable,50285,39249.0,27966,67215.0,-16930.0,-33.67,-0.0,High Risk
U327,2024,2,229596.0,Salary Increases & Fixed Expenses Remain Stable,50285,39249.0,30154,69403.0,-19118.0,-38.02,0.02,High Risk
U327,2024,3,210478.0,Salary Increases & Fixed Expenses Remain Stable,75294,39249.0,52122,91371.0,-16077.0,-21.35,-0.02,High Risk
U327,2024,4,194401.0,Salary Increases & Fixed Expenses Remain Stable,75294,39249.0,40962,80211.0,-4917.0,-6.53,-0.02,High Risk
U327,2024,5,189484.0,Salary Increases & Fixed Expenses Remain Stable,75294,39249.0,40740,79989.0,-4695.0,-6.24,0.03,High Risk
U327,2024,6,184789.0,Salary Increases & Fixed Expenses Remain Stable,75294,39249.0,42475,81724.0,-6430.0,-8.54,-0.04,High Risk
U327,2024,7,178359.0,Salary Increases & Fixed Expenses Remain Stable,75294,39249.0,43563,82812.0,-7518.0,-9.98,0.05,High Risk
U327,2024,8,170841.0,Salary Increases & Fixed Expenses Remain Stable,75294,39249.0,33620,72869.0,2425.0,3.22,0.05,High Risk
U327,2024,9,173266.0,Salary Increases & Fixed Expenses Remain Stable,75294,39249.0,44125,83374.0,-8080.0,-10.73,0.03,High Risk
U327,2024,10,165186.0,Salary Increases & Fixed Expenses Remain Stable,75294,39249.0,38829,78078.0,-2784.0,-3.7,-0.02,High Risk
U327,2024,11,162402.0,Salary Increases & Fixed Expenses Remain Stable,75294,39249.0,40481,79730.0,-4436.0,-5.89,0.05,High Risk
U327,2024,12,157966.0,Salary Increases & Fixed Expenses Remain Stable,75294,39249.0,33707,72956.0,2338.0,3.11,0.0,High Risk
U328,2024,1,225545.0,Salary Increases & Fixed Expenses Remain Stable,161224,55057.0,118792,173849.0,-12625.0,-7.83,-0.01,High Risk
U328,2024,2,212920.0,Salary Increases & Fixed Expenses Remain Stable,161224,55057.0,99293,154350.0,6874.0,4.26,0.0,High Risk
U328,2024,3,219794.0,Salary Increases & Fixed Expenses Remain Stable,161224,55057.0,129422,184479.0,-23255.0,-14.42,-0.02,High Risk
U328,2024,4,196539.0,Salary Increases & Fixed Expenses Remain Stable,161224,55057.0,125629,180686.0,-19462.0,-12.07,-0.01,High Risk
U328,2024,5,177077.0,Salary Increases & Fixed Expenses Remain Stable,161224,55057.0,97780,152837.0,8387.0,5.2,-0.04,High Risk
U328,2024,6,185464.0,Salary Increases & Fixed Expenses Remain Stable,161224,55057.0,110568,165625.0,-4401.0,-2.73,0.03,High Risk
U328,2024,7,181063.0,Salary Increases & Fixed Expenses Remain Stable,170742,55057.0,125877,180934.0,-10192.0,-5.97,0.03,High Risk
U328,2024,8,170871.0,Salary Increases & Fixed Expenses Remain Stable,170742,55057.0,106933,161990.0,8752.0,5.13,0.0,High Risk
U328,2024,9,179623.0,Salary Increases & Fixed Expenses Remain Stable,170742,55057.0,129718,184775.0,-14033.0,-8.22,0.04,High Risk
U328,2024,10,165590.0,Salary Increases & Fixed Expenses Remain Stable,170742,55057.0,126197,181254.0,-10512.0,-6.16,0.03,High Risk
U328,2024,11,155078.0,Salary Increases & Fixed Expenses Remain Stable,170742,55057.0,135193,190250.0,-19508.0,-11.43,-0.02,High Risk
U328,2024,12,135570.0,Salary Increases & Fixed Expenses Remain Stable,170742,55057.0,139137,194194.0,-23452.0,-13.74,-0.05,High Risk
U329,2024,1,202172.0,Stable Salary & Stable Fixed Expenses,147072,62728.0,54516,117244.0,29828.0,20.28,0.0,Medium Risk
U329,2024,2,232000.0,Stable Salary & Stable Fixed Expenses,147072,62728.0,46957,109685.0,37387.0,25.42,-0.01,Low Risk
U329,2024,3,269387.0,Stable Salary & Stable Fixed Expenses,147072,62728.0,62539,125267.0,21805.0,14.83,-0.01,High Risk
U329,2024,4,291192.0,Stable Salary & Stable Fixed Expenses,147072,62728.0,49933,112661.0,34411.0,23.4,0.0,Medium Risk
U329,2024,5,325603.0,Stable Salary & Stable Fixed Expenses,147072,62728.0,49696,112424.0,34648.0,23.56,-0.02,Medium Risk
U329,2024,6,360251.0,Stable Salary & Stable Fixed Expenses,147072,62728.0,45221,107949.0,39123.0,26.6,-0.03,Low Risk
U329,2024,7,399374.0,Stable Salary & Stable Fixed Expenses,147072,62728.0,58370,121098.0,25974.0,17.66,-0.03,Medium Risk
U329,2024,8,425348.0,Stable Salary & Stable Fixed Expenses,147072,62728.0,54810,117538.0,29534.0,20.08,-0.05,Medium Risk
U329,2024,9,454882.0,Stable Salary & Stable Fixed Expenses,147072,62728.0,58462,121190.0,25882.0,17.6,0.03,Medium Risk
U329,2024,10,480764.0,Stable Salary & Stable Fixed Expenses,147072,62728.0,72571,135299.0,11773.0,8.0,-0.0,High Risk
U329,2024,11,492537.0,Stable Salary & Stable Fixed Expenses,147072,62728.0,53041,115769.0,31303.0,21.28,0.02,Medium Risk
U329,2024,12,523840.0,Stable Salary & Stable Fixed Expenses,147072,62728.0,55113,117841.0,29231.0,19.88,0.04,Medium Risk
U330,2024,1,235109.0,Salary Increases & Fixed Expenses Remain Stable,285573,112465.0,121267,233732.0,51841.0,18.15,0.02,Medium Risk
U330,2024,2,286950.0,Salary Increases & Fixed Expenses Remain Stable,285573,112465.0,142411,254876.0,30697.0,10.75,-0.04,High Risk
U330,2024,3,317647.0,Salary Increases & Fixed Expenses Remain Stable,285573,112465.0,187141,299606.0,-14033.0,-4.91,-0.05,High Risk
U330,2024,4,303614.0,Salary Increases & Fixed Expenses Remain Stable,285573,112465.0,123134,235599.0,49974.0,17.5,0.04,Medium Risk
U330,2024,5,353588.0,Salary Increases & Fixed Expenses Remain Stable,285573,112465.0,163451,275916.0,9657.0,3.38,0.04,High Risk
U330,2024,6,363245.0,Salary Increases & Fixed Expenses Remain Stable,295336,112465.0,130539,243004.0,52332.0,17.72,0.0,Medium Risk
U330,2024,7,415577.0,Salary Increases & Fixed Expenses Remain Stable,295336,112465.0,135170,247635.0,47701.0,16.15,-0.05,Medium Risk
U330,2024,8,463278.0,Salary Increases & Fixed Expenses Remain Stable,295336,112465.0,154112,266577.0,28759.0,9.74,-0.04,High Risk
U330,2024,9,492037.0,Salary Increases & Fixed Expenses Remain Stable,295336,112465.0,145256,257721.0,37615.0,12.74,-0.02,High Risk
U330,2024,10,529652.0,Salary Increases & Fixed Expenses Remain Stable,295336,112465.0,196145,308610.0,-13274.0,-4.49,0.0,High Risk
U330,2024,11,516378.0,Salary Increases & Fixed Expenses Remain Stable,295336,112465.0,142671,255136.0,40200.0,13.61,-0.01,High Risk
U330,2024,12,556578.0,Salary Increases & Fixed Expenses Remain Stable,295336,112465.0,148263,260728.0,34608.0,11.72,-0.04,High Risk
U331,2024,1,243794.0,Salary Increases & Fixed Expenses Remain Stable,92266,23578.0,52431,76009.0,16257.0,17.62,0.03,Medium Risk
U331,2024,2,260051.0,Salary Increases & Fixed Expenses Remain Stable,92266,23578.0,46994,70572.0,21694.0,23.51,0.04,Medium Risk
U331,2024,3,281745.0,Salary Increases & Fixed Expenses Remain Stable,92266,23578.0,66343,89921.0,2345.0,2.54,0.0,High Risk
U331,2024,4,284090.0,Salary Increases & Fixed Expenses Remain Stable,92266,23578.0,45473,69051.0,23215.0,25.16,-0.01,Low Risk
U331,2024,5,307305.0,Salary Increases & Fixed Expenses Remain Stable,101081,23578.0,41604,65182.0,35899.0,35.52,0.04,Low Risk
U331,2024,6,343204.0,Salary Increases & Fixed Expenses Remain Stable,101081,23578.0,51481,75059.0,26022.0,25.74,-0.02,Low Risk
U331,2024,7,369226.0,Salary Increases & Fixed Expenses Remain Stable,101081,23578.0,50535,74113.0,26968.0,26.68,-0.03,Low Risk
U331,2024,8,396194.0,Salary Increases & Fixed Expenses Remain Stable,101081,23578.0,45599,69177.0,31904.0,31.56,-0.01,Low Risk
U331,2024,9,428098.0,Salary Increases & Fixed Expenses Remain Stable,101081,23578.0,44757,68335.0,32746.0,32.4,-0.02,Low Risk
U331,2024,10,460844.0,Salary Increases & Fixed Expenses Remain Stable,101081,23578.0,66100,89678.0,11403.0,11.28,0.02,High Risk
U331,2024,11,472247.0,Salary Increases & Fixed Expenses Remain Stable,101081,23578.0,66975,90553.0,10528.0,10.42,0.01,High Risk
U331,2024,12,482775.0,Salary Increases & Fixed Expenses Remain Stable,101081,23578.0,65082,88660.0,12421.0,12.29,-0.01,High Risk
U332,2024,1,210389.0,Stable Salary & Stable Fixed Expenses,147249,74651.0,83043,157694.0,-10445.0,-7.09,0.05,High Risk
U332,2024,2,199944.0,Stable Salary & Stable Fixed Expenses,147249,74651.0,83565,158216.0,-10967.0,-7.45,-0.02,High Risk
U332,2024,3,188977.0,Stable Salary & Stable Fixed Expenses,147249,74651.0,99006,173657.0,-26408.0,-17.93,-0.02,High Risk
U332,2024,4,162569.0,Stable Salary & Stable Fixed Expenses,147249,74651.0,64160,138811.0,8438.0,5.73,-0.03,High Risk
U332,2024,5,171007.0,Stable Salary & Stable Fixed Expenses,147249,74651.0,74822,149473.0,-2224.0,-1.51,0.05,High Risk
U332,2024,6,168783.0,Stable Salary & Stable Fixed Expenses,147249,74651.0,83601,158252.0,-11003.0,-7.47,0.03,High Risk
U332,2024,7,157780.0,Stable Salary & Stable Fixed Expenses,147249,74651.0,77921,152572.0,-5323.0,-3.61,0.01,High Risk
U332,2024,8,152457.0,Stable Salary & Stable Fixed Expenses,147249,74651.0,59444,134095.0,13154.0,8.93,-0.05,High Risk
U332,2024,9,165611.0,Stable Salary & Stable Fixed Expenses,147249,74651.0,86335,160986.0,-13737.0,-9.33,-0.0,High Risk
U332,2024,10,151874.0,Stable Salary & Stable Fixed Expenses,147249,74651.0,99446,174097.0,-26848.0,-18.23,0.03,High Risk
U332,2024,11,125026.0,Stable Salary & Stable Fixed Expenses,147249,74651.0,62544,137195.0,10054.0,6.83,0.05,High Risk
U332,2024,12,135080.0,Stable Salary & Stable Fixed Expenses,147249,74651.0,73862,148513.0,-1264.0,-0.86,0.0,High Risk
U333,2024,1,249940.0,Stable Salary & Stable Fixed Expenses,139261,73894.0,52234,126128.0,13133.0,9.43,-0.05,High Risk
U333,2024,2,263073.0,Stable Salary & Stable Fixed Expenses,139261,73894.0,50918,124812.0,14449.0,10.38,0.03,High Risk
U333,2024,3,277522.0,Stable Salary & Stable Fixed Expenses,139261,73894.0,61161,135055.0,4206.0,3.02,0.03,High Risk
U333,2024,4,281728.0,Stable Salary & Stable Fixed Expenses,139261,73894.0,52123,126017.0,13244.0,9.51,0.02,High Risk
U333,2024,5,294972.0,Stable Salary & Stable Fixed Expenses,139261,73894.0,50428,124322.0,14939.0,10.73,-0.02,High Risk
U333,2024,6,309911.0,Stable Salary & Stable Fixed Expenses,139261,73894.0,48449,122343.0,16918.0,12.15,-0.03,High Risk
U333,2024,7,326829.0,Stable Salary & Stable Fixed Expenses,139261,73894.0,52228,126122.0,13139.0,9.43,-0.02,High Risk
U333,2024,8,339968.0,Stable Salary & Stable Fixed Expenses,139261,73894.0,54840,128734.0,10527.0,7.56,-0.05,High Risk
U333,2024,9,350495.0,Stable Salary & Stable Fixed Expenses,139261,73894.0,50442,124336.0,14925.0,10.72,0.0,High Risk
U333,2024,10,365420.0,Stable Salary & Stable Fixed Expenses,139261,73894.0,55659,129553.0,9708.0,6.97,-0.04,High Risk
U333,2024,11,375128.0,Stable Salary & Stable Fixed Expenses,139261,73894.0,46941,120835.0,18426.0,13.23,0.03,High Risk
U333,2024,12,393554.0,Stable Salary & Stable Fixed Expenses,139261,73894.0,42020,115914.0,23347.0,16.76,-0.04,Medium Risk
U334,2024,1,231468.0,Stable Salary & Decreasing Fixed Expenses,79382,34709.0,25105,59814.0,19568.0,24.65,0.05,Medium Risk
U334,2024,2,251036.0,Stable Salary & Decreasing Fixed Expenses,79382,34709.0,25063,59772.0,19610.0,24.7,0.03,Medium Risk
U334,2024,3,270646.0,Stable Salary & Decreasing Fixed Expenses,79382,34709.0,33963,68672.0,10710.0,13.49,0.02,High Risk
U334,2024,4,281356.0,Stable Salary & Decreasing Fixed Expenses,79382,34709.0,29236,63945.0,15437.0,19.45,-0.01,Medium Risk
U334,2024,5,296793.0,Stable Salary & Decreasing Fixed Expenses,79382,34709.0,23838,58547.0,20835.0,26.25,0.01,Low Risk
U334,2024,6,317628.0,Stable Salary & Decreasing Fixed Expenses,79382,34152.0,29481,63633.0,15749.0,19.84,-0.01,Medium Risk
U334,2024,7,333377.0,Stable Salary & Decreasing Fixed Expenses,79382,34152.0,29243,63395.0,15987.0,20.14,0.0,Medium Risk
U334,2024,8,349364.0,Stable Salary & Decreasing Fixed Expenses,79382,34152.0,29599,63751.0,15631.0,19.69,-0.0,Medium Risk
U334,2024,9,364995.0,Stable Salary & Decreasing Fixed Expenses,79382,34152.0,26746,60898.0,18484.0,23.28,0.01,Medium Risk
U334,2024,10,383479.0,Stable Salary & Decreasing Fixed Expenses,79382,34152.0,29534,63686.0,15696.0,19.77,0.01,Medium Risk
U334,2024,11,399175.0,Stable Salary & Decreasing Fixed Expenses,79382,34152.0,26113,60265.0,19117.0,24.08,0.02,Medium Risk
U334,2024,12,418292.0,Stable Salary & Decreasing Fixed Expenses,79382,34152.0,25208,59360.0,20022.0,25.22,0.02,Low Risk
U335,2024,1,220792.0,Salary Increases & Fixed Expenses Remain Stable,237574,85018.0,99139,184157.0,53417.0,22.48,-0.01,Medium Risk
U335,2024,2,274209.0,Salary Increases & Fixed Expenses Remain Stable,237574,85018.0,127241,212259.0,25315.0,10.66,-0.04,High Risk
U335,2024,3,299524.0,Salary Increases & Fixed Expenses Remain Stable,248786,85018.0,178194,263212.0,-14426.0,-5.8,-0.01,High Risk
U335,2024,4,285098.0,Salary Increases & Fixed Expenses Remain Stable,248786,85018.0,136117,221135.0,27651.0,11.11,0.03,High Risk
U335,2024,5,312749.0,Salary Increases & Fixed Expenses Remain Stable,248786,85018.0,122133,207151.0,41635.0,16.74,-0.05,Medium Risk
U335,2024,6,354384.0,Salary Increases & Fixed Expenses Remain Stable,248786,85018.0,145676,230694.0,18092.0,7.27,0.05,High Risk
U335,2024,7,372476.0,Salary Increases & Fixed Expenses Remain Stable,248786,85018.0,114980,199998.0,48788.0,19.61,-0.04,Medium Risk
U335,2024,8,421264.0,Salary Increases & Fixed Expenses Remain Stable,248786,85018.0,101273,186291.0,62495.0,25.12,0.05,Low Risk
U335,2024,9,483759.0,Salary Increases & Fixed Expenses Remain Stable,248786,85018.0,110128,195146.0,53640.0,21.56,-0.02,Medium Risk
U335,2024,10,537399.0,Salary Increases & Fixed Expenses Remain Stable,248786,85018.0,142767,227785.0,21001.0,8.44,-0.03,High Risk
U335,2024,11,558400.0,Salary Increases & Fixed Expenses Remain Stable,248786,85018.0,123869,208887.0,39899.0,16.04,0.0,Medium Risk
U335,2024,12,598299.0,Salary Increases & Fixed Expenses Remain Stable,248786,85018.0,102434,187452.0,61334.0,24.65,-0.0,Medium Risk
U336,2024,1,246611.0,Salary Increases & Fixed Expenses Decrease,250598,82949.0,163496,246445.0,4153.0,1.66,0.02,High Risk
U336,2024,2,250764.0,Salary Increases & Fixed Expenses Decrease,250598,82949.0,155705,238654.0,11944.0,4.77,0.04,High Risk
U336,2024,3,262708.0,Salary Increases & Fixed Expenses Decrease,250598,82949.0,208677,291626.0,-41028.0,-16.37,-0.02,High Risk
U336,2024,4,221680.0,Salary Increases & Fixed Expenses Decrease,250598,82949.0,185230,268179.0,-17581.0,-7.02,0.05,High Risk
U336,2024,5,204099.0,Salary Increases & Fixed Expenses Decrease,250598,82949.0,189535,272484.0,-21886.0,-8.73,-0.04,High Risk
U336,2024,6,182213.0,Salary Increases & Fixed Expenses Decrease,250598,82949.0,162477,245426.0,5172.0,2.06,-0.05,High Risk
U336,2024,7,187385.0,Salary Increases & Fixed Expenses Decrease,274624,82949.0,169515,252464.0,22160.0,8.07,0.02,High Risk
U336,2024,8,209545.0,Salary Increases & Fixed Expenses Decrease,274624,82949.0,206901,289850.0,-15226.0,-5.54,-0.04,High Risk
U336,2024,9,194319.0,Salary Increases & Fixed Expenses Decrease,274624,82295.0,215872,298167.0,-23543.0,-8.57,-0.05,High Risk
U336,2024,10,170776.0,Salary Increases & Fixed Expenses Decrease,274624,82295.0,259029,341324.0,-66700.0,-24.29,0.03,High Risk
U336,2024,11,104076.0,Salary Increases & Fixed Expenses Decrease,274624,82295.0,215746,298041.0,-23417.0,-8.53,-0.04,High Risk
U336,2024,12,80659.0,Salary Increases & Fixed Expenses Decrease,274624,82295.0,191643,273938.0,686.0,0.25,-0.04,High Risk
U337,2024,1,238818.0,Salary Increases & Fixed Expenses Decrease,71654,28409.0,36716,65125.0,6529.0,9.11,0.04,High Risk
U337,2024,2,245347.0,Salary Increases & Fixed Expenses Decrease,71654,28409.0,36752,65161.0,6493.0,9.06,0.02,High Risk
U337,2024,3,251840.0,Salary Increases & Fixed Expenses Decrease,71654,28409.0,36732,65141.0,6513.0,9.09,-0.02,High Risk
U337,2024,4,258353.0,Salary Increases & Fixed Expenses Decrease,71654,28409.0,39363,67772.0,3882.0,5.42,-0.0,High Risk
U337,2024,5,262235.0,Salary Increases & Fixed Expenses Decrease,71654,28409.0,41770,70179.0,1475.0,2.06,0.03,High Risk
U337,2024,6,263710.0,Salary Increases & Fixed Expenses Decrease,87148,28409.0,44963,73372.0,13776.0,15.81,0.04,Medium Risk
U337,2024,7,277486.0,Salary Increases & Fixed Expenses Decrease,87148,28409.0,39225,67634.0,19514.0,22.39,0.03,Medium Risk
U337,2024,8,297000.0,Salary Increases & Fixed Expenses Decrease,87148,28409.0,40271,68680.0,18468.0,21.19,0.04,Medium Risk
U337,2024,9,315468.0,Salary Increases & Fixed Expenses Decrease,87148,27359.0,51073,78432.0,8716.0,10.0,-0.02,High Risk
U337,2024,10,324184.0,Salary Increases & Fixed Expenses Decrease,87148,25481.0,52060,77541.0,9607.0,11.02,-0.04,High Risk
U337,2024,11,333791.0,Salary Increases & Fixed Expenses Decrease,87148,25481.0,49940,75421.0,11727.0,13.46,-0.01,High Risk
U337,2024,12,345518.0,Salary Increases & Fixed Expenses Decrease,87148,24326.0,48296,72622.0,14526.0,16.67,0.01,Medium Risk
U338,2024,1,223690.0,Salary Increases & Fixed Expenses Remain Stable,172656,64176.0,67566,131742.0,40914.0,23.7,-0.01,Medium Risk
U338,2024,2,264604.0,Salary Increases & Fixed Expenses Remain Stable,172656,64176.0,56920,121096.0,51560.0,29.86,0.02,Low Risk
U338,2024,3,316164.0,Salary Increases & Fixed Expenses Remain Stable,189622,64176.0,75306,139482.0,50140.0,26.44,-0.01,Low Risk
U338,2024,4,366304.0,Salary Increases & Fixed Expenses Remain Stable,189622,64176.0,73231,137407.0,52215.0,27.54,0.01,Low Risk
U338,2024,5,418519.0,Salary Increases & Fixed Expenses Remain Stable,189622,64176.0,62423,126599.0,63023.0,33.24,-0.05,Low Risk
U338,2024,6,481542.0,Salary Increases & Fixed Expenses Remain Stable,189622,64176.0,73390,137566.0,52056.0,27.45,-0.0,Low Risk
U338,2024,7,533598.0,Salary Increases & Fixed Expenses Remain Stable,189622,64176.0,75822,139998.0,49624.0,26.17,0.03,Low Risk
U338,2024,8,583222.0,Salary Increases & Fixed Expenses Remain Stable,189622,64176.0,59866,124042.0,65580.0,34.58,-0.01,Low Risk
U338,2024,9,648802.0,Salary Increases & Fixed Expenses Remain Stable,189622,64176.0,64137,128313.0,61309.0,32.33,0.01,Low Risk
U338,2024,10,710111.0,Salary Increases & Fixed Expenses Remain Stable,189622,64176.0,76786,140962.0,48660.0,25.66,0.04,Low Risk
U338,2024,11,758771.0,Salary Increases & Fixed Expenses Remain Stable,189622,64176.0,63854,128030.0,61592.0,32.48,0.03,Low Risk
U338,2024,12,820363.0,Salary Increases & Fixed Expenses Remain Stable,189622,64176.0,71820,135996.0,53626.0,28.28,0.02,Low Risk
U339,2024,1,221846.0,Salary Increases & Fixed Expenses Remain Stable,187072,65376.0,62930,128306.0,58766.0,31.41,0.03,Low Risk
U339,2024,2,280612.0,Salary Increases & Fixed Expenses Remain Stable,187072,65376.0,69664,135040.0,52032.0,27.81,0.05,Low Risk
U339,2024,3,332644.0,Salary Increases & Fixed Expenses Remain Stable,215184,65376.0,80000,145376.0,69808.0,32.44,-0.02,Low Risk
U339,2024,4,402452.0,Salary Increases & Fixed Expenses Remain Stable,215184,65376.0,85297,150673.0,64511.0,29.98,0.03,Low Risk
U339,2024,5,466963.0,Salary Increases & Fixed Expenses Remain Stable,215184,65376.0,76489,141865.0,73319.0,34.07,0.02,Low Risk
U339,2024,6,540282.0,Salary Increases & Fixed Expenses Remain Stable,215184,65376.0,78748,144124.0,71060.0,33.02,0.01,Low Risk
U339,2024,7,611342.0,Salary Increases & Fixed Expenses Remain Stable,215184,65376.0,81780,147156.0,68028.0,31.61,-0.02,Low Risk
U339,2024,8,679370.0,Salary Increases & Fixed Expenses Remain Stable,215184,65376.0,75454,140830.0,74354.0,34.55,0.03,Low Risk
U339,2024,9,753724.0,Salary Increases & Fixed Expenses Remain Stable,215184,65376.0,85314,150690.0,64494.0,29.97,0.03,Low Risk
U339,2024,10,818218.0,Salary Increases & Fixed Expenses Remain Stable,215184,65376.0,70487,135863.0,79321.0,36.86,-0.03,Low Risk
U339,2024,11,897539.0,Salary Increases & Fixed Expenses Remain Stable,215184,65376.0,75428,140804.0,74380.0,34.57,0.04,Low Risk
U339,2024,12,971919.0,Salary Increases & Fixed Expenses Remain Stable,215184,65376.0,68711,134087.0,81097.0,37.69,0.01,Low Risk
U340,2024,1,216559.0,Stable Salary & Stable Fixed Expenses,83040,27988.0,34796,62784.0,20256.0,24.39,0.01,Medium Risk
U340,2024,2,236815.0,Stable Salary & Stable Fixed Expenses,83040,27988.0,49634,77622.0,5418.0,6.52,0.03,High Risk
U340,2024,3,242233.0,Stable Salary & Stable Fixed Expenses,83040,27988.0,37058,65046.0,17994.0,21.67,-0.03,Medium Risk
U340,2024,4,260227.0,Stable Salary & Stable Fixed Expenses,83040,27988.0,44205,72193.0,10847.0,13.06,-0.04,High Risk
U340,2024,5,271074.0,Stable Salary & Stable Fixed Expenses,83040,27988.0,38787,66775.0,16265.0,19.59,-0.05,Medium Risk
U340,2024,6,287339.0,Stable Salary & Stable Fixed Expenses,83040,27988.0,47868,75856.0,7184.0,8.65,-0.0,High Risk
U340,2024,7,294523.0,Stable Salary & Stable Fixed Expenses,83040,27988.0,45055,73043.0,9997.0,12.04,-0.03,High Risk
U340,2024,8,304520.0,Stable Salary & Stable Fixed Expenses,83040,27988.0,41672,69660.0,13380.0,16.11,0.02,Medium Risk
U340,2024,9,317900.0,Stable Salary & Stable Fixed Expenses,83040,27988.0,37688,65676.0,17364.0,20.91,-0.03,Medium Risk
U340,2024,10,335264.0,Stable Salary & Stable Fixed Expenses,83040,27988.0,41026,69014.0,14026.0,16.89,-0.04,Medium Risk
U340,2024,11,349290.0,Stable Salary & Stable Fixed Expenses,83040,27988.0,46442,74430.0,8610.0,10.37,0.04,High Risk
U340,2024,12,357900.0,Stable Salary & Stable Fixed Expenses,83040,27988.0,48611,76599.0,6441.0,7.76,-0.03,High Risk
U341,2024,1,232061.0,Stable Salary & Stable Fixed Expenses,60720,30552.0,30332,60884.0,-164.0,-0.27,-0.02,High Risk
U341,2024,2,231897.0,Stable Salary & Stable Fixed Expenses,60720,30552.0,26644,57196.0,3524.0,5.8,-0.04,High Risk
U341,2024,3,235421.0,Stable Salary & Stable Fixed Expenses,60720,30552.0,36534,67086.0,-6366.0,-10.48,0.03,High Risk
U341,2024,4,229055.0,Stable Salary & Stable Fixed Expenses,60720,30552.0,33212,63764.0,-3044.0,-5.01,0.01,High Risk
U341,2024,5,226011.0,Stable Salary & Stable Fixed Expenses,60720,30552.0,24947,55499.0,5221.0,8.6,0.01,High Risk
U341,2024,6,231232.0,Stable Salary & Stable Fixed Expenses,60720,30552.0,28885,59437.0,1283.0,2.11,0.0,High Risk
U341,2024,7,232515.0,Stable Salary & Stable Fixed Expenses,60720,30552.0,25363,55915.0,4805.0,7.91,-0.02,High Risk
U341,2024,8,237320.0,Stable Salary & Stable Fixed Expenses,60720,30552.0,26020,56572.0,4148.0,6.83,0.03,High Risk
U341,2024,9,241468.0,Stable Salary & Stable Fixed Expenses,60720,30552.0,31208,61760.0,-1040.0,-1.71,0.05,High Risk
U341,2024,10,240428.0,Stable Salary & Stable Fixed Expenses,60720,30552.0,33573,64125.0,-3405.0,-5.61,0.01,High Risk
U341,2024,11,237023.0,Stable Salary & Stable Fixed Expenses,60720,30552.0,28764,59316.0,1404.0,2.31,0.03,High Risk
U341,2024,12,238427.0,Stable Salary & Stable Fixed Expenses,60720,30552.0,30725,61277.0,-557.0,-0.92,-0.05,High Risk
U342,2024,1,247405.0,Salary Increases & Fixed Expenses Increase,200752,77340.0,83239,160579.0,40173.0,20.01,0.05,Medium Risk
U342,2024,2,287578.0,Salary Increases & Fixed Expenses Increase,200752,79185.0,84178,163363.0,37389.0,18.62,-0.04,Medium Risk
U342,2024,3,324967.0,Salary Increases & Fixed Expenses Increase,200752,79185.0,132158,211343.0,-10591.0,-5.28,0.02,High Risk
U342,2024,4,314376.0,Salary Increases & Fixed Expenses Increase,219988,79185.0,110904,190089.0,29899.0,13.59,-0.05,High Risk
U342,2024,5,344275.0,Salary Increases & Fixed Expenses Increase,219988,79185.0,129931,209116.0,10872.0,4.94,0.02,High Risk
U342,2024,6,355147.0,Salary Increases & Fixed Expenses Increase,219988,80012.0,128039,208051.0,11937.0,5.43,0.04,High Risk
U342,2024,7,367084.0,Salary Increases & Fixed Expenses Increase,219988,80012.0,103788,183800.0,36188.0,16.45,0.0,Medium Risk
U342,2024,8,403272.0,Salary Increases & Fixed Expenses Increase,219988,80012.0,101285,181297.0,38691.0,17.59,-0.03,Medium Risk
U342,2024,9,441963.0,Salary Increases & Fixed Expenses Increase,219988,80012.0,112131,192143.0,27845.0,12.66,-0.01,High Risk
U342,2024,10,469808.0,Salary Increases & Fixed Expenses Increase,219988,80012.0,122702,202714.0,17274.0,7.85,-0.05,High Risk
U342,2024,11,487082.0,Salary Increases & Fixed Expenses Increase,219988,80012.0,105042,185054.0,34934.0,15.88,0.03,Medium Risk
U342,2024,12,522016.0,Salary Increases & Fixed Expenses Increase,219988,80012.0,122762,202774.0,17214.0,7.82,0.04,High Risk
U343,2024,1,244825.0,Salary Increases & Fixed Expenses Remain Stable,81979,38832.0,39221,78053.0,3926.0,4.79,0.01,High Risk
U343,2024,2,248751.0,Salary Increases & Fixed Expenses Remain Stable,81979,38832.0,33400,72232.0,9747.0,11.89,-0.01,High Risk
U343,2024,3,258498.0,Salary Increases & Fixed Expenses Remain Stable,81979,38832.0,51939,90771.0,-8792.0,-10.72,-0.01,High Risk
U343,2024,4,249706.0,Salary Increases & Fixed Expenses Remain Stable,107009,38832.0,60909,99741.0,7268.0,6.79,0.01,High Risk
U343,2024,5,256974.0,Salary Increases & Fixed Expenses Remain Stable,107009,38832.0,58758,97590.0,9419.0,8.8,-0.03,High Risk
U343,2024,6,266393.0,Salary Increases & Fixed Expenses Remain Stable,107009,38832.0,58690,97522.0,9487.0,8.87,0.05,High Risk
U343,2024,7,275880.0,Salary Increases & Fixed Expenses Remain Stable,107009,38832.0,53366,92198.0,14811.0,13.84,0.02,High Risk
U343,2024,8,290691.0,Salary Increases & Fixed Expenses Remain Stable,107009,38832.0,52393,91225.0,15784.0,14.75,-0.03,High Risk
U343,2024,9,306475.0,Salary Increases & Fixed Expenses Remain Stable,107009,38832.0,48708,87540.0,19469.0,18.19,0.03,Medium Risk
U343,2024,10,325944.0,Salary Increases & Fixed Expenses Remain Stable,107009,38832.0,67324,106156.0,853.0,0.8,-0.02,High Risk
U343,2024,11,326797.0,Salary Increases & Fixed Expenses Remain Stable,107009,38832.0,63735,102567.0,4442.0,4.15,-0.03,High Risk
U343,2024,12,331239.0,Salary Increases & Fixed Expenses Remain Stable,107009,38832.0,57608,96440.0,10569.0,9.88,-0.0,High Risk
U344,2024,1,247101.0,Stable Salary & Stable Fixed Expenses,219613,100077.0,130859,230936.0,-11323.0,-5.16,-0.0,High Risk
U344,2024,2,235778.0,Stable Salary & Stable Fixed Expenses,219613,100077.0,130876,230953.0,-11340.0,-5.16,0.05,High Risk
U344,2024,3,224438.0,Stable Salary & Stable Fixed Expenses,219613,100077.0,128785,228862.0,-9249.0,-4.21,-0.04,High Risk
U344,2024,4,215189.0,Stable Salary & Stable Fixed Expenses,219613,100077.0,94869,194946.0,24667.0,11.23,0.04,High Risk
U344,2024,5,239856.0,Stable Salary & Stable Fixed Expenses,219613,100077.0,116973,217050.0,2563.0,1.17,-0.03,High Risk
U344,2024,6,242419.0,Stable Salary & Stable Fixed Expenses,219613,100077.0,125627,225704.0,-6091.0,-2.77,0.05,High Risk
U344,2024,7,236328.0,Stable Salary & Stable Fixed Expenses,219613,100077.0,95059,195136.0,24477.0,11.15,-0.0,High Risk
U344,2024,8,260805.0,Stable Salary & Stable Fixed Expenses,219613,100077.0,119920,219997.0,-384.0,-0.17,-0.01,High Risk
U344,2024,9,260421.0,Stable Salary & Stable Fixed Expenses,219613,100077.0,117505,217582.0,2031.0,0.92,0.0,High Risk
U344,2024,10,262452.0,Stable Salary & Stable Fixed Expenses,219613,100077.0,110254,210331.0,9282.0,4.23,-0.01,High Risk
U344,2024,11,271734.0,Stable Salary & Stable Fixed Expenses,219613,100077.0,117685,217762.0,1851.0,0.84,-0.02,High Risk
U344,2024,12,273585.0,Stable Salary & Stable Fixed Expenses,219613,100077.0,129937,230014.0,-10401.0,-4.74,-0.01,High Risk
U345,2024,1,224843.0,Stable Salary & Increasing Fixed Expenses,23099,11638.0,11628,23266.0,-167.0,-0.72,-0.01,High Risk
U345,2024,2,224676.0,Stable Salary & Increasing Fixed Expenses,23099,11638.0,13447,25085.0,-1986.0,-8.6,0.03,High Risk
U345,2024,3,222690.0,Stable Salary & Increasing Fixed Expenses,23099,11638.0,12324,23962.0,-863.0,-3.74,0.05,High Risk
U345,2024,4,221827.0,Stable Salary & Increasing Fixed Expenses,23099,11638.0,9330,20968.0,2131.0,9.23,-0.04,High Risk
U345,2024,5,223958.0,Stable Salary & Increasing Fixed Expenses,23099,11638.0,9996,21634.0,1465.0,6.34,-0.01,High Risk
U345,2024,6,225423.0,Stable Salary & Increasing Fixed Expenses,23099,11638.0,11861,23499.0,-400.0,-1.73,0.01,High Risk
U345,2024,7,225023.0,Stable Salary & Increasing Fixed Expenses,23099,11638.0,12708,24346.0,-1247.0,-5.4,0.03,High Risk
U345,2024,8,223776.0,Stable Salary & Increasing Fixed Expenses,23099,11638.0,10821,22459.0,640.0,2.77,0.02,High Risk
U345,2024,9,224416.0,Stable Salary & Increasing Fixed Expenses,23099,11638.0,12015,23653.0,-554.0,-2.4,0.01,High Risk
U345,2024,10,223862.0,Stable Salary & Increasing Fixed Expenses,23099,11638.0,11276,22914.0,185.0,0.8,-0.04,High Risk
U345,2024,11,224047.0,Stable Salary & Increasing Fixed Expenses,23099,11638.0,13048,24686.0,-1587.0,-6.87,0.05,High Risk
U345,2024,12,222460.0,Stable Salary & Increasing Fixed Expenses,23099,12624.0,12600,25224.0,-2125.0,-9.2,0.05,High Risk
U346,2024,1,217656.0,Stable Salary & Increasing Fixed Expenses,69452,23413.0,33547,56960.0,12492.0,17.99,-0.03,Medium Risk
U346,2024,2,230148.0,Stable Salary & Increasing Fixed Expenses,69452,23413.0,38167,61580.0,7872.0,11.33,-0.02,High Risk
U346,2024,3,238020.0,Stable Salary & Increasing Fixed Expenses,69452,23413.0,35690,59103.0,10349.0,14.9,-0.04,High Risk
U346,2024,4,248369.0,Stable Salary & Increasing Fixed Expenses,69452,23413.0,37734,61147.0,8305.0,11.96,0.01,High Risk
U346,2024,5,256674.0,Stable Salary & Increasing Fixed Expenses,69452,23413.0,30223,53636.0,15816.0,22.77,-0.02,Medium Risk
U346,2024,6,272490.0,Stable Salary & Increasing Fixed Expenses,69452,24569.0,37831,62400.0,7052.0,10.15,0.01,High Risk
U346,2024,7,279542.0,Stable Salary & Increasing Fixed Expenses,69452,24569.0,29385,53954.0,15498.0,22.31,0.04,Medium Risk
U346,2024,8,295040.0,Stable Salary & Increasing Fixed Expenses,69452,24569.0,35536,60105.0,9347.0,13.46,-0.0,High Risk
U346,2024,9,304387.0,Stable Salary & Increasing Fixed Expenses,69452,24569.0,28691,53260.0,16192.0,23.31,-0.02,Medium Risk
U346,2024,10,320579.0,Stable Salary & Increasing Fixed Expenses,69452,24569.0,40175,64744.0,4708.0,6.78,-0.02,High Risk
U346,2024,11,325287.0,Stable Salary & Increasing Fixed Expenses,69452,24569.0,29121,53690.0,15762.0,22.69,0.02,Medium Risk
U346,2024,12,341049.0,Stable Salary & Increasing Fixed Expenses,69452,24569.0,28483,53052.0,16400.0,23.61,-0.03,Medium Risk
U347,2024,1,248423.0,Stable Salary & Stable Fixed Expenses,191570,79823.0,68696,148519.0,43051.0,22.47,-0.01,Medium Risk
U347,2024,2,291474.0,Stable Salary & Stable Fixed Expenses,191570,79823.0,66828,146651.0,44919.0,23.45,0.01,Medium Risk
U347,2024,3,336393.0,Stable Salary & Stable Fixed Expenses,191570,79823.0,82174,161997.0,29573.0,15.44,-0.0,Medium Risk
U347,2024,4,365966.0,Stable Salary & Stable Fixed Expenses,191570,79823.0,59726,139549.0,52021.0,27.16,-0.0,Low Risk
U347,2024,5,417987.0,Stable Salary & Stable Fixed Expenses,191570,79823.0,63959,143782.0,47788.0,24.95,-0.02,Medium Risk
U347,2024,6,465775.0,Stable Salary & Stable Fixed Expenses,191570,79823.0,67420,147243.0,44327.0,23.14,0.03,Medium Risk
U347,2024,7,510102.0,Stable Salary & Stable Fixed Expenses,191570,79823.0,60198,140021.0,51549.0,26.91,-0.02,Low Risk
U347,2024,8,561651.0,Stable Salary & Stable Fixed Expenses,191570,79823.0,58649,138472.0,53098.0,27.72,-0.04,Low Risk
U347,2024,9,614749.0,Stable Salary & Stable Fixed Expenses,191570,79823.0,71741,151564.0,40006.0,20.88,0.03,Medium Risk
U347,2024,10,654755.0,Stable Salary & Stable Fixed Expenses,191570,79823.0,84530,164353.0,27217.0,14.21,-0.03,High Risk
U347,2024,11,681972.0,Stable Salary & Stable Fixed Expenses,191570,79823.0,67248,147071.0,44499.0,23.23,-0.03,Medium Risk
U347,2024,12,726471.0,Stable Salary & Stable Fixed Expenses,191570,79823.0,63051,142874.0,48696.0,25.42,0.0,Low Risk
U348,2024,1,247950.0,Salary Increases & Fixed Expenses Remain Stable,202708,65203.0,66622,131825.0,70883.0,34.97,-0.01,Low Risk
U348,2024,2,318833.0,Salary Increases & Fixed Expenses Remain Stable,202708,65203.0,77575,142778.0,59930.0,29.56,0.04,Low Risk
U348,2024,3,378763.0,Salary Increases & Fixed Expenses Remain Stable,202708,65203.0,92992,158195.0,44513.0,21.96,-0.01,Medium Risk
U348,2024,4,423276.0,Salary Increases & Fixed Expenses Remain Stable,202708,65203.0,67404,132607.0,70101.0,34.58,-0.01,Low Risk
U348,2024,5,493377.0,Salary Increases & Fixed Expenses Remain Stable,202708,65203.0,80131,145334.0,57374.0,28.3,-0.01,Low Risk
U348,2024,6,550751.0,Salary Increases & Fixed Expenses Remain Stable,223694,65203.0,69516,134719.0,88975.0,39.78,0.01,Low Risk
U348,2024,7,639726.0,Salary Increases & Fixed Expenses Remain Stable,223694,65203.0,76663,141866.0,81828.0,36.58,0.01,Low Risk
U348,2024,8,721554.0,Salary Increases & Fixed Expenses Remain Stable,223694,65203.0,82481,147684.0,76010.0,33.98,-0.02,Low Risk
U348,2024,9,797564.0,Salary Increases & Fixed Expenses Remain Stable,223694,65203.0,86480,151683.0,72011.0,32.19,-0.02,Low Risk
U348,2024,10,869575.0,Salary Increases & Fixed Expenses Remain Stable,223694,65203.0,99844,165047.0,58647.0,26.22,0.0,Low Risk
U348,2024,11,928222.0,Salary Increases & Fixed Expenses Remain Stable,223694,65203.0,73572,138775.0,84919.0,37.96,0.02,Low Risk
U348,2024,12,1013141.0,Salary Increases & Fixed Expenses Remain Stable,223694,65203.0,79602,144805.0,78889.0,35.27,-0.05,Low Risk
U349,2024,1,244831.0,Salary Increases & Fixed Expenses Increase,31827,17593.0,20282,37875.0,-6048.0,-19.0,-0.02,High Risk
U349,2024,2,238783.0,Salary Increases & Fixed Expenses Increase,31827,18526.0,19877,38403.0,-6576.0,-20.66,0.01,High Risk
U349,2024,3,232207.0,Salary Increases & Fixed Expenses Increase,31827,18526.0,24040,42566.0,-10739.0,-33.74,-0.0,High Risk
U349,2024,4,221468.0,Salary Increases & Fixed Expenses Increase,31827,18526.0,25305,43831.0,-12004.0,-37.72,-0.04,High Risk
U349,2024,5,209464.0,Salary Increases & Fixed Expenses Increase,31827,18526.0,22263,40789.0,-8962.0,-28.16,0.03,High Risk
U349,2024,6,200502.0,Salary Increases & Fixed Expenses Increase,58684,18526.0,39504,58030.0,654.0,1.11,0.05,High Risk
U349,2024,7,201156.0,Salary Increases & Fixed Expenses Increase,58684,20337.0,36662,56999.0,1685.0,2.87,0.01,High Risk
U349,2024,8,202841.0,Salary Increases & Fixed Expenses Increase,58684,20337.0,35661,55998.0,2686.0,4.58,0.02,High Risk
U349,2024,9,205527.0,Salary Increases & Fixed Expenses Increase,58684,20337.0,50137,70474.0,-11790.0,-20.09,-0.04,High Risk
U349,2024,10,193737.0,Salary Increases & Fixed Expenses Increase,58684,20957.0,46967,67924.0,-9240.0,-15.75,0.01,High Risk
U349,2024,11,184497.0,Salary Increases & Fixed Expenses Increase,58684,20957.0,38914,59871.0,-1187.0,-2.02,0.05,High Risk
U349,2024,12,183310.0,Salary Increases & Fixed Expenses Increase,58684,21904.0,50415,72319.0,-13635.0,-23.23,-0.03,High Risk
U350,2024,1,230235.0,Stable Salary & Stable Fixed Expenses,24937,21013.0,13539,34552.0,-9615.0,-38.56,0.04,High Risk
U350,2024,2,220620.0,Stable Salary & Stable Fixed Expenses,24937,21013.0,12958,33971.0,-9034.0,-36.23,-0.05,High Risk
U350,2024,3,211586.0,Stable Salary & Stable Fixed Expenses,24937,21013.0,18021,39034.0,-14097.0,-56.53,-0.03,High Risk
U350,2024,4,197489.0,Stable Salary & Stable Fixed Expenses,24937,21013.0,10566,31579.0,-6642.0,-26.64,-0.04,High Risk
U350,2024,5,190847.0,Stable Salary & Stable Fixed Expenses,24937,21013.0,13946,34959.0,-10022.0,-40.19,0.03,High Risk
U350,2024,6,180825.0,Stable Salary & Stable Fixed Expenses,24937,21013.0,10135,31148.0,-6211.0,-24.91,-0.04,High Risk
U350,2024,7,174614.0,Stable Salary & Stable Fixed Expenses,24937,21013.0,10984,31997.0,-7060.0,-28.31,0.02,High Risk
U350,2024,8,167554.0,Stable Salary & Stable Fixed Expenses,24937,21013.0,12443,33456.0,-8519.0,-34.16,0.04,High Risk
U350,2024,9,159035.0,Stable Salary & Stable Fixed Expenses,24937,21013.0,11375,32388.0,-7451.0,-29.88,-0.01,High Risk
U350,2024,10,151584.0,Stable Salary & Stable Fixed Expenses,24937,21013.0,18250,39263.0,-14326.0,-57.45,-0.01,High Risk
U350,2024,11,137258.0,Stable Salary & Stable Fixed Expenses,24937,21013.0,13170,34183.0,-9246.0,-37.08,0.05,High Risk
U350,2024,12,128012.0,Stable Salary & Stable Fixed Expenses,24937,21013.0,13847,34860.0,-9923.0,-39.79,0.02,High Risk
U351,2024,1,233544.0,Stable Salary & Increasing Fixed Expenses,86627,29935.0,28677,58612.0,28015.0,32.34,0.03,Low Risk
U351,2024,2,261559.0,Stable Salary & Increasing Fixed Expenses,86627,30463.0,29127,59590.0,27037.0,31.21,0.02,Low Risk
U351,2024,3,288596.0,Stable Salary & Increasing Fixed Expenses,86627,30463.0,36263,66726.0,19901.0,22.97,-0.01,Medium Risk
U351,2024,4,308497.0,Stable Salary & Increasing Fixed Expenses,86627,31588.0,29240,60828.0,25799.0,29.78,0.05,Low Risk
U351,2024,5,334296.0,Stable Salary & Increasing Fixed Expenses,86627,31588.0,33121,64709.0,21918.0,25.3,0.02,Low Risk
U351,2024,6,356214.0,Stable Salary & Increasing Fixed Expenses,86627,31588.0,31554,63142.0,23485.0,27.11,-0.01,Low Risk
U351,2024,7,379699.0,Stable Salary & Increasing Fixed Expenses,86627,31588.0,28022,59610.0,27017.0,31.19,0.04,Low Risk
U351,2024,8,406716.0,Stable Salary & Increasing Fixed Expenses,86627,31588.0,28728,60316.0,26311.0,30.37,0.04,Low Risk
U351,2024,9,433027.0,Stable Salary & Increasing Fixed Expenses,86627,31588.0,30972,62560.0,24067.0,27.78,-0.05,Low Risk
U351,2024,10,457094.0,Stable Salary & Increasing Fixed Expenses,86627,31588.0,35584,67172.0,19455.0,22.46,0.04,Medium Risk
U351,2024,11,476549.0,Stable Salary & Increasing Fixed Expenses,86627,31588.0,31643,63231.0,23396.0,27.01,-0.0,Low Risk
U351,2024,12,499945.0,Stable Salary & Increasing Fixed Expenses,86627,31588.0,32943,64531.0,22096.0,25.51,-0.01,Low Risk
U352,2024,1,208499.0,Salary Increases & Fixed Expenses Remain Stable,216035,76137.0,67244,143381.0,72654.0,33.63,0.0,Low Risk
U352,2024,2,281153.0,Salary Increases & Fixed Expenses Remain Stable,216035,76137.0,75443,151580.0,64455.0,29.84,-0.02,Low Risk
U352,2024,3,345608.0,Salary Increases & Fixed Expenses Remain Stable,216035,76137.0,68171,144308.0,71727.0,33.2,0.03,Low Risk
U352,2024,4,417335.0,Salary Increases & Fixed Expenses Remain Stable,216035,76137.0,80826,156963.0,59072.0,27.34,-0.0,Low Risk
U352,2024,5,476407.0,Salary Increases & Fixed Expenses Remain Stable,234516,76137.0,71620,147757.0,86759.0,36.99,-0.01,Low Risk
U352,2024,6,563166.0,Salary Increases & Fixed Expenses Remain Stable,234516,76137.0,78247,154384.0,80132.0,34.17,0.04,Low Risk
U352,2024,7,643298.0,Salary Increases & Fixed Expenses Remain Stable,234516,76137.0,91853,167990.0,66526.0,28.37,0.03,Low Risk
U352,2024,8,709824.0,Salary Increases & Fixed Expenses Remain Stable,234516,76137.0,89996,166133.0,68383.0,29.16,0.03,Low Risk
U352,2024,9,778207.0,Salary Increases & Fixed Expenses Remain Stable,234516,76137.0,91333,167470.0,67046.0,28.59,-0.02,Low Risk
U352,2024,10,845253.0,Salary Increases & Fixed Expenses Remain Stable,234516,76137.0,75367,151504.0,83012.0,35.4,-0.02,Low Risk
U352,2024,11,928265.0,Salary Increases & Fixed Expenses Remain Stable,234516,76137.0,93661,169798.0,64718.0,27.6,0.03,Low Risk
U352,2024,12,992983.0,Salary Increases & Fixed Expenses Remain Stable,234516,76137.0,85975,162112.0,72404.0,30.87,0.02,Low Risk
U353,2024,1,209036.0,Stable Salary & Stable Fixed Expenses,202304,70751.0,116341,187092.0,15212.0,7.52,-0.03,High Risk
U353,2024,2,224248.0,Stable Salary & Stable Fixed Expenses,202304,70751.0,114287,185038.0,17266.0,8.53,0.01,High Risk
U353,2024,3,241514.0,Stable Salary & Stable Fixed Expenses,202304,70751.0,91221,161972.0,40332.0,19.94,-0.05,Medium Risk
U353,2024,4,281846.0,Stable Salary & Stable Fixed Expenses,202304,70751.0,94187,164938.0,37366.0,18.47,-0.02,Medium Risk
U353,2024,5,319212.0,Stable Salary & Stable Fixed Expenses,202304,70751.0,102490,173241.0,29063.0,14.37,0.02,High Risk
U353,2024,6,348275.0,Stable Salary & Stable Fixed Expenses,202304,70751.0,85388,156139.0,46165.0,22.82,0.04,Medium Risk
U353,2024,7,394440.0,Stable Salary & Stable Fixed Expenses,202304,70751.0,98694,169445.0,32859.0,16.24,-0.05,Medium Risk
U353,2024,8,427299.0,Stable Salary & Stable Fixed Expenses,202304,70751.0,92204,162955.0,39349.0,19.45,-0.04,Medium Risk
U353,2024,9,466648.0,Stable Salary & Stable Fixed Expenses,202304,70751.0,116085,186836.0,15468.0,7.65,0.03,High Risk
U353,2024,10,482116.0,Stable Salary & Stable Fixed Expenses,202304,70751.0,117062,187813.0,14491.0,7.16,-0.0,High Risk
U353,2024,11,496607.0,Stable Salary & Stable Fixed Expenses,202304,70751.0,105298,176049.0,26255.0,12.98,-0.02,High Risk
U353,2024,12,522862.0,Stable Salary & Stable Fixed Expenses,202304,70751.0,105211,175962.0,26342.0,13.02,-0.01,High Risk
U354,2024,1,216661.0,Salary Increases & Fixed Expenses Remain Stable,164007,56886.0,104336,161222.0,2785.0,1.7,-0.04,High Risk
U354,2024,2,219446.0,Salary Increases & Fixed Expenses Remain Stable,164007,56886.0,109541,166427.0,-2420.0,-1.48,-0.04,High Risk
U354,2024,3,217026.0,Salary Increases & Fixed Expenses Remain Stable,164007,56886.0,128218,185104.0,-21097.0,-12.86,-0.01,High Risk
U354,2024,4,195929.0,Salary Increases & Fixed Expenses Remain Stable,172790,56886.0,105573,162459.0,10331.0,5.98,-0.02,High Risk
U354,2024,5,206260.0,Salary Increases & Fixed Expenses Remain Stable,172790,56886.0,122310,179196.0,-6406.0,-3.71,0.02,High Risk
U354,2024,6,199854.0,Salary Increases & Fixed Expenses Remain Stable,172790,56886.0,120947,177833.0,-5043.0,-2.92,-0.01,High Risk
U354,2024,7,194811.0,Salary Increases & Fixed Expenses Remain Stable,172790,56886.0,118860,175746.0,-2956.0,-1.71,-0.03,High Risk
U354,2024,8,191855.0,Salary Increases & Fixed Expenses Remain Stable,172790,56886.0,115937,172823.0,-33.0,-0.02,0.02,High Risk
U354,2024,9,191822.0,Salary Increases & Fixed Expenses Remain Stable,172790,56886.0,123112,179998.0,-7208.0,-4.17,0.03,High Risk
U354,2024,10,184614.0,Salary Increases & Fixed Expenses Remain Stable,172790,56886.0,134686,191572.0,-18782.0,-10.87,0.0,High Risk
U354,2024,11,165832.0,Salary Increases & Fixed Expenses Remain Stable,172790,56886.0,136312,193198.0,-20408.0,-11.81,-0.01,High Risk
U354,2024,12,145424.0,Salary Increases & Fixed Expenses Remain Stable,172790,56886.0,129021,185907.0,-13117.0,-7.59,0.03,High Risk
U355,2024,1,227175.0,Stable Salary & Stable Fixed Expenses,205852,68906.0,131228,200134.0,5718.0,2.78,0.01,High Risk
U355,2024,2,232893.0,Stable Salary & Stable Fixed Expenses,205852,68906.0,157354,226260.0,-20408.0,-9.91,0.03,High Risk
U355,2024,3,212485.0,Stable Salary & Stable Fixed Expenses,205852,68906.0,162644,231550.0,-25698.0,-12.48,0.04,High Risk
U355,2024,4,186787.0,Stable Salary & Stable Fixed Expenses,205852,68906.0,130800,199706.0,6146.0,2.99,-0.03,High Risk
U355,2024,5,192933.0,Stable Salary & Stable Fixed Expenses,205852,68906.0,155247,224153.0,-18301.0,-8.89,-0.05,High Risk
U355,2024,6,174632.0,Stable Salary & Stable Fixed Expenses,205852,68906.0,152944,221850.0,-15998.0,-7.77,-0.03,High Risk
U355,2024,7,158634.0,Stable Salary & Stable Fixed Expenses,205852,68906.0,141167,210073.0,-4221.0,-2.05,-0.04,High Risk
U355,2024,8,154413.0,Stable Salary & Stable Fixed Expenses,205852,68906.0,147674,216580.0,-10728.0,-5.21,-0.04,High Risk
U355,2024,9,143685.0,Stable Salary & Stable Fixed Expenses,205852,68906.0,146125,215031.0,-9179.0,-4.46,0.02,High Risk
U355,2024,10,134506.0,Stable Salary & Stable Fixed Expenses,205852,68906.0,159798,228704.0,-22852.0,-11.1,0.03,High Risk
U355,2024,11,111654.0,Stable Salary & Stable Fixed Expenses,205852,68906.0,141112,210018.0,-4166.0,-2.02,-0.01,High Risk
U355,2024,12,107488.0,Stable Salary & Stable Fixed Expenses,205852,68906.0,150302,219208.0,-13356.0,-6.49,0.02,High Risk
U356,2024,1,214694.0,Salary Increases & Fixed Expenses Increase,206276,97614.0,153471,251085.0,-44809.0,-21.72,0.03,High Risk
U356,2024,2,169885.0,Salary Increases & Fixed Expenses Increase,206276,97614.0,164754,262368.0,-56092.0,-27.19,-0.03,High Risk
U356,2024,3,113793.0,Salary Increases & Fixed Expenses Increase,206276,98846.0,127381,226227.0,-19951.0,-9.67,-0.03,High Risk
U356,2024,4,93842.0,Salary Increases & Fixed Expenses Increase,206276,98846.0,149417,248263.0,-41987.0,-20.35,0.05,High Risk
U356,2024,5,51855.0,Salary Increases & Fixed Expenses Increase,206276,98846.0,146195,245041.0,-38765.0,-18.79,0.02,High Risk
U356,2024,6,13090.0,Salary Increases & Fixed Expenses Increase,206276,98846.0,150878,249724.0,-43448.0,-21.06,0.05,High Risk
U356,2024,7,-30358.0,Salary Increases & Fixed Expenses Increase,235483,98846.0,164067,262913.0,-27430.0,-11.65,0.04,High Risk
U356,2024,8,-57788.0,Salary Increases & Fixed Expenses Increase,235483,98846.0,187841,286687.0,-51204.0,-21.74,-0.0,High Risk
U356,2024,9,-108992.0,Salary Increases & Fixed Expenses Increase,235483,98846.0,150981,249827.0,-14344.0,-6.09,0.03,High Risk
U356,2024,10,-123336.0,Salary Increases & Fixed Expenses Increase,235483,100784.0,167642,268426.0,-32943.0,-13.99,-0.03,High Risk
U356,2024,11,-156279.0,Salary Increases & Fixed Expenses Increase,235483,100784.0,167566,268350.0,-32867.0,-13.96,-0.03,High Risk
U356,2024,12,-189146.0,Salary Increases & Fixed Expenses Increase,235483,100784.0,153946,254730.0,-19247.0,-8.17,-0.02,High Risk
U357,2024,1,205915.0,Stable Salary & Stable Fixed Expenses,236731,117694.0,122675,240369.0,-3638.0,-1.54,0.04,High Risk
U357,2024,2,202277.0,Stable Salary & Stable Fixed Expenses,236731,117694.0,123979,241673.0,-4942.0,-2.09,0.01,High Risk
U357,2024,3,197335.0,Stable Salary & Stable Fixed Expenses,236731,117694.0,142731,260425.0,-23694.0,-10.01,0.01,High Risk
U357,2024,4,173641.0,Stable Salary & Stable Fixed Expenses,236731,117694.0,97791,215485.0,21246.0,8.97,0.0,High Risk
U357,2024,5,194887.0,Stable Salary & Stable Fixed Expenses,236731,117694.0,124072,241766.0,-5035.0,-2.13,-0.02,High Risk
U357,2024,6,189852.0,Stable Salary & Stable Fixed Expenses,236731,117694.0,101685,219379.0,17352.0,7.33,0.02,High Risk
U357,2024,7,207204.0,Stable Salary & Stable Fixed Expenses,236731,117694.0,114524,232218.0,4513.0,1.91,0.04,High Risk
U357,2024,8,211717.0,Stable Salary & Stable Fixed Expenses,236731,117694.0,129725,247419.0,-10688.0,-4.51,-0.03,High Risk
U357,2024,9,201029.0,Stable Salary & Stable Fixed Expenses,236731,117694.0,109447,227141.0,9590.0,4.05,0.01,High Risk
U357,2024,10,210619.0,Stable Salary & Stable Fixed Expenses,236731,117694.0,152447,270141.0,-33410.0,-14.11,0.02,High Risk
U357,2024,11,177209.0,Stable Salary & Stable Fixed Expenses,236731,117694.0,96775,214469.0,22262.0,9.4,-0.04,High Risk
U357,2024,12,199471.0,Stable Salary & Stable Fixed Expenses,236731,117694.0,97059,214753.0,21978.0,9.28,0.02,High Risk
U358,2024,1,240127.0,Stable Salary & Stable Fixed Expenses,148788,71632.0,91234,162866.0,-14078.0,-9.46,-0.02,High Risk
U358,2024,2,226049.0,Stable Salary & Stable Fixed Expenses,148788,71632.0,109952,181584.0,-32796.0,-22.04,-0.05,High Risk
U358,2024,3,193253.0,Stable Salary & Stable Fixed Expenses,148788,71632.0,139969,211601.0,-62813.0,-42.22,-0.05,High Risk
U358,2024,4,130440.0,Stable Salary & Stable Fixed Expenses,148788,71632.0,93611,165243.0,-16455.0,-11.06,0.01,High Risk
U358,2024,5,113985.0,Stable Salary & Stable Fixed Expenses,148788,71632.0,103398,175030.0,-26242.0,-17.64,0.04,High Risk
U358,2024,6,87743.0,Stable Salary & Stable Fixed Expenses,148788,71632.0,118028,189660.0,-40872.0,-27.47,0.04,High Risk
U358,2024,7,46871.0,Stable Salary & Stable Fixed Expenses,148788,71632.0,102266,173898.0,-25110.0,-16.88,-0.02,High Risk
U358,2024,8,21761.0,Stable Salary & Stable Fixed Expenses,148788,71632.0,105382,177014.0,-28226.0,-18.97,0.02,High Risk
U358,2024,9,-6465.0,Stable Salary & Stable Fixed Expenses,148788,71632.0,92946,164578.0,-15790.0,-10.61,-0.01,High Risk
U358,2024,10,-22255.0,Stable Salary & Stable Fixed Expenses,148788,71632.0,122434,194066.0,-45278.0,-30.43,0.03,High Risk
U358,2024,11,-67533.0,Stable Salary & Stable Fixed Expenses,148788,71632.0,115596,187228.0,-38440.0,-25.84,-0.01,High Risk
U358,2024,12,-105973.0,Stable Salary & Stable Fixed Expenses,148788,71632.0,97256,168888.0,-20100.0,-13.51,-0.05,High Risk
U359,2024,1,237121.0,Salary Increases & Fixed Expenses Remain Stable,85476,34455.0,38991,73446.0,12030.0,14.07,0.05,High Risk
U359,2024,2,249151.0,Salary Increases & Fixed Expenses Remain Stable,85476,34455.0,40690,75145.0,10331.0,12.09,-0.03,High Risk
U359,2024,3,259482.0,Salary Increases & Fixed Expenses Remain Stable,85476,34455.0,44288,78743.0,6733.0,7.88,-0.04,High Risk
U359,2024,4,266215.0,Salary Increases & Fixed Expenses Remain Stable,85476,34455.0,34576,69031.0,16445.0,19.24,-0.03,Medium Risk
U359,2024,5,282660.0,Salary Increases & Fixed Expenses Remain Stable,85476,34455.0,46651,81106.0,4370.0,5.11,0.04,High Risk
U359,2024,6,287030.0,Salary Increases & Fixed Expenses Remain Stable,85476,34455.0,44646,79101.0,6375.0,7.46,-0.02,High Risk
U359,2024,7,293405.0,Salary Increases & Fixed Expenses Remain Stable,85476,34455.0,35999,70454.0,15022.0,17.57,-0.03,Medium Risk
U359,2024,8,308427.0,Salary Increases & Fixed Expenses Remain Stable,107606,34455.0,59411,93866.0,13740.0,12.77,-0.01,High Risk
U359,2024,9,322167.0,Salary Increases & Fixed Expenses Remain Stable,107606,34455.0,62290,96745.0,10861.0,10.09,0.02,High Risk
U359,2024,10,333028.0,Salary Increases & Fixed Expenses Remain Stable,107606,34455.0,64731,99186.0,8420.0,7.82,0.0,High Risk
U359,2024,11,341448.0,Salary Increases & Fixed Expenses Remain Stable,107606,34455.0,52328,86783.0,20823.0,19.35,0.03,Medium Risk
U359,2024,12,362271.0,Salary Increases & Fixed Expenses Remain Stable,107606,34455.0,65247,99702.0,7904.0,7.35,-0.03,High Risk
U360,2024,1,224242.0,Salary Increases & Fixed Expenses Remain Stable,264715,86071.0,85810,171881.0,92834.0,35.07,-0.04,Low Risk
U360,2024,2,317076.0,Salary Increases & Fixed Expenses Remain Stable,264715,86071.0,101574,187645.0,77070.0,29.11,-0.01,Low Risk
U360,2024,3,394146.0,Salary Increases & Fixed Expenses Remain Stable,272797,86071.0,113607,199678.0,73119.0,26.8,-0.04,Low Risk
U360,2024,4,467265.0,Salary Increases & Fixed Expenses Remain Stable,272797,86071.0,85266,171337.0,101460.0,37.19,0.02,Low Risk
U360,2024,5,568725.0,Salary Increases & Fixed Expenses Remain Stable,272797,86071.0,100766,186837.0,85960.0,31.51,-0.04,Low Risk
U360,2024,6,654685.0,Salary Increases & Fixed Expenses Remain Stable,272797,86071.0,96621,182692.0,90105.0,33.03,0.0,Low Risk
U360,2024,7,744790.0,Salary Increases & Fixed Expenses Remain Stable,272797,86071.0,104766,190837.0,81960.0,30.04,-0.02,Low Risk
U360,2024,8,826750.0,Salary Increases & Fixed Expenses Remain Stable,272797,86071.0,89753,175824.0,96973.0,35.55,0.04,Low Risk
U360,2024,9,923723.0,Salary Increases & Fixed Expenses Remain Stable,272797,86071.0,87614,173685.0,99112.0,36.33,-0.02,Low Risk
U360,2024,10,1022835.0,Salary Increases & Fixed Expenses Remain Stable,272797,86071.0,126399,212470.0,60327.0,22.11,0.05,Medium Risk
U360,2024,11,1083162.0,Salary Increases & Fixed Expenses Remain Stable,272797,86071.0,87928,173999.0,98798.0,36.22,-0.04,Low Risk
U360,2024,12,1181960.0,Salary Increases & Fixed Expenses Remain Stable,272797,86071.0,103939,190010.0,82787.0,30.35,0.02,Low Risk
U361,2024,1,201000.0,Salary Increases & Fixed Expenses Decrease,299213,80286.0,151198,231484.0,67729.0,22.64,-0.03,Medium Risk
U361,2024,2,268729.0,Salary Increases & Fixed Expenses Decrease,299213,80286.0,127944,208230.0,90983.0,30.41,-0.05,Low Risk
U361,2024,3,359712.0,Salary Increases & Fixed Expenses Decrease,299213,80286.0,147958,228244.0,70969.0,23.72,-0.01,Medium Risk
U361,2024,4,430681.0,Salary Increases & Fixed Expenses Decrease,316992,80286.0,142771,223057.0,93935.0,29.63,0.03,Low Risk
U361,2024,5,524616.0,Salary Increases & Fixed Expenses Decrease,316992,80286.0,146705,226991.0,90001.0,28.39,-0.03,Low Risk
U361,2024,6,614617.0,Salary Increases & Fixed Expenses Decrease,316992,79444.0,164795,244239.0,72753.0,22.95,0.02,Medium Risk
U361,2024,7,687370.0,Salary Increases & Fixed Expenses Decrease,316992,79444.0,135908,215352.0,101640.0,32.06,0.02,Low Risk
U361,2024,8,789010.0,Salary Increases & Fixed Expenses Decrease,316992,79444.0,144581,224025.0,92967.0,29.33,-0.01,Low Risk
U361,2024,9,881977.0,Salary Increases & Fixed Expenses Decrease,316992,79444.0,189046,268490.0,48502.0,15.3,0.02,Medium Risk
U361,2024,10,930479.0,Salary Increases & Fixed Expenses Decrease,316992,79444.0,144372,223816.0,93176.0,29.39,0.01,Low Risk
U361,2024,11,1023655.0,Salary Increases & Fixed Expenses Decrease,316992,79444.0,165779,245223.0,71769.0,22.64,0.01,Medium Risk
U361,2024,12,1095424.0,Salary Increases & Fixed Expenses Decrease,316992,79444.0,157709,237153.0,79839.0,25.19,-0.03,Low Risk
U362,2024,1,214967.0,Salary Increases & Fixed Expenses Decrease,141693,74147.0,64833,138980.0,2713.0,1.91,-0.04,High Risk
U362,2024,2,217680.0,Salary Increases & Fixed Expenses Decrease,141693,74147.0,61996,136143.0,5550.0,3.92,0.02,High Risk
U362,2024,3,223230.0,Salary Increases & Fixed Expenses Decrease,141693,74147.0,76440,150587.0,-8894.0,-6.28,-0.01,High Risk
U362,2024,4,214336.0,Salary Increases & Fixed Expenses Decrease,141693,74147.0,78013,152160.0,-10467.0,-7.39,-0.05,High Risk
U362,2024,5,203869.0,Salary Increases & Fixed Expenses Decrease,141693,74147.0,82288,156435.0,-14742.0,-10.4,-0.0,High Risk
U362,2024,6,189127.0,Salary Increases & Fixed Expenses Decrease,141693,74147.0,66289,140436.0,1257.0,0.89,0.03,High Risk
U362,2024,7,190384.0,Salary Increases & Fixed Expenses Decrease,171551,74147.0,82171,156318.0,15233.0,8.88,-0.01,High Risk
U362,2024,8,205617.0,Salary Increases & Fixed Expenses Decrease,171551,74147.0,101792,175939.0,-4388.0,-2.56,-0.04,High Risk
U362,2024,9,201229.0,Salary Increases & Fixed Expenses Decrease,171551,74147.0,104341,178488.0,-6937.0,-4.04,0.04,High Risk
U362,2024,10,194292.0,Salary Increases & Fixed Expenses Decrease,171551,74147.0,116080,190227.0,-18676.0,-10.89,0.0,High Risk
U362,2024,11,175616.0,Salary Increases & Fixed Expenses Decrease,171551,74147.0,103085,177232.0,-5681.0,-3.31,0.04,High Risk
U362,2024,12,169935.0,Salary Increases & Fixed Expenses Decrease,171551,74147.0,107616,181763.0,-10212.0,-5.95,0.02,High Risk
U363,2024,1,207113.0,Stable Salary & Stable Fixed Expenses,264621,96879.0,91047,187926.0,76695.0,28.98,0.02,Low Risk
U363,2024,2,283808.0,Stable Salary & Stable Fixed Expenses,264621,96879.0,85570,182449.0,82172.0,31.05,-0.04,Low Risk
U363,2024,3,365980.0,Stable Salary & Stable Fixed Expenses,264621,96879.0,125626,222505.0,42116.0,15.92,-0.0,Medium Risk
U363,2024,4,408096.0,Stable Salary & Stable Fixed Expenses,264621,96879.0,94933,191812.0,72809.0,27.51,-0.03,Low Risk
U363,2024,5,480905.0,Stable Salary & Stable Fixed Expenses,264621,96879.0,100321,197200.0,67421.0,25.48,-0.0,Low Risk
U363,2024,6,548326.0,Stable Salary & Stable Fixed Expenses,264621,96879.0,92145,189024.0,75597.0,28.57,-0.04,Low Risk
U363,2024,7,623923.0,Stable Salary & Stable Fixed Expenses,264621,96879.0,99330,196209.0,68412.0,25.85,-0.04,Low Risk
U363,2024,8,692335.0,Stable Salary & Stable Fixed Expenses,264621,96879.0,86077,182956.0,81665.0,30.86,-0.02,Low Risk
U363,2024,9,774000.0,Stable Salary & Stable Fixed Expenses,264621,96879.0,82159,179038.0,85583.0,32.34,-0.04,Low Risk
U363,2024,10,859583.0,Stable Salary & Stable Fixed Expenses,264621,96879.0,117692,214571.0,50050.0,18.91,-0.04,Medium Risk
U363,2024,11,909633.0,Stable Salary & Stable Fixed Expenses,264621,96879.0,88210,185089.0,79532.0,30.06,0.01,Low Risk
U363,2024,12,989165.0,Stable Salary & Stable Fixed Expenses,264621,96879.0,88548,185427.0,79194.0,29.93,0.02,Low Risk
U364,2024,1,209226.0,Salary Increases & Fixed Expenses Increase,167155,79310.0,88309,167619.0,-464.0,-0.28,0.02,High Risk
U364,2024,2,208762.0,Salary Increases & Fixed Expenses Increase,167155,79310.0,100027,179337.0,-12182.0,-7.29,0.03,High Risk
U364,2024,3,196580.0,Salary Increases & Fixed Expenses Increase,167155,79310.0,104473,183783.0,-16628.0,-9.95,-0.03,High Risk
U364,2024,4,179952.0,Salary Increases & Fixed Expenses Increase,167155,79310.0,71560,150870.0,16285.0,9.74,0.02,High Risk
U364,2024,5,196237.0,Salary Increases & Fixed Expenses Increase,196695,79310.0,88907,168217.0,28478.0,14.48,-0.0,High Risk
U364,2024,6,224715.0,Salary Increases & Fixed Expenses Increase,196695,79310.0,117211,196521.0,174.0,0.09,0.03,High Risk
U364,2024,7,224889.0,Salary Increases & Fixed Expenses Increase,196695,79310.0,86919,166229.0,30466.0,15.49,0.0,Medium Risk
U364,2024,8,255355.0,Salary Increases & Fixed Expenses Increase,196695,79310.0,116936,196246.0,449.0,0.23,0.02,High Risk
U364,2024,9,255804.0,Salary Increases & Fixed Expenses Increase,196695,79310.0,81803,161113.0,35582.0,18.09,-0.02,Medium Risk
U364,2024,10,291386.0,Salary Increases & Fixed Expenses Increase,196695,79310.0,119859,199169.0,-2474.0,-1.26,0.03,High Risk
U364,2024,11,288912.0,Salary Increases & Fixed Expenses Increase,196695,79310.0,109066,188376.0,8319.0,4.23,-0.04,High Risk
U364,2024,12,297231.0,Salary Increases & Fixed Expenses Increase,196695,79310.0,101181,180491.0,16204.0,8.24,0.02,High Risk
U365,2024,1,213399.0,Stable Salary & Increasing Fixed Expenses,130001,80786.0,73257,154043.0,-24042.0,-18.49,-0.03,High Risk
U365,2024,2,189357.0,Stable Salary & Increasing Fixed Expenses,130001,80786.0,75500,156286.0,-26285.0,-20.22,-0.01,High Risk
U365,2024,3,163072.0,Stable Salary & Increasing Fixed Expenses,130001,80786.0,75401,156187.0,-26186.0,-20.14,0.02,High Risk
U365,2024,4,136886.0,Stable Salary & Increasing Fixed Expenses,130001,80786.0,76853,157639.0,-27638.0,-21.26,0.02,High Risk
U365,2024,5,109248.0,Stable Salary & Increasing Fixed Expenses,130001,82599.0,60220,142819.0,-12818.0,-9.86,0.03,High Risk
U365,2024,6,96430.0,Stable Salary & Increasing Fixed Expenses,130001,82599.0,57835,140434.0,-10433.0,-8.03,-0.0,High Risk
U365,2024,7,85997.0,Stable Salary & Increasing Fixed Expenses,130001,82599.0,70660,153259.0,-23258.0,-17.89,-0.02,High Risk
U365,2024,8,62739.0,Stable Salary & Increasing Fixed Expenses,130001,82599.0,72763,155362.0,-25361.0,-19.51,-0.04,High Risk
U365,2024,9,37378.0,Stable Salary & Increasing Fixed Expenses,130001,82599.0,79077,161676.0,-31675.0,-24.37,-0.04,High Risk
U365,2024,10,5703.0,Stable Salary & Increasing Fixed Expenses,130001,82599.0,64433,147032.0,-17031.0,-13.1,0.0,High Risk
U365,2024,11,-11328.0,Stable Salary & Increasing Fixed Expenses,130001,82599.0,56148,138747.0,-8746.0,-6.73,0.01,High Risk
U365,2024,12,-20074.0,Stable Salary & Increasing Fixed Expenses,130001,82599.0,81220,163819.0,-33818.0,-26.01,0.01,High Risk
U366,2024,1,245108.0,Stable Salary & Stable Fixed Expenses,157123,64878.0,83271,148149.0,8974.0,5.71,0.03,High Risk
U366,2024,2,254082.0,Stable Salary & Stable Fixed Expenses,157123,64878.0,75112,139990.0,17133.0,10.9,-0.03,High Risk
U366,2024,3,271215.0,Stable Salary & Stable Fixed Expenses,157123,64878.0,85841,150719.0,6404.0,4.08,0.01,High Risk
U366,2024,4,277619.0,Stable Salary & Stable Fixed Expenses,157123,64878.0,78547,143425.0,13698.0,8.72,0.03,High Risk
U366,2024,5,291317.0,Stable Salary & Stable Fixed Expenses,157123,64878.0,81928,146806.0,10317.0,6.57,-0.01,High Risk
U366,2024,6,301634.0,Stable Salary & Stable Fixed Expenses,157123,64878.0,84899,149777.0,7346.0,4.68,-0.0,High Risk
U366,2024,7,308980.0,Stable Salary & Stable Fixed Expenses,157123,64878.0,67372,132250.0,24873.0,15.83,-0.04,Medium Risk
U366,2024,8,333853.0,Stable Salary & Stable Fixed Expenses,157123,64878.0,84340,149218.0,7905.0,5.03,0.0,High Risk
U366,2024,9,341758.0,Stable Salary & Stable Fixed Expenses,157123,64878.0,70829,135707.0,21416.0,13.63,-0.02,High Risk
U366,2024,10,363174.0,Stable Salary & Stable Fixed Expenses,157123,64878.0,104494,169372.0,-12249.0,-7.8,-0.05,High Risk
U366,2024,11,350925.0,Stable Salary & Stable Fixed Expenses,157123,64878.0,73042,137920.0,19203.0,12.22,-0.05,High Risk
U366,2024,12,370128.0,Stable Salary & Stable Fixed Expenses,157123,64878.0,113457,178335.0,-21212.0,-13.5,0.02,High Risk
U367,2024,1,237730.0,Stable Salary & Stable Fixed Expenses,43110,13395.0,31651,45046.0,-1936.0,-4.49,-0.01,High Risk
U367,2024,2,235794.0,Stable Salary & Stable Fixed Expenses,43110,13395.0,30140,43535.0,-425.0,-0.99,0.03,High Risk
U367,2024,3,235369.0,Stable Salary & Stable Fixed Expenses,43110,13395.0,37084,50479.0,-7369.0,-17.09,-0.05,High Risk
U367,2024,4,228000.0,Stable Salary & Stable Fixed Expenses,43110,13395.0,28822,42217.0,893.0,2.07,-0.04,High Risk
U367,2024,5,228893.0,Stable Salary & Stable Fixed Expenses,43110,13395.0,32498,45893.0,-2783.0,-6.46,-0.02,High Risk
U367,2024,6,226110.0,Stable Salary & Stable Fixed Expenses,43110,13395.0,31101,44496.0,-1386.0,-3.22,-0.0,High Risk
U367,2024,7,224724.0,Stable Salary & Stable Fixed Expenses,43110,13395.0,27120,40515.0,2595.0,6.02,0.05,High Risk
U367,2024,8,227319.0,Stable Salary & Stable Fixed Expenses,43110,13395.0,27511,40906.0,2204.0,5.11,-0.04,High Risk
U367,2024,9,229523.0,Stable Salary & Stable Fixed Expenses,43110,13395.0,34394,47789.0,-4679.0,-10.85,-0.01,High Risk
U367,2024,10,224844.0,Stable Salary & Stable Fixed Expenses,43110,13395.0,31828,45223.0,-2113.0,-4.9,0.03,High Risk
U367,2024,11,222731.0,Stable Salary & Stable Fixed Expenses,43110,13395.0,37259,50654.0,-7544.0,-17.5,-0.04,High Risk
U367,2024,12,215187.0,Stable Salary & Stable Fixed Expenses,43110,13395.0,32776,46171.0,-3061.0,-7.1,0.02,High Risk
U368,2024,1,226744.0,Stable Salary & Decreasing Fixed Expenses,166619,44371.0,66153,110524.0,56095.0,33.67,0.02,Low Risk
U368,2024,2,282839.0,Stable Salary & Decreasing Fixed Expenses,166619,44371.0,66483,110854.0,55765.0,33.47,0.04,Low Risk
U368,2024,3,338604.0,Stable Salary & Decreasing Fixed Expenses,166619,44371.0,52315,96686.0,69933.0,41.97,-0.02,Low Risk
U368,2024,4,408537.0,Stable Salary & Decreasing Fixed Expenses,166619,44371.0,61140,105511.0,61108.0,36.68,-0.02,Low Risk
U368,2024,5,469645.0,Stable Salary & Decreasing Fixed Expenses,166619,44371.0,60885,105256.0,61363.0,36.83,0.01,Low Risk
U368,2024,6,531008.0,Stable Salary & Decreasing Fixed Expenses,166619,44371.0,50570,94941.0,71678.0,43.02,0.03,Low Risk
U368,2024,7,602686.0,Stable Salary & Decreasing Fixed Expenses,166619,44371.0,54936,99307.0,67312.0,40.4,-0.02,Low Risk
U368,2024,8,669998.0,Stable Salary & Decreasing Fixed Expenses,166619,44371.0,64398,108769.0,57850.0,34.72,-0.01,Low Risk
U368,2024,9,727848.0,Stable Salary & Decreasing Fixed Expenses,166619,44371.0,57248,101619.0,65000.0,39.01,0.02,Low Risk
U368,2024,10,792848.0,Stable Salary & Decreasing Fixed Expenses,166619,42847.0,65549,108396.0,58223.0,34.94,-0.03,Low Risk
U368,2024,11,851071.0,Stable Salary & Decreasing Fixed Expenses,166619,42847.0,51320,94167.0,72452.0,43.48,0.03,Low Risk
U368,2024,12,923523.0,Stable Salary & Decreasing Fixed Expenses,166619,42847.0,63932,106779.0,59840.0,35.91,-0.03,Low Risk
U369,2024,1,222172.0,Stable Salary & Stable Fixed Expenses,89154,33503.0,38206,71709.0,17445.0,19.57,-0.03,Medium Risk
U369,2024,2,239617.0,Stable Salary & Stable Fixed Expenses,89154,33503.0,51069,84572.0,4582.0,5.14,-0.01,High Risk
U369,2024,3,244199.0,Stable Salary & Stable Fixed Expenses,89154,33503.0,52336,85839.0,3315.0,3.72,-0.01,High Risk
U369,2024,4,247514.0,Stable Salary & Stable Fixed Expenses,89154,33503.0,36756,70259.0,18895.0,21.19,0.05,Medium Risk
U369,2024,5,266409.0,Stable Salary & Stable Fixed Expenses,89154,33503.0,50000,83503.0,5651.0,6.34,0.02,High Risk
U369,2024,6,272060.0,Stable Salary & Stable Fixed Expenses,89154,33503.0,51904,85407.0,3747.0,4.2,0.01,High Risk
U369,2024,7,275807.0,Stable Salary & Stable Fixed Expenses,89154,33503.0,45912,79415.0,9739.0,10.92,0.0,High Risk
U369,2024,8,285546.0,Stable Salary & Stable Fixed Expenses,89154,33503.0,37393,70896.0,18258.0,20.48,0.02,Medium Risk
U369,2024,9,303804.0,Stable Salary & Stable Fixed Expenses,89154,33503.0,37177,70680.0,18474.0,20.72,0.02,Medium Risk
U369,2024,10,322278.0,Stable Salary & Stable Fixed Expenses,89154,33503.0,51911,85414.0,3740.0,4.19,-0.03,High Risk
U369,2024,11,326018.0,Stable Salary & Stable Fixed Expenses,89154,33503.0,45693,79196.0,9958.0,11.17,-0.04,High Risk
U369,2024,12,335976.0,Stable Salary & Stable Fixed Expenses,89154,33503.0,38864,72367.0,16787.0,18.83,0.04,Medium Risk
U370,2024,1,219185.0,Stable Salary & Increasing Fixed Expenses,290301,87352.0,221905,309257.0,-18956.0,-6.53,-0.04,High Risk
U370,2024,2,200229.0,Stable Salary & Increasing Fixed Expenses,290301,87352.0,228224,315576.0,-25275.0,-8.71,0.04,High Risk
U370,2024,3,174954.0,Stable Salary & Increasing Fixed Expenses,290301,87352.0,223979,311331.0,-21030.0,-7.24,0.02,High Risk
U370,2024,4,153924.0,Stable Salary & Increasing Fixed Expenses,290301,87352.0,199866,287218.0,3083.0,1.06,-0.02,High Risk
U370,2024,5,157007.0,Stable Salary & Increasing Fixed Expenses,290301,87352.0,204414,291766.0,-1465.0,-0.5,0.03,High Risk
U370,2024,6,155542.0,Stable Salary & Increasing Fixed Expenses,290301,87352.0,202537,289889.0,412.0,0.14,-0.05,High Risk
U370,2024,7,155954.0,Stable Salary & Increasing Fixed Expenses,290301,89253.0,187802,277055.0,13246.0,4.56,-0.02,High Risk
U370,2024,8,169200.0,Stable Salary & Increasing Fixed Expenses,290301,89253.0,212237,301490.0,-11189.0,-3.85,-0.04,High Risk
U370,2024,9,158011.0,Stable Salary & Increasing Fixed Expenses,290301,89253.0,244980,334233.0,-43932.0,-15.13,-0.04,High Risk
U370,2024,10,114079.0,Stable Salary & Increasing Fixed Expenses,290301,89253.0,213157,302410.0,-12109.0,-4.17,0.04,High Risk
U370,2024,11,101970.0,Stable Salary & Increasing Fixed Expenses,290301,89253.0,190589,279842.0,10459.0,3.6,-0.04,High Risk
U370,2024,12,112429.0,Stable Salary & Increasing Fixed Expenses,290301,89253.0,257906,347159.0,-56858.0,-19.59,0.0,High Risk
U371,2024,1,220387.0,Stable Salary & Stable Fixed Expenses,215086,67097.0,76486,143583.0,71503.0,33.24,0.04,Low Risk
U371,2024,2,291890.0,Stable Salary & Stable Fixed Expenses,215086,67097.0,75170,142267.0,72819.0,33.86,-0.0,Low Risk
U371,2024,3,364709.0,Stable Salary & Stable Fixed Expenses,215086,67097.0,67546,134643.0,80443.0,37.4,0.05,Low Risk
U371,2024,4,445152.0,Stable Salary & Stable Fixed Expenses,215086,67097.0,65811,132908.0,82178.0,38.21,0.02,Low Risk
U371,2024,5,527330.0,Stable Salary & Stable Fixed Expenses,215086,67097.0,75708,142805.0,72281.0,33.61,0.04,Low Risk
U371,2024,6,599611.0,Stable Salary & Stable Fixed Expenses,215086,67097.0,65855,132952.0,82134.0,38.19,0.02,Low Risk
U371,2024,7,681745.0,Stable Salary & Stable Fixed Expenses,215086,67097.0,70688,137785.0,77301.0,35.94,0.02,Low Risk
U371,2024,8,759046.0,Stable Salary & Stable Fixed Expenses,215086,67097.0,66978,134075.0,81011.0,37.66,-0.03,Low Risk
U371,2024,9,840057.0,Stable Salary & Stable Fixed Expenses,215086,67097.0,84862,151959.0,63127.0,29.35,-0.01,Low Risk
U371,2024,10,903184.0,Stable Salary & Stable Fixed Expenses,215086,67097.0,75253,142350.0,72736.0,33.82,0.02,Low Risk
U371,2024,11,975920.0,Stable Salary & Stable Fixed Expenses,215086,67097.0,77136,144233.0,70853.0,32.94,0.02,Low Risk
U371,2024,12,1046773.0,Stable Salary & Stable Fixed Expenses,215086,67097.0,81736,148833.0,66253.0,30.8,-0.01,Low Risk
U372,2024,1,213965.0,Stable Salary & Stable Fixed Expenses,55836,27387.0,21305,48692.0,7144.0,12.79,0.01,High Risk
U372,2024,2,221109.0,Stable Salary & Stable Fixed Expenses,55836,27387.0,18481,45868.0,9968.0,17.85,0.03,Medium Risk
U372,2024,3,231077.0,Stable Salary & Stable Fixed Expenses,55836,27387.0,21592,48979.0,6857.0,12.28,-0.03,High Risk
U372,2024,4,237934.0,Stable Salary & Stable Fixed Expenses,55836,27387.0,19697,47084.0,8752.0,15.67,-0.02,Medium Risk
U372,2024,5,246686.0,Stable Salary & Stable Fixed Expenses,55836,27387.0,20195,47582.0,8254.0,14.78,0.04,High Risk
U372,2024,6,254940.0,Stable Salary & Stable Fixed Expenses,55836,27387.0,19362,46749.0,9087.0,16.27,-0.04,Medium Risk
U372,2024,7,264027.0,Stable Salary & Stable Fixed Expenses,55836,27387.0,20240,47627.0,8209.0,14.7,0.01,High Risk
U372,2024,8,272236.0,Stable Salary & Stable Fixed Expenses,55836,27387.0,19705,47092.0,8744.0,15.66,-0.05,Medium Risk
U372,2024,9,280980.0,Stable Salary & Stable Fixed Expenses,55836,27387.0,22075,49462.0,6374.0,11.42,0.01,High Risk
U372,2024,10,287354.0,Stable Salary & Stable Fixed Expenses,55836,27387.0,23316,50703.0,5133.0,9.19,-0.02,High Risk
U372,2024,11,292487.0,Stable Salary & Stable Fixed Expenses,55836,27387.0,23128,50515.0,5321.0,9.53,0.02,High Risk
U372,2024,12,297808.0,Stable Salary & Stable Fixed Expenses,55836,27387.0,22893,50280.0,5556.0,9.95,0.03,High Risk
U373,2024,1,235744.0,Salary Increases & Fixed Expenses Remain Stable,34617,13910.0,12262,26172.0,8445.0,24.4,0.0,Medium Risk
U373,2024,2,244189.0,Salary Increases & Fixed Expenses Remain Stable,34617,13910.0,11913,25823.0,8794.0,25.4,-0.01,Low Risk
U373,2024,3,252983.0,Salary Increases & Fixed Expenses Remain Stable,54909,13910.0,17418,31328.0,23581.0,42.95,-0.0,Low Risk
U373,2024,4,276564.0,Salary Increases & Fixed Expenses Remain Stable,54909,13910.0,17153,31063.0,23846.0,43.43,0.01,Low Risk
U373,2024,5,300410.0,Salary Increases & Fixed Expenses Remain Stable,54909,13910.0,19698,33608.0,21301.0,38.79,-0.04,Low Risk
U373,2024,6,321711.0,Salary Increases & Fixed Expenses Remain Stable,54909,13910.0,18163,32073.0,22836.0,41.59,-0.02,Low Risk
U373,2024,7,344547.0,Salary Increases & Fixed Expenses Remain Stable,54909,13910.0,19875,33785.0,21124.0,38.47,0.0,Low Risk
U373,2024,8,365671.0,Salary Increases & Fixed Expenses Remain Stable,54909,13910.0,17832,31742.0,23167.0,42.19,-0.03,Low Risk
U373,2024,9,388838.0,Salary Increases & Fixed Expenses Remain Stable,54909,13910.0,21363,35273.0,19636.0,35.76,0.03,Low Risk
U373,2024,10,408474.0,Salary Increases & Fixed Expenses Remain Stable,54909,13910.0,20038,33948.0,20961.0,38.17,0.03,Low Risk
U373,2024,11,429435.0,Salary Increases & Fixed Expenses Remain Stable,54909,13910.0,17236,31146.0,23763.0,43.28,0.04,Low Risk
U373,2024,12,453198.0,Salary Increases & Fixed Expenses Remain Stable,54909,13910.0,19398,33308.0,21601.0,39.34,-0.05,Low Risk
U374,2024,1,221419.0,Salary Increases & Fixed Expenses Remain Stable,191489,67434.0,65782,133216.0,58273.0,30.43,-0.02,Low Risk
U374,2024,2,279692.0,Salary Increases & Fixed Expenses Remain Stable,191489,67434.0,58713,126147.0,65342.0,34.12,0.01,Low Risk
U374,2024,3,345034.0,Salary Increases & Fixed Expenses Remain Stable,217823,67434.0,105462,172896.0,44927.0,20.63,-0.02,Medium Risk
U374,2024,4,389961.0,Salary Increases & Fixed Expenses Remain Stable,217823,67434.0,69211,136645.0,81178.0,37.27,0.03,Low Risk
U374,2024,5,471139.0,Salary Increases & Fixed Expenses Remain Stable,217823,67434.0,68922,136356.0,81467.0,37.4,0.01,Low Risk
U374,2024,6,552606.0,Salary Increases & Fixed Expenses Remain Stable,217823,67434.0,82560,149994.0,67829.0,31.14,-0.01,Low Risk
U374,2024,7,620435.0,Salary Increases & Fixed Expenses Remain Stable,217823,67434.0,76102,143536.0,74287.0,34.1,-0.05,Low Risk
U374,2024,8,694722.0,Salary Increases & Fixed Expenses Remain Stable,217823,67434.0,70880,138314.0,79509.0,36.5,0.01,Low Risk
U374,2024,9,774231.0,Salary Increases & Fixed Expenses Remain Stable,217823,67434.0,80630,148064.0,69759.0,32.03,0.02,Low Risk
U374,2024,10,843990.0,Salary Increases & Fixed Expenses Remain Stable,217823,67434.0,93319,160753.0,57070.0,26.2,0.04,Low Risk
U374,2024,11,901060.0,Salary Increases & Fixed Expenses Remain Stable,217823,67434.0,86220,153654.0,64169.0,29.46,0.0,Low Risk
U374,2024,12,965229.0,Salary Increases & Fixed Expenses Remain Stable,217823,67434.0,81640,149074.0,68749.0,31.56,-0.05,Low Risk
U375,2024,1,226284.0,Stable Salary & Increasing Fixed Expenses,79512,24708.0,54917,79625.0,-113.0,-0.14,-0.05,High Risk
U375,2024,2,226171.0,Stable Salary & Increasing Fixed Expenses,79512,24708.0,54444,79152.0,360.0,0.45,0.05,High Risk
U375,2024,3,226531.0,Stable Salary & Increasing Fixed Expenses,79512,24708.0,63380,88088.0,-8576.0,-10.79,-0.02,High Risk
U375,2024,4,217955.0,Stable Salary & Increasing Fixed Expenses,79512,26452.0,49535,75987.0,3525.0,4.43,0.01,High Risk
U375,2024,5,221480.0,Stable Salary & Increasing Fixed Expenses,79512,26452.0,54344,80796.0,-1284.0,-1.61,-0.05,High Risk
U375,2024,6,220196.0,Stable Salary & Increasing Fixed Expenses,79512,26452.0,60553,87005.0,-7493.0,-9.42,-0.03,High Risk
U375,2024,7,212703.0,Stable Salary & Increasing Fixed Expenses,79512,26452.0,61548,88000.0,-8488.0,-10.68,-0.01,High Risk
U375,2024,8,204215.0,Stable Salary & Increasing Fixed Expenses,79512,26452.0,59984,86436.0,-6924.0,-8.71,-0.01,High Risk
U375,2024,9,197291.0,Stable Salary & Increasing Fixed Expenses,79512,26452.0,63144,89596.0,-10084.0,-12.68,-0.01,High Risk
U375,2024,10,187207.0,Stable Salary & Increasing Fixed Expenses,79512,26452.0,60055,86507.0,-6995.0,-8.8,-0.02,High Risk
U375,2024,11,180212.0,Stable Salary & Increasing Fixed Expenses,79512,26452.0,60009,86461.0,-6949.0,-8.74,-0.02,High Risk
U375,2024,12,173263.0,Stable Salary & Increasing Fixed Expenses,79512,26452.0,63616,90068.0,-10556.0,-13.28,0.04,High Risk
U376,2024,1,238248.0,Salary Increases & Fixed Expenses Increase,91961,29173.0,33338,62511.0,29450.0,32.02,0.02,Low Risk
U376,2024,2,267698.0,Salary Increases & Fixed Expenses Increase,91961,29173.0,34568,63741.0,28220.0,30.69,0.0,Low Risk
U376,2024,3,295918.0,Salary Increases & Fixed Expenses Increase,91961,29173.0,39621,68794.0,23167.0,25.19,0.02,Low Risk
U376,2024,4,319085.0,Salary Increases & Fixed Expenses Increase,91961,29173.0,35084,64257.0,27704.0,30.13,0.0,Low Risk
U376,2024,5,346789.0,Salary Increases & Fixed Expenses Increase,107014,29778.0,38632,68410.0,38604.0,36.07,0.04,Low Risk
U376,2024,6,385393.0,Salary Increases & Fixed Expenses Increase,107014,29778.0,35305,65083.0,41931.0,39.18,0.04,Low Risk
U376,2024,7,427324.0,Salary Increases & Fixed Expenses Increase,107014,29778.0,39543,69321.0,37693.0,35.22,0.01,Low Risk
U376,2024,8,465017.0,Salary Increases & Fixed Expenses Increase,107014,29778.0,34257,64035.0,42979.0,40.16,-0.01,Low Risk
U376,2024,9,507996.0,Salary Increases & Fixed Expenses Increase,107014,29778.0,43512,73290.0,33724.0,31.51,0.04,Low Risk
U376,2024,10,541720.0,Salary Increases & Fixed Expenses Increase,107014,29778.0,39062,68840.0,38174.0,35.67,-0.04,Low Risk
U376,2024,11,579894.0,Salary Increases & Fixed Expenses Increase,107014,29778.0,37581,67359.0,39655.0,37.06,-0.01,Low Risk
U376,2024,12,619549.0,Salary Increases & Fixed Expenses Increase,107014,29778.0,51150,80928.0,26086.0,24.38,0.03,Medium Risk
U377,2024,1,214114.0,Salary Increases & Fixed Expenses Remain Stable,29052,15691.0,14468,30159.0,-1107.0,-3.81,-0.04,High Risk
U377,2024,2,213007.0,Salary Increases & Fixed Expenses Remain Stable,29052,15691.0,13267,28958.0,94.0,0.32,-0.03,High Risk
U377,2024,3,213101.0,Salary Increases & Fixed Expenses Remain Stable,29052,15691.0,19188,34879.0,-5827.0,-20.06,0.03,High Risk
U377,2024,4,207274.0,Salary Increases & Fixed Expenses Remain Stable,29052,15691.0,11898,27589.0,1463.0,5.04,0.05,High Risk
U377,2024,5,208737.0,Salary Increases & Fixed Expenses Remain Stable,29052,15691.0,12238,27929.0,1123.0,3.87,0.03,High Risk
U377,2024,6,209860.0,Salary Increases & Fixed Expenses Remain Stable,29052,15691.0,15532,31223.0,-2171.0,-7.47,0.01,High Risk
U377,2024,7,207689.0,Salary Increases & Fixed Expenses Remain Stable,34610,15691.0,17788,33479.0,1131.0,3.27,0.05,High Risk
U377,2024,8,208820.0,Salary Increases & Fixed Expenses Remain Stable,34610,15691.0,14804,30495.0,4115.0,11.89,-0.02,High Risk
U377,2024,9,212935.0,Salary Increases & Fixed Expenses Remain Stable,34610,15691.0,15882,31573.0,3037.0,8.77,0.04,High Risk
U377,2024,10,215972.0,Salary Increases & Fixed Expenses Remain Stable,34610,15691.0,16878,32569.0,2041.0,5.9,0.02,High Risk
U377,2024,11,218013.0,Salary Increases & Fixed Expenses Remain Stable,34610,15691.0,15855,31546.0,3064.0,8.85,-0.02,High Risk
U377,2024,12,221077.0,Salary Increases & Fixed Expenses Remain Stable,34610,15691.0,22988,38679.0,-4069.0,-11.76,0.01,High Risk
U378,2024,1,234560.0,Salary Increases & Fixed Expenses Increase,172917,65599.0,74645,140244.0,32673.0,18.9,0.02,Medium Risk
U378,2024,2,267233.0,Salary Increases & Fixed Expenses Increase,172917,65599.0,73489,139088.0,33829.0,19.56,0.02,Medium Risk
U378,2024,3,301062.0,Salary Increases & Fixed Expenses Increase,172917,65599.0,107836,173435.0,-518.0,-0.3,0.0,High Risk
U378,2024,4,300544.0,Salary Increases & Fixed Expenses Increase,172917,65599.0,74730,140329.0,32588.0,18.85,0.0,Medium Risk
U378,2024,5,333132.0,Salary Increases & Fixed Expenses Increase,172917,65599.0,90510,156109.0,16808.0,9.72,-0.05,High Risk
U378,2024,6,349940.0,Salary Increases & Fixed Expenses Increase,172917,65599.0,87485,153084.0,19833.0,11.47,-0.04,High Risk
U378,2024,7,369773.0,Salary Increases & Fixed Expenses Increase,172917,66599.0,95923,162522.0,10395.0,6.01,-0.02,High Risk
U378,2024,8,380168.0,Salary Increases & Fixed Expenses Increase,184889,66599.0,99898,166497.0,18392.0,9.95,0.04,High Risk
U378,2024,9,398560.0,Salary Increases & Fixed Expenses Increase,184889,68123.0,97598,165721.0,19168.0,10.37,-0.04,High Risk
U378,2024,10,417728.0,Salary Increases & Fixed Expenses Increase,184889,68123.0,129824,197947.0,-13058.0,-7.06,-0.01,High Risk
U378,2024,11,404670.0,Salary Increases & Fixed Expenses Increase,184889,68123.0,123156,191279.0,-6390.0,-3.46,0.04,High Risk
U378,2024,12,398280.0,Salary Increases & Fixed Expenses Increase,184889,68123.0,122278,190401.0,-5512.0,-2.98,0.03,High Risk
U379,2024,1,223696.0,Stable Salary & Stable Fixed Expenses,223583,68474.0,158488,226962.0,-3379.0,-1.51,-0.04,High Risk
U379,2024,2,220317.0,Stable Salary & Stable Fixed Expenses,223583,68474.0,150560,219034.0,4549.0,2.03,-0.01,High Risk
U379,2024,3,224866.0,Stable Salary & Stable Fixed Expenses,223583,68474.0,173608,242082.0,-18499.0,-8.27,-0.0,High Risk
U379,2024,4,206367.0,Stable Salary & Stable Fixed Expenses,223583,68474.0,150826,219300.0,4283.0,1.92,-0.02,High Risk
U379,2024,5,210650.0,Stable Salary & Stable Fixed Expenses,223583,68474.0,175477,243951.0,-20368.0,-9.11,-0.03,High Risk
U379,2024,6,190282.0,Stable Salary & Stable Fixed Expenses,223583,68474.0,176729,245203.0,-21620.0,-9.67,-0.01,High Risk
U379,2024,7,168662.0,Stable Salary & Stable Fixed Expenses,223583,68474.0,159404,227878.0,-4295.0,-1.92,-0.02,High Risk
U379,2024,8,164367.0,Stable Salary & Stable Fixed Expenses,223583,68474.0,153125,221599.0,1984.0,0.89,0.01,High Risk
U379,2024,9,166351.0,Stable Salary & Stable Fixed Expenses,223583,68474.0,159439,227913.0,-4330.0,-1.94,0.0,High Risk
U379,2024,10,162021.0,Stable Salary & Stable Fixed Expenses,223583,68474.0,140784,209258.0,14325.0,6.41,0.01,High Risk
U379,2024,11,176346.0,Stable Salary & Stable Fixed Expenses,223583,68474.0,171346,239820.0,-16237.0,-7.26,-0.0,High Risk
U379,2024,12,160109.0,Stable Salary & Stable Fixed Expenses,223583,68474.0,158697,227171.0,-3588.0,-1.6,0.02,High Risk
U380,2024,1,237435.0,Salary Increases & Fixed Expenses Remain Stable,147688,51535.0,78250,129785.0,17903.0,12.12,0.0,High Risk
U380,2024,2,255338.0,Salary Increases & Fixed Expenses Remain Stable,147688,51535.0,73399,124934.0,22754.0,15.41,-0.01,Medium Risk
U380,2024,3,278092.0,Salary Increases & Fixed Expenses Remain Stable,147688,51535.0,86034,137569.0,10119.0,6.85,-0.01,High Risk
U380,2024,4,288211.0,Salary Increases & Fixed Expenses Remain Stable,147688,51535.0,75257,126792.0,20896.0,14.15,0.02,High Risk
U380,2024,5,309107.0,Salary Increases & Fixed Expenses Remain Stable,147688,51535.0,82460,133995.0,13693.0,9.27,-0.02,High Risk
U380,2024,6,322800.0,Salary Increases & Fixed Expenses Remain Stable,147688,51535.0,64356,115891.0,31797.0,21.53,-0.03,Medium Risk
U380,2024,7,354597.0,Salary Increases & Fixed Expenses Remain Stable,159403,51535.0,81836,133371.0,26032.0,16.33,0.03,Medium Risk
U380,2024,8,380629.0,Salary Increases & Fixed Expenses Remain Stable,159403,51535.0,94294,145829.0,13574.0,8.52,-0.02,High Risk
U380,2024,9,394203.0,Salary Increases & Fixed Expenses Remain Stable,159403,51535.0,76981,128516.0,30887.0,19.38,0.0,Medium Risk
U380,2024,10,425090.0,Salary Increases & Fixed Expenses Remain Stable,159403,51535.0,86959,138494.0,20909.0,13.12,0.02,High Risk
U380,2024,11,445999.0,Salary Increases & Fixed Expenses Remain Stable,159403,51535.0,71298,122833.0,36570.0,22.94,-0.02,Medium Risk
U380,2024,12,482569.0,Salary Increases & Fixed Expenses Remain Stable,159403,51535.0,86760,138295.0,21108.0,13.24,-0.0,High Risk
U381,2024,1,228209.0,Stable Salary & Stable Fixed Expenses,271500,81939.0,123920,205859.0,65641.0,24.18,-0.04,Medium Risk
U381,2024,2,293850.0,Stable Salary & Stable Fixed Expenses,271500,81939.0,152957,234896.0,36604.0,13.48,-0.02,High Risk
U381,2024,3,330454.0,Stable Salary & Stable Fixed Expenses,271500,81939.0,185938,267877.0,3623.0,1.33,0.01,High Risk
U381,2024,4,334077.0,Stable Salary & Stable Fixed Expenses,271500,81939.0,131108,213047.0,58453.0,21.53,-0.05,Medium Risk
U381,2024,5,392530.0,Stable Salary & Stable Fixed Expenses,271500,81939.0,158393,240332.0,31168.0,11.48,-0.02,High Risk
U381,2024,6,423698.0,Stable Salary & Stable Fixed Expenses,271500,81939.0,150025,231964.0,39536.0,14.56,-0.02,High Risk
U381,2024,7,463234.0,Stable Salary & Stable Fixed Expenses,271500,81939.0,158363,240302.0,31198.0,11.49,-0.04,High Risk
U381,2024,8,494432.0,Stable Salary & Stable Fixed Expenses,271500,81939.0,126306,208245.0,63255.0,23.3,-0.01,Medium Risk
U381,2024,9,557687.0,Stable Salary & Stable Fixed Expenses,271500,81939.0,138483,220422.0,51078.0,18.81,-0.03,Medium Risk
U381,2024,10,608765.0,Stable Salary & Stable Fixed Expenses,271500,81939.0,140527,222466.0,49034.0,18.06,-0.01,Medium Risk
U381,2024,11,657799.0,Stable Salary & Stable Fixed Expenses,271500,81939.0,125148,207087.0,64413.0,23.72,-0.03,Medium Risk
U381,2024,12,722212.0,Stable Salary & Stable Fixed Expenses,271500,81939.0,183462,265401.0,6099.0,2.25,0.04,High Risk
U382,2024,1,220644.0,Stable Salary & Increasing Fixed Expenses,156411,58524.0,73979,132503.0,23908.0,15.29,-0.02,Medium Risk
U382,2024,2,244552.0,Stable Salary & Increasing Fixed Expenses,156411,58524.0,62568,121092.0,35319.0,22.58,-0.01,Medium Risk
U382,2024,3,279871.0,Stable Salary & Increasing Fixed Expenses,156411,58524.0,81680,140204.0,16207.0,10.36,-0.0,High Risk
U382,2024,4,296078.0,Stable Salary & Increasing Fixed Expenses,156411,60471.0,84455,144926.0,11485.0,7.34,0.04,High Risk
U382,2024,5,307563.0,Stable Salary & Increasing Fixed Expenses,156411,60471.0,86402,146873.0,9538.0,6.1,-0.03,High Risk
U382,2024,6,317101.0,Stable Salary & Increasing Fixed Expenses,156411,62037.0,64046,126083.0,30328.0,19.39,-0.05,Medium Risk
U382,2024,7,347429.0,Stable Salary & Increasing Fixed Expenses,156411,62037.0,90415,152452.0,3959.0,2.53,-0.03,High Risk
U382,2024,8,351388.0,Stable Salary & Increasing Fixed Expenses,156411,62037.0,65576,127613.0,28798.0,18.41,-0.04,Medium Risk
U382,2024,9,380186.0,Stable Salary & Increasing Fixed Expenses,156411,63087.0,79896,142983.0,13428.0,8.59,-0.04,High Risk
U382,2024,10,393614.0,Stable Salary & Increasing Fixed Expenses,156411,63087.0,76744,139831.0,16580.0,10.6,0.04,High Risk
U382,2024,11,410194.0,Stable Salary & Increasing Fixed Expenses,156411,63087.0,75028,138115.0,18296.0,11.7,-0.04,High Risk
U382,2024,12,428490.0,Stable Salary & Increasing Fixed Expenses,156411,63087.0,75850,138937.0,17474.0,11.17,0.02,High Risk
U383,2024,1,241966.0,Salary Increases & Fixed Expenses Remain Stable,228350,70523.0,91270,161793.0,66557.0,29.15,0.0,Low Risk
U383,2024,2,308523.0,Salary Increases & Fixed Expenses Remain Stable,228350,70523.0,78430,148953.0,79397.0,34.77,0.01,Low Risk
U383,2024,3,387920.0,Salary Increases & Fixed Expenses Remain Stable,228350,70523.0,82011,152534.0,75816.0,33.2,0.03,Low Risk
U383,2024,4,463736.0,Salary Increases & Fixed Expenses Remain Stable,228350,70523.0,70606,141129.0,87221.0,38.2,0.05,Low Risk
U383,2024,5,550957.0,Salary Increases & Fixed Expenses Remain Stable,228350,70523.0,89537,160060.0,68290.0,29.91,0.01,Low Risk
U383,2024,6,619247.0,Salary Increases & Fixed Expenses Remain Stable,243130,70523.0,79644,150167.0,92963.0,38.24,-0.0,Low Risk
U383,2024,7,712210.0,Salary Increases & Fixed Expenses Remain Stable,243130,70523.0,75097,145620.0,97510.0,40.11,-0.02,Low Risk
U383,2024,8,809720.0,Salary Increases & Fixed Expenses Remain Stable,243130,70523.0,89994,160517.0,82613.0,33.98,0.03,Low Risk
U383,2024,9,892333.0,Salary Increases & Fixed Expenses Remain Stable,243130,70523.0,90953,161476.0,81654.0,33.58,-0.04,Low Risk
U383,2024,10,973987.0,Salary Increases & Fixed Expenses Remain Stable,243130,70523.0,92075,162598.0,80532.0,33.12,0.03,Low Risk
U383,2024,11,1054519.0,Salary Increases & Fixed Expenses Remain Stable,243130,70523.0,83419,153942.0,89188.0,36.68,0.05,Low Risk
U383,2024,12,1143707.0,Salary Increases & Fixed Expenses Remain Stable,243130,70523.0,83038,153561.0,89569.0,36.84,-0.02,Low Risk
U384,2024,1,214552.0,Stable Salary & Stable Fixed Expenses,211616,107272.0,103709,210981.0,635.0,0.3,-0.01,High Risk
U384,2024,2,215187.0,Stable Salary & Stable Fixed Expenses,211616,107272.0,109331,216603.0,-4987.0,-2.36,-0.03,High Risk
U384,2024,3,210200.0,Stable Salary & Stable Fixed Expenses,211616,107272.0,113473,220745.0,-9129.0,-4.31,-0.01,High Risk
U384,2024,4,201071.0,Stable Salary & Stable Fixed Expenses,211616,107272.0,112337,219609.0,-7993.0,-3.78,-0.03,High Risk
U384,2024,5,193078.0,Stable Salary & Stable Fixed Expenses,211616,107272.0,92229,199501.0,12115.0,5.72,-0.0,High Risk
U384,2024,6,205193.0,Stable Salary & Stable Fixed Expenses,211616,107272.0,124426,231698.0,-20082.0,-9.49,-0.02,High Risk
U384,2024,7,185111.0,Stable Salary & Stable Fixed Expenses,211616,107272.0,84961,192233.0,19383.0,9.16,-0.0,High Risk
U384,2024,8,204494.0,Stable Salary & Stable Fixed Expenses,211616,107272.0,97745,205017.0,6599.0,3.12,0.0,High Risk
U384,2024,9,211093.0,Stable Salary & Stable Fixed Expenses,211616,107272.0,94297,201569.0,10047.0,4.75,0.04,High Risk
U384,2024,10,221140.0,Stable Salary & Stable Fixed Expenses,211616,107272.0,114859,222131.0,-10515.0,-4.97,-0.02,High Risk
U384,2024,11,210625.0,Stable Salary & Stable Fixed Expenses,211616,107272.0,118126,225398.0,-13782.0,-6.51,0.01,High Risk
U384,2024,12,196843.0,Stable Salary & Stable Fixed Expenses,211616,107272.0,121833,229105.0,-17489.0,-8.26,-0.03,High Risk
U385,2024,1,241005.0,Salary Increases & Fixed Expenses Increase,101414,71988.0,45481,117469.0,-16055.0,-15.83,-0.04,High Risk
U385,2024,2,224950.0,Salary Increases & Fixed Expenses Increase,101414,71988.0,41245,113233.0,-11819.0,-11.65,-0.03,High Risk
U385,2024,3,213131.0,Salary Increases & Fixed Expenses Increase,101414,71988.0,47940,119928.0,-18514.0,-18.26,0.01,High Risk
U385,2024,4,194617.0,Salary Increases & Fixed Expenses Increase,101414,71988.0,56598,128586.0,-27172.0,-26.79,-0.02,High Risk
U385,2024,5,167445.0,Salary Increases & Fixed Expenses Increase,101414,72877.0,51568,124445.0,-23031.0,-22.71,-0.01,High Risk
U385,2024,6,144414.0,Salary Increases & Fixed Expenses Increase,101414,72877.0,50682,123559.0,-22145.0,-21.84,-0.03,High Risk
U385,2024,7,122269.0,Salary Increases & Fixed Expenses Increase,101414,72877.0,45565,118442.0,-17028.0,-16.79,0.04,High Risk
U385,2024,8,105241.0,Salary Increases & Fixed Expenses Increase,129170,72877.0,76425,149302.0,-20132.0,-15.59,0.03,High Risk
U385,2024,9,85109.0,Salary Increases & Fixed Expenses Increase,129170,74713.0,62083,136796.0,-7626.0,-5.9,0.01,High Risk
U385,2024,10,77483.0,Salary Increases & Fixed Expenses Increase,129170,74713.0,71596,146309.0,-17139.0,-13.27,0.01,High Risk
U385,2024,11,60344.0,Salary Increases & Fixed Expenses Increase,129170,74713.0,77158,151871.0,-22701.0,-17.57,-0.04,High Risk
U385,2024,12,37643.0,Salary Increases & Fixed Expenses Increase,129170,75703.0,69981,145684.0,-16514.0,-12.78,-0.04,High Risk
U386,2024,1,201316.0,Stable Salary & Stable Fixed Expenses,34286,20514.0,17760,38274.0,-3988.0,-11.63,-0.03,High Risk
U386,2024,2,197328.0,Stable Salary & Stable Fixed Expenses,34286,20514.0,17758,38272.0,-3986.0,-11.63,-0.05,High Risk
U386,2024,3,193342.0,Stable Salary & Stable Fixed Expenses,34286,20514.0,22062,42576.0,-8290.0,-24.18,0.04,High Risk
U386,2024,4,185052.0,Stable Salary & Stable Fixed Expenses,34286,20514.0,18372,38886.0,-4600.0,-13.42,0.03,High Risk
U386,2024,5,180452.0,Stable Salary & Stable Fixed Expenses,34286,20514.0,19019,39533.0,-5247.0,-15.3,0.05,High Risk
U386,2024,6,175205.0,Stable Salary & Stable Fixed Expenses,34286,20514.0,15782,36296.0,-2010.0,-5.86,-0.03,High Risk
U386,2024,7,173195.0,Stable Salary & Stable Fixed Expenses,34286,20514.0,17296,37810.0,-3524.0,-10.28,0.02,High Risk
U386,2024,8,169671.0,Stable Salary & Stable Fixed Expenses,34286,20514.0,14099,34613.0,-327.0,-0.95,-0.03,High Risk
U386,2024,9,169344.0,Stable Salary & Stable Fixed Expenses,34286,20514.0,22199,42713.0,-8427.0,-24.58,0.0,High Risk
U386,2024,10,160917.0,Stable Salary & Stable Fixed Expenses,34286,20514.0,18991,39505.0,-5219.0,-15.22,-0.04,High Risk
U386,2024,11,155698.0,Stable Salary & Stable Fixed Expenses,34286,20514.0,18120,38634.0,-4348.0,-12.68,0.02,High Risk
U386,2024,12,151350.0,Stable Salary & Stable Fixed Expenses,34286,20514.0,18515,39029.0,-4743.0,-13.83,0.01,High Risk
U387,2024,1,203915.0,Salary Increases & Fixed Expenses Remain Stable,253751,110918.0,97485,208403.0,45348.0,17.87,0.0,Medium Risk
U387,2024,2,249263.0,Salary Increases & Fixed Expenses Remain Stable,253751,110918.0,99752,210670.0,43081.0,16.98,-0.03,Medium Risk
U387,2024,3,292344.0,Salary Increases & Fixed Expenses Remain Stable,253751,110918.0,97521,208439.0,45312.0,17.86,0.03,Medium Risk
U387,2024,4,337656.0,Salary Increases & Fixed Expenses Remain Stable,253751,110918.0,79038,189956.0,63795.0,25.14,0.0,Low Risk
U387,2024,5,401451.0,Salary Increases & Fixed Expenses Remain Stable,270282,110918.0,106234,217152.0,53130.0,19.66,0.05,Medium Risk
U387,2024,6,454581.0,Salary Increases & Fixed Expenses Remain Stable,270282,110918.0,95649,206567.0,63715.0,23.57,-0.02,Medium Risk
U387,2024,7,518296.0,Salary Increases & Fixed Expenses Remain Stable,270282,110918.0,81991,192909.0,77373.0,28.63,0.05,Low Risk
U387,2024,8,595669.0,Salary Increases & Fixed Expenses Remain Stable,270282,110918.0,90633,201551.0,68731.0,25.43,-0.01,Low Risk
U387,2024,9,664400.0,Salary Increases & Fixed Expenses Remain Stable,270282,110918.0,84373,195291.0,74991.0,27.75,-0.03,Low Risk
U387,2024,10,739391.0,Salary Increases & Fixed Expenses Remain Stable,270282,110918.0,95377,206295.0,63987.0,23.67,0.01,Medium Risk
U387,2024,11,803378.0,Salary Increases & Fixed Expenses Remain Stable,270282,110918.0,83579,194497.0,75785.0,28.04,0.02,Low Risk
U387,2024,12,879163.0,Salary Increases & Fixed Expenses Remain Stable,270282,110918.0,90030,200948.0,69334.0,25.65,-0.03,Low Risk
U388,2024,1,249132.0,Salary Increases & Fixed Expenses Decrease,32332,18329.0,16228,34557.0,-2225.0,-6.88,0.02,High Risk
U388,2024,2,246907.0,Salary Increases & Fixed Expenses Decrease,32332,18329.0,18188,36517.0,-4185.0,-12.94,-0.03,High Risk
U388,2024,3,242722.0,Salary Increases & Fixed Expenses Decrease,32332,18329.0,18180,36509.0,-4177.0,-12.92,-0.01,High Risk
U388,2024,4,238545.0,Salary Increases & Fixed Expenses Decrease,32332,16658.0,17137,33795.0,-1463.0,-4.52,0.03,High Risk
U388,2024,5,237082.0,Salary Increases & Fixed Expenses Decrease,41004,16658.0,19140,35798.0,5206.0,12.7,0.03,High Risk
U388,2024,6,242288.0,Salary Increases & Fixed Expenses Decrease,41004,16658.0,24201,40859.0,145.0,0.35,0.0,High Risk
U388,2024,7,242433.0,Salary Increases & Fixed Expenses Decrease,41004,16658.0,17480,34138.0,6866.0,16.74,0.04,Medium Risk
U388,2024,8,249299.0,Salary Increases & Fixed Expenses Decrease,41004,16658.0,17201,33859.0,7145.0,17.43,0.02,Medium Risk
U388,2024,9,256444.0,Salary Increases & Fixed Expenses Decrease,41004,16658.0,26739,43397.0,-2393.0,-5.84,-0.03,High Risk
U388,2024,10,254051.0,Salary Increases & Fixed Expenses Decrease,41004,16658.0,20380,37038.0,3966.0,9.67,-0.04,High Risk
U388,2024,11,258017.0,Salary Increases & Fixed Expenses Decrease,41004,16658.0,24542,41200.0,-196.0,-0.48,-0.01,High Risk
U388,2024,12,257821.0,Salary Increases & Fixed Expenses Decrease,41004,15111.0,22250,37361.0,3643.0,8.88,0.01,High Risk
U389,2024,1,228215.0,Stable Salary & Increasing Fixed Expenses,190062,44379.0,132937,177316.0,12746.0,6.71,-0.05,High Risk
U389,2024,2,240961.0,Stable Salary & Increasing Fixed Expenses,190062,46320.0,149311,195631.0,-5569.0,-2.93,-0.04,High Risk
U389,2024,3,235392.0,Stable Salary & Increasing Fixed Expenses,190062,46320.0,142729,189049.0,1013.0,0.53,-0.0,High Risk
U389,2024,4,236405.0,Stable Salary & Increasing Fixed Expenses,190062,46320.0,127874,174194.0,15868.0,8.35,0.01,High Risk
U389,2024,5,252273.0,Stable Salary & Increasing Fixed Expenses,190062,46320.0,131717,178037.0,12025.0,6.33,-0.05,High Risk
U389,2024,6,264298.0,Stable Salary & Increasing Fixed Expenses,190062,46320.0,116100,162420.0,27642.0,14.54,0.03,High Risk
U389,2024,7,291940.0,Stable Salary & Increasing Fixed Expenses,190062,46320.0,135695,182015.0,8047.0,4.23,0.02,High Risk
U389,2024,8,299987.0,Stable Salary & Increasing Fixed Expenses,190062,48140.0,145315,193455.0,-3393.0,-1.79,0.03,High Risk
U389,2024,9,296594.0,Stable Salary & Increasing Fixed Expenses,190062,48140.0,147394,195534.0,-5472.0,-2.88,0.02,High Risk
U389,2024,10,291122.0,Stable Salary & Increasing Fixed Expenses,190062,49822.0,119698,169520.0,20542.0,10.81,-0.02,High Risk
U389,2024,11,311664.0,Stable Salary & Increasing Fixed Expenses,190062,49822.0,116205,166027.0,24035.0,12.65,-0.03,High Risk
U389,2024,12,335699.0,Stable Salary & Increasing Fixed Expenses,190062,49822.0,136710,186532.0,3530.0,1.86,-0.04,High Risk
U390,2024,1,234076.0,Salary Increases & Fixed Expenses Increase,45766,17835.0,20345,38180.0,7586.0,16.58,0.01,Medium Risk
U390,2024,2,241662.0,Salary Increases & Fixed Expenses Increase,45766,17835.0,19396,37231.0,8535.0,18.65,0.05,Medium Risk
U390,2024,3,250197.0,Salary Increases & Fixed Expenses Increase,45766,18618.0,25050,43668.0,2098.0,4.58,-0.04,High Risk
U390,2024,4,252295.0,Salary Increases & Fixed Expenses Increase,69497,18618.0,28468,47086.0,22411.0,32.25,-0.02,Low Risk
U390,2024,5,274706.0,Salary Increases & Fixed Expenses Increase,69497,18618.0,30702,49320.0,20177.0,29.03,0.04,Low Risk
U390,2024,6,294883.0,Salary Increases & Fixed Expenses Increase,69497,18618.0,40560,59178.0,10319.0,14.85,0.02,High Risk
U390,2024,7,305202.0,Salary Increases & Fixed Expenses Increase,69497,20217.0,37114,57331.0,12166.0,17.51,-0.02,Medium Risk
U390,2024,8,317368.0,Salary Increases & Fixed Expenses Increase,69497,20217.0,38906,59123.0,10374.0,14.93,-0.01,High Risk
U390,2024,9,327742.0,Salary Increases & Fixed Expenses Increase,69497,20784.0,31828,52612.0,16885.0,24.3,-0.04,Medium Risk
U390,2024,10,344627.0,Salary Increases & Fixed Expenses Increase,69497,20784.0,38811,59595.0,9902.0,14.25,-0.03,High Risk
U390,2024,11,354529.0,Salary Increases & Fixed Expenses Increase,69497,20784.0,28458,49242.0,20255.0,29.15,0.03,Low Risk
U390,2024,12,374784.0,Salary Increases & Fixed Expenses Increase,69497,21391.0,28448,49839.0,19658.0,28.29,-0.02,Low Risk
U391,2024,1,244493.0,Salary Increases & Fixed Expenses Decrease,150977,78644.0,64198,142842.0,8135.0,5.39,0.03,High Risk
U391,2024,2,252628.0,Salary Increases & Fixed Expenses Decrease,150977,78644.0,86674,165318.0,-14341.0,-9.5,0.0,High Risk
U391,2024,3,238287.0,Salary Increases & Fixed Expenses Decrease,150977,78644.0,100090,178734.0,-27757.0,-18.38,-0.03,High Risk
U391,2024,4,210530.0,Salary Increases & Fixed Expenses Decrease,150977,78644.0,67966,146610.0,4367.0,2.89,0.03,High Risk
U391,2024,5,214897.0,Salary Increases & Fixed Expenses Decrease,150977,78644.0,81177,159821.0,-8844.0,-5.86,-0.03,High Risk
U391,2024,6,206053.0,Salary Increases & Fixed Expenses Decrease,150977,78644.0,73139,151783.0,-806.0,-0.53,0.01,High Risk
U391,2024,7,205247.0,Salary Increases & Fixed Expenses Decrease,150977,78644.0,78450,157094.0,-6117.0,-4.05,-0.01,High Risk
U391,2024,8,199130.0,Salary Increases & Fixed Expenses Decrease,167917,78644.0,93955,172599.0,-4682.0,-2.79,-0.02,High Risk
U391,2024,9,194448.0,Salary Increases & Fixed Expenses Decrease,167917,78644.0,79002,157646.0,10271.0,6.12,0.0,High Risk
U391,2024,10,204719.0,Salary Increases & Fixed Expenses Decrease,167917,78644.0,99620,178264.0,-10347.0,-6.16,0.02,High Risk
U391,2024,11,194372.0,Salary Increases & Fixed Expenses Decrease,167917,78644.0,88556,167200.0,717.0,0.43,0.0,High Risk
U391,2024,12,195089.0,Salary Increases & Fixed Expenses Decrease,167917,78644.0,70323,148967.0,18950.0,11.29,-0.05,High Risk
U392,2024,1,244862.0,Stable Salary & Stable Fixed Expenses,228165,83561.0,83270,166831.0,61334.0,26.88,0.03,Low Risk
U392,2024,2,306196.0,Stable Salary & Stable Fixed Expenses,228165,83561.0,74445,158006.0,70159.0,30.75,-0.0,Low Risk
U392,2024,3,376355.0,Stable Salary & Stable Fixed Expenses,228165,83561.0,102830,186391.0,41774.0,18.31,-0.0,Medium Risk
U392,2024,4,418129.0,Stable Salary & Stable Fixed Expenses,228165,83561.0,77488,161049.0,67116.0,29.42,-0.05,Low Risk
U392,2024,5,485245.0,Stable Salary & Stable Fixed Expenses,228165,83561.0,91050,174611.0,53554.0,23.47,0.02,Medium Risk
U392,2024,6,538799.0,Stable Salary & Stable Fixed Expenses,228165,83561.0,84716,168277.0,59888.0,26.25,-0.02,Low Risk
U392,2024,7,598687.0,Stable Salary & Stable Fixed Expenses,228165,83561.0,77964,161525.0,66640.0,29.21,-0.02,Low Risk
U392,2024,8,665327.0,Stable Salary & Stable Fixed Expenses,228165,83561.0,69716,153277.0,74888.0,32.82,0.04,Low Risk
U392,2024,9,740215.0,Stable Salary & Stable Fixed Expenses,228165,83561.0,72268,155829.0,72336.0,31.7,-0.02,Low Risk
U392,2024,10,812551.0,Stable Salary & Stable Fixed Expenses,228165,83561.0,109018,192579.0,35586.0,15.6,0.04,Medium Risk
U392,2024,11,848137.0,Stable Salary & Stable Fixed Expenses,228165,83561.0,71341,154902.0,73263.0,32.11,0.02,Low Risk
U392,2024,12,921400.0,Stable Salary & Stable Fixed Expenses,228165,83561.0,87531,171092.0,57073.0,25.01,-0.01,Low Risk
U393,2024,1,233981.0,Stable Salary & Increasing Fixed Expenses,238636,66478.0,107059,173537.0,65099.0,27.28,-0.04,Low Risk
U393,2024,2,299080.0,Stable Salary & Increasing Fixed Expenses,238636,66478.0,107973,174451.0,64185.0,26.9,0.01,Low Risk
U393,2024,3,363265.0,Stable Salary & Increasing Fixed Expenses,238636,66478.0,118648,185126.0,53510.0,22.42,-0.01,Medium Risk
U393,2024,4,416775.0,Stable Salary & Increasing Fixed Expenses,238636,66478.0,105255,171733.0,66903.0,28.04,-0.05,Low Risk
U393,2024,5,483678.0,Stable Salary & Increasing Fixed Expenses,238636,66478.0,110956,177434.0,61202.0,25.65,-0.05,Low Risk
U393,2024,6,544880.0,Stable Salary & Increasing Fixed Expenses,238636,66478.0,115632,182110.0,56526.0,23.69,-0.04,Medium Risk
U393,2024,7,601406.0,Stable Salary & Increasing Fixed Expenses,238636,66478.0,133179,199657.0,38979.0,16.33,-0.01,Medium Risk
U393,2024,8,640385.0,Stable Salary & Increasing Fixed Expenses,238636,66478.0,128817,195295.0,43341.0,18.16,0.01,Medium Risk
U393,2024,9,683726.0,Stable Salary & Increasing Fixed Expenses,238636,67481.0,142125,209606.0,29030.0,12.16,0.05,High Risk
U393,2024,10,712756.0,Stable Salary & Increasing Fixed Expenses,238636,67481.0,118199,185680.0,52956.0,22.19,-0.05,Medium Risk
U393,2024,11,765712.0,Stable Salary & Increasing Fixed Expenses,238636,69142.0,122092,191234.0,47402.0,19.86,-0.02,Medium Risk
U393,2024,12,813114.0,Stable Salary & Increasing Fixed Expenses,238636,69863.0,132256,202119.0,36517.0,15.3,0.03,Medium Risk
U394,2024,1,213192.0,Salary Increases & Fixed Expenses Remain Stable,205775,65951.0,89275,155226.0,50549.0,24.57,0.01,Medium Risk
U394,2024,2,263741.0,Salary Increases & Fixed Expenses Remain Stable,205775,65951.0,113010,178961.0,26814.0,13.03,-0.04,High Risk
U394,2024,3,290555.0,Salary Increases & Fixed Expenses Remain Stable,233572,65951.0,153454,219405.0,14167.0,6.07,0.01,High Risk
U394,2024,4,304722.0,Salary Increases & Fixed Expenses Remain Stable,233572,65951.0,135638,201589.0,31983.0,13.69,-0.0,High Risk
U394,2024,5,336705.0,Salary Increases & Fixed Expenses Remain Stable,233572,65951.0,96905,162856.0,70716.0,30.28,-0.0,Low Risk
U394,2024,6,407421.0,Salary Increases & Fixed Expenses Remain Stable,233572,65951.0,106090,172041.0,61531.0,26.34,-0.03,Low Risk
U394,2024,7,468952.0,Salary Increases & Fixed Expenses Remain Stable,233572,65951.0,128076,194027.0,39545.0,16.93,-0.01,Medium Risk
U394,2024,8,508497.0,Salary Increases & Fixed Expenses Remain Stable,233572,65951.0,111340,177291.0,56281.0,24.1,0.0,Medium Risk
U394,2024,9,564778.0,Salary Increases & Fixed Expenses Remain Stable,233572,65951.0,141967,207918.0,25654.0,10.98,0.01,High Risk
U394,2024,10,590432.0,Salary Increases & Fixed Expenses Remain Stable,233572,65951.0,142891,208842.0,24730.0,10.59,0.05,High Risk
U394,2024,11,615162.0,Salary Increases & Fixed Expenses Remain Stable,233572,65951.0,140238,206189.0,27383.0,11.72,-0.0,High Risk
U394,2024,12,642545.0,Salary Increases & Fixed Expenses Remain Stable,233572,65951.0,160606,226557.0,7015.0,3.0,-0.01,High Risk
U395,2024,1,202333.0,Stable Salary & Increasing Fixed Expenses,266067,97284.0,131085,228369.0,37698.0,14.17,-0.03,High Risk
U395,2024,2,240031.0,Stable Salary & Increasing Fixed Expenses,266067,97284.0,118510,215794.0,50273.0,18.89,0.01,Medium Risk
U395,2024,3,290304.0,Stable Salary & Increasing Fixed Expenses,266067,97284.0,156384,253668.0,12399.0,4.66,0.02,High Risk
U395,2024,4,302703.0,Stable Salary & Increasing Fixed Expenses,266067,97284.0,150329,247613.0,18454.0,6.94,0.05,High Risk
U395,2024,5,321157.0,Stable Salary & Increasing Fixed Expenses,266067,97284.0,124551,221835.0,44232.0,16.62,0.04,Medium Risk
U395,2024,6,365389.0,Stable Salary & Increasing Fixed Expenses,266067,97284.0,113953,211237.0,54830.0,20.61,0.04,Medium Risk
U395,2024,7,420219.0,Stable Salary & Increasing Fixed Expenses,266067,97284.0,108547,205831.0,60236.0,22.64,0.04,Medium Risk
U395,2024,8,480455.0,Stable Salary & Increasing Fixed Expenses,266067,97284.0,113640,210924.0,55143.0,20.73,0.01,Medium Risk
U395,2024,9,535598.0,Stable Salary & Increasing Fixed Expenses,266067,97284.0,142600,239884.0,26183.0,9.84,0.02,High Risk
U395,2024,10,561781.0,Stable Salary & Increasing Fixed Expenses,266067,97284.0,119152,216436.0,49631.0,18.65,0.01,Medium Risk
U395,2024,11,611412.0,Stable Salary & Increasing Fixed Expenses,266067,97284.0,124671,221955.0,44112.0,16.58,0.01,Medium Risk
U395,2024,12,655524.0,Stable Salary & Increasing Fixed Expenses,266067,97284.0,137212,234496.0,31571.0,11.87,-0.04,High Risk
U396,2024,1,238225.0,Salary Increases & Fixed Expenses Decrease,271806,112534.0,200195,312729.0,-40923.0,-15.06,-0.01,High Risk
U396,2024,2,197302.0,Salary Increases & Fixed Expenses Decrease,271806,112534.0,170601,283135.0,-11329.0,-4.17,-0.04,High Risk
U396,2024,3,185973.0,Salary Increases & Fixed Expenses Decrease,271806,112534.0,210194,322728.0,-50922.0,-18.73,0.04,High Risk
U396,2024,4,135051.0,Salary Increases & Fixed Expenses Decrease,271806,112534.0,185849,298383.0,-26577.0,-9.78,0.05,High Risk
U396,2024,5,108474.0,Salary Increases & Fixed Expenses Decrease,271806,112534.0,216792,329326.0,-57520.0,-21.16,-0.02,High Risk
U396,2024,6,50954.0,Salary Increases & Fixed Expenses Decrease,271806,112534.0,198033,310567.0,-38761.0,-14.26,-0.01,High Risk
U396,2024,7,12193.0,Salary Increases & Fixed Expenses Decrease,299908,112534.0,229628,342162.0,-42254.0,-14.09,-0.03,High Risk
U396,2024,8,-30061.0,Salary Increases & Fixed Expenses Decrease,299908,112534.0,202612,315146.0,-15238.0,-5.08,-0.02,High Risk
U396,2024,9,-45299.0,Salary Increases & Fixed Expenses Decrease,299908,112534.0,221255,333789.0,-33881.0,-11.3,-0.03,High Risk
U396,2024,10,-79180.0,Salary Increases & Fixed Expenses Decrease,299908,112534.0,197446,309980.0,-10072.0,-3.36,-0.01,High Risk
U396,2024,11,-89252.0,Salary Increases & Fixed Expenses Decrease,299908,112534.0,214740,327274.0,-27366.0,-9.12,-0.0,High Risk
U396,2024,12,-116618.0,Salary Increases & Fixed Expenses Decrease,299908,112534.0,231329,343863.0,-43955.0,-14.66,-0.05,High Risk
U397,2024,1,232598.0,Stable Salary & Increasing Fixed Expenses,281596,62091.0,134319,196410.0,85186.0,30.25,-0.02,Low Risk
U397,2024,2,317784.0,Stable Salary & Increasing Fixed Expenses,281596,62091.0,163754,225845.0,55751.0,19.8,-0.02,Medium Risk
U397,2024,3,373535.0,Stable Salary & Increasing Fixed Expenses,281596,62091.0,142084,204175.0,77421.0,27.49,-0.03,Low Risk
U397,2024,4,450956.0,Stable Salary & Increasing Fixed Expenses,281596,62091.0,160647,222738.0,58858.0,20.9,-0.05,Medium Risk
U397,2024,5,509814.0,Stable Salary & Increasing Fixed Expenses,281596,62091.0,140301,202392.0,79204.0,28.13,0.03,Low Risk
U397,2024,6,589018.0,Stable Salary & Increasing Fixed Expenses,281596,62091.0,150177,212268.0,69328.0,24.62,-0.05,Medium Risk
U397,2024,7,658346.0,Stable Salary & Increasing Fixed Expenses,281596,63688.0,132288,195976.0,85620.0,30.41,-0.0,Low Risk
U397,2024,8,743966.0,Stable Salary & Increasing Fixed Expenses,281596,64244.0,144630,208874.0,72722.0,25.82,-0.01,Low Risk
U397,2024,9,816688.0,Stable Salary & Increasing Fixed Expenses,281596,65635.0,142753,208388.0,73208.0,26.0,0.03,Low Risk
U397,2024,10,889896.0,Stable Salary & Increasing Fixed Expenses,281596,65635.0,118433,184068.0,97528.0,34.63,0.01,Low Risk
U397,2024,11,987424.0,Stable Salary & Increasing Fixed Expenses,281596,65635.0,152132,217767.0,63829.0,22.67,-0.04,Medium Risk
U397,2024,12,1051253.0,Stable Salary & Increasing Fixed Expenses,281596,65635.0,155978,221613.0,59983.0,21.3,0.01,Medium Risk
U398,2024,1,238166.0,Salary Increases & Fixed Expenses Remain Stable,150959,76621.0,70007,146628.0,4331.0,2.87,-0.03,High Risk
U398,2024,2,242497.0,Salary Increases & Fixed Expenses Remain Stable,150959,76621.0,64415,141036.0,9923.0,6.57,0.05,High Risk
U398,2024,3,252420.0,Salary Increases & Fixed Expenses Remain Stable,150959,76621.0,108426,185047.0,-34088.0,-22.58,-0.0,High Risk
U398,2024,4,218332.0,Salary Increases & Fixed Expenses Remain Stable,150959,76621.0,80272,156893.0,-5934.0,-3.93,0.05,High Risk
U398,2024,5,212398.0,Salary Increases & Fixed Expenses Remain Stable,171332,76621.0,73740,150361.0,20971.0,12.24,0.03,High Risk
U398,2024,6,233369.0,Salary Increases & Fixed Expenses Remain Stable,171332,76621.0,77770,154391.0,16941.0,9.89,-0.01,High Risk
U398,2024,7,250310.0,Salary Increases & Fixed Expenses Remain Stable,171332,76621.0,86436,163057.0,8275.0,4.83,-0.02,High Risk
U398,2024,8,258585.0,Salary Increases & Fixed Expenses Remain Stable,171332,76621.0,83073,159694.0,11638.0,6.79,0.02,High Risk
U398,2024,9,270223.0,Salary Increases & Fixed Expenses Remain Stable,171332,76621.0,80850,157471.0,13861.0,8.09,-0.02,High Risk
U398,2024,10,284084.0,Salary Increases & Fixed Expenses Remain Stable,171332,76621.0,100655,177276.0,-5944.0,-3.47,-0.02,High Risk
U398,2024,11,278140.0,Salary Increases & Fixed Expenses Remain Stable,171332,76621.0,101719,178340.0,-7008.0,-4.09,0.02,High Risk
U398,2024,12,271132.0,Salary Increases & Fixed Expenses Remain Stable,171332,76621.0,127078,203699.0,-32367.0,-18.89,-0.01,High Risk
U399,2024,1,220028.0,Stable Salary & Decreasing Fixed Expenses,99606,31736.0,45723,77459.0,22147.0,22.23,0.02,Medium Risk
U399,2024,2,242175.0,Stable Salary & Decreasing Fixed Expenses,99606,31736.0,40100,71836.0,27770.0,27.88,-0.04,Low Risk
U399,2024,3,269945.0,Stable Salary & Decreasing Fixed Expenses,99606,31736.0,52438,84174.0,15432.0,15.49,-0.03,Medium Risk
U399,2024,4,285377.0,Stable Salary & Decreasing Fixed Expenses,99606,31736.0,54837,86573.0,13033.0,13.08,0.01,High Risk
U399,2024,5,298410.0,Stable Salary & Decreasing Fixed Expenses,99606,31736.0,46041,77777.0,21829.0,21.92,0.02,Medium Risk
U399,2024,6,320239.0,Stable Salary & Decreasing Fixed Expenses,99606,31736.0,43123,74859.0,24747.0,24.84,0.02,Medium Risk
U399,2024,7,344986.0,Stable Salary & Decreasing Fixed Expenses,99606,31736.0,57160,88896.0,10710.0,10.75,0.04,High Risk
U399,2024,8,355696.0,Stable Salary & Decreasing Fixed Expenses,99606,31736.0,48934,80670.0,18936.0,19.01,-0.01,Medium Risk
U399,2024,9,374632.0,Stable Salary & Decreasing Fixed Expenses,99606,31736.0,58621,90357.0,9249.0,9.29,-0.02,High Risk
U399,2024,10,383881.0,Stable Salary & Decreasing Fixed Expenses,99606,31736.0,54489,86225.0,13381.0,13.43,-0.01,High Risk
U399,2024,11,397262.0,Stable Salary & Decreasing Fixed Expenses,99606,31736.0,54859,86595.0,13011.0,13.06,-0.01,High Risk
U399,2024,12,410273.0,Stable Salary & Decreasing Fixed Expenses,99606,31736.0,41322,73058.0,26548.0,26.65,0.03,Low Risk
U400,2024,1,227836.0,Stable Salary & Stable Fixed Expenses,44188,10891.0,19359,30250.0,13938.0,31.54,-0.04,Low Risk
U400,2024,2,241774.0,Stable Salary & Stable Fixed Expenses,44188,10891.0,18729,29620.0,14568.0,32.97,0.03,Low Risk
U400,2024,3,256342.0,Stable Salary & Stable Fixed Expenses,44188,10891.0,31101,41992.0,2196.0,4.97,-0.0,High Risk
U400,2024,4,258538.0,Stable Salary & Stable Fixed Expenses,44188,10891.0,23117,34008.0,10180.0,23.04,-0.01,Medium Risk
U400,2024,5,268718.0,Stable Salary & Stable Fixed Expenses,44188,10891.0,19489,30380.0,13808.0,31.25,0.02,Low Risk
U400,2024,6,282526.0,Stable Salary & Stable Fixed Expenses,44188,10891.0,24653,35544.0,8644.0,19.56,-0.04,Medium Risk
U400,2024,7,291170.0,Stable Salary & Stable Fixed Expenses,44188,10891.0,24159,35050.0,9138.0,20.68,-0.04,Medium Risk
U400,2024,8,300308.0,Stable Salary & Stable Fixed Expenses,44188,10891.0,20317,31208.0,12980.0,29.37,-0.03,Low Risk
U400,2024,9,313288.0,Stable Salary & Stable Fixed Expenses,44188,10891.0,23749,34640.0,9548.0,21.61,0.01,Medium Risk
U400,2024,10,322836.0,Stable Salary & Stable Fixed Expenses,44188,10891.0,22729,33620.0,10568.0,23.92,-0.02,Medium Risk
U400,2024,11,333404.0,Stable Salary & Stable Fixed Expenses,44188,10891.0,19543,30434.0,13754.0,31.13,0.03,Low Risk
U400,2024,12,347158.0,Stable Salary & Stable Fixed Expenses,44188,10891.0,17979,28870.0,15318.0,34.67,-0.02,Low Risk
U401,2024,1,248767.0,Salary Increases & Fixed Expenses Remain Stable,276156,116166.0,165451,281617.0,-5461.0,-1.98,0.04,High Risk
U401,2024,2,243306.0,Salary Increases & Fixed Expenses Remain Stable,276156,116166.0,155972,272138.0,4018.0,1.45,-0.02,High Risk
U401,2024,3,247324.0,Salary Increases & Fixed Expenses Remain Stable,276156,116166.0,149951,266117.0,10039.0,3.64,-0.05,High Risk
U401,2024,4,257363.0,Salary Increases & Fixed Expenses Remain Stable,276156,116166.0,160954,277120.0,-964.0,-0.35,-0.04,High Risk
U401,2024,5,256399.0,Salary Increases & Fixed Expenses Remain Stable,276156,116166.0,123174,239340.0,36816.0,13.33,0.0,High Risk
U401,2024,6,293215.0,Salary Increases & Fixed Expenses Remain Stable,276156,116166.0,134053,250219.0,25937.0,9.39,0.05,High Risk
U401,2024,7,319152.0,Salary Increases & Fixed Expenses Remain Stable,276156,116166.0,142312,258478.0,17678.0,6.4,0.03,High Risk
U401,2024,8,336830.0,Salary Increases & Fixed Expenses Remain Stable,303994,116166.0,127898,244064.0,59930.0,19.71,-0.03,Medium Risk
U401,2024,9,396760.0,Salary Increases & Fixed Expenses Remain Stable,303994,116166.0,182373,298539.0,5455.0,1.79,-0.04,High Risk
U401,2024,10,402215.0,Salary Increases & Fixed Expenses Remain Stable,303994,116166.0,169430,285596.0,18398.0,6.05,-0.04,High Risk
U401,2024,11,420613.0,Salary Increases & Fixed Expenses Remain Stable,303994,116166.0,142941,259107.0,44887.0,14.77,-0.01,High Risk
U401,2024,12,465500.0,Salary Increases & Fixed Expenses Remain Stable,303994,116166.0,125809,241975.0,62019.0,20.4,-0.02,Medium Risk
U402,2024,1,245978.0,Salary Increases & Fixed Expenses Remain Stable,228101,67399.0,77083,144482.0,83619.0,36.66,0.01,Low Risk
U402,2024,2,329597.0,Salary Increases & Fixed Expenses Remain Stable,228101,67399.0,90763,158162.0,69939.0,30.66,0.04,Low Risk
U402,2024,3,399536.0,Salary Increases & Fixed Expenses Remain Stable,228101,67399.0,109757,177156.0,50945.0,22.33,-0.04,Medium Risk
U402,2024,4,450481.0,Salary Increases & Fixed Expenses Remain Stable,228101,67399.0,83568,150967.0,77134.0,33.82,0.05,Low Risk
U402,2024,5,527615.0,Salary Increases & Fixed Expenses Remain Stable,228101,67399.0,80391,147790.0,80311.0,35.21,0.0,Low Risk
U402,2024,6,607926.0,Salary Increases & Fixed Expenses Remain Stable,228101,67399.0,74784,142183.0,85918.0,37.67,0.05,Low Risk
U402,2024,7,693844.0,Salary Increases & Fixed Expenses Remain Stable,248729,67399.0,99198,166597.0,82132.0,33.02,-0.04,Low Risk
U402,2024,8,775976.0,Salary Increases & Fixed Expenses Remain Stable,248729,67399.0,95475,162874.0,85855.0,34.52,0.03,Low Risk
U402,2024,9,861831.0,Salary Increases & Fixed Expenses Remain Stable,248729,67399.0,79575,146974.0,101755.0,40.91,0.01,Low Risk
U402,2024,10,963586.0,Salary Increases & Fixed Expenses Remain Stable,248729,67399.0,107481,174880.0,73849.0,29.69,-0.0,Low Risk
U402,2024,11,1037435.0,Salary Increases & Fixed Expenses Remain Stable,248729,67399.0,78963,146362.0,102367.0,41.16,0.04,Low Risk
U402,2024,12,1139802.0,Salary Increases & Fixed Expenses Remain Stable,248729,67399.0,78168,145567.0,103162.0,41.48,-0.04,Low Risk
U403,2024,1,222334.0,Salary Increases & Fixed Expenses Remain Stable,246376,82773.0,129275,212048.0,34328.0,13.93,-0.04,High Risk
U403,2024,2,256662.0,Salary Increases & Fixed Expenses Remain Stable,246376,82773.0,142698,225471.0,20905.0,8.48,-0.01,High Risk
U403,2024,3,277567.0,Salary Increases & Fixed Expenses Remain Stable,270386,82773.0,146127,228900.0,41486.0,15.34,0.01,Medium Risk
U403,2024,4,319053.0,Salary Increases & Fixed Expenses Remain Stable,270386,82773.0,139346,222119.0,48267.0,17.85,-0.01,Medium Risk
U403,2024,5,367320.0,Salary Increases & Fixed Expenses Remain Stable,270386,82773.0,129319,212092.0,58294.0,21.56,0.03,Medium Risk
U403,2024,6,425614.0,Salary Increases & Fixed Expenses Remain Stable,270386,82773.0,151803,234576.0,35810.0,13.24,0.01,High Risk
U403,2024,7,461424.0,Salary Increases & Fixed Expenses Remain Stable,270386,82773.0,155196,237969.0,32417.0,11.99,-0.03,High Risk
U403,2024,8,493841.0,Salary Increases & Fixed Expenses Remain Stable,270386,82773.0,153069,235842.0,34544.0,12.78,-0.03,High Risk
U403,2024,9,528385.0,Salary Increases & Fixed Expenses Remain Stable,270386,82773.0,147798,230571.0,39815.0,14.73,-0.05,High Risk
U403,2024,10,568200.0,Salary Increases & Fixed Expenses Remain Stable,270386,82773.0,144655,227428.0,42958.0,15.89,0.04,Medium Risk
U403,2024,11,611158.0,Salary Increases & Fixed Expenses Remain Stable,270386,82773.0,123754,206527.0,63859.0,23.62,-0.03,Medium Risk
U403,2024,12,675017.0,Salary Increases & Fixed Expenses Remain Stable,270386,82773.0,152826,235599.0,34787.0,12.87,0.04,High Risk
U404,2024,1,206743.0,Salary Increases & Fixed Expenses Increase,56102,23681.0,21325,45006.0,11096.0,19.78,0.03,Medium Risk
U404,2024,2,217839.0,Salary Increases & Fixed Expenses Increase,56102,23681.0,21755,45436.0,10666.0,19.01,-0.02,Medium Risk
U404,2024,3,228505.0,Salary Increases & Fixed Expenses Increase,56102,23681.0,18606,42287.0,13815.0,24.62,-0.05,Medium Risk
U404,2024,4,242320.0,Salary Increases & Fixed Expenses Increase,56102,23681.0,19134,42815.0,13287.0,23.68,0.02,Medium Risk
U404,2024,5,255607.0,Salary Increases & Fixed Expenses Increase,56102,23681.0,20522,44203.0,11899.0,21.21,0.01,Medium Risk
U404,2024,6,267506.0,Salary Increases & Fixed Expenses Increase,56102,23681.0,17600,41281.0,14821.0,26.42,-0.01,Low Risk
U404,2024,7,282327.0,Salary Increases & Fixed Expenses Increase,56102,25320.0,21133,46453.0,9649.0,17.2,0.01,Medium Risk
U404,2024,8,291976.0,Salary Increases & Fixed Expenses Increase,69693,26900.0,22523,49423.0,20270.0,29.08,0.03,Low Risk
U404,2024,9,312246.0,Salary Increases & Fixed Expenses Increase,69693,26900.0,24445,51345.0,18348.0,26.33,-0.04,Low Risk
U404,2024,10,330594.0,Salary Increases & Fixed Expenses Increase,69693,26900.0,31022,57922.0,11771.0,16.89,-0.03,Medium Risk
U404,2024,11,342365.0,Salary Increases & Fixed Expenses Increase,69693,26900.0,24112,51012.0,18681.0,26.8,-0.04,Low Risk
U404,2024,12,361046.0,Salary Increases & Fixed Expenses Increase,69693,26900.0,27136,54036.0,15657.0,22.47,-0.04,Medium Risk
U405,2024,1,240836.0,Stable Salary & Decreasing Fixed Expenses,184049,75327.0,74768,150095.0,33954.0,18.45,-0.05,Medium Risk
U405,2024,2,274790.0,Stable Salary & Decreasing Fixed Expenses,184049,75327.0,106586,181913.0,2136.0,1.16,-0.02,High Risk
U405,2024,3,276926.0,Stable Salary & Decreasing Fixed Expenses,184049,75327.0,92776,168103.0,15946.0,8.66,-0.02,High Risk
U405,2024,4,292872.0,Stable Salary & Decreasing Fixed Expenses,184049,75327.0,107873,183200.0,849.0,0.46,0.02,High Risk
U405,2024,5,293721.0,Stable Salary & Decreasing Fixed Expenses,184049,75327.0,93432,168759.0,15290.0,8.31,0.01,High Risk
U405,2024,6,309011.0,Stable Salary & Decreasing Fixed Expenses,184049,75327.0,102536,177863.0,6186.0,3.36,0.03,High Risk
U405,2024,7,315197.0,Stable Salary & Decreasing Fixed Expenses,184049,75327.0,86505,161832.0,22217.0,12.07,0.03,High Risk
U405,2024,8,337414.0,Stable Salary & Decreasing Fixed Expenses,184049,75327.0,79357,154684.0,29365.0,15.95,0.04,Medium Risk
U405,2024,9,366779.0,Stable Salary & Decreasing Fixed Expenses,184049,75327.0,100074,175401.0,8648.0,4.7,-0.04,High Risk
U405,2024,10,375427.0,Stable Salary & Decreasing Fixed Expenses,184049,75327.0,94741,170068.0,13981.0,7.6,0.01,High Risk
U405,2024,11,389408.0,Stable Salary & Decreasing Fixed Expenses,184049,75327.0,92938,168265.0,15784.0,8.58,-0.02,High Risk
U405,2024,12,405192.0,Stable Salary & Decreasing Fixed Expenses,184049,75327.0,83100,158427.0,25622.0,13.92,-0.0,High Risk
U406,2024,1,210725.0,Salary Increases & Fixed Expenses Remain Stable,42488,19826.0,28055,47881.0,-5393.0,-12.69,0.05,High Risk
U406,2024,2,205332.0,Salary Increases & Fixed Expenses Remain Stable,42488,19826.0,29358,49184.0,-6696.0,-15.76,-0.03,High Risk
U406,2024,3,198636.0,Salary Increases & Fixed Expenses Remain Stable,42488,19826.0,32744,52570.0,-10082.0,-23.73,0.04,High Risk
U406,2024,4,188554.0,Salary Increases & Fixed Expenses Remain Stable,42488,19826.0,32295,52121.0,-9633.0,-22.67,-0.02,High Risk
U406,2024,5,178921.0,Salary Increases & Fixed Expenses Remain Stable,42488,19826.0,25656,45482.0,-2994.0,-7.05,-0.0,High Risk
U406,2024,6,175927.0,Salary Increases & Fixed Expenses Remain Stable,56255,19826.0,41290,61116.0,-4861.0,-8.64,0.05,High Risk
U406,2024,7,171066.0,Salary Increases & Fixed Expenses Remain Stable,56255,19826.0,35427,55253.0,1002.0,1.78,-0.02,High Risk
U406,2024,8,172068.0,Salary Increases & Fixed Expenses Remain Stable,56255,19826.0,36451,56277.0,-22.0,-0.04,-0.01,High Risk
U406,2024,9,172046.0,Salary Increases & Fixed Expenses Remain Stable,56255,19826.0,42285,62111.0,-5856.0,-10.41,-0.02,High Risk
U406,2024,10,166190.0,Salary Increases & Fixed Expenses Remain Stable,56255,19826.0,37078,56904.0,-649.0,-1.15,0.03,High Risk
U406,2024,11,165541.0,Salary Increases & Fixed Expenses Remain Stable,56255,19826.0,42515,62341.0,-6086.0,-10.82,-0.01,High Risk
U406,2024,12,159455.0,Salary Increases & Fixed Expenses Remain Stable,56255,19826.0,41330,61156.0,-4901.0,-8.71,-0.01,High Risk
U407,2024,1,206645.0,Stable Salary & Increasing Fixed Expenses,44658,21541.0,22862,44403.0,255.0,0.57,-0.03,High Risk
U407,2024,2,206900.0,Stable Salary & Increasing Fixed Expenses,44658,21541.0,22481,44022.0,636.0,1.42,0.01,High Risk
U407,2024,3,207536.0,Stable Salary & Increasing Fixed Expenses,44658,21541.0,29289,50830.0,-6172.0,-13.82,-0.02,High Risk
U407,2024,4,201364.0,Stable Salary & Increasing Fixed Expenses,44658,21541.0,20597,42138.0,2520.0,5.64,0.04,High Risk
U407,2024,5,203884.0,Stable Salary & Increasing Fixed Expenses,44658,21541.0,25456,46997.0,-2339.0,-5.24,0.02,High Risk
U407,2024,6,201545.0,Stable Salary & Increasing Fixed Expenses,44658,21541.0,25096,46637.0,-1979.0,-4.43,-0.03,High Risk
U407,2024,7,199566.0,Stable Salary & Increasing Fixed Expenses,44658,21541.0,24956,46497.0,-1839.0,-4.12,-0.02,High Risk
U407,2024,8,197727.0,Stable Salary & Increasing Fixed Expenses,44658,21541.0,20688,42229.0,2429.0,5.44,-0.0,High Risk
U407,2024,9,200156.0,Stable Salary & Increasing Fixed Expenses,44658,21541.0,24245,45786.0,-1128.0,-2.53,-0.04,High Risk
U407,2024,10,199028.0,Stable Salary & Increasing Fixed Expenses,44658,21541.0,24468,46009.0,-1351.0,-3.03,-0.02,High Risk
U407,2024,11,197677.0,Stable Salary & Increasing Fixed Expenses,44658,21541.0,27032,48573.0,-3915.0,-8.77,0.01,High Risk
U407,2024,12,193762.0,Stable Salary & Increasing Fixed Expenses,44658,21541.0,28206,49747.0,-5089.0,-11.4,-0.01,High Risk
U408,2024,1,233751.0,Stable Salary & Decreasing Fixed Expenses,298524,86135.0,170531,256666.0,41858.0,14.02,0.01,High Risk
U408,2024,2,275609.0,Stable Salary & Decreasing Fixed Expenses,298524,86135.0,146363,232498.0,66026.0,22.12,-0.02,Medium Risk
U408,2024,3,341635.0,Stable Salary & Decreasing Fixed Expenses,298524,86135.0,200938,287073.0,11451.0,3.84,0.02,High Risk
U408,2024,4,353086.0,Stable Salary & Decreasing Fixed Expenses,298524,86135.0,160780,246915.0,51609.0,17.29,0.03,Medium Risk
U408,2024,5,404695.0,Stable Salary & Decreasing Fixed Expenses,298524,86135.0,136427,222562.0,75962.0,25.45,-0.03,Low Risk
U408,2024,6,480657.0,Stable Salary & Decreasing Fixed Expenses,298524,86135.0,174425,260560.0,37964.0,12.72,-0.05,High Risk
U408,2024,7,518621.0,Stable Salary & Decreasing Fixed Expenses,298524,86135.0,152608,238743.0,59781.0,20.03,0.03,Medium Risk
U408,2024,8,578402.0,Stable Salary & Decreasing Fixed Expenses,298524,86135.0,170877,257012.0,41512.0,13.91,-0.04,High Risk
U408,2024,9,619914.0,Stable Salary & Decreasing Fixed Expenses,298524,86135.0,154220,240355.0,58169.0,19.49,-0.04,Medium Risk
U408,2024,10,678083.0,Stable Salary & Decreasing Fixed Expenses,298524,86135.0,199256,285391.0,13133.0,4.4,0.0,High Risk
U408,2024,11,691216.0,Stable Salary & Decreasing Fixed Expenses,298524,86135.0,163316,249451.0,49073.0,16.44,0.03,Medium Risk
U408,2024,12,740289.0,Stable Salary & Decreasing Fixed Expenses,298524,86135.0,225621,311756.0,-13232.0,-4.43,0.04,High Risk
U409,2024,1,246988.0,Salary Increases & Fixed Expenses Remain Stable,34182,22789.0,14255,37044.0,-2862.0,-8.37,-0.05,High Risk
U409,2024,2,244126.0,Salary Increases & Fixed Expenses Remain Stable,34182,22789.0,17372,40161.0,-5979.0,-17.49,0.0,High Risk
U409,2024,3,238147.0,Salary Increases & Fixed Expenses Remain Stable,34182,22789.0,22613,45402.0,-11220.0,-32.82,-0.05,High Risk
U409,2024,4,226927.0,Salary Increases & Fixed Expenses Remain Stable,34182,22789.0,16920,39709.0,-5527.0,-16.17,-0.03,High Risk
U409,2024,5,221400.0,Salary Increases & Fixed Expenses Remain Stable,41524,22789.0,19343,42132.0,-608.0,-1.46,0.05,High Risk
U409,2024,6,220792.0,Salary Increases & Fixed Expenses Remain Stable,41524,22789.0,20893,43682.0,-2158.0,-5.2,-0.03,High Risk
U409,2024,7,218634.0,Salary Increases & Fixed Expenses Remain Stable,41524,22789.0,22843,45632.0,-4108.0,-9.89,0.02,High Risk
U409,2024,8,214526.0,Salary Increases & Fixed Expenses Remain Stable,41524,22789.0,22536,45325.0,-3801.0,-9.15,0.03,High Risk
U409,2024,9,210725.0,Salary Increases & Fixed Expenses Remain Stable,41524,22789.0,28386,51175.0,-9651.0,-23.24,-0.03,High Risk
U409,2024,10,201074.0,Salary Increases & Fixed Expenses Remain Stable,41524,22789.0,26734,49523.0,-7999.0,-19.26,-0.04,High Risk
U409,2024,11,193075.0,Salary Increases & Fixed Expenses Remain Stable,41524,22789.0,22370,45159.0,-3635.0,-8.75,0.02,High Risk
U409,2024,12,189440.0,Salary Increases & Fixed Expenses Remain Stable,41524,22789.0,28164,50953.0,-9429.0,-22.71,0.03,High Risk
U410,2024,1,223297.0,Salary Increases & Fixed Expenses Decrease,49022,17773.0,26339,44112.0,4910.0,10.02,0.04,High Risk
U410,2024,2,228207.0,Salary Increases & Fixed Expenses Decrease,49022,17773.0,21522,39295.0,9727.0,19.84,-0.05,Medium Risk
U410,2024,3,237934.0,Salary Increases & Fixed Expenses Decrease,49022,17773.0,29072,46845.0,2177.0,4.44,-0.0,High Risk
U410,2024,4,240111.0,Salary Increases & Fixed Expenses Decrease,49022,17773.0,23240,41013.0,8009.0,16.34,0.03,Medium Risk
U410,2024,5,248120.0,Salary Increases & Fixed Expenses Decrease,49022,17773.0,23051,40824.0,8198.0,16.72,-0.01,Medium Risk
U410,2024,6,256318.0,Salary Increases & Fixed Expenses Decrease,49022,17773.0,23905,41678.0,7344.0,14.98,0.01,High Risk
U410,2024,7,263662.0,Salary Increases & Fixed Expenses Decrease,58691,17773.0,29777,47550.0,11141.0,18.98,-0.0,Medium Risk
U410,2024,8,274803.0,Salary Increases & Fixed Expenses Decrease,58691,15995.7,30761,46756.7,11934.300000000003,20.33,-0.04,Medium Risk
U410,2024,9,286737.3,Salary Increases & Fixed Expenses Decrease,58691,15995.7,26104,42099.7,16591.300000000003,28.27,0.03,Low Risk
U410,2024,10,303328.6,Salary Increases & Fixed Expenses Decrease,58691,15995.7,34646,50641.7,8049.300000000003,13.71,0.05,High Risk
U410,2024,11,311377.89999999997,Salary Increases & Fixed Expenses Decrease,58691,15995.7,33688,49683.7,9007.300000000003,15.35,-0.01,Medium Risk
U410,2024,12,320385.19999999995,Salary Increases & Fixed Expenses Decrease,58691,15995.7,24629,40624.7,18066.300000000003,30.78,-0.02,Low Risk
U411,2024,1,238206.0,Stable Salary & Increasing Fixed Expenses,244260,102011.0,77795,179806.0,64454.0,26.39,-0.0,Low Risk
U411,2024,2,302660.0,Stable Salary & Increasing Fixed Expenses,244260,102011.0,88205,190216.0,54044.0,22.13,0.02,Medium Risk
U411,2024,3,356704.0,Stable Salary & Increasing Fixed Expenses,244260,102011.0,104978,206989.0,37271.0,15.26,0.02,Medium Risk
U411,2024,4,393975.0,Stable Salary & Increasing Fixed Expenses,244260,102011.0,78866,180877.0,63383.0,25.95,-0.04,Low Risk
U411,2024,5,457358.0,Stable Salary & Increasing Fixed Expenses,244260,103713.0,76608,180321.0,63939.0,26.18,-0.02,Low Risk
U411,2024,6,521297.0,Stable Salary & Increasing Fixed Expenses,244260,103713.0,92823,196536.0,47724.0,19.54,-0.0,Medium Risk
U411,2024,7,569021.0,Stable Salary & Increasing Fixed Expenses,244260,103713.0,75596,179309.0,64951.0,26.59,0.05,Low Risk
U411,2024,8,633972.0,Stable Salary & Increasing Fixed Expenses,244260,105101.0,79691,184792.0,59468.0,24.35,-0.01,Medium Risk
U411,2024,9,693440.0,Stable Salary & Increasing Fixed Expenses,244260,105101.0,88884,193985.0,50275.0,20.58,-0.05,Medium Risk
U411,2024,10,743715.0,Stable Salary & Increasing Fixed Expenses,244260,105101.0,102828,207929.0,36331.0,14.87,0.03,High Risk
U411,2024,11,780046.0,Stable Salary & Increasing Fixed Expenses,244260,105101.0,89297,194398.0,49862.0,20.41,0.03,Medium Risk
U411,2024,12,829908.0,Stable Salary & Increasing Fixed Expenses,244260,105101.0,102754,207855.0,36405.0,14.9,0.02,High Risk
U412,2024,1,218471.0,Salary Increases & Fixed Expenses Remain Stable,29584,15559.0,10486,26045.0,3539.0,11.96,0.02,High Risk
U412,2024,2,222010.0,Salary Increases & Fixed Expenses Remain Stable,29584,15559.0,11759,27318.0,2266.0,7.66,-0.02,High Risk
U412,2024,3,224276.0,Salary Increases & Fixed Expenses Remain Stable,29584,15559.0,11653,27212.0,2372.0,8.02,0.04,High Risk
U412,2024,4,226648.0,Salary Increases & Fixed Expenses Remain Stable,29584,15559.0,10161,25720.0,3864.0,13.06,-0.02,High Risk
U412,2024,5,230512.0,Salary Increases & Fixed Expenses Remain Stable,29584,15559.0,9855,25414.0,4170.0,14.1,-0.03,High Risk
U412,2024,6,234682.0,Salary Increases & Fixed Expenses Remain Stable,29584,15559.0,10600,26159.0,3425.0,11.58,-0.01,High Risk
U412,2024,7,238107.0,Salary Increases & Fixed Expenses Remain Stable,29584,15559.0,11105,26664.0,2920.0,9.87,-0.01,High Risk
U412,2024,8,241027.0,Salary Increases & Fixed Expenses Remain Stable,51558,15559.0,19365,34924.0,16634.0,32.26,-0.02,Low Risk
U412,2024,9,257661.0,Salary Increases & Fixed Expenses Remain Stable,51558,15559.0,17588,33147.0,18411.0,35.71,0.02,Low Risk
U412,2024,10,276072.0,Salary Increases & Fixed Expenses Remain Stable,51558,15559.0,20553,36112.0,15446.0,29.96,-0.0,Low Risk
U412,2024,11,291518.0,Salary Increases & Fixed Expenses Remain Stable,51558,15559.0,17904,33463.0,18095.0,35.1,-0.0,Low Risk
U412,2024,12,309613.0,Salary Increases & Fixed Expenses Remain Stable,51558,15559.0,18931,34490.0,17068.0,33.1,0.03,Low Risk
U413,2024,1,206349.0,Salary Increases & Fixed Expenses Increase,166923,41251.0,112281,153532.0,13391.0,8.02,-0.01,High Risk
U413,2024,2,219740.0,Salary Increases & Fixed Expenses Increase,166923,42018.0,132425,174443.0,-7520.0,-4.51,0.04,High Risk
U413,2024,3,212220.0,Salary Increases & Fixed Expenses Increase,166923,42018.0,137435,179453.0,-12530.0,-7.51,0.04,High Risk
U413,2024,4,199690.0,Salary Increases & Fixed Expenses Increase,166923,42018.0,132713,174731.0,-7808.0,-4.68,-0.04,High Risk
U413,2024,5,191882.0,Salary Increases & Fixed Expenses Increase,166923,42018.0,114739,156757.0,10166.0,6.09,-0.03,High Risk
U413,2024,6,202048.0,Salary Increases & Fixed Expenses Increase,193928,42018.0,135683,177701.0,16227.0,8.37,-0.03,High Risk
U413,2024,7,218275.0,Salary Increases & Fixed Expenses Increase,193928,42018.0,120023,162041.0,31887.0,16.44,0.02,Medium Risk
U413,2024,8,250162.0,Salary Increases & Fixed Expenses Increase,193928,42018.0,154427,196445.0,-2517.0,-1.3,-0.01,High Risk
U413,2024,9,247645.0,Salary Increases & Fixed Expenses Increase,193928,43618.0,118403,162021.0,31907.0,16.45,0.02,Medium Risk
U413,2024,10,279552.0,Salary Increases & Fixed Expenses Increase,193928,43618.0,139084,182702.0,11226.0,5.79,-0.01,High Risk
U413,2024,11,290778.0,Salary Increases & Fixed Expenses Increase,193928,44526.0,144667,189193.0,4735.0,2.44,-0.0,High Risk
U413,2024,12,295513.0,Salary Increases & Fixed Expenses Increase,193928,44526.0,135526,180052.0,13876.0,7.16,0.01,High Risk
U414,2024,1,236532.0,Salary Increases & Fixed Expenses Increase,194453,60477.0,79587,140064.0,54389.0,27.97,-0.0,Low Risk
U414,2024,2,290921.0,Salary Increases & Fixed Expenses Increase,194453,61723.0,94713,156436.0,38017.0,19.55,0.01,Medium Risk
U414,2024,3,328938.0,Salary Increases & Fixed Expenses Increase,194453,61723.0,116172,177895.0,16558.0,8.52,0.0,High Risk
U414,2024,4,345496.0,Salary Increases & Fixed Expenses Increase,194453,61723.0,115094,176817.0,17636.0,9.07,0.02,High Risk
U414,2024,5,363132.0,Salary Increases & Fixed Expenses Increase,206351,61723.0,105501,167224.0,39127.0,18.96,-0.02,Medium Risk
U414,2024,6,402259.0,Salary Increases & Fixed Expenses Increase,206351,61723.0,118459,180182.0,26169.0,12.68,-0.02,High Risk
U414,2024,7,428428.0,Salary Increases & Fixed Expenses Increase,206351,62478.0,121201,183679.0,22672.0,10.99,-0.04,High Risk
U414,2024,8,451100.0,Salary Increases & Fixed Expenses Increase,206351,62478.0,104642,167120.0,39231.0,19.01,0.02,Medium Risk
U414,2024,9,490331.0,Salary Increases & Fixed Expenses Increase,206351,62478.0,104886,167364.0,38987.0,18.89,0.02,Medium Risk
U414,2024,10,529318.0,Salary Increases & Fixed Expenses Increase,206351,62478.0,107391,169869.0,36482.0,17.68,-0.03,Medium Risk
U414,2024,11,565800.0,Salary Increases & Fixed Expenses Increase,206351,62478.0,104994,167472.0,38879.0,18.84,0.02,Medium Risk
U414,2024,12,604679.0,Salary Increases & Fixed Expenses Increase,206351,62478.0,99283,161761.0,44590.0,21.61,-0.01,Medium Risk
U415,2024,1,248626.0,Salary Increases & Fixed Expenses Remain Stable,272162,69935.0,102285,172220.0,99942.0,36.72,0.01,Low Risk
U415,2024,2,348568.0,Salary Increases & Fixed Expenses Remain Stable,272162,69935.0,88769,158704.0,113458.0,41.69,0.05,Low Risk
U415,2024,3,462026.0,Salary Increases & Fixed Expenses Remain Stable,272162,69935.0,131086,201021.0,71141.0,26.14,0.03,Low Risk
U415,2024,4,533167.0,Salary Increases & Fixed Expenses Remain Stable,289880,69935.0,102463,172398.0,117482.0,40.53,0.05,Low Risk
U415,2024,5,650649.0,Salary Increases & Fixed Expenses Remain Stable,289880,69935.0,93994,163929.0,125951.0,43.45,-0.04,Low Risk
U415,2024,6,776600.0,Salary Increases & Fixed Expenses Remain Stable,289880,69935.0,114508,184443.0,105437.0,36.37,0.05,Low Risk
U415,2024,7,882037.0,Salary Increases & Fixed Expenses Remain Stable,289880,69935.0,96205,166140.0,123740.0,42.69,0.01,Low Risk
U415,2024,8,1005777.0,Salary Increases & Fixed Expenses Remain Stable,289880,69935.0,113225,183160.0,106720.0,36.82,-0.01,Low Risk
U415,2024,9,1112497.0,Salary Increases & Fixed Expenses Remain Stable,289880,69935.0,127469,197404.0,92476.0,31.9,-0.04,Low Risk
U415,2024,10,1204973.0,Salary Increases & Fixed Expenses Remain Stable,289880,69935.0,119538,189473.0,100407.0,34.64,0.01,Low Risk
U415,2024,11,1305380.0,Salary Increases & Fixed Expenses Remain Stable,289880,69935.0,113631,183566.0,106314.0,36.68,-0.03,Low Risk
U415,2024,12,1411694.0,Salary Increases & Fixed Expenses Remain Stable,289880,69935.0,120303,190238.0,99642.0,34.37,0.01,Low Risk
U416,2024,1,249481.0,Salary Increases & Fixed Expenses Remain Stable,130194,75931.0,49405,125336.0,4858.0,3.73,0.04,High Risk
U416,2024,2,254339.0,Salary Increases & Fixed Expenses Remain Stable,130194,75931.0,46624,122555.0,7639.0,5.87,-0.05,High Risk
U416,2024,3,261978.0,Salary Increases & Fixed Expenses Remain Stable,130194,75931.0,53478,129409.0,785.0,0.6,-0.03,High Risk
U416,2024,4,262763.0,Salary Increases & Fixed Expenses Remain Stable,130194,75931.0,49845,125776.0,4418.0,3.39,0.03,High Risk
U416,2024,5,267181.0,Salary Increases & Fixed Expenses Remain Stable,130194,75931.0,46426,122357.0,7837.0,6.02,-0.02,High Risk
U416,2024,6,275018.0,Salary Increases & Fixed Expenses Remain Stable,130194,75931.0,47336,123267.0,6927.0,5.32,0.05,High Risk
U416,2024,7,281945.0,Salary Increases & Fixed Expenses Remain Stable,130194,75931.0,43364,119295.0,10899.0,8.37,0.04,High Risk
U416,2024,8,292844.0,Salary Increases & Fixed Expenses Remain Stable,154420,75931.0,52791,128722.0,25698.0,16.64,-0.03,Medium Risk
U416,2024,9,318542.0,Salary Increases & Fixed Expenses Remain Stable,154420,75931.0,57770,133701.0,20719.0,13.42,0.04,High Risk
U416,2024,10,339261.0,Salary Increases & Fixed Expenses Remain Stable,154420,75931.0,61114,137045.0,17375.0,11.25,-0.02,High Risk
U416,2024,11,356636.0,Salary Increases & Fixed Expenses Remain Stable,154420,75931.0,52977,128908.0,25512.0,16.52,0.03,Medium Risk
U416,2024,12,382148.0,Salary Increases & Fixed Expenses Remain Stable,154420,75931.0,50689,126620.0,27800.0,18.0,-0.02,Medium Risk
U417,2024,1,203561.0,Salary Increases & Fixed Expenses Remain Stable,294355,101129.0,189598,290727.0,3628.0,1.23,0.02,High Risk
U417,2024,2,207189.0,Salary Increases & Fixed Expenses Remain Stable,294355,101129.0,218305,319434.0,-25079.0,-8.52,0.03,High Risk
U417,2024,3,182110.0,Salary Increases & Fixed Expenses Remain Stable,294355,101129.0,258498,359627.0,-65272.0,-22.17,0.01,High Risk
U417,2024,4,116838.0,Salary Increases & Fixed Expenses Remain Stable,294355,101129.0,212155,313284.0,-18929.0,-6.43,0.01,High Risk
U417,2024,5,97909.0,Salary Increases & Fixed Expenses Remain Stable,305986,101129.0,188086,289215.0,16771.0,5.48,-0.02,High Risk
U417,2024,6,114680.0,Salary Increases & Fixed Expenses Remain Stable,305986,101129.0,241898,343027.0,-37041.0,-12.11,0.04,High Risk
U417,2024,7,77639.0,Salary Increases & Fixed Expenses Remain Stable,305986,101129.0,228772,329901.0,-23915.0,-7.82,-0.04,High Risk
U417,2024,8,53724.0,Salary Increases & Fixed Expenses Remain Stable,305986,101129.0,210163,311292.0,-5306.0,-1.73,-0.0,High Risk
U417,2024,9,48418.0,Salary Increases & Fixed Expenses Remain Stable,305986,101129.0,225988,327117.0,-21131.0,-6.91,0.03,High Risk
U417,2024,10,27287.0,Salary Increases & Fixed Expenses Remain Stable,305986,101129.0,222002,323131.0,-17145.0,-5.6,-0.02,High Risk
U417,2024,11,10142.0,Salary Increases & Fixed Expenses Remain Stable,305986,101129.0,204693,305822.0,164.0,0.05,0.0,High Risk
U417,2024,12,10306.0,Salary Increases & Fixed Expenses Remain Stable,305986,101129.0,239686,340815.0,-34829.0,-11.38,0.03,High Risk
U418,2024,1,222888.0,Stable Salary & Stable Fixed Expenses,296310,115551.0,199632,315183.0,-18873.0,-6.37,0.02,High Risk
U418,2024,2,204015.0,Stable Salary & Stable Fixed Expenses,296310,115551.0,203085,318636.0,-22326.0,-7.53,-0.03,High Risk
U418,2024,3,181689.0,Stable Salary & Stable Fixed Expenses,296310,115551.0,246175,361726.0,-65416.0,-22.08,0.01,High Risk
U418,2024,4,116273.0,Stable Salary & Stable Fixed Expenses,296310,115551.0,205198,320749.0,-24439.0,-8.25,-0.01,High Risk
U418,2024,5,91834.0,Stable Salary & Stable Fixed Expenses,296310,115551.0,230120,345671.0,-49361.0,-16.66,-0.01,High Risk
U418,2024,6,42473.0,Stable Salary & Stable Fixed Expenses,296310,115551.0,230959,346510.0,-50200.0,-16.94,-0.03,High Risk
U418,2024,7,-7727.0,Stable Salary & Stable Fixed Expenses,296310,115551.0,184515,300066.0,-3756.0,-1.27,-0.01,High Risk
U418,2024,8,-11483.0,Stable Salary & Stable Fixed Expenses,296310,115551.0,209495,325046.0,-28736.0,-9.7,0.05,High Risk
U418,2024,9,-40219.0,Stable Salary & Stable Fixed Expenses,296310,115551.0,232783,348334.0,-52024.0,-17.56,-0.03,High Risk
U418,2024,10,-92243.0,Stable Salary & Stable Fixed Expenses,296310,115551.0,264403,379954.0,-83644.0,-28.23,0.0,High Risk
U418,2024,11,-175887.0,Stable Salary & Stable Fixed Expenses,296310,115551.0,223994,339545.0,-43235.0,-14.59,0.03,High Risk
U418,2024,12,-219122.0,Stable Salary & Stable Fixed Expenses,296310,115551.0,184427,299978.0,-3668.0,-1.24,-0.02,High Risk
U419,2024,1,200674.0,Salary Increases & Fixed Expenses Increase,87785,35026.0,30107,65133.0,22652.0,25.8,0.03,Low Risk
U419,2024,2,223326.0,Salary Increases & Fixed Expenses Increase,87785,35026.0,28466,63492.0,24293.0,27.67,-0.01,Low Risk
U419,2024,3,247619.0,Salary Increases & Fixed Expenses Increase,112635,35026.0,45492,80518.0,32117.0,28.51,0.01,Low Risk
U419,2024,4,279736.0,Salary Increases & Fixed Expenses Increase,112635,35026.0,35022,70048.0,42587.0,37.81,0.04,Low Risk
U419,2024,5,322323.0,Salary Increases & Fixed Expenses Increase,112635,35026.0,41837,76863.0,35772.0,31.76,0.0,Low Risk
U419,2024,6,358095.0,Salary Increases & Fixed Expenses Increase,112635,35585.0,38613,74198.0,38437.0,34.13,0.03,Low Risk
U419,2024,7,396532.0,Salary Increases & Fixed Expenses Increase,112635,35585.0,34991,70576.0,42059.0,37.34,-0.01,Low Risk
U419,2024,8,438591.0,Salary Increases & Fixed Expenses Increase,112635,35585.0,38071,73656.0,38979.0,34.61,-0.03,Low Risk
U419,2024,9,477570.0,Salary Increases & Fixed Expenses Increase,112635,37205.0,37755,74960.0,37675.0,33.45,0.0,Low Risk
U419,2024,10,515245.0,Salary Increases & Fixed Expenses Increase,112635,38004.0,48341,86345.0,26290.0,23.34,-0.02,Medium Risk
U419,2024,11,541535.0,Salary Increases & Fixed Expenses Increase,112635,39360.0,42085,81445.0,31190.0,27.69,0.04,Low Risk
U419,2024,12,572725.0,Salary Increases & Fixed Expenses Increase,112635,39360.0,45003,84363.0,28272.0,25.1,-0.03,Low Risk
U420,2024,1,230107.0,Salary Increases & Fixed Expenses Decrease,158157,67722.0,94666,162388.0,-4231.0,-2.68,-0.04,High Risk
U420,2024,2,225876.0,Salary Increases & Fixed Expenses Decrease,158157,67722.0,93061,160783.0,-2626.0,-1.66,0.03,High Risk
U420,2024,3,223250.0,Salary Increases & Fixed Expenses Decrease,158157,67722.0,100147,167869.0,-9712.0,-6.14,0.0,High Risk
U420,2024,4,213538.0,Salary Increases & Fixed Expenses Decrease,158157,67722.0,86472,154194.0,3963.0,2.51,-0.04,High Risk
U420,2024,5,217501.0,Salary Increases & Fixed Expenses Decrease,185727,67722.0,84881,152603.0,33124.0,17.83,-0.0,Medium Risk
U420,2024,6,250625.0,Salary Increases & Fixed Expenses Decrease,185727,67722.0,98517,166239.0,19488.0,10.49,0.03,High Risk
U420,2024,7,270113.0,Salary Increases & Fixed Expenses Decrease,185727,67722.0,104976,172698.0,13029.0,7.02,-0.03,High Risk
U420,2024,8,283142.0,Salary Increases & Fixed Expenses Decrease,185727,67722.0,100130,167852.0,17875.0,9.62,-0.0,High Risk
U420,2024,9,301017.0,Salary Increases & Fixed Expenses Decrease,185727,67722.0,95307,163029.0,22698.0,12.22,-0.03,High Risk
U420,2024,10,323715.0,Salary Increases & Fixed Expenses Decrease,185727,67722.0,103921,171643.0,14084.0,7.58,0.05,High Risk
U420,2024,11,337799.0,Salary Increases & Fixed Expenses Decrease,185727,67722.0,102806,170528.0,15199.0,8.18,0.03,High Risk
U420,2024,12,352998.0,Salary Increases & Fixed Expenses Decrease,185727,67722.0,88999,156721.0,29006.0,15.62,-0.05,Medium Risk
U421,2024,1,210106.0,Stable Salary & Decreasing Fixed Expenses,268629,62467.0,159394,221861.0,46768.0,17.41,0.01,Medium Risk
U421,2024,2,256874.0,Stable Salary & Decreasing Fixed Expenses,268629,62467.0,116578,179045.0,89584.0,33.35,0.03,Low Risk
U421,2024,3,346458.0,Stable Salary & Decreasing Fixed Expenses,268629,62467.0,187560,250027.0,18602.0,6.92,0.04,High Risk
U421,2024,4,365060.0,Stable Salary & Decreasing Fixed Expenses,268629,62467.0,111726,174193.0,94436.0,35.15,0.04,Low Risk
U421,2024,5,459496.0,Stable Salary & Decreasing Fixed Expenses,268629,62467.0,150708,213175.0,55454.0,20.64,-0.0,Medium Risk
U421,2024,6,514950.0,Stable Salary & Decreasing Fixed Expenses,268629,62467.0,143887,206354.0,62275.0,23.18,0.0,Medium Risk
U421,2024,7,577225.0,Stable Salary & Decreasing Fixed Expenses,268629,62467.0,125642,188109.0,80520.0,29.97,0.05,Low Risk
U421,2024,8,657745.0,Stable Salary & Decreasing Fixed Expenses,268629,62467.0,126873,189340.0,79289.0,29.52,0.02,Low Risk
U421,2024,9,737034.0,Stable Salary & Decreasing Fixed Expenses,268629,62467.0,148780,211247.0,57382.0,21.36,-0.03,Medium Risk
U421,2024,10,794416.0,Stable Salary & Decreasing Fixed Expenses,268629,62467.0,188791,251258.0,17371.0,6.47,0.04,High Risk
U421,2024,11,811787.0,Stable Salary & Decreasing Fixed Expenses,268629,62467.0,132030,194497.0,74132.0,27.6,-0.04,Low Risk
U421,2024,12,885919.0,Stable Salary & Decreasing Fixed Expenses,268629,62467.0,153568,216035.0,52594.0,19.58,-0.03,Medium Risk
U422,2024,1,239002.0,Salary Increases & Fixed Expenses Increase,126576,74439.0,44770,119209.0,7367.0,5.82,-0.0,High Risk
U422,2024,2,246369.0,Salary Increases & Fixed Expenses Increase,126576,75520.0,48512,124032.0,2544.0,2.01,0.01,High Risk
U422,2024,3,248913.0,Salary Increases & Fixed Expenses Increase,156017,76798.0,64939,141737.0,14280.0,9.15,-0.01,High Risk
U422,2024,4,263193.0,Salary Increases & Fixed Expenses Increase,156017,76798.0,52920,129718.0,26299.0,16.86,0.01,Medium Risk
U422,2024,5,289492.0,Salary Increases & Fixed Expenses Increase,156017,76798.0,52553,129351.0,26666.0,17.09,-0.01,Medium Risk
U422,2024,6,316158.0,Salary Increases & Fixed Expenses Increase,156017,76798.0,52668,129466.0,26551.0,17.02,0.0,Medium Risk
U422,2024,7,342709.0,Salary Increases & Fixed Expenses Increase,156017,76798.0,58900,135698.0,20319.0,13.02,0.04,High Risk
U422,2024,8,363028.0,Salary Increases & Fixed Expenses Increase,156017,76798.0,61988,138786.0,17231.0,11.04,-0.01,High Risk
U422,2024,9,380259.0,Salary Increases & Fixed Expenses Increase,156017,78278.0,58294,136572.0,19445.0,12.46,0.03,High Risk
U422,2024,10,399704.0,Salary Increases & Fixed Expenses Increase,156017,78278.0,72800,151078.0,4939.0,3.17,-0.01,High Risk
U422,2024,11,404643.0,Salary Increases & Fixed Expenses Increase,156017,78278.0,56123,134401.0,21616.0,13.85,-0.03,High Risk
U422,2024,12,426259.0,Salary Increases & Fixed Expenses Increase,156017,78278.0,69101,147379.0,8638.0,5.54,0.02,High Risk
U423,2024,1,212856.0,Stable Salary & Increasing Fixed Expenses,269606,78259.0,154954,233213.0,36393.0,13.5,0.04,High Risk
U423,2024,2,249249.0,Stable Salary & Increasing Fixed Expenses,269606,78259.0,115836,194095.0,75511.0,28.01,0.04,Low Risk
U423,2024,3,324760.0,Stable Salary & Increasing Fixed Expenses,269606,78259.0,171896,250155.0,19451.0,7.21,0.04,High Risk
U423,2024,4,344211.0,Stable Salary & Increasing Fixed Expenses,269606,78259.0,134052,212311.0,57295.0,21.25,0.03,Medium Risk
U423,2024,5,401506.0,Stable Salary & Increasing Fixed Expenses,269606,78259.0,150524,228783.0,40823.0,15.14,0.0,Medium Risk
U423,2024,6,442329.0,Stable Salary & Increasing Fixed Expenses,269606,78259.0,112665,190924.0,78682.0,29.18,0.01,Low Risk
U423,2024,7,521011.0,Stable Salary & Increasing Fixed Expenses,269606,78259.0,132484,210743.0,58863.0,21.83,-0.03,Medium Risk
U423,2024,8,579874.0,Stable Salary & Increasing Fixed Expenses,269606,78259.0,114068,192327.0,77279.0,28.66,-0.04,Low Risk
U423,2024,9,657153.0,Stable Salary & Increasing Fixed Expenses,269606,78259.0,114092,192351.0,77255.0,28.65,-0.01,Low Risk
U423,2024,10,734408.0,Stable Salary & Increasing Fixed Expenses,269606,78259.0,150918,229177.0,40429.0,15.0,-0.03,High Risk
U423,2024,11,774837.0,Stable Salary & Increasing Fixed Expenses,269606,78259.0,131313,209572.0,60034.0,22.27,-0.05,Medium Risk
U423,2024,12,834871.0,Stable Salary & Increasing Fixed Expenses,269606,78259.0,143684,221943.0,47663.0,17.68,-0.03,Medium Risk
U424,2024,1,215040.0,Salary Increases & Fixed Expenses Remain Stable,278529,70978.0,147454,218432.0,60097.0,21.58,-0.02,Medium Risk
U424,2024,2,275137.0,Salary Increases & Fixed Expenses Remain Stable,278529,70978.0,148242,219220.0,59309.0,21.29,-0.03,Medium Risk
U424,2024,3,334446.0,Salary Increases & Fixed Expenses Remain Stable,278529,70978.0,153631,224609.0,53920.0,19.36,-0.01,Medium Risk
U424,2024,4,388366.0,Salary Increases & Fixed Expenses Remain Stable,278529,70978.0,118146,189124.0,89405.0,32.1,-0.05,Low Risk
U424,2024,5,477771.0,Salary Increases & Fixed Expenses Remain Stable,278529,70978.0,163520,234498.0,44031.0,15.81,0.0,Medium Risk
U424,2024,6,521802.0,Salary Increases & Fixed Expenses Remain Stable,295021,70978.0,143385,214363.0,80658.0,27.34,-0.02,Low Risk
U424,2024,7,602460.0,Salary Increases & Fixed Expenses Remain Stable,295021,70978.0,154698,225676.0,69345.0,23.51,0.05,Medium Risk
U424,2024,8,671805.0,Salary Increases & Fixed Expenses Remain Stable,295021,70978.0,161507,232485.0,62536.0,21.2,0.02,Medium Risk
U424,2024,9,734341.0,Salary Increases & Fixed Expenses Remain Stable,295021,70978.0,166253,237231.0,57790.0,19.59,-0.02,Medium Risk
U424,2024,10,792131.0,Salary Increases & Fixed Expenses Remain Stable,295021,70978.0,161628,232606.0,62415.0,21.16,0.04,Medium Risk
U424,2024,11,854546.0,Salary Increases & Fixed Expenses Remain Stable,295021,70978.0,136942,207920.0,87101.0,29.52,-0.04,Low Risk
U424,2024,12,941647.0,Salary Increases & Fixed Expenses Remain Stable,295021,70978.0,174488,245466.0,49555.0,16.8,-0.03,Medium Risk
U425,2024,1,223312.0,Salary Increases & Fixed Expenses Increase,80668,37852.0,54155,92007.0,-11339.0,-14.06,0.02,High Risk
U425,2024,2,211973.0,Salary Increases & Fixed Expenses Increase,80668,37852.0,57586,95438.0,-14770.0,-18.31,-0.02,High Risk
U425,2024,3,197203.0,Salary Increases & Fixed Expenses Increase,80668,37852.0,49031,86883.0,-6215.0,-7.7,-0.03,High Risk
U425,2024,4,190988.0,Salary Increases & Fixed Expenses Increase,80668,37852.0,60549,98401.0,-17733.0,-21.98,0.04,High Risk
U425,2024,5,173255.0,Salary Increases & Fixed Expenses Increase,80668,37852.0,62009,99861.0,-19193.0,-23.79,0.02,High Risk
U425,2024,6,154062.0,Salary Increases & Fixed Expenses Increase,80668,38671.0,58943,97614.0,-16946.0,-21.01,0.01,High Risk
U425,2024,7,137116.0,Salary Increases & Fixed Expenses Increase,101758,38671.0,68563,107234.0,-5476.0,-5.38,-0.04,High Risk
U425,2024,8,131640.0,Salary Increases & Fixed Expenses Increase,101758,38671.0,78124,116795.0,-15037.0,-14.78,-0.05,High Risk
U425,2024,9,116603.0,Salary Increases & Fixed Expenses Increase,101758,38671.0,80155,118826.0,-17068.0,-16.77,0.03,High Risk
U425,2024,10,99535.0,Salary Increases & Fixed Expenses Increase,101758,38671.0,75643,114314.0,-12556.0,-12.34,0.02,High Risk
U425,2024,11,86979.0,Salary Increases & Fixed Expenses Increase,101758,38671.0,71230,109901.0,-8143.0,-8.0,-0.05,High Risk
U425,2024,12,78836.0,Salary Increases & Fixed Expenses Increase,101758,38671.0,74441,113112.0,-11354.0,-11.16,0.04,High Risk
U426,2024,1,247634.0,Salary Increases & Fixed Expenses Increase,201435,77130.0,115298,192428.0,9007.0,4.47,-0.01,High Risk
U426,2024,2,256641.0,Salary Increases & Fixed Expenses Increase,201435,77130.0,98736,175866.0,25569.0,12.69,-0.03,High Risk
U426,2024,3,282210.0,Salary Increases & Fixed Expenses Increase,222247,78877.0,121193,200070.0,22177.0,9.98,-0.04,High Risk
U426,2024,4,304387.0,Salary Increases & Fixed Expenses Increase,222247,78877.0,122109,200986.0,21261.0,9.57,-0.02,High Risk
U426,2024,5,325648.0,Salary Increases & Fixed Expenses Increase,222247,78877.0,105041,183918.0,38329.0,17.25,-0.05,Medium Risk
U426,2024,6,363977.0,Salary Increases & Fixed Expenses Increase,222247,78877.0,106788,185665.0,36582.0,16.46,0.02,Medium Risk
U426,2024,7,400559.0,Salary Increases & Fixed Expenses Increase,222247,80379.0,130643,211022.0,11225.0,5.05,-0.04,High Risk
U426,2024,8,411784.0,Salary Increases & Fixed Expenses Increase,222247,81170.0,116441,197611.0,24636.0,11.08,-0.04,High Risk
U426,2024,9,436420.0,Salary Increases & Fixed Expenses Increase,222247,81170.0,94950,176120.0,46127.0,20.75,-0.02,Medium Risk
U426,2024,10,482547.0,Salary Increases & Fixed Expenses Increase,222247,83026.0,95206,178232.0,44015.0,19.8,-0.05,Medium Risk
U426,2024,11,526562.0,Salary Increases & Fixed Expenses Increase,222247,83026.0,90993,174019.0,48228.0,21.7,-0.02,Medium Risk
U426,2024,12,574790.0,Salary Increases & Fixed Expenses Increase,222247,84170.0,90729,174899.0,47348.0,21.3,0.02,Medium Risk
U427,2024,1,208361.0,Stable Salary & Stable Fixed Expenses,240544,72456.0,99899,172355.0,68189.0,28.35,-0.0,Low Risk
U427,2024,2,276550.0,Stable Salary & Stable Fixed Expenses,240544,72456.0,135662,208118.0,32426.0,13.48,-0.01,High Risk
U427,2024,3,308976.0,Stable Salary & Stable Fixed Expenses,240544,72456.0,96270,168726.0,71818.0,29.86,-0.05,Low Risk
U427,2024,4,380794.0,Stable Salary & Stable Fixed Expenses,240544,72456.0,142977,215433.0,25111.0,10.44,-0.01,High Risk
U427,2024,5,405905.0,Stable Salary & Stable Fixed Expenses,240544,72456.0,122909,195365.0,45179.0,18.78,0.04,Medium Risk
U427,2024,6,451084.0,Stable Salary & Stable Fixed Expenses,240544,72456.0,120796,193252.0,47292.0,19.66,-0.04,Medium Risk
U427,2024,7,498376.0,Stable Salary & Stable Fixed Expenses,240544,72456.0,97889,170345.0,70199.0,29.18,-0.0,Low Risk
U427,2024,8,568575.0,Stable Salary & Stable Fixed Expenses,240544,72456.0,138382,210838.0,29706.0,12.35,0.04,High Risk
U427,2024,9,598281.0,Stable Salary & Stable Fixed Expenses,240544,72456.0,134997,207453.0,33091.0,13.76,0.03,High Risk
U427,2024,10,631372.0,Stable Salary & Stable Fixed Expenses,240544,72456.0,132877,205333.0,35211.0,14.64,-0.01,High Risk
U427,2024,11,666583.0,Stable Salary & Stable Fixed Expenses,240544,72456.0,137877,210333.0,30211.0,12.56,0.02,High Risk
U427,2024,12,696794.0,Stable Salary & Stable Fixed Expenses,240544,72456.0,122804,195260.0,45284.0,18.83,-0.02,Medium Risk
U428,2024,1,249246.0,Salary Increases & Fixed Expenses Remain Stable,49649,16891.0,19844,36735.0,12914.0,26.01,0.01,Low Risk
U428,2024,2,262160.0,Salary Increases & Fixed Expenses Remain Stable,49649,16891.0,19760,36651.0,12998.0,26.18,0.04,Low Risk
U428,2024,3,275158.0,Salary Increases & Fixed Expenses Remain Stable,49649,16891.0,16327,33218.0,16431.0,33.09,-0.01,Low Risk
U428,2024,4,291589.0,Salary Increases & Fixed Expenses Remain Stable,49649,16891.0,17759,34650.0,14999.0,30.21,0.02,Low Risk
U428,2024,5,306588.0,Salary Increases & Fixed Expenses Remain Stable,49649,16891.0,18968,35859.0,13790.0,27.77,0.04,Low Risk
U428,2024,6,320378.0,Salary Increases & Fixed Expenses Remain Stable,49649,16891.0,19738,36629.0,13020.0,26.22,-0.01,Low Risk
U428,2024,7,333398.0,Salary Increases & Fixed Expenses Remain Stable,61981,16891.0,20960,37851.0,24130.0,38.93,-0.04,Low Risk
U428,2024,8,357528.0,Salary Increases & Fixed Expenses Remain Stable,61981,16891.0,24582,41473.0,20508.0,33.09,-0.01,Low Risk
U428,2024,9,378036.0,Salary Increases & Fixed Expenses Remain Stable,61981,16891.0,20358,37249.0,24732.0,39.9,-0.0,Low Risk
U428,2024,10,402768.0,Salary Increases & Fixed Expenses Remain Stable,61981,16891.0,20166,37057.0,24924.0,40.21,0.03,Low Risk
U428,2024,11,427692.0,Salary Increases & Fixed Expenses Remain Stable,61981,16891.0,21206,38097.0,23884.0,38.53,-0.01,Low Risk
U428,2024,12,451576.0,Salary Increases & Fixed Expenses Remain Stable,61981,16891.0,22451,39342.0,22639.0,36.53,-0.03,Low Risk
U429,2024,1,230663.0,Stable Salary & Stable Fixed Expenses,130214,79264.0,85582,164846.0,-34632.0,-26.6,0.0,High Risk
U429,2024,2,196031.0,Stable Salary & Stable Fixed Expenses,130214,79264.0,102555,181819.0,-51605.0,-39.63,0.01,High Risk
U429,2024,3,144426.0,Stable Salary & Stable Fixed Expenses,130214,79264.0,98441,177705.0,-47491.0,-36.47,0.04,High Risk
U429,2024,4,96935.0,Stable Salary & Stable Fixed Expenses,130214,79264.0,90658,169922.0,-39708.0,-30.49,-0.05,High Risk
U429,2024,5,57227.0,Stable Salary & Stable Fixed Expenses,130214,79264.0,94031,173295.0,-43081.0,-33.08,-0.01,High Risk
U429,2024,6,14146.0,Stable Salary & Stable Fixed Expenses,130214,79264.0,81314,160578.0,-30364.0,-23.32,0.03,High Risk
U429,2024,7,-16218.0,Stable Salary & Stable Fixed Expenses,130214,79264.0,100490,179754.0,-49540.0,-38.05,-0.04,High Risk
U429,2024,8,-65758.0,Stable Salary & Stable Fixed Expenses,130214,79264.0,81850,161114.0,-30900.0,-23.73,0.05,High Risk
U429,2024,9,-96658.0,Stable Salary & Stable Fixed Expenses,130214,79264.0,91540,170804.0,-40590.0,-31.17,0.04,High Risk
U429,2024,10,-137248.0,Stable Salary & Stable Fixed Expenses,130214,79264.0,78821,158085.0,-27871.0,-21.4,0.01,High Risk
U429,2024,11,-165119.0,Stable Salary & Stable Fixed Expenses,130214,79264.0,95714,174978.0,-44764.0,-34.38,0.04,High Risk
U429,2024,12,-209883.0,Stable Salary & Stable Fixed Expenses,130214,79264.0,78934,158198.0,-27984.0,-21.49,-0.02,High Risk
U430,2024,1,242640.0,Stable Salary & Increasing Fixed Expenses,29713,14502.0,15938,30440.0,-727.0,-2.45,0.05,High Risk
U430,2024,2,241913.0,Stable Salary & Increasing Fixed Expenses,29713,14502.0,14821,29323.0,390.0,1.31,0.0,High Risk
U430,2024,3,242303.0,Stable Salary & Increasing Fixed Expenses,29713,14502.0,16042,30544.0,-831.0,-2.8,0.01,High Risk
U430,2024,4,241472.0,Stable Salary & Increasing Fixed Expenses,29713,14502.0,12826,27328.0,2385.0,8.03,-0.02,High Risk
U430,2024,5,243857.0,Stable Salary & Increasing Fixed Expenses,29713,14502.0,16832,31334.0,-1621.0,-5.46,0.03,High Risk
U430,2024,6,242236.0,Stable Salary & Increasing Fixed Expenses,29713,14502.0,16646,31148.0,-1435.0,-4.83,-0.02,High Risk
U430,2024,7,240801.0,Stable Salary & Increasing Fixed Expenses,29713,14502.0,13438,27940.0,1773.0,5.97,0.04,High Risk
U430,2024,8,242574.0,Stable Salary & Increasing Fixed Expenses,29713,14502.0,17606,32108.0,-2395.0,-8.06,0.01,High Risk
U430,2024,9,240179.0,Stable Salary & Increasing Fixed Expenses,29713,14502.0,18289,32791.0,-3078.0,-10.36,-0.03,High Risk
U430,2024,10,237101.0,Stable Salary & Increasing Fixed Expenses,29713,15778.0,17869,33647.0,-3934.0,-13.24,0.03,High Risk
U430,2024,11,233167.0,Stable Salary & Increasing Fixed Expenses,29713,15778.0,14646,30424.0,-711.0,-2.39,-0.02,High Risk
U430,2024,12,232456.0,Stable Salary & Increasing Fixed Expenses,29713,15778.0,15120,30898.0,-1185.0,-3.99,0.02,High Risk
U431,2024,1,236588.0,Salary Increases & Fixed Expenses Remain Stable,231783,109072.0,113593,222665.0,9118.0,3.93,0.03,High Risk
U431,2024,2,245706.0,Salary Increases & Fixed Expenses Remain Stable,231783,109072.0,124655,233727.0,-1944.0,-0.84,-0.04,High Risk
U431,2024,3,243762.0,Salary Increases & Fixed Expenses Remain Stable,231783,109072.0,118028,227100.0,4683.0,2.02,0.02,High Risk
U431,2024,4,248445.0,Salary Increases & Fixed Expenses Remain Stable,231783,109072.0,94255,203327.0,28456.0,12.28,0.05,High Risk
U431,2024,5,276901.0,Salary Increases & Fixed Expenses Remain Stable,231783,109072.0,132937,242009.0,-10226.0,-4.41,-0.01,High Risk
U431,2024,6,266675.0,Salary Increases & Fixed Expenses Remain Stable,231783,109072.0,121572,230644.0,1139.0,0.49,-0.02,High Risk
U431,2024,7,267814.0,Salary Increases & Fixed Expenses Remain Stable,231783,109072.0,119642,228714.0,3069.0,1.32,0.0,High Risk
U431,2024,8,270883.0,Salary Increases & Fixed Expenses Remain Stable,238010,109072.0,140640,249712.0,-11702.0,-4.92,-0.05,High Risk
U431,2024,9,259181.0,Salary Increases & Fixed Expenses Remain Stable,238010,109072.0,128417,237489.0,521.0,0.22,-0.02,High Risk
U431,2024,10,259702.0,Salary Increases & Fixed Expenses Remain Stable,238010,109072.0,134310,243382.0,-5372.0,-2.26,0.03,High Risk
U431,2024,11,254330.0,Salary Increases & Fixed Expenses Remain Stable,238010,109072.0,139128,248200.0,-10190.0,-4.28,-0.01,High Risk
U431,2024,12,244140.0,Salary Increases & Fixed Expenses Remain Stable,238010,109072.0,132523,241595.0,-3585.0,-1.51,0.04,High Risk
U432,2024,1,224799.0,Stable Salary & Increasing Fixed Expenses,181763,74523.0,135375,209898.0,-28135.0,-15.48,-0.02,High Risk
U432,2024,2,196664.0,Stable Salary & Increasing Fixed Expenses,181763,74523.0,143381,217904.0,-36141.0,-19.88,-0.01,High Risk
U432,2024,3,160523.0,Stable Salary & Increasing Fixed Expenses,181763,75564.0,117008,192572.0,-10809.0,-5.95,0.03,High Risk
U432,2024,4,149714.0,Stable Salary & Increasing Fixed Expenses,181763,76340.0,121394,197734.0,-15971.0,-8.79,-0.02,High Risk
U432,2024,5,133743.0,Stable Salary & Increasing Fixed Expenses,181763,76340.0,126389,202729.0,-20966.0,-11.53,0.04,High Risk
U432,2024,6,112777.0,Stable Salary & Increasing Fixed Expenses,181763,76340.0,111117,187457.0,-5694.0,-3.13,0.05,High Risk
U432,2024,7,107083.0,Stable Salary & Increasing Fixed Expenses,181763,76340.0,126834,203174.0,-21411.0,-11.78,0.02,High Risk
U432,2024,8,85672.0,Stable Salary & Increasing Fixed Expenses,181763,76340.0,121987,198327.0,-16564.0,-9.11,-0.01,High Risk
U432,2024,9,69108.0,Stable Salary & Increasing Fixed Expenses,181763,76340.0,126870,203210.0,-21447.0,-11.8,0.02,High Risk
U432,2024,10,47661.0,Stable Salary & Increasing Fixed Expenses,181763,76340.0,132363,208703.0,-26940.0,-14.82,0.0,High Risk
U432,2024,11,20721.0,Stable Salary & Increasing Fixed Expenses,181763,76340.0,127278,203618.0,-21855.0,-12.02,-0.03,High Risk
U432,2024,12,-1134.0,Stable Salary & Increasing Fixed Expenses,181763,76340.0,116990,193330.0,-11567.0,-6.36,0.02,High Risk
U433,2024,1,242283.0,Stable Salary & Increasing Fixed Expenses,267551,100154.0,141676,241830.0,25721.0,9.61,-0.03,High Risk
U433,2024,2,268004.0,Stable Salary & Increasing Fixed Expenses,267551,100154.0,110548,210702.0,56849.0,21.25,-0.04,Medium Risk
U433,2024,3,324853.0,Stable Salary & Increasing Fixed Expenses,267551,100154.0,132579,232733.0,34818.0,13.01,-0.04,High Risk
U433,2024,4,359671.0,Stable Salary & Increasing Fixed Expenses,267551,101431.0,138809,240240.0,27311.0,10.21,0.01,High Risk
U433,2024,5,386982.0,Stable Salary & Increasing Fixed Expenses,267551,101431.0,119711,221142.0,46409.0,17.35,-0.03,Medium Risk
U433,2024,6,433391.0,Stable Salary & Increasing Fixed Expenses,267551,101431.0,122391,223822.0,43729.0,16.34,0.03,Medium Risk
U433,2024,7,477120.0,Stable Salary & Increasing Fixed Expenses,267551,101431.0,156357,257788.0,9763.0,3.65,0.0,High Risk
U433,2024,8,486883.0,Stable Salary & Increasing Fixed Expenses,267551,101431.0,132712,234143.0,33408.0,12.49,-0.01,High Risk
U433,2024,9,520291.0,Stable Salary & Increasing Fixed Expenses,267551,101431.0,109897,211328.0,56223.0,21.01,0.04,Medium Risk
U433,2024,10,576514.0,Stable Salary & Increasing Fixed Expenses,267551,101431.0,131372,232803.0,34748.0,12.99,0.0,High Risk
U433,2024,11,611262.0,Stable Salary & Increasing Fixed Expenses,267551,101431.0,142816,244247.0,23304.0,8.71,0.02,High Risk
U433,2024,12,634566.0,Stable Salary & Increasing Fixed Expenses,267551,101431.0,154825,256256.0,11295.0,4.22,-0.03,High Risk
U434,2024,1,210179.0,Stable Salary & Stable Fixed Expenses,94066,39850.0,47061,86911.0,7155.0,7.61,0.04,High Risk
U434,2024,2,217334.0,Stable Salary & Stable Fixed Expenses,94066,39850.0,50458,90308.0,3758.0,4.0,-0.03,High Risk
U434,2024,3,221092.0,Stable Salary & Stable Fixed Expenses,94066,39850.0,53773,93623.0,443.0,0.47,-0.05,High Risk
U434,2024,4,221535.0,Stable Salary & Stable Fixed Expenses,94066,39850.0,48328,88178.0,5888.0,6.26,0.05,High Risk
U434,2024,5,227423.0,Stable Salary & Stable Fixed Expenses,94066,39850.0,54828,94678.0,-612.0,-0.65,0.02,High Risk
U434,2024,6,226811.0,Stable Salary & Stable Fixed Expenses,94066,39850.0,45701,85551.0,8515.0,9.05,-0.01,High Risk
U434,2024,7,235326.0,Stable Salary & Stable Fixed Expenses,94066,39850.0,47027,86877.0,7189.0,7.64,0.02,High Risk
U434,2024,8,242515.0,Stable Salary & Stable Fixed Expenses,94066,39850.0,41913,81763.0,12303.0,13.08,0.01,High Risk
U434,2024,9,254818.0,Stable Salary & Stable Fixed Expenses,94066,39850.0,47828,87678.0,6388.0,6.79,-0.01,High Risk
U434,2024,10,261206.0,Stable Salary & Stable Fixed Expenses,94066,39850.0,46796,86646.0,7420.0,7.89,0.05,High Risk
U434,2024,11,268626.0,Stable Salary & Stable Fixed Expenses,94066,39850.0,37974,77824.0,16242.0,17.27,0.04,Medium Risk
U434,2024,12,284868.0,Stable Salary & Stable Fixed Expenses,94066,39850.0,53639,93489.0,577.0,0.61,0.03,High Risk
U435,2024,1,218239.0,Stable Salary & Stable Fixed Expenses,116771,74570.0,70762,145332.0,-28561.0,-24.46,-0.02,High Risk
U435,2024,2,189678.0,Stable Salary & Stable Fixed Expenses,116771,74570.0,92847,167417.0,-50646.0,-43.37,-0.02,High Risk
U435,2024,3,139032.0,Stable Salary & Stable Fixed Expenses,116771,74570.0,104191,178761.0,-61990.0,-53.09,0.01,High Risk
U435,2024,4,77042.0,Stable Salary & Stable Fixed Expenses,116771,74570.0,76442,151012.0,-34241.0,-29.32,0.05,High Risk
U435,2024,5,42801.0,Stable Salary & Stable Fixed Expenses,116771,74570.0,87779,162349.0,-45578.0,-39.03,0.01,High Risk
U435,2024,6,-2777.0,Stable Salary & Stable Fixed Expenses,116771,74570.0,78758,153328.0,-36557.0,-31.31,-0.01,High Risk
U435,2024,7,-39334.0,Stable Salary & Stable Fixed Expenses,116771,74570.0,71551,146121.0,-29350.0,-25.13,-0.03,High Risk
U435,2024,8,-68684.0,Stable Salary & Stable Fixed Expenses,116771,74570.0,70633,145203.0,-28432.0,-24.35,0.01,High Risk
U435,2024,9,-97116.0,Stable Salary & Stable Fixed Expenses,116771,74570.0,75492,150062.0,-33291.0,-28.51,0.05,High Risk
U435,2024,10,-130407.0,Stable Salary & Stable Fixed Expenses,116771,74570.0,109563,184133.0,-67362.0,-57.69,-0.01,High Risk
U435,2024,11,-197769.0,Stable Salary & Stable Fixed Expenses,116771,74570.0,92706,167276.0,-50505.0,-43.25,-0.02,High Risk
U435,2024,12,-248274.0,Stable Salary & Stable Fixed Expenses,116771,74570.0,103981,178551.0,-61780.0,-52.91,-0.0,High Risk
U436,2024,1,212898.0,Stable Salary & Stable Fixed Expenses,269842,110676.0,118114,228790.0,41052.0,15.21,-0.05,Medium Risk
U436,2024,2,253950.0,Stable Salary & Stable Fixed Expenses,269842,110676.0,110977,221653.0,48189.0,17.86,-0.05,Medium Risk
U436,2024,3,302139.0,Stable Salary & Stable Fixed Expenses,269842,110676.0,172049,282725.0,-12883.0,-4.77,0.04,High Risk
U436,2024,4,289256.0,Stable Salary & Stable Fixed Expenses,269842,110676.0,153383,264059.0,5783.0,2.14,-0.03,High Risk
U436,2024,5,295039.0,Stable Salary & Stable Fixed Expenses,269842,110676.0,149752,260428.0,9414.0,3.49,-0.05,High Risk
U436,2024,6,304453.0,Stable Salary & Stable Fixed Expenses,269842,110676.0,114339,225015.0,44827.0,16.61,0.0,Medium Risk
U436,2024,7,349280.0,Stable Salary & Stable Fixed Expenses,269842,110676.0,124295,234971.0,34871.0,12.92,-0.01,High Risk
U436,2024,8,384151.0,Stable Salary & Stable Fixed Expenses,269842,110676.0,161414,272090.0,-2248.0,-0.83,0.01,High Risk
U436,2024,9,381903.0,Stable Salary & Stable Fixed Expenses,269842,110676.0,143515,254191.0,15651.0,5.8,-0.01,High Risk
U436,2024,10,397554.0,Stable Salary & Stable Fixed Expenses,269842,110676.0,198871,309547.0,-39705.0,-14.71,0.05,High Risk
U436,2024,11,357849.0,Stable Salary & Stable Fixed Expenses,269842,110676.0,142291,252967.0,16875.0,6.25,-0.02,High Risk
U436,2024,12,374724.0,Stable Salary & Stable Fixed Expenses,269842,110676.0,160160,270836.0,-994.0,-0.37,0.01,High Risk
U437,2024,1,229684.0,Stable Salary & Increasing Fixed Expenses,176376,78204.0,101444,179648.0,-3272.0,-1.86,0.02,High Risk
U437,2024,2,226412.0,Stable Salary & Increasing Fixed Expenses,176376,78204.0,83182,161386.0,14990.0,8.5,-0.0,High Risk
U437,2024,3,241402.0,Stable Salary & Increasing Fixed Expenses,176376,79399.0,99613,179012.0,-2636.0,-1.49,0.0,High Risk
U437,2024,4,238766.0,Stable Salary & Increasing Fixed Expenses,176376,81195.0,100952,182147.0,-5771.0,-3.27,0.03,High Risk
U437,2024,5,232995.0,Stable Salary & Increasing Fixed Expenses,176376,81195.0,80727,161922.0,14454.0,8.19,0.04,High Risk
U437,2024,6,247449.0,Stable Salary & Increasing Fixed Expenses,176376,81195.0,71293,152488.0,23888.0,13.54,-0.01,High Risk
U437,2024,7,271337.0,Stable Salary & Increasing Fixed Expenses,176376,81195.0,81834,163029.0,13347.0,7.57,0.01,High Risk
U437,2024,8,284684.0,Stable Salary & Increasing Fixed Expenses,176376,81195.0,73968,155163.0,21213.0,12.03,0.01,High Risk
U437,2024,9,305897.0,Stable Salary & Increasing Fixed Expenses,176376,81195.0,97092,178287.0,-1911.0,-1.08,-0.04,High Risk
U437,2024,10,303986.0,Stable Salary & Increasing Fixed Expenses,176376,81195.0,98666,179861.0,-3485.0,-1.98,0.02,High Risk
U437,2024,11,300501.0,Stable Salary & Increasing Fixed Expenses,176376,82527.0,75037,157564.0,18812.0,10.67,0.03,High Risk
U437,2024,12,319313.0,Stable Salary & Increasing Fixed Expenses,176376,82527.0,81945,164472.0,11904.0,6.75,-0.04,High Risk
U438,2024,1,226436.0,Salary Increases & Fixed Expenses Remain Stable,35223,20438.0,19852,40290.0,-5067.0,-14.39,0.0,High Risk
U438,2024,2,221369.0,Salary Increases & Fixed Expenses Remain Stable,35223,20438.0,17196,37634.0,-2411.0,-6.84,-0.02,High Risk
U438,2024,3,218958.0,Salary Increases & Fixed Expenses Remain Stable,35223,20438.0,16085,36523.0,-1300.0,-3.69,0.04,High Risk
U438,2024,4,217658.0,Salary Increases & Fixed Expenses Remain Stable,35223,20438.0,19191,39629.0,-4406.0,-12.51,-0.01,High Risk
U438,2024,5,213252.0,Salary Increases & Fixed Expenses Remain Stable,61057,20438.0,31543,51981.0,9076.0,14.86,0.04,High Risk
U438,2024,6,222328.0,Salary Increases & Fixed Expenses Remain Stable,61057,20438.0,34757,55195.0,5862.0,9.6,0.03,High Risk
U438,2024,7,228190.0,Salary Increases & Fixed Expenses Remain Stable,61057,20438.0,24996,45434.0,15623.0,25.59,-0.03,Low Risk
U438,2024,8,243813.0,Salary Increases & Fixed Expenses Remain Stable,61057,20438.0,25294,45732.0,15325.0,25.1,0.02,Low Risk
U438,2024,9,259138.0,Salary Increases & Fixed Expenses Remain Stable,61057,20438.0,32260,52698.0,8359.0,13.69,-0.05,High Risk
U438,2024,10,267497.0,Salary Increases & Fixed Expenses Remain Stable,61057,20438.0,35508,55946.0,5111.0,8.37,-0.03,High Risk
U438,2024,11,272608.0,Salary Increases & Fixed Expenses Remain Stable,61057,20438.0,34049,54487.0,6570.0,10.76,-0.04,High Risk
U438,2024,12,279178.0,Salary Increases & Fixed Expenses Remain Stable,61057,20438.0,25245,45683.0,15374.0,25.18,-0.03,Low Risk
U439,2024,1,229763.0,Salary Increases & Fixed Expenses Increase,156488,67013.0,54974,121987.0,34501.0,22.05,-0.03,Medium Risk
U439,2024,2,264264.0,Salary Increases & Fixed Expenses Increase,156488,67013.0,57473,124486.0,32002.0,20.45,-0.02,Medium Risk
U439,2024,3,296266.0,Salary Increases & Fixed Expenses Increase,156488,67013.0,49903,116916.0,39572.0,25.29,-0.0,Low Risk
U439,2024,4,335838.0,Salary Increases & Fixed Expenses Increase,156488,67013.0,51638,118651.0,37837.0,24.18,-0.03,Medium Risk
U439,2024,5,373675.0,Salary Increases & Fixed Expenses Increase,180409,67013.0,58451,125464.0,54945.0,30.46,-0.01,Low Risk
U439,2024,6,428620.0,Salary Increases & Fixed Expenses Increase,180409,67013.0,68948,135961.0,44448.0,24.64,-0.0,Medium Risk
U439,2024,7,473068.0,Salary Increases & Fixed Expenses Increase,180409,67013.0,71724,138737.0,41672.0,23.1,-0.04,Medium Risk
U439,2024,8,514740.0,Salary Increases & Fixed Expenses Increase,180409,67013.0,69160,136173.0,44236.0,24.52,-0.0,Medium Risk
U439,2024,9,558976.0,Salary Increases & Fixed Expenses Increase,180409,67013.0,66621,133634.0,46775.0,25.93,0.03,Low Risk
U439,2024,10,605751.0,Salary Increases & Fixed Expenses Increase,180409,67823.0,57928,125751.0,54658.0,30.3,-0.01,Low Risk
U439,2024,11,660409.0,Salary Increases & Fixed Expenses Increase,180409,67823.0,62271,130094.0,50315.0,27.89,0.01,Low Risk
U439,2024,12,710724.0,Salary Increases & Fixed Expenses Increase,180409,67823.0,59604,127427.0,52982.0,29.37,0.04,Low Risk
U440,2024,1,231160.0,Stable Salary & Stable Fixed Expenses,126602,74139.0,40045,114184.0,12418.0,9.81,-0.01,High Risk
U440,2024,2,243578.0,Stable Salary & Stable Fixed Expenses,126602,74139.0,44546,118685.0,7917.0,6.25,-0.04,High Risk
U440,2024,3,251495.0,Stable Salary & Stable Fixed Expenses,126602,74139.0,59915,134054.0,-7452.0,-5.89,-0.0,High Risk
U440,2024,4,244043.0,Stable Salary & Stable Fixed Expenses,126602,74139.0,40841,114980.0,11622.0,9.18,0.05,High Risk
U440,2024,5,255665.0,Stable Salary & Stable Fixed Expenses,126602,74139.0,40207,114346.0,12256.0,9.68,0.01,High Risk
U440,2024,6,267921.0,Stable Salary & Stable Fixed Expenses,126602,74139.0,43767,117906.0,8696.0,6.87,0.01,High Risk
U440,2024,7,276617.0,Stable Salary & Stable Fixed Expenses,126602,74139.0,45168,119307.0,7295.0,5.76,-0.05,High Risk
U440,2024,8,283912.0,Stable Salary & Stable Fixed Expenses,126602,74139.0,40449,114588.0,12014.0,9.49,0.01,High Risk
U440,2024,9,295926.0,Stable Salary & Stable Fixed Expenses,126602,74139.0,45458,119597.0,7005.0,5.53,0.04,High Risk
U440,2024,10,302931.0,Stable Salary & Stable Fixed Expenses,126602,74139.0,46917,121056.0,5546.0,4.38,0.04,High Risk
U440,2024,11,308477.0,Stable Salary & Stable Fixed Expenses,126602,74139.0,46044,120183.0,6419.0,5.07,-0.03,High Risk
U440,2024,12,314896.0,Stable Salary & Stable Fixed Expenses,126602,74139.0,60073,134212.0,-7610.0,-6.01,0.03,High Risk
U441,2024,1,204678.0,Salary Increases & Fixed Expenses Remain Stable,35738,17757.0,27485,45242.0,-9504.0,-26.59,-0.03,High Risk
U441,2024,2,195174.0,Salary Increases & Fixed Expenses Remain Stable,35738,17757.0,22501,40258.0,-4520.0,-12.65,-0.04,High Risk
U441,2024,3,190654.0,Salary Increases & Fixed Expenses Remain Stable,35738,17757.0,28073,45830.0,-10092.0,-28.24,0.04,High Risk
U441,2024,4,180562.0,Salary Increases & Fixed Expenses Remain Stable,35738,17757.0,22621,40378.0,-4640.0,-12.98,0.04,High Risk
U441,2024,5,175922.0,Salary Increases & Fixed Expenses Remain Stable,35738,17757.0,23761,41518.0,-5780.0,-16.17,-0.01,High Risk
U441,2024,6,170142.0,Salary Increases & Fixed Expenses Remain Stable,40801,17757.0,28020,45777.0,-4976.0,-12.2,0.04,High Risk
U441,2024,7,165166.0,Salary Increases & Fixed Expenses Remain Stable,40801,17757.0,29403,47160.0,-6359.0,-15.59,-0.03,High Risk
U441,2024,8,158807.0,Salary Increases & Fixed Expenses Remain Stable,40801,17757.0,27906,45663.0,-4862.0,-11.92,0.03,High Risk
U441,2024,9,153945.0,Salary Increases & Fixed Expenses Remain Stable,40801,17757.0,33088,50845.0,-10044.0,-24.62,-0.02,High Risk
U441,2024,10,143901.0,Salary Increases & Fixed Expenses Remain Stable,40801,17757.0,29668,47425.0,-6624.0,-16.23,0.04,High Risk
U441,2024,11,137277.0,Salary Increases & Fixed Expenses Remain Stable,40801,17757.0,31514,49271.0,-8470.0,-20.76,-0.05,High Risk
U441,2024,12,128807.0,Salary Increases & Fixed Expenses Remain Stable,40801,17757.0,36309,54066.0,-13265.0,-32.51,-0.0,High Risk
U442,2024,1,230805.0,Salary Increases & Fixed Expenses Increase,121824,77324.0,70227,147551.0,-25727.0,-21.12,0.01,High Risk
U442,2024,2,205078.0,Salary Increases & Fixed Expenses Increase,121824,77324.0,52498,129822.0,-7998.0,-6.57,-0.02,High Risk
U442,2024,3,197080.0,Salary Increases & Fixed Expenses Increase,121824,77324.0,58460,135784.0,-13960.0,-11.46,0.04,High Risk
U442,2024,4,183120.0,Salary Increases & Fixed Expenses Increase,144734,77324.0,69623,146947.0,-2213.0,-1.53,0.04,High Risk
U442,2024,5,180907.0,Salary Increases & Fixed Expenses Increase,144734,77324.0,70077,147401.0,-2667.0,-1.84,0.01,High Risk
U442,2024,6,178240.0,Salary Increases & Fixed Expenses Increase,144734,78309.0,69609,147918.0,-3184.0,-2.2,0.05,High Risk
U442,2024,7,175056.0,Salary Increases & Fixed Expenses Increase,144734,79466.0,86647,166113.0,-21379.0,-14.77,-0.01,High Risk
U442,2024,8,153677.0,Salary Increases & Fixed Expenses Increase,144734,79466.0,63269,142735.0,1999.0,1.38,-0.01,High Risk
U442,2024,9,155676.0,Salary Increases & Fixed Expenses Increase,144734,79466.0,78700,158166.0,-13432.0,-9.28,0.01,High Risk
U442,2024,10,142244.0,Salary Increases & Fixed Expenses Increase,144734,79466.0,87390,166856.0,-22122.0,-15.28,0.03,High Risk
U442,2024,11,120122.0,Salary Increases & Fixed Expenses Increase,144734,79466.0,70729,150195.0,-5461.0,-3.77,-0.01,High Risk
U442,2024,12,114661.0,Salary Increases & Fixed Expenses Increase,144734,79466.0,66183,145649.0,-915.0,-0.63,-0.02,High Risk
U443,2024,1,221112.0,Salary Increases & Fixed Expenses Remain Stable,33075,11388.0,11087,22475.0,10600.0,32.05,-0.0,Low Risk
U443,2024,2,231712.0,Salary Increases & Fixed Expenses Remain Stable,33075,11388.0,11475,22863.0,10212.0,30.88,-0.04,Low Risk
U443,2024,3,241924.0,Salary Increases & Fixed Expenses Remain Stable,33075,11388.0,13164,24552.0,8523.0,25.77,0.01,Low Risk
U443,2024,4,250447.0,Salary Increases & Fixed Expenses Remain Stable,33075,11388.0,11114,22502.0,10573.0,31.97,-0.05,Low Risk
U443,2024,5,261020.0,Salary Increases & Fixed Expenses Remain Stable,33075,11388.0,12576,23964.0,9111.0,27.55,0.03,Low Risk
U443,2024,6,270131.0,Salary Increases & Fixed Expenses Remain Stable,33075,11388.0,12331,23719.0,9356.0,28.29,0.05,Low Risk
U443,2024,7,279487.0,Salary Increases & Fixed Expenses Remain Stable,48678,11388.0,18176,29564.0,19114.0,39.27,0.01,Low Risk
U443,2024,8,298601.0,Salary Increases & Fixed Expenses Remain Stable,48678,11388.0,14932,26320.0,22358.0,45.93,-0.04,Low Risk
U443,2024,9,320959.0,Salary Increases & Fixed Expenses Remain Stable,48678,11388.0,19008,30396.0,18282.0,37.56,-0.0,Low Risk
U443,2024,10,339241.0,Salary Increases & Fixed Expenses Remain Stable,48678,11388.0,17475,28863.0,19815.0,40.71,-0.03,Low Risk
U443,2024,11,359056.0,Salary Increases & Fixed Expenses Remain Stable,48678,11388.0,19380,30768.0,17910.0,36.79,-0.03,Low Risk
U443,2024,12,376966.0,Salary Increases & Fixed Expenses Remain Stable,48678,11388.0,17852,29240.0,19438.0,39.93,0.02,Low Risk
U444,2024,1,210273.0,Salary Increases & Fixed Expenses Remain Stable,185695,61544.0,115501,177045.0,8650.0,4.66,0.01,High Risk
U444,2024,2,218923.0,Salary Increases & Fixed Expenses Remain Stable,185695,61544.0,124561,186105.0,-410.0,-0.22,0.04,High Risk
U444,2024,3,218513.0,Salary Increases & Fixed Expenses Remain Stable,185695,61544.0,158962,220506.0,-34811.0,-18.75,0.03,High Risk
U444,2024,4,183702.0,Salary Increases & Fixed Expenses Remain Stable,210030,61544.0,140698,202242.0,7788.0,3.71,-0.04,High Risk
U444,2024,5,191490.0,Salary Increases & Fixed Expenses Remain Stable,210030,61544.0,139833,201377.0,8653.0,4.12,0.02,High Risk
U444,2024,6,200143.0,Salary Increases & Fixed Expenses Remain Stable,210030,61544.0,127309,188853.0,21177.0,10.08,0.01,High Risk
U444,2024,7,221320.0,Salary Increases & Fixed Expenses Remain Stable,210030,61544.0,136261,197805.0,12225.0,5.82,0.04,High Risk
U444,2024,8,233545.0,Salary Increases & Fixed Expenses Remain Stable,210030,61544.0,131411,192955.0,17075.0,8.13,0.04,High Risk
U444,2024,9,250620.0,Salary Increases & Fixed Expenses Remain Stable,210030,61544.0,160479,222023.0,-11993.0,-5.71,0.01,High Risk
U444,2024,10,238627.0,Salary Increases & Fixed Expenses Remain Stable,210030,61544.0,185374,246918.0,-36888.0,-17.56,0.04,High Risk
U444,2024,11,201739.0,Salary Increases & Fixed Expenses Remain Stable,210030,61544.0,158216,219760.0,-9730.0,-4.63,0.0,High Risk
U444,2024,12,192009.0,Salary Increases & Fixed Expenses Remain Stable,210030,61544.0,198004,259548.0,-49518.0,-23.58,-0.03,High Risk
U445,2024,1,207640.0,Salary Increases & Fixed Expenses Increase,264532,86009.0,148932,234941.0,29591.0,11.19,0.03,High Risk
U445,2024,2,237231.0,Salary Increases & Fixed Expenses Increase,264532,86009.0,122885,208894.0,55638.0,21.03,0.01,Medium Risk
U445,2024,3,292869.0,Salary Increases & Fixed Expenses Increase,264532,86009.0,185318,271327.0,-6795.0,-2.57,0.04,High Risk
U445,2024,4,286074.0,Salary Increases & Fixed Expenses Increase,264532,86009.0,115255,201264.0,63268.0,23.92,0.04,Medium Risk
U445,2024,5,349342.0,Salary Increases & Fixed Expenses Increase,285310,86538.0,153009,239547.0,45763.0,16.04,-0.01,Medium Risk
U445,2024,6,395105.0,Salary Increases & Fixed Expenses Increase,285310,86538.0,146462,233000.0,52310.0,18.33,0.0,Medium Risk
U445,2024,7,447415.0,Salary Increases & Fixed Expenses Increase,285310,87558.0,134973,222531.0,62779.0,22.0,-0.0,Medium Risk
U445,2024,8,510194.0,Salary Increases & Fixed Expenses Increase,285310,89110.0,169018,258128.0,27182.0,9.53,0.02,High Risk
U445,2024,9,537376.0,Salary Increases & Fixed Expenses Increase,285310,89110.0,145480,234590.0,50720.0,17.78,-0.05,Medium Risk
U445,2024,10,588096.0,Salary Increases & Fixed Expenses Increase,285310,89110.0,161587,250697.0,34613.0,12.13,-0.02,High Risk
U445,2024,11,622709.0,Salary Increases & Fixed Expenses Increase,285310,89110.0,143776,232886.0,52424.0,18.37,-0.0,Medium Risk
U445,2024,12,675133.0,Salary Increases & Fixed Expenses Increase,285310,89110.0,127311,216421.0,68889.0,24.15,-0.03,Medium Risk
U446,2024,1,235757.0,Stable Salary & Increasing Fixed Expenses,160018,77694.0,112234,189928.0,-29910.0,-18.69,-0.02,High Risk
U446,2024,2,205847.0,Stable Salary & Increasing Fixed Expenses,160018,79355.0,104531,183886.0,-23868.0,-14.92,-0.03,High Risk
U446,2024,3,181979.0,Stable Salary & Increasing Fixed Expenses,160018,79995.0,132289,212284.0,-52266.0,-32.66,-0.01,High Risk
U446,2024,4,129713.0,Stable Salary & Increasing Fixed Expenses,160018,79995.0,116475,196470.0,-36452.0,-22.78,-0.04,High Risk
U446,2024,5,93261.0,Stable Salary & Increasing Fixed Expenses,160018,81608.0,105719,187327.0,-27309.0,-17.07,0.04,High Risk
U446,2024,6,65952.0,Stable Salary & Increasing Fixed Expenses,160018,81608.0,105072,186680.0,-26662.0,-16.66,0.03,High Risk
U446,2024,7,39290.0,Stable Salary & Increasing Fixed Expenses,160018,81608.0,125087,206695.0,-46677.0,-29.17,-0.01,High Risk
U446,2024,8,-7387.0,Stable Salary & Increasing Fixed Expenses,160018,81608.0,109707,191315.0,-31297.0,-19.56,0.03,High Risk
U446,2024,9,-38684.0,Stable Salary & Increasing Fixed Expenses,160018,81608.0,119350,200958.0,-40940.0,-25.58,-0.05,High Risk
U446,2024,10,-79624.0,Stable Salary & Increasing Fixed Expenses,160018,81608.0,132781,214389.0,-54371.0,-33.98,0.03,High Risk
U446,2024,11,-133995.0,Stable Salary & Increasing Fixed Expenses,160018,81608.0,127683,209291.0,-49273.0,-30.79,0.01,High Risk
U446,2024,12,-183268.0,Stable Salary & Increasing Fixed Expenses,160018,81608.0,119466,201074.0,-41056.0,-25.66,0.05,High Risk
U447,2024,1,240480.0,Stable Salary & Stable Fixed Expenses,268096,64818.0,125275,190093.0,78003.0,29.1,-0.02,Low Risk
U447,2024,2,318483.0,Stable Salary & Stable Fixed Expenses,268096,64818.0,123743,188561.0,79535.0,29.67,0.04,Low Risk
U447,2024,3,398018.0,Stable Salary & Stable Fixed Expenses,268096,64818.0,132804,197622.0,70474.0,26.29,-0.03,Low Risk
U447,2024,4,468492.0,Stable Salary & Stable Fixed Expenses,268096,64818.0,142628,207446.0,60650.0,22.62,0.02,Medium Risk
U447,2024,5,529142.0,Stable Salary & Stable Fixed Expenses,268096,64818.0,143290,208108.0,59988.0,22.38,-0.01,Medium Risk
U447,2024,6,589130.0,Stable Salary & Stable Fixed Expenses,268096,64818.0,136728,201546.0,66550.0,24.82,-0.02,Medium Risk
U447,2024,7,655680.0,Stable Salary & Stable Fixed Expenses,268096,64818.0,150363,215181.0,52915.0,19.74,-0.02,Medium Risk
U447,2024,8,708595.0,Stable Salary & Stable Fixed Expenses,268096,64818.0,132049,196867.0,71229.0,26.57,0.02,Low Risk
U447,2024,9,779824.0,Stable Salary & Stable Fixed Expenses,268096,64818.0,121065,185883.0,82213.0,30.67,-0.01,Low Risk
U447,2024,10,862037.0,Stable Salary & Stable Fixed Expenses,268096,64818.0,123737,188555.0,79541.0,29.67,0.02,Low Risk
U447,2024,11,941578.0,Stable Salary & Stable Fixed Expenses,268096,64818.0,123897,188715.0,79381.0,29.61,-0.01,Low Risk
U447,2024,12,1020959.0,Stable Salary & Stable Fixed Expenses,268096,64818.0,156163,220981.0,47115.0,17.57,-0.01,Medium Risk
U448,2024,1,225310.0,Stable Salary & Increasing Fixed Expenses,52811,27071.0,40695,67766.0,-14955.0,-28.32,0.03,High Risk
U448,2024,2,210355.0,Stable Salary & Increasing Fixed Expenses,52811,27071.0,38812,65883.0,-13072.0,-24.75,-0.01,High Risk
U448,2024,3,197283.0,Stable Salary & Increasing Fixed Expenses,52811,27071.0,46808,73879.0,-21068.0,-39.89,0.01,High Risk
U448,2024,4,176215.0,Stable Salary & Increasing Fixed Expenses,52811,27071.0,34651,61722.0,-8911.0,-16.87,-0.02,High Risk
U448,2024,5,167304.0,Stable Salary & Increasing Fixed Expenses,52811,27071.0,37257,64328.0,-11517.0,-21.81,0.02,High Risk
U448,2024,6,155787.0,Stable Salary & Increasing Fixed Expenses,52811,27071.0,39560,66631.0,-13820.0,-26.17,-0.03,High Risk
U448,2024,7,141967.0,Stable Salary & Increasing Fixed Expenses,52811,27071.0,42197,69268.0,-16457.0,-31.16,-0.04,High Risk
U448,2024,8,125510.0,Stable Salary & Increasing Fixed Expenses,52811,27071.0,36183,63254.0,-10443.0,-19.77,-0.05,High Risk
U448,2024,9,115067.0,Stable Salary & Increasing Fixed Expenses,52811,27846.0,35944,63790.0,-10979.0,-20.79,-0.01,High Risk
U448,2024,10,104088.0,Stable Salary & Increasing Fixed Expenses,52811,27846.0,45883,73729.0,-20918.0,-39.61,-0.03,High Risk
U448,2024,11,83170.0,Stable Salary & Increasing Fixed Expenses,52811,27846.0,40318,68164.0,-15353.0,-29.07,-0.02,High Risk
U448,2024,12,67817.0,Stable Salary & Increasing Fixed Expenses,52811,27846.0,36248,64094.0,-11283.0,-21.36,-0.04,High Risk
U449,2024,1,224305.0,Salary Increases & Fixed Expenses Increase,99683,30237.0,51196,81433.0,18250.0,18.31,0.0,Medium Risk
U449,2024,2,242555.0,Salary Increases & Fixed Expenses Increase,99683,30237.0,46460,76697.0,22986.0,23.06,-0.03,Medium Risk
U449,2024,3,265541.0,Salary Increases & Fixed Expenses Increase,99683,30237.0,62618,92855.0,6828.0,6.85,0.04,High Risk
U449,2024,4,272369.0,Salary Increases & Fixed Expenses Increase,99683,30997.0,42107,73104.0,26579.0,26.66,-0.04,Low Risk
U449,2024,5,298948.0,Salary Increases & Fixed Expenses Increase,126608,32425.0,69658,102083.0,24525.0,19.37,-0.03,Medium Risk
U449,2024,6,323473.0,Salary Increases & Fixed Expenses Increase,126608,32425.0,58973,91398.0,35210.0,27.81,-0.01,Low Risk
U449,2024,7,358683.0,Salary Increases & Fixed Expenses Increase,126608,32425.0,64850,97275.0,29333.0,23.17,0.02,Medium Risk
U449,2024,8,388016.0,Salary Increases & Fixed Expenses Increase,126608,32425.0,64541,96966.0,29642.0,23.41,-0.05,Medium Risk
U449,2024,9,417658.0,Salary Increases & Fixed Expenses Increase,126608,32425.0,50946,83371.0,43237.0,34.15,0.02,Low Risk
U449,2024,10,460895.0,Salary Increases & Fixed Expenses Increase,126608,32425.0,81002,113427.0,13181.0,10.41,-0.01,High Risk
U449,2024,11,474076.0,Salary Increases & Fixed Expenses Increase,126608,32425.0,64773,97198.0,29410.0,23.23,0.03,Medium Risk
U449,2024,12,503486.0,Salary Increases & Fixed Expenses Increase,126608,33339.0,57088,90427.0,36181.0,28.58,0.04,Low Risk
U450,2024,1,248791.0,Salary Increases & Fixed Expenses Remain Stable,220569,77549.0,83779,161328.0,59241.0,26.86,0.01,Low Risk
U450,2024,2,308032.0,Salary Increases & Fixed Expenses Remain Stable,220569,77549.0,75608,153157.0,67412.0,30.56,0.03,Low Risk
U450,2024,3,375444.0,Salary Increases & Fixed Expenses Remain Stable,250534,77549.0,94597,172146.0,78388.0,31.29,0.01,Low Risk
U450,2024,4,453832.0,Salary Increases & Fixed Expenses Remain Stable,250534,77549.0,82001,159550.0,90984.0,36.32,-0.04,Low Risk
U450,2024,5,544816.0,Salary Increases & Fixed Expenses Remain Stable,250534,77549.0,77495,155044.0,95490.0,38.11,0.03,Low Risk
U450,2024,6,640306.0,Salary Increases & Fixed Expenses Remain Stable,250534,77549.0,79186,156735.0,93799.0,37.44,-0.02,Low Risk
U450,2024,7,734105.0,Salary Increases & Fixed Expenses Remain Stable,250534,77549.0,94509,172058.0,78476.0,31.32,0.04,Low Risk
U450,2024,8,812581.0,Salary Increases & Fixed Expenses Remain Stable,250534,77549.0,85941,163490.0,87044.0,34.74,0.0,Low Risk
U450,2024,9,899625.0,Salary Increases & Fixed Expenses Remain Stable,250534,77549.0,97240,174789.0,75745.0,30.23,-0.04,Low Risk
U450,2024,10,975370.0,Salary Increases & Fixed Expenses Remain Stable,250534,77549.0,90977,168526.0,82008.0,32.73,0.02,Low Risk
U450,2024,11,1057378.0,Salary Increases & Fixed Expenses Remain Stable,250534,77549.0,89214,166763.0,83771.0,33.44,0.01,Low Risk
U450,2024,12,1141149.0,Salary Increases & Fixed Expenses Remain Stable,250534,77549.0,113839,191388.0,59146.0,23.61,-0.03,Medium Risk
U451,2024,1,236254.0,Salary Increases & Fixed Expenses Remain Stable,286207,69249.0,151700,220949.0,65258.0,22.8,0.02,Medium Risk
U451,2024,2,301512.0,Salary Increases & Fixed Expenses Remain Stable,286207,69249.0,117447,186696.0,99511.0,34.77,-0.05,Low Risk
U451,2024,3,401023.0,Salary Increases & Fixed Expenses Remain Stable,286207,69249.0,162448,231697.0,54510.0,19.05,0.05,Medium Risk
U451,2024,4,455533.0,Salary Increases & Fixed Expenses Remain Stable,286207,69249.0,125495,194744.0,91463.0,31.96,0.03,Low Risk
U451,2024,5,546996.0,Salary Increases & Fixed Expenses Remain Stable,298040,69249.0,155630,224879.0,73161.0,24.55,-0.05,Medium Risk
U451,2024,6,620157.0,Salary Increases & Fixed Expenses Remain Stable,298040,69249.0,172631,241880.0,56160.0,18.84,-0.03,Medium Risk
U451,2024,7,676317.0,Salary Increases & Fixed Expenses Remain Stable,298040,69249.0,137804,207053.0,90987.0,30.53,0.05,Low Risk
U451,2024,8,767304.0,Salary Increases & Fixed Expenses Remain Stable,298040,69249.0,155028,224277.0,73763.0,24.75,0.03,Medium Risk
U451,2024,9,841067.0,Salary Increases & Fixed Expenses Remain Stable,298040,69249.0,147577,216826.0,81214.0,27.25,0.04,Low Risk
U451,2024,10,922281.0,Salary Increases & Fixed Expenses Remain Stable,298040,69249.0,141307,210556.0,87484.0,29.35,0.04,Low Risk
U451,2024,11,1009765.0,Salary Increases & Fixed Expenses Remain Stable,298040,69249.0,176355,245604.0,52436.0,17.59,0.03,Medium Risk
U451,2024,12,1062201.0,Salary Increases & Fixed Expenses Remain Stable,298040,69249.0,140617,209866.0,88174.0,29.58,0.04,Low Risk
U452,2024,1,234147.0,Salary Increases & Fixed Expenses Increase,96846,35747.0,39335,75082.0,21764.0,22.47,0.04,Medium Risk
U452,2024,2,255911.0,Salary Increases & Fixed Expenses Increase,96846,35747.0,38889,74636.0,22210.0,22.93,0.01,Medium Risk
U452,2024,3,278121.0,Salary Increases & Fixed Expenses Increase,96846,35747.0,53571,89318.0,7528.0,7.77,0.05,High Risk
U452,2024,4,285649.0,Salary Increases & Fixed Expenses Increase,96846,35747.0,54278,90025.0,6821.0,7.04,0.04,High Risk
U452,2024,5,292470.0,Salary Increases & Fixed Expenses Increase,112086,35747.0,49953,85700.0,26386.0,23.54,0.04,Medium Risk
U452,2024,6,318856.0,Salary Increases & Fixed Expenses Increase,112086,35747.0,47623,83370.0,28716.0,25.62,0.04,Low Risk
U452,2024,7,347572.0,Salary Increases & Fixed Expenses Increase,112086,36269.0,64415,100684.0,11402.0,10.17,-0.02,High Risk
U452,2024,8,358974.0,Salary Increases & Fixed Expenses Increase,112086,36269.0,64918,101187.0,10899.0,9.72,0.05,High Risk
U452,2024,9,369873.0,Salary Increases & Fixed Expenses Increase,112086,36269.0,49091,85360.0,26726.0,23.84,-0.01,Medium Risk
U452,2024,10,396599.0,Salary Increases & Fixed Expenses Increase,112086,36269.0,65307,101576.0,10510.0,9.38,-0.01,High Risk
U452,2024,11,407109.0,Salary Increases & Fixed Expenses Increase,112086,36269.0,58076,94345.0,17741.0,15.83,-0.02,Medium Risk
U452,2024,12,424850.0,Salary Increases & Fixed Expenses Increase,112086,36269.0,56947,93216.0,18870.0,16.84,-0.04,Medium Risk
U453,2024,1,217756.0,Salary Increases & Fixed Expenses Remain Stable,108663,73904.0,59218,133122.0,-24459.0,-22.51,0.01,High Risk
U453,2024,2,193297.0,Salary Increases & Fixed Expenses Remain Stable,108663,73904.0,54745,128649.0,-19986.0,-18.39,0.01,High Risk
U453,2024,3,173311.0,Salary Increases & Fixed Expenses Remain Stable,108663,73904.0,60509,134413.0,-25750.0,-23.7,0.03,High Risk
U453,2024,4,147561.0,Salary Increases & Fixed Expenses Remain Stable,108663,73904.0,44892,118796.0,-10133.0,-9.33,0.02,High Risk
U453,2024,5,137428.0,Salary Increases & Fixed Expenses Remain Stable,108663,73904.0,59854,133758.0,-25095.0,-23.09,0.03,High Risk
U453,2024,6,112333.0,Salary Increases & Fixed Expenses Remain Stable,108663,73904.0,62548,136452.0,-27789.0,-25.57,-0.01,High Risk
U453,2024,7,84544.0,Salary Increases & Fixed Expenses Remain Stable,134039,73904.0,64890,138794.0,-4755.0,-3.55,-0.05,High Risk
U453,2024,8,79789.0,Salary Increases & Fixed Expenses Remain Stable,134039,73904.0,65131,139035.0,-4996.0,-3.73,-0.0,High Risk
U453,2024,9,74793.0,Salary Increases & Fixed Expenses Remain Stable,134039,73904.0,76426,150330.0,-16291.0,-12.15,-0.01,High Risk
U453,2024,10,58502.0,Salary Increases & Fixed Expenses Remain Stable,134039,73904.0,79571,153475.0,-19436.0,-14.5,0.05,High Risk
U453,2024,11,39066.0,Salary Increases & Fixed Expenses Remain Stable,134039,73904.0,66331,140235.0,-6196.0,-4.62,-0.0,High Risk
U453,2024,12,32870.0,Salary Increases & Fixed Expenses Remain Stable,134039,73904.0,78576,152480.0,-18441.0,-13.76,0.03,High Risk
U454,2024,1,221817.0,Salary Increases & Fixed Expenses Remain Stable,284848,87812.0,88753,176565.0,108283.0,38.01,-0.04,Low Risk
U454,2024,2,330100.0,Salary Increases & Fixed Expenses Remain Stable,284848,87812.0,103741,191553.0,93295.0,32.75,-0.02,Low Risk
U454,2024,3,423395.0,Salary Increases & Fixed Expenses Remain Stable,284848,87812.0,131508,219320.0,65528.0,23.0,0.05,Medium Risk
U454,2024,4,488923.0,Salary Increases & Fixed Expenses Remain Stable,295617,87812.0,95611,183423.0,112194.0,37.95,0.02,Low Risk
U454,2024,5,601117.0,Salary Increases & Fixed Expenses Remain Stable,295617,87812.0,89940,177752.0,117865.0,39.87,0.02,Low Risk
U454,2024,6,718982.0,Salary Increases & Fixed Expenses Remain Stable,295617,87812.0,115219,203031.0,92586.0,31.32,-0.02,Low Risk
U454,2024,7,811568.0,Salary Increases & Fixed Expenses Remain Stable,295617,87812.0,96231,184043.0,111574.0,37.74,-0.05,Low Risk
U454,2024,8,923142.0,Salary Increases & Fixed Expenses Remain Stable,295617,87812.0,114702,202514.0,93103.0,31.49,-0.04,Low Risk
U454,2024,9,1016245.0,Salary Increases & Fixed Expenses Remain Stable,295617,87812.0,100198,188010.0,107607.0,36.4,-0.05,Low Risk
U454,2024,10,1123852.0,Salary Increases & Fixed Expenses Remain Stable,295617,87812.0,122169,209981.0,85636.0,28.97,-0.02,Low Risk
U454,2024,11,1209488.0,Salary Increases & Fixed Expenses Remain Stable,295617,87812.0,103249,191061.0,104556.0,35.37,-0.05,Low Risk
U454,2024,12,1314044.0,Salary Increases & Fixed Expenses Remain Stable,295617,87812.0,139913,227725.0,67892.0,22.97,-0.01,Medium Risk
U455,2024,1,249510.0,Stable Salary & Stable Fixed Expenses,74171,27265.0,48564,75829.0,-1658.0,-2.24,-0.02,High Risk
U455,2024,2,247852.0,Stable Salary & Stable Fixed Expenses,74171,27265.0,57069,84334.0,-10163.0,-13.7,0.03,High Risk
U455,2024,3,237689.0,Stable Salary & Stable Fixed Expenses,74171,27265.0,71609,98874.0,-24703.0,-33.31,0.01,High Risk
U455,2024,4,212986.0,Stable Salary & Stable Fixed Expenses,74171,27265.0,47451,74716.0,-545.0,-0.73,0.02,High Risk
U455,2024,5,212441.0,Stable Salary & Stable Fixed Expenses,74171,27265.0,46249,73514.0,657.0,0.89,0.02,High Risk
U455,2024,6,213098.0,Stable Salary & Stable Fixed Expenses,74171,27265.0,55961,83226.0,-9055.0,-12.21,0.01,High Risk
U455,2024,7,204043.0,Stable Salary & Stable Fixed Expenses,74171,27265.0,48146,75411.0,-1240.0,-1.67,0.03,High Risk
U455,2024,8,202803.0,Stable Salary & Stable Fixed Expenses,74171,27265.0,56930,84195.0,-10024.0,-13.51,0.05,High Risk
U455,2024,9,192779.0,Stable Salary & Stable Fixed Expenses,74171,27265.0,45642,72907.0,1264.0,1.7,-0.04,High Risk
U455,2024,10,194043.0,Stable Salary & Stable Fixed Expenses,74171,27265.0,64987,92252.0,-18081.0,-24.38,-0.04,High Risk
U455,2024,11,175962.0,Stable Salary & Stable Fixed Expenses,74171,27265.0,56772,84037.0,-9866.0,-13.3,0.02,High Risk
U455,2024,12,166096.0,Stable Salary & Stable Fixed Expenses,74171,27265.0,45365,72630.0,1541.0,2.08,0.03,High Risk
U456,2024,1,216492.0,Salary Increases & Fixed Expenses Remain Stable,150791,47313.0,52620,99933.0,50858.0,33.73,-0.05,Low Risk
U456,2024,2,267350.0,Salary Increases & Fixed Expenses Remain Stable,150791,47313.0,51760,99073.0,51718.0,34.3,-0.02,Low Risk
U456,2024,3,319068.0,Salary Increases & Fixed Expenses Remain Stable,161288,47313.0,65894,113207.0,48081.0,29.81,-0.04,Low Risk
U456,2024,4,367149.0,Salary Increases & Fixed Expenses Remain Stable,161288,47313.0,55468,102781.0,58507.0,36.27,-0.05,Low Risk
U456,2024,5,425656.0,Salary Increases & Fixed Expenses Remain Stable,161288,47313.0,49765,97078.0,64210.0,39.81,0.0,Low Risk
U456,2024,6,489866.0,Salary Increases & Fixed Expenses Remain Stable,161288,47313.0,63263,110576.0,50712.0,31.44,0.0,Low Risk
U456,2024,7,540578.0,Salary Increases & Fixed Expenses Remain Stable,161288,47313.0,54235,101548.0,59740.0,37.04,0.04,Low Risk
U456,2024,8,600318.0,Salary Increases & Fixed Expenses Remain Stable,161288,47313.0,56875,104188.0,57100.0,35.4,-0.04,Low Risk
U456,2024,9,657418.0,Salary Increases & Fixed Expenses Remain Stable,161288,47313.0,55715,103028.0,58260.0,36.12,-0.01,Low Risk
U456,2024,10,715678.0,Salary Increases & Fixed Expenses Remain Stable,161288,47313.0,65435,112748.0,48540.0,30.1,0.05,Low Risk
U456,2024,11,764218.0,Salary Increases & Fixed Expenses Remain Stable,161288,47313.0,63310,110623.0,50665.0,31.41,-0.03,Low Risk
U456,2024,12,814883.0,Salary Increases & Fixed Expenses Remain Stable,161288,47313.0,59686,106999.0,54289.0,33.66,-0.05,Low Risk
U457,2024,1,227899.0,Salary Increases & Fixed Expenses Increase,81067,37014.0,35075,72089.0,8978.0,11.07,0.04,High Risk
U457,2024,2,236877.0,Salary Increases & Fixed Expenses Increase,81067,37014.0,41403,78417.0,2650.0,3.27,-0.01,High Risk
U457,2024,3,239527.0,Salary Increases & Fixed Expenses Increase,88729,37014.0,63626,100640.0,-11911.0,-13.42,0.05,High Risk
U457,2024,4,227616.0,Salary Increases & Fixed Expenses Increase,88729,37014.0,40501,77515.0,11214.0,12.64,0.02,High Risk
U457,2024,5,238830.0,Salary Increases & Fixed Expenses Increase,88729,37014.0,42526,79540.0,9189.0,10.36,0.04,High Risk
U457,2024,6,248019.0,Salary Increases & Fixed Expenses Increase,88729,37014.0,52076,89090.0,-361.0,-0.41,-0.02,High Risk
U457,2024,7,247658.0,Salary Increases & Fixed Expenses Increase,88729,38675.0,52588,91263.0,-2534.0,-2.86,0.01,High Risk
U457,2024,8,245124.0,Salary Increases & Fixed Expenses Increase,88729,38675.0,40592,79267.0,9462.0,10.66,0.05,High Risk
U457,2024,9,254586.0,Salary Increases & Fixed Expenses Increase,88729,38675.0,52508,91183.0,-2454.0,-2.77,0.02,High Risk
U457,2024,10,252132.0,Salary Increases & Fixed Expenses Increase,88729,38675.0,42257,80932.0,7797.0,8.79,-0.05,High Risk
U457,2024,11,259929.0,Salary Increases & Fixed Expenses Increase,88729,38675.0,44325,83000.0,5729.0,6.46,0.0,High Risk
U457,2024,12,265658.0,Salary Increases & Fixed Expenses Increase,88729,38675.0,45141,83816.0,4913.0,5.54,-0.03,High Risk
U458,2024,1,248391.0,Salary Increases & Fixed Expenses Increase,40250,18146.0,23436,41582.0,-1332.0,-3.31,0.03,High Risk
U458,2024,2,247059.0,Salary Increases & Fixed Expenses Increase,40250,18146.0,19773,37919.0,2331.0,5.79,-0.02,High Risk
U458,2024,3,249390.0,Salary Increases & Fixed Expenses Increase,40250,18146.0,23622,41768.0,-1518.0,-3.77,-0.02,High Risk
U458,2024,4,247872.0,Salary Increases & Fixed Expenses Increase,40250,18146.0,18197,36343.0,3907.0,9.71,0.04,High Risk
U458,2024,5,251779.0,Salary Increases & Fixed Expenses Increase,59593,18146.0,29712,47858.0,11735.0,19.69,0.02,Medium Risk
U458,2024,6,263514.0,Salary Increases & Fixed Expenses Increase,59593,18146.0,27116,45262.0,14331.0,24.05,-0.0,Medium Risk
U458,2024,7,277845.0,Salary Increases & Fixed Expenses Increase,59593,18146.0,27062,45208.0,14385.0,24.14,0.05,Medium Risk
U458,2024,8,292230.0,Salary Increases & Fixed Expenses Increase,59593,18146.0,31659,49805.0,9788.0,16.42,0.05,Medium Risk
U458,2024,9,302018.0,Salary Increases & Fixed Expenses Increase,59593,18146.0,28577,46723.0,12870.0,21.6,-0.01,Medium Risk
U458,2024,10,314888.0,Salary Increases & Fixed Expenses Increase,59593,19048.0,35267,54315.0,5278.0,8.86,-0.03,High Risk
U458,2024,11,320166.0,Salary Increases & Fixed Expenses Increase,59593,19048.0,36106,55154.0,4439.0,7.45,0.0,High Risk
U458,2024,12,324605.0,Salary Increases & Fixed Expenses Increase,59593,19048.0,35404,54452.0,5141.0,8.63,-0.05,High Risk
U459,2024,1,209926.0,Stable Salary & Increasing Fixed Expenses,211391,108465.0,102134,210599.0,792.0,0.37,0.02,High Risk
U459,2024,2,210718.0,Stable Salary & Increasing Fixed Expenses,211391,108465.0,97435,205900.0,5491.0,2.6,0.01,High Risk
U459,2024,3,216209.0,Stable Salary & Increasing Fixed Expenses,211391,108465.0,116533,224998.0,-13607.0,-6.44,-0.02,High Risk
U459,2024,4,202602.0,Stable Salary & Increasing Fixed Expenses,211391,108465.0,96254,204719.0,6672.0,3.16,-0.04,High Risk
U459,2024,5,209274.0,Stable Salary & Increasing Fixed Expenses,211391,108465.0,112062,220527.0,-9136.0,-4.32,0.02,High Risk
U459,2024,6,200138.0,Stable Salary & Increasing Fixed Expenses,211391,108465.0,106647,215112.0,-3721.0,-1.76,0.04,High Risk
U459,2024,7,196417.0,Stable Salary & Increasing Fixed Expenses,211391,109112.0,115253,224365.0,-12974.0,-6.14,-0.01,High Risk
U459,2024,8,183443.0,Stable Salary & Increasing Fixed Expenses,211391,109112.0,114695,223807.0,-12416.0,-5.87,-0.02,High Risk
U459,2024,9,171027.0,Stable Salary & Increasing Fixed Expenses,211391,109112.0,103265,212377.0,-986.0,-0.47,0.03,High Risk
U459,2024,10,170041.0,Stable Salary & Increasing Fixed Expenses,211391,111061.0,95976,207037.0,4354.0,2.06,0.0,High Risk
U459,2024,11,174395.0,Stable Salary & Increasing Fixed Expenses,211391,111061.0,117595,228656.0,-17265.0,-8.17,-0.01,High Risk
U459,2024,12,157130.0,Stable Salary & Increasing Fixed Expenses,211391,111061.0,144821,255882.0,-44491.0,-21.05,0.02,High Risk
U460,2024,1,235969.0,Stable Salary & Stable Fixed Expenses,182578,67045.0,138917,205962.0,-23384.0,-12.81,-0.03,High Risk
U460,2024,2,212585.0,Stable Salary & Stable Fixed Expenses,182578,67045.0,138937,205982.0,-23404.0,-12.82,0.0,High Risk
U460,2024,3,189181.0,Stable Salary & Stable Fixed Expenses,182578,67045.0,148032,215077.0,-32499.0,-17.8,-0.02,High Risk
U460,2024,4,156682.0,Stable Salary & Stable Fixed Expenses,182578,67045.0,121882,188927.0,-6349.0,-3.48,0.0,High Risk
U460,2024,5,150333.0,Stable Salary & Stable Fixed Expenses,182578,67045.0,137140,204185.0,-21607.0,-11.83,-0.05,High Risk
U460,2024,6,128726.0,Stable Salary & Stable Fixed Expenses,182578,67045.0,110197,177242.0,5336.0,2.92,-0.02,High Risk
U460,2024,7,134062.0,Stable Salary & Stable Fixed Expenses,182578,67045.0,125218,192263.0,-9685.0,-5.3,0.01,High Risk
U460,2024,8,124377.0,Stable Salary & Stable Fixed Expenses,182578,67045.0,143950,210995.0,-28417.0,-15.56,-0.05,High Risk
U460,2024,9,95960.0,Stable Salary & Stable Fixed Expenses,182578,67045.0,154164,221209.0,-38631.0,-21.16,-0.01,High Risk
U460,2024,10,57329.0,Stable Salary & Stable Fixed Expenses,182578,67045.0,146675,213720.0,-31142.0,-17.06,-0.04,High Risk
U460,2024,11,26187.0,Stable Salary & Stable Fixed Expenses,182578,67045.0,149631,216676.0,-34098.0,-18.68,0.01,High Risk
U460,2024,12,-7911.0,Stable Salary & Stable Fixed Expenses,182578,67045.0,180828,247873.0,-65295.0,-35.76,0.05,High Risk
U461,2024,1,235118.0,Stable Salary & Stable Fixed Expenses,213698,60072.0,93278,153350.0,60348.0,28.24,-0.03,Low Risk
U461,2024,2,295466.0,Stable Salary & Stable Fixed Expenses,213698,60072.0,97475,157547.0,56151.0,26.28,-0.03,Low Risk
U461,2024,3,351617.0,Stable Salary & Stable Fixed Expenses,213698,60072.0,151401,211473.0,2225.0,1.04,-0.0,High Risk
U461,2024,4,353842.0,Stable Salary & Stable Fixed Expenses,213698,60072.0,111010,171082.0,42616.0,19.94,0.04,Medium Risk
U461,2024,5,396458.0,Stable Salary & Stable Fixed Expenses,213698,60072.0,99551,159623.0,54075.0,25.3,-0.01,Low Risk
U461,2024,6,450533.0,Stable Salary & Stable Fixed Expenses,213698,60072.0,95124,155196.0,58502.0,27.38,0.02,Low Risk
U461,2024,7,509035.0,Stable Salary & Stable Fixed Expenses,213698,60072.0,100870,160942.0,52756.0,24.69,0.03,Medium Risk
U461,2024,8,561791.0,Stable Salary & Stable Fixed Expenses,213698,60072.0,106538,166610.0,47088.0,22.03,-0.04,Medium Risk
U461,2024,9,608879.0,Stable Salary & Stable Fixed Expenses,213698,60072.0,98321,158393.0,55305.0,25.88,-0.01,Low Risk
U461,2024,10,664184.0,Stable Salary & Stable Fixed Expenses,213698,60072.0,105841,165913.0,47785.0,22.36,-0.01,Medium Risk
U461,2024,11,711969.0,Stable Salary & Stable Fixed Expenses,213698,60072.0,105139,165211.0,48487.0,22.69,-0.0,Medium Risk
U461,2024,12,760456.0,Stable Salary & Stable Fixed Expenses,213698,60072.0,100022,160094.0,53604.0,25.08,-0.0,Low Risk
U462,2024,1,249589.0,Stable Salary & Stable Fixed Expenses,80433,38249.0,24280,62529.0,17904.0,22.26,0.0,Medium Risk
U462,2024,2,267493.0,Stable Salary & Stable Fixed Expenses,80433,38249.0,31280,69529.0,10904.0,13.56,0.02,High Risk
U462,2024,3,278397.0,Stable Salary & Stable Fixed Expenses,80433,38249.0,36421,74670.0,5763.0,7.16,0.04,High Risk
U462,2024,4,284160.0,Stable Salary & Stable Fixed Expenses,80433,38249.0,28375,66624.0,13809.0,17.17,0.01,Medium Risk
U462,2024,5,297969.0,Stable Salary & Stable Fixed Expenses,80433,38249.0,30537,68786.0,11647.0,14.48,0.0,High Risk
U462,2024,6,309616.0,Stable Salary & Stable Fixed Expenses,80433,38249.0,29489,67738.0,12695.0,15.78,-0.04,Medium Risk
U462,2024,7,322311.0,Stable Salary & Stable Fixed Expenses,80433,38249.0,27705,65954.0,14479.0,18.0,0.0,Medium Risk
U462,2024,8,336790.0,Stable Salary & Stable Fixed Expenses,80433,38249.0,27544,65793.0,14640.0,18.2,-0.01,Medium Risk
U462,2024,9,351430.0,Stable Salary & Stable Fixed Expenses,80433,38249.0,26045,64294.0,16139.0,20.07,0.01,Medium Risk
U462,2024,10,367569.0,Stable Salary & Stable Fixed Expenses,80433,38249.0,29166,67415.0,13018.0,16.18,0.03,Medium Risk
U462,2024,11,380587.0,Stable Salary & Stable Fixed Expenses,80433,38249.0,27841,66090.0,14343.0,17.83,-0.01,Medium Risk
U462,2024,12,394930.0,Stable Salary & Stable Fixed Expenses,80433,38249.0,24680,62929.0,17504.0,21.76,0.01,Medium Risk
U463,2024,1,205192.0,Salary Increases & Fixed Expenses Remain Stable,120439,43078.0,42193,85271.0,35168.0,29.2,-0.02,Low Risk
U463,2024,2,240360.0,Salary Increases & Fixed Expenses Remain Stable,120439,43078.0,46235,89313.0,31126.0,25.84,0.03,Low Risk
U463,2024,3,271486.0,Salary Increases & Fixed Expenses Remain Stable,120439,43078.0,45038,88116.0,32323.0,26.84,-0.03,Low Risk
U463,2024,4,303809.0,Salary Increases & Fixed Expenses Remain Stable,120439,43078.0,42382,85460.0,34979.0,29.04,0.02,Low Risk
U463,2024,5,338788.0,Salary Increases & Fixed Expenses Remain Stable,120439,43078.0,47305,90383.0,30056.0,24.96,-0.02,Medium Risk
U463,2024,6,368844.0,Salary Increases & Fixed Expenses Remain Stable,120439,43078.0,42022,85100.0,35339.0,29.34,0.02,Low Risk
U463,2024,7,404183.0,Salary Increases & Fixed Expenses Remain Stable,132214,43078.0,48400,91478.0,40736.0,30.81,0.05,Low Risk
U463,2024,8,444919.0,Salary Increases & Fixed Expenses Remain Stable,132214,43078.0,46806,89884.0,42330.0,32.02,-0.02,Low Risk
U463,2024,9,487249.0,Salary Increases & Fixed Expenses Remain Stable,132214,43078.0,44082,87160.0,45054.0,34.08,-0.03,Low Risk
U463,2024,10,532303.0,Salary Increases & Fixed Expenses Remain Stable,132214,43078.0,41928,85006.0,47208.0,35.71,-0.01,Low Risk
U463,2024,11,579511.0,Salary Increases & Fixed Expenses Remain Stable,132214,43078.0,42338,85416.0,46798.0,35.4,-0.03,Low Risk
U463,2024,12,626309.0,Salary Increases & Fixed Expenses Remain Stable,132214,43078.0,40772,83850.0,48364.0,36.58,-0.01,Low Risk
U464,2024,1,236454.0,Salary Increases & Fixed Expenses Increase,160869,70106.0,106317,176423.0,-15554.0,-9.67,0.01,High Risk
U464,2024,2,220900.0,Salary Increases & Fixed Expenses Increase,160869,70106.0,111464,181570.0,-20701.0,-12.87,-0.03,High Risk
U464,2024,3,200199.0,Salary Increases & Fixed Expenses Increase,160869,71632.0,125719,197351.0,-36482.0,-22.68,0.03,High Risk
U464,2024,4,163717.0,Salary Increases & Fixed Expenses Increase,160869,71632.0,97720,169352.0,-8483.0,-5.27,-0.05,High Risk
U464,2024,5,155234.0,Salary Increases & Fixed Expenses Increase,160869,71632.0,96728,168360.0,-7491.0,-4.66,0.03,High Risk
U464,2024,6,147743.0,Salary Increases & Fixed Expenses Increase,160869,72819.0,97343,170162.0,-9293.0,-5.78,0.04,High Risk
U464,2024,7,138450.0,Salary Increases & Fixed Expenses Increase,174339,72819.0,116942,189761.0,-15422.0,-8.85,-0.04,High Risk
U464,2024,8,123028.0,Salary Increases & Fixed Expenses Increase,174339,74255.0,137639,211894.0,-37555.0,-21.54,0.02,High Risk
U464,2024,9,85473.0,Salary Increases & Fixed Expenses Increase,174339,74255.0,126546,200801.0,-26462.0,-15.18,0.02,High Risk
U464,2024,10,59011.0,Salary Increases & Fixed Expenses Increase,174339,74255.0,151554,225809.0,-51470.0,-29.52,0.04,High Risk
U464,2024,11,7541.0,Salary Increases & Fixed Expenses Increase,174339,75179.0,116264,191443.0,-17104.0,-9.81,0.01,High Risk
U464,2024,12,-9563.0,Salary Increases & Fixed Expenses Increase,174339,75179.0,129708,204887.0,-30548.0,-17.52,0.03,High Risk
U465,2024,1,226620.0,Stable Salary & Decreasing Fixed Expenses,298281,88434.0,153125,241559.0,56722.0,19.02,-0.02,Medium Risk
U465,2024,2,283342.0,Stable Salary & Decreasing Fixed Expenses,298281,88434.0,123463,211897.0,86384.0,28.96,0.02,Low Risk
U465,2024,3,369726.0,Stable Salary & Decreasing Fixed Expenses,298281,88434.0,191438,279872.0,18409.0,6.17,-0.03,High Risk
U465,2024,4,388135.0,Stable Salary & Decreasing Fixed Expenses,298281,88434.0,133957,222391.0,75890.0,25.44,-0.03,Low Risk
U465,2024,5,464025.0,Stable Salary & Decreasing Fixed Expenses,298281,88434.0,147290,235724.0,62557.0,20.97,-0.04,Medium Risk
U465,2024,6,526582.0,Stable Salary & Decreasing Fixed Expenses,298281,88434.0,127917,216351.0,81930.0,27.47,-0.03,Low Risk
U465,2024,7,608512.0,Stable Salary & Decreasing Fixed Expenses,298281,88434.0,178280,266714.0,31567.0,10.58,-0.03,High Risk
U465,2024,8,640079.0,Stable Salary & Decreasing Fixed Expenses,298281,88434.0,160214,248648.0,49633.0,16.64,-0.02,Medium Risk
U465,2024,9,689712.0,Stable Salary & Decreasing Fixed Expenses,298281,88434.0,167279,255713.0,42568.0,14.27,-0.02,High Risk
U465,2024,10,732280.0,Stable Salary & Decreasing Fixed Expenses,298281,88434.0,194765,283199.0,15082.0,5.06,0.05,High Risk
U465,2024,11,747362.0,Stable Salary & Decreasing Fixed Expenses,298281,88434.0,162188,250622.0,47659.0,15.98,-0.04,Medium Risk
U465,2024,12,795021.0,Stable Salary & Decreasing Fixed Expenses,298281,88434.0,171124,259558.0,38723.0,12.98,0.03,High Risk
U466,2024,1,238666.0,Stable Salary & Stable Fixed Expenses,200845,108848.0,79254,188102.0,12743.0,6.34,-0.01,High Risk
U466,2024,2,251409.0,Stable Salary & Stable Fixed Expenses,200845,108848.0,79153,188001.0,12844.0,6.39,0.04,High Risk
U466,2024,3,264253.0,Stable Salary & Stable Fixed Expenses,200845,108848.0,87813,196661.0,4184.0,2.08,0.01,High Risk
U466,2024,4,268437.0,Stable Salary & Stable Fixed Expenses,200845,108848.0,70992,179840.0,21005.0,10.46,-0.01,High Risk
U466,2024,5,289442.0,Stable Salary & Stable Fixed Expenses,200845,108848.0,72172,181020.0,19825.0,9.87,0.01,High Risk
U466,2024,6,309267.0,Stable Salary & Stable Fixed Expenses,200845,108848.0,71798,180646.0,20199.0,10.06,0.05,High Risk
U466,2024,7,329466.0,Stable Salary & Stable Fixed Expenses,200845,108848.0,67049,175897.0,24948.0,12.42,-0.03,High Risk
U466,2024,8,354414.0,Stable Salary & Stable Fixed Expenses,200845,108848.0,79927,188775.0,12070.0,6.01,0.04,High Risk
U466,2024,9,366484.0,Stable Salary & Stable Fixed Expenses,200845,108848.0,69338,178186.0,22659.0,11.28,0.02,High Risk
U466,2024,10,389143.0,Stable Salary & Stable Fixed Expenses,200845,108848.0,82564,191412.0,9433.0,4.7,0.02,High Risk
U466,2024,11,398576.0,Stable Salary & Stable Fixed Expenses,200845,108848.0,62840,171688.0,29157.0,14.52,0.04,High Risk
U466,2024,12,427733.0,Stable Salary & Stable Fixed Expenses,200845,108848.0,75491,184339.0,16506.0,8.22,0.03,High Risk
U467,2024,1,206143.0,Salary Increases & Fixed Expenses Decrease,198586,64218.0,132573,196791.0,1795.0,0.9,0.01,High Risk
U467,2024,2,207938.0,Salary Increases & Fixed Expenses Decrease,198586,64218.0,136915,201133.0,-2547.0,-1.28,-0.02,High Risk
U467,2024,3,205391.0,Salary Increases & Fixed Expenses Decrease,198586,64218.0,180714,244932.0,-46346.0,-23.34,0.02,High Risk
U467,2024,4,159045.0,Salary Increases & Fixed Expenses Decrease,198586,64218.0,144494,208712.0,-10126.0,-5.1,-0.04,High Risk
U467,2024,5,148919.0,Salary Increases & Fixed Expenses Decrease,198586,64218.0,155562,219780.0,-21194.0,-10.67,0.02,High Risk
U467,2024,6,127725.0,Salary Increases & Fixed Expenses Decrease,198586,64218.0,149431,213649.0,-15063.0,-7.59,0.05,High Risk
U467,2024,7,112662.0,Salary Increases & Fixed Expenses Decrease,198586,64218.0,153219,217437.0,-18851.0,-9.49,-0.0,High Risk
U467,2024,8,93811.0,Salary Increases & Fixed Expenses Decrease,206797,64218.0,144977,209195.0,-2398.0,-1.16,0.02,High Risk
U467,2024,9,91413.0,Salary Increases & Fixed Expenses Decrease,206797,64218.0,163729,227947.0,-21150.0,-10.23,-0.04,High Risk
U467,2024,10,70263.0,Salary Increases & Fixed Expenses Decrease,206797,64218.0,170811,235029.0,-28232.0,-13.65,-0.04,High Risk
U467,2024,11,42031.0,Salary Increases & Fixed Expenses Decrease,206797,64218.0,140550,204768.0,2029.0,0.98,0.0,High Risk
U467,2024,12,44060.0,Salary Increases & Fixed Expenses Decrease,206797,64218.0,164008,228226.0,-21429.0,-10.36,0.0,High Risk
U468,2024,1,201273.0,Stable Salary & Stable Fixed Expenses,168463,65751.0,92518,158269.0,10194.0,6.05,-0.01,High Risk
U468,2024,2,211467.0,Stable Salary & Stable Fixed Expenses,168463,65751.0,96747,162498.0,5965.0,3.54,-0.04,High Risk
U468,2024,3,217432.0,Stable Salary & Stable Fixed Expenses,168463,65751.0,69106,134857.0,33606.0,19.95,0.01,Medium Risk
U468,2024,4,251038.0,Stable Salary & Stable Fixed Expenses,168463,65751.0,76773,142524.0,25939.0,15.4,0.03,Medium Risk
U468,2024,5,276977.0,Stable Salary & Stable Fixed Expenses,168463,65751.0,87494,153245.0,15218.0,9.03,0.01,High Risk
U468,2024,6,292195.0,Stable Salary & Stable Fixed Expenses,168463,65751.0,86983,152734.0,15729.0,9.34,-0.03,High Risk
U468,2024,7,307924.0,Stable Salary & Stable Fixed Expenses,168463,65751.0,90940,156691.0,11772.0,6.99,0.04,High Risk
U468,2024,8,319696.0,Stable Salary & Stable Fixed Expenses,168463,65751.0,69906,135657.0,32806.0,19.47,0.04,Medium Risk
U468,2024,9,352502.0,Stable Salary & Stable Fixed Expenses,168463,65751.0,88416,154167.0,14296.0,8.49,0.02,High Risk
U468,2024,10,366798.0,Stable Salary & Stable Fixed Expenses,168463,65751.0,96689,162440.0,6023.0,3.58,-0.05,High Risk
U468,2024,11,372821.0,Stable Salary & Stable Fixed Expenses,168463,65751.0,82593,148344.0,20119.0,11.94,-0.01,High Risk
U468,2024,12,392940.0,Stable Salary & Stable Fixed Expenses,168463,65751.0,100332,166083.0,2380.0,1.41,-0.0,High Risk
U469,2024,1,245280.0,Salary Increases & Fixed Expenses Remain Stable,50284,33094.0,32621,65715.0,-15431.0,-30.69,-0.03,High Risk
U469,2024,2,229849.0,Salary Increases & Fixed Expenses Remain Stable,50284,33094.0,32345,65439.0,-15155.0,-30.14,-0.03,High Risk
U469,2024,3,214694.0,Salary Increases & Fixed Expenses Remain Stable,50284,33094.0,36065,69159.0,-18875.0,-37.54,0.04,High Risk
U469,2024,4,195819.0,Salary Increases & Fixed Expenses Remain Stable,50284,33094.0,30964,64058.0,-13774.0,-27.39,0.05,High Risk
U469,2024,5,182045.0,Salary Increases & Fixed Expenses Remain Stable,50284,33094.0,35284,68378.0,-18094.0,-35.98,0.03,High Risk
U469,2024,6,163951.0,Salary Increases & Fixed Expenses Remain Stable,50284,33094.0,31161,64255.0,-13971.0,-27.78,0.03,High Risk
U469,2024,7,149980.0,Salary Increases & Fixed Expenses Remain Stable,50284,33094.0,38892,71986.0,-21702.0,-43.16,-0.0,High Risk
U469,2024,8,128278.0,Salary Increases & Fixed Expenses Remain Stable,64787,33094.0,43774,76868.0,-12081.0,-18.65,0.04,High Risk
U469,2024,9,116197.0,Salary Increases & Fixed Expenses Remain Stable,64787,33094.0,48026,81120.0,-16333.0,-25.21,-0.04,High Risk
U469,2024,10,99864.0,Salary Increases & Fixed Expenses Remain Stable,64787,33094.0,46842,79936.0,-15149.0,-23.38,0.02,High Risk
U469,2024,11,84715.0,Salary Increases & Fixed Expenses Remain Stable,64787,33094.0,43758,76852.0,-12065.0,-18.62,0.0,High Risk
U469,2024,12,72650.0,Salary Increases & Fixed Expenses Remain Stable,64787,33094.0,41883,74977.0,-10190.0,-15.73,0.04,High Risk
U470,2024,1,241750.0,Stable Salary & Increasing Fixed Expenses,167379,48888.0,86313,135201.0,32178.0,19.22,0.04,Medium Risk
U470,2024,2,273928.0,Stable Salary & Increasing Fixed Expenses,167379,48888.0,79757,128645.0,38734.0,23.14,0.05,Medium Risk
U470,2024,3,312662.0,Stable Salary & Increasing Fixed Expenses,167379,48888.0,96955,145843.0,21536.0,12.87,-0.02,High Risk
U470,2024,4,334198.0,Stable Salary & Increasing Fixed Expenses,167379,48888.0,98361,147249.0,20130.0,12.03,-0.04,High Risk
U470,2024,5,354328.0,Stable Salary & Increasing Fixed Expenses,167379,49691.0,83526,133217.0,34162.0,20.41,-0.04,Medium Risk
U470,2024,6,388490.0,Stable Salary & Increasing Fixed Expenses,167379,49691.0,99720,149411.0,17968.0,10.73,-0.01,High Risk
U470,2024,7,406458.0,Stable Salary & Increasing Fixed Expenses,167379,49691.0,76937,126628.0,40751.0,24.35,-0.03,Medium Risk
U470,2024,8,447209.0,Stable Salary & Increasing Fixed Expenses,167379,51648.0,83266,134914.0,32465.0,19.4,-0.02,Medium Risk
U470,2024,9,479674.0,Stable Salary & Increasing Fixed Expenses,167379,51648.0,95215,146863.0,20516.0,12.26,-0.04,High Risk
U470,2024,10,500190.0,Stable Salary & Increasing Fixed Expenses,167379,51648.0,113191,164839.0,2540.0,1.52,0.04,High Risk
U470,2024,11,502730.0,Stable Salary & Increasing Fixed Expenses,167379,51648.0,93135,144783.0,22596.0,13.5,0.04,High Risk
U470,2024,12,525326.0,Stable Salary & Increasing Fixed Expenses,167379,52782.0,89139,141921.0,25458.0,15.21,-0.0,Medium Risk
U471,2024,1,212162.0,Stable Salary & Stable Fixed Expenses,23318,19639.0,10440,30079.0,-6761.0,-28.99,0.02,High Risk
U471,2024,2,205401.0,Stable Salary & Stable Fixed Expenses,23318,19639.0,12585,32224.0,-8906.0,-38.19,0.02,High Risk
U471,2024,3,196495.0,Stable Salary & Stable Fixed Expenses,23318,19639.0,12628,32267.0,-8949.0,-38.38,0.03,High Risk
U471,2024,4,187546.0,Stable Salary & Stable Fixed Expenses,23318,19639.0,11106,30745.0,-7427.0,-31.85,-0.02,High Risk
U471,2024,5,180119.0,Stable Salary & Stable Fixed Expenses,23318,19639.0,10146,29785.0,-6467.0,-27.73,0.04,High Risk
U471,2024,6,173652.0,Stable Salary & Stable Fixed Expenses,23318,19639.0,11100,30739.0,-7421.0,-31.83,-0.02,High Risk
U471,2024,7,166231.0,Stable Salary & Stable Fixed Expenses,23318,19639.0,10872,30511.0,-7193.0,-30.85,-0.03,High Risk
U471,2024,8,159038.0,Stable Salary & Stable Fixed Expenses,23318,19639.0,12477,32116.0,-8798.0,-37.73,-0.02,High Risk
U471,2024,9,150240.0,Stable Salary & Stable Fixed Expenses,23318,19639.0,11548,31187.0,-7869.0,-33.75,-0.04,High Risk
U471,2024,10,142371.0,Stable Salary & Stable Fixed Expenses,23318,19639.0,11610,31249.0,-7931.0,-34.01,0.0,High Risk
U471,2024,11,134440.0,Stable Salary & Stable Fixed Expenses,23318,19639.0,10062,29701.0,-6383.0,-27.37,-0.04,High Risk
U471,2024,12,128057.0,Stable Salary & Stable Fixed Expenses,23318,19639.0,10883,30522.0,-7204.0,-30.89,-0.01,High Risk
U472,2024,1,231972.0,Salary Increases & Fixed Expenses Increase,53638,34769.0,22920,57689.0,-4051.0,-7.55,-0.02,High Risk
U472,2024,2,227921.0,Salary Increases & Fixed Expenses Increase,53638,35770.0,29670,65440.0,-11802.0,-22.0,-0.02,High Risk
U472,2024,3,216119.0,Salary Increases & Fixed Expenses Increase,53638,35770.0,27015,62785.0,-9147.0,-17.05,0.03,High Risk
U472,2024,4,206972.0,Salary Increases & Fixed Expenses Increase,53638,35770.0,21880,57650.0,-4012.0,-7.48,0.04,High Risk
U472,2024,5,202960.0,Salary Increases & Fixed Expenses Increase,53638,35770.0,23984,59754.0,-6116.0,-11.4,-0.03,High Risk
U472,2024,6,196844.0,Salary Increases & Fixed Expenses Increase,53638,35770.0,30924,66694.0,-13056.0,-24.34,0.04,High Risk
U472,2024,7,183788.0,Salary Increases & Fixed Expenses Increase,53638,35770.0,23407,59177.0,-5539.0,-10.33,0.02,High Risk
U472,2024,8,178249.0,Salary Increases & Fixed Expenses Increase,76482,35770.0,30879,66649.0,9833.0,12.86,-0.05,High Risk
U472,2024,9,188082.0,Salary Increases & Fixed Expenses Increase,76482,35770.0,37294,73064.0,3418.0,4.47,-0.01,High Risk
U472,2024,10,191500.0,Salary Increases & Fixed Expenses Increase,76482,35770.0,51470,87240.0,-10758.0,-14.07,-0.03,High Risk
U472,2024,11,180742.0,Salary Increases & Fixed Expenses Increase,76482,37285.0,39382,76667.0,-185.0,-0.24,0.04,High Risk
U472,2024,12,180557.0,Salary Increases & Fixed Expenses Increase,76482,38011.0,40992,79003.0,-2521.0,-3.3,-0.01,High Risk
U473,2024,1,227991.0,Stable Salary & Increasing Fixed Expenses,201153,67225.0,66761,133986.0,67167.0,33.39,-0.01,Low Risk
U473,2024,2,295158.0,Stable Salary & Increasing Fixed Expenses,201153,67225.0,63128,130353.0,70800.0,35.2,-0.03,Low Risk
U473,2024,3,365958.0,Stable Salary & Increasing Fixed Expenses,201153,67225.0,79375,146600.0,54553.0,27.12,-0.0,Low Risk
U473,2024,4,420511.0,Stable Salary & Increasing Fixed Expenses,201153,67225.0,65847,133072.0,68081.0,33.85,-0.01,Low Risk
U473,2024,5,488592.0,Stable Salary & Increasing Fixed Expenses,201153,67225.0,78754,145979.0,55174.0,27.43,0.03,Low Risk
U473,2024,6,543766.0,Stable Salary & Increasing Fixed Expenses,201153,67225.0,67445,134670.0,66483.0,33.05,0.03,Low Risk
U473,2024,7,610249.0,Stable Salary & Increasing Fixed Expenses,201153,67225.0,76546,143771.0,57382.0,28.53,-0.04,Low Risk
U473,2024,8,667631.0,Stable Salary & Increasing Fixed Expenses,201153,67225.0,71535,138760.0,62393.0,31.02,-0.05,Low Risk
U473,2024,9,730024.0,Stable Salary & Increasing Fixed Expenses,201153,67225.0,61980,129205.0,71948.0,35.77,-0.04,Low Risk
U473,2024,10,801972.0,Stable Salary & Increasing Fixed Expenses,201153,67225.0,62247,129472.0,71681.0,35.64,-0.04,Low Risk
U473,2024,11,873653.0,Stable Salary & Increasing Fixed Expenses,201153,68903.0,61201,130104.0,71049.0,35.32,-0.03,Low Risk
U473,2024,12,944702.0,Stable Salary & Increasing Fixed Expenses,201153,70422.0,80118,150540.0,50613.0,25.16,0.02,Low Risk
U474,2024,1,210966.0,Stable Salary & Decreasing Fixed Expenses,34322,15284.0,17337,32621.0,1701.0,4.96,0.03,High Risk
U474,2024,2,212667.0,Stable Salary & Decreasing Fixed Expenses,34322,15284.0,18481,33765.0,557.0,1.62,-0.0,High Risk
U474,2024,3,213224.0,Stable Salary & Decreasing Fixed Expenses,34322,15284.0,19742,35026.0,-704.0,-2.05,0.02,High Risk
U474,2024,4,212520.0,Stable Salary & Decreasing Fixed Expenses,34322,15284.0,19700,34984.0,-662.0,-1.93,0.04,High Risk
U474,2024,5,211858.0,Stable Salary & Decreasing Fixed Expenses,34322,15284.0,15136,30420.0,3902.0,11.37,-0.04,High Risk
U474,2024,6,215760.0,Stable Salary & Decreasing Fixed Expenses,34322,15284.0,18271,33555.0,767.0,2.23,-0.0,High Risk
U474,2024,7,216527.0,Stable Salary & Decreasing Fixed Expenses,34322,15284.0,18572,33856.0,466.0,1.36,0.01,High Risk
U474,2024,8,216993.0,Stable Salary & Decreasing Fixed Expenses,34322,15284.0,17099,32383.0,1939.0,5.65,-0.02,High Risk
U474,2024,9,218932.0,Stable Salary & Decreasing Fixed Expenses,34322,15284.0,21928,37212.0,-2890.0,-8.42,0.04,High Risk
U474,2024,10,216042.0,Stable Salary & Decreasing Fixed Expenses,34322,15284.0,23807,39091.0,-4769.0,-13.89,-0.01,High Risk
U474,2024,11,211273.0,Stable Salary & Decreasing Fixed Expenses,34322,15284.0,16168,31452.0,2870.0,8.36,0.03,High Risk
U474,2024,12,214143.0,Stable Salary & Decreasing Fixed Expenses,34322,15284.0,16716,32000.0,2322.0,6.77,-0.01,High Risk
U475,2024,1,213915.0,Salary Increases & Fixed Expenses Remain Stable,211734,74689.0,93995,168684.0,43050.0,20.33,0.02,Medium Risk
U475,2024,2,256965.0,Salary Increases & Fixed Expenses Remain Stable,211734,74689.0,117107,191796.0,19938.0,9.42,0.0,High Risk
U475,2024,3,276903.0,Salary Increases & Fixed Expenses Remain Stable,222015,74689.0,106944,181633.0,40382.0,18.19,0.02,Medium Risk
U475,2024,4,317285.0,Salary Increases & Fixed Expenses Remain Stable,222015,74689.0,124631,199320.0,22695.0,10.22,0.02,High Risk
U475,2024,5,339980.0,Salary Increases & Fixed Expenses Remain Stable,222015,74689.0,131640,206329.0,15686.0,7.07,-0.0,High Risk
U475,2024,6,355666.0,Salary Increases & Fixed Expenses Remain Stable,222015,74689.0,89571,164260.0,57755.0,26.01,-0.01,Low Risk
U475,2024,7,413421.0,Salary Increases & Fixed Expenses Remain Stable,222015,74689.0,92450,167139.0,54876.0,24.72,0.04,Medium Risk
U475,2024,8,468297.0,Salary Increases & Fixed Expenses Remain Stable,222015,74689.0,126609,201298.0,20717.0,9.33,-0.04,High Risk
U475,2024,9,489014.0,Salary Increases & Fixed Expenses Remain Stable,222015,74689.0,114566,189255.0,32760.0,14.76,-0.03,High Risk
U475,2024,10,521774.0,Salary Increases & Fixed Expenses Remain Stable,222015,74689.0,157052,231741.0,-9726.0,-4.38,-0.05,High Risk
U475,2024,11,512048.0,Salary Increases & Fixed Expenses Remain Stable,222015,74689.0,115288,189977.0,32038.0,14.43,-0.01,High Risk
U475,2024,12,544086.0,Salary Increases & Fixed Expenses Remain Stable,222015,74689.0,113529,188218.0,33797.0,15.22,-0.03,Medium Risk
U476,2024,1,200088.0,Salary Increases & Fixed Expenses Increase,284458,66379.0,98508,164887.0,119571.0,42.03,0.05,Low Risk
U476,2024,2,319659.0,Salary Increases & Fixed Expenses Increase,284458,68362.0,106744,175106.0,109352.0,38.44,0.03,Low Risk
U476,2024,3,429011.0,Salary Increases & Fixed Expenses Increase,284458,68362.0,102310,170672.0,113786.0,40.0,-0.01,Low Risk
U476,2024,4,542797.0,Salary Increases & Fixed Expenses Increase,284458,68362.0,97752,166114.0,118344.0,41.6,-0.02,Low Risk
U476,2024,5,661141.0,Salary Increases & Fixed Expenses Increase,284458,69807.0,103221,173028.0,111430.0,39.17,-0.03,Low Risk
U476,2024,6,772571.0,Salary Increases & Fixed Expenses Increase,284458,71031.0,112217,183248.0,101210.0,35.58,0.04,Low Risk
U476,2024,7,873781.0,Salary Increases & Fixed Expenses Increase,300817,71031.0,101347,172378.0,128439.0,42.7,0.0,Low Risk
U476,2024,8,1002220.0,Salary Increases & Fixed Expenses Increase,300817,71738.0,108417,180155.0,120662.0,40.11,0.0,Low Risk
U476,2024,9,1122882.0,Salary Increases & Fixed Expenses Increase,300817,71738.0,113295,185033.0,115784.0,38.49,-0.01,Low Risk
U476,2024,10,1238666.0,Salary Increases & Fixed Expenses Increase,300817,73047.0,136187,209234.0,91583.0,30.44,-0.01,Low Risk
U476,2024,11,1330249.0,Salary Increases & Fixed Expenses Increase,300817,73047.0,107790,180837.0,119980.0,39.88,0.0,Low Risk
U476,2024,12,1450229.0,Salary Increases & Fixed Expenses Increase,300817,73047.0,102167,175214.0,125603.0,41.75,0.04,Low Risk
U477,2024,1,223662.0,Salary Increases & Fixed Expenses Increase,87473,36784.0,53619,90403.0,-2930.0,-3.35,-0.04,High Risk
U477,2024,2,220732.0,Salary Increases & Fixed Expenses Increase,87473,36784.0,52817,89601.0,-2128.0,-2.43,0.0,High Risk
U477,2024,3,218604.0,Salary Increases & Fixed Expenses Increase,87473,36784.0,69376,106160.0,-18687.0,-21.36,0.02,High Risk
U477,2024,4,199917.0,Salary Increases & Fixed Expenses Increase,87473,36784.0,62529,99313.0,-11840.0,-13.54,-0.02,High Risk
U477,2024,5,188077.0,Salary Increases & Fixed Expenses Increase,101134,36784.0,61894,98678.0,2456.0,2.43,0.02,High Risk
U477,2024,6,190533.0,Salary Increases & Fixed Expenses Increase,101134,36784.0,77638,114422.0,-13288.0,-13.14,-0.01,High Risk
U477,2024,7,177245.0,Salary Increases & Fixed Expenses Increase,101134,36784.0,70634,107418.0,-6284.0,-6.21,0.04,High Risk
U477,2024,8,170961.0,Salary Increases & Fixed Expenses Increase,101134,36784.0,66406,103190.0,-2056.0,-2.03,0.04,High Risk
U477,2024,9,168905.0,Salary Increases & Fixed Expenses Increase,101134,36784.0,67303,104087.0,-2953.0,-2.92,0.02,High Risk
U477,2024,10,165952.0,Salary Increases & Fixed Expenses Increase,101134,37519.0,84455,121974.0,-20840.0,-20.61,0.04,High Risk
U477,2024,11,145112.0,Salary Increases & Fixed Expenses Increase,101134,39408.0,68497,107905.0,-6771.0,-6.7,-0.02,High Risk
U477,2024,12,138341.0,Salary Increases & Fixed Expenses Increase,101134,39408.0,77797,117205.0,-16071.0,-15.89,0.01,High Risk
U478,2024,1,246275.0,Salary Increases & Fixed Expenses Increase,275865,89162.0,112847,202009.0,73856.0,26.77,0.04,Low Risk
U478,2024,2,320131.0,Salary Increases & Fixed Expenses Increase,275865,89162.0,158751,247913.0,27952.0,10.13,0.0,High Risk
U478,2024,3,348083.0,Salary Increases & Fixed Expenses Increase,275865,89162.0,141357,230519.0,45346.0,16.44,0.03,Medium Risk
U478,2024,4,393429.0,Salary Increases & Fixed Expenses Increase,288976,89162.0,133275,222437.0,66539.0,23.03,-0.01,Medium Risk
U478,2024,5,459968.0,Salary Increases & Fixed Expenses Increase,288976,89162.0,148413,237575.0,51401.0,17.79,0.01,Medium Risk
U478,2024,6,511369.0,Salary Increases & Fixed Expenses Increase,288976,90795.0,130274,221069.0,67907.0,23.5,0.03,Medium Risk
U478,2024,7,579276.0,Salary Increases & Fixed Expenses Increase,288976,90795.0,142426,233221.0,55755.0,19.29,0.01,Medium Risk
U478,2024,8,635031.0,Salary Increases & Fixed Expenses Increase,288976,90795.0,125403,216198.0,72778.0,25.18,0.03,Low Risk
U478,2024,9,707809.0,Salary Increases & Fixed Expenses Increase,288976,90795.0,123862,214657.0,74319.0,25.72,0.01,Low Risk
U478,2024,10,782128.0,Salary Increases & Fixed Expenses Increase,288976,90795.0,151913,242708.0,46268.0,16.01,-0.01,Medium Risk
U478,2024,11,828396.0,Salary Increases & Fixed Expenses Increase,288976,90795.0,161930,252725.0,36251.0,12.54,0.02,High Risk
U478,2024,12,864647.0,Salary Increases & Fixed Expenses Increase,288976,92515.0,141166,233681.0,55295.0,19.13,0.05,Medium Risk
U479,2024,1,222546.0,Salary Increases & Fixed Expenses Increase,50261,40251.0,21753,62004.0,-11743.0,-23.36,-0.01,High Risk
U479,2024,2,210803.0,Salary Increases & Fixed Expenses Increase,50261,40251.0,29388,69639.0,-19378.0,-38.55,-0.01,High Risk
U479,2024,3,191425.0,Salary Increases & Fixed Expenses Increase,50261,40251.0,24461,64712.0,-14451.0,-28.75,0.0,High Risk
U479,2024,4,176974.0,Salary Increases & Fixed Expenses Increase,50261,40251.0,29345,69596.0,-19335.0,-38.47,-0.02,High Risk
U479,2024,5,157639.0,Salary Increases & Fixed Expenses Increase,50261,40923.0,28084,69007.0,-18746.0,-37.3,0.05,High Risk
U479,2024,6,138893.0,Salary Increases & Fixed Expenses Increase,73648,40923.0,35951,76874.0,-3226.0,-4.38,-0.01,High Risk
U479,2024,7,135667.0,Salary Increases & Fixed Expenses Increase,73648,40923.0,37471,78394.0,-4746.0,-6.44,-0.01,High Risk
U479,2024,8,130921.0,Salary Increases & Fixed Expenses Increase,73648,40923.0,33786,74709.0,-1061.0,-1.44,0.01,High Risk
U479,2024,9,129860.0,Salary Increases & Fixed Expenses Increase,73648,40923.0,40915,81838.0,-8190.0,-11.12,-0.03,High Risk
U479,2024,10,121670.0,Salary Increases & Fixed Expenses Increase,73648,41658.0,47707,89365.0,-15717.0,-21.34,0.0,High Risk
U479,2024,11,105953.0,Salary Increases & Fixed Expenses Increase,73648,41658.0,42654,84312.0,-10664.0,-14.48,-0.03,High Risk
U479,2024,12,95289.0,Salary Increases & Fixed Expenses Increase,73648,41658.0,38072,79730.0,-6082.0,-8.26,-0.05,High Risk
U480,2024,1,238215.0,Salary Increases & Fixed Expenses Remain Stable,56132,28194.0,26579,54773.0,1359.0,2.42,-0.03,High Risk
U480,2024,2,239574.0,Salary Increases & Fixed Expenses Remain Stable,56132,28194.0,31056,59250.0,-3118.0,-5.55,-0.03,High Risk
U480,2024,3,236456.0,Salary Increases & Fixed Expenses Remain Stable,56132,28194.0,40981,69175.0,-13043.0,-23.24,-0.0,High Risk
U480,2024,4,223413.0,Salary Increases & Fixed Expenses Remain Stable,69771,28194.0,34781,62975.0,6796.0,9.74,0.05,High Risk
U480,2024,5,230209.0,Salary Increases & Fixed Expenses Remain Stable,69771,28194.0,35610,63804.0,5967.0,8.55,0.05,High Risk
U480,2024,6,236176.0,Salary Increases & Fixed Expenses Remain Stable,69771,28194.0,34694,62888.0,6883.0,9.87,0.02,High Risk
U480,2024,7,243059.0,Salary Increases & Fixed Expenses Remain Stable,69771,28194.0,28340,56534.0,13237.0,18.97,0.05,Medium Risk
U480,2024,8,256296.0,Salary Increases & Fixed Expenses Remain Stable,69771,28194.0,31921,60115.0,9656.0,13.84,0.04,High Risk
U480,2024,9,265952.0,Salary Increases & Fixed Expenses Remain Stable,69771,28194.0,30314,58508.0,11263.0,16.14,-0.02,Medium Risk
U480,2024,10,277215.0,Salary Increases & Fixed Expenses Remain Stable,69771,28194.0,46253,74447.0,-4676.0,-6.7,0.01,High Risk
U480,2024,11,272539.0,Salary Increases & Fixed Expenses Remain Stable,69771,28194.0,34859,63053.0,6718.0,9.63,-0.05,High Risk
U480,2024,12,279257.0,Salary Increases & Fixed Expenses Remain Stable,69771,28194.0,34666,62860.0,6911.0,9.91,0.03,High Risk
U481,2024,1,244655.0,Salary Increases & Fixed Expenses Increase,44822,18784.0,17287,36071.0,8751.0,19.52,0.04,Medium Risk
U481,2024,2,253406.0,Salary Increases & Fixed Expenses Increase,44822,18784.0,16077,34861.0,9961.0,22.22,0.01,Medium Risk
U481,2024,3,263367.0,Salary Increases & Fixed Expenses Increase,52372,18784.0,22604,41388.0,10984.0,20.97,-0.05,Medium Risk
U481,2024,4,274351.0,Salary Increases & Fixed Expenses Increase,52372,18784.0,17188,35972.0,16400.0,31.31,0.05,Low Risk
U481,2024,5,290751.0,Salary Increases & Fixed Expenses Increase,52372,18784.0,17227,36011.0,16361.0,31.24,-0.03,Low Risk
U481,2024,6,307112.0,Salary Increases & Fixed Expenses Increase,52372,20138.0,16739,36877.0,15495.0,29.59,-0.03,Low Risk
U481,2024,7,322607.0,Salary Increases & Fixed Expenses Increase,52372,20138.0,15817,35955.0,16417.0,31.35,-0.02,Low Risk
U481,2024,8,339024.0,Salary Increases & Fixed Expenses Increase,52372,20138.0,18668,38806.0,13566.0,25.9,-0.01,Low Risk
U481,2024,9,352590.0,Salary Increases & Fixed Expenses Increase,52372,20138.0,20017,40155.0,12217.0,23.33,0.02,Medium Risk
U481,2024,10,364807.0,Salary Increases & Fixed Expenses Increase,52372,20138.0,23185,43323.0,9049.0,17.28,0.02,Medium Risk
U481,2024,11,373856.0,Salary Increases & Fixed Expenses Increase,52372,20138.0,15941,36079.0,16293.0,31.11,-0.0,Low Risk
U481,2024,12,390149.0,Salary Increases & Fixed Expenses Increase,52372,20138.0,19372,39510.0,12862.0,24.56,-0.01,Medium Risk
U482,2024,1,242048.0,Stable Salary & Stable Fixed Expenses,235097,98815.0,178328,277143.0,-42046.0,-17.88,-0.03,High Risk
U482,2024,2,200002.0,Stable Salary & Stable Fixed Expenses,235097,98815.0,157175,255990.0,-20893.0,-8.89,-0.0,High Risk
U482,2024,3,179109.0,Stable Salary & Stable Fixed Expenses,235097,98815.0,197975,296790.0,-61693.0,-26.24,0.03,High Risk
U482,2024,4,117416.0,Stable Salary & Stable Fixed Expenses,235097,98815.0,149519,248334.0,-13237.0,-5.63,-0.01,High Risk
U482,2024,5,104179.0,Stable Salary & Stable Fixed Expenses,235097,98815.0,180373,279188.0,-44091.0,-18.75,0.05,High Risk
U482,2024,6,60088.0,Stable Salary & Stable Fixed Expenses,235097,98815.0,164050,262865.0,-27768.0,-11.81,-0.04,High Risk
U482,2024,7,32320.0,Stable Salary & Stable Fixed Expenses,235097,98815.0,158693,257508.0,-22411.0,-9.53,0.03,High Risk
U482,2024,8,9909.0,Stable Salary & Stable Fixed Expenses,235097,98815.0,159264,258079.0,-22982.0,-9.78,0.03,High Risk
U482,2024,9,-13073.0,Stable Salary & Stable Fixed Expenses,235097,98815.0,168217,267032.0,-31935.0,-13.58,0.01,High Risk
U482,2024,10,-45008.0,Stable Salary & Stable Fixed Expenses,235097,98815.0,213628,312443.0,-77346.0,-32.9,0.0,High Risk
U482,2024,11,-122354.0,Stable Salary & Stable Fixed Expenses,235097,98815.0,208433,307248.0,-72151.0,-30.69,0.02,High Risk
U482,2024,12,-194505.0,Stable Salary & Stable Fixed Expenses,235097,98815.0,194677,293492.0,-58395.0,-24.84,0.03,High Risk
U483,2024,1,233377.0,Stable Salary & Stable Fixed Expenses,26788,20147.0,15571,35718.0,-8930.0,-33.34,0.03,High Risk
U483,2024,2,224447.0,Stable Salary & Stable Fixed Expenses,26788,20147.0,15909,36056.0,-9268.0,-34.6,-0.02,High Risk
U483,2024,3,215179.0,Stable Salary & Stable Fixed Expenses,26788,20147.0,15062,35209.0,-8421.0,-31.44,-0.04,High Risk
U483,2024,4,206758.0,Stable Salary & Stable Fixed Expenses,26788,20147.0,12211,32358.0,-5570.0,-20.79,0.04,High Risk
U483,2024,5,201188.0,Stable Salary & Stable Fixed Expenses,26788,20147.0,14920,35067.0,-8279.0,-30.91,-0.0,High Risk
U483,2024,6,192909.0,Stable Salary & Stable Fixed Expenses,26788,20147.0,13447,33594.0,-6806.0,-25.41,-0.01,High Risk
U483,2024,7,186103.0,Stable Salary & Stable Fixed Expenses,26788,20147.0,13578,33725.0,-6937.0,-25.9,-0.01,High Risk
U483,2024,8,179166.0,Stable Salary & Stable Fixed Expenses,26788,20147.0,11061,31208.0,-4420.0,-16.5,-0.03,High Risk
U483,2024,9,174746.0,Stable Salary & Stable Fixed Expenses,26788,20147.0,13134,33281.0,-6493.0,-24.24,0.0,High Risk
U483,2024,10,168253.0,Stable Salary & Stable Fixed Expenses,26788,20147.0,12608,32755.0,-5967.0,-22.27,0.05,High Risk
U483,2024,11,162286.0,Stable Salary & Stable Fixed Expenses,26788,20147.0,12700,32847.0,-6059.0,-22.62,0.03,High Risk
U483,2024,12,156227.0,Stable Salary & Stable Fixed Expenses,26788,20147.0,12897,33044.0,-6256.0,-23.35,-0.01,High Risk
U484,2024,1,222013.0,Salary Increases & Fixed Expenses Remain Stable,209952,84753.0,72095,156848.0,53104.0,25.29,0.05,Low Risk
U484,2024,2,275117.0,Salary Increases & Fixed Expenses Remain Stable,209952,84753.0,67458,152211.0,57741.0,27.5,-0.01,Low Risk
U484,2024,3,332858.0,Salary Increases & Fixed Expenses Remain Stable,209952,84753.0,65542,150295.0,59657.0,28.41,0.03,Low Risk
U484,2024,4,392515.0,Salary Increases & Fixed Expenses Remain Stable,221669,84753.0,81526,166279.0,55390.0,24.99,-0.03,Medium Risk
U484,2024,5,447905.0,Salary Increases & Fixed Expenses Remain Stable,221669,84753.0,66984,151737.0,69932.0,31.55,0.03,Low Risk
U484,2024,6,517837.0,Salary Increases & Fixed Expenses Remain Stable,221669,84753.0,67777,152530.0,69139.0,31.19,0.02,Low Risk
U484,2024,7,586976.0,Salary Increases & Fixed Expenses Remain Stable,221669,84753.0,82703,167456.0,54213.0,24.46,-0.0,Medium Risk
U484,2024,8,641189.0,Salary Increases & Fixed Expenses Remain Stable,221669,84753.0,71996,156749.0,64920.0,29.29,-0.05,Low Risk
U484,2024,9,706109.0,Salary Increases & Fixed Expenses Remain Stable,221669,84753.0,79537,164290.0,57379.0,25.88,-0.04,Low Risk
U484,2024,10,763488.0,Salary Increases & Fixed Expenses Remain Stable,221669,84753.0,83238,167991.0,53678.0,24.22,-0.01,Medium Risk
U484,2024,11,817166.0,Salary Increases & Fixed Expenses Remain Stable,221669,84753.0,84792,169545.0,52124.0,23.51,-0.01,Medium Risk
U484,2024,12,869290.0,Salary Increases & Fixed Expenses Remain Stable,221669,84753.0,87986,172739.0,48930.0,22.07,-0.05,Medium Risk
U485,2024,1,246208.0,Salary Increases & Fixed Expenses Remain Stable,164658,75520.0,67031,142551.0,22107.0,13.43,-0.02,High Risk
U485,2024,2,268315.0,Salary Increases & Fixed Expenses Remain Stable,164658,75520.0,95034,170554.0,-5896.0,-3.58,-0.01,High Risk
U485,2024,3,262419.0,Salary Increases & Fixed Expenses Remain Stable,164658,75520.0,111734,187254.0,-22596.0,-13.72,0.03,High Risk
U485,2024,4,239823.0,Salary Increases & Fixed Expenses Remain Stable,164658,75520.0,86754,162274.0,2384.0,1.45,-0.02,High Risk
U485,2024,5,242207.0,Salary Increases & Fixed Expenses Remain Stable,164658,75520.0,68819,144339.0,20319.0,12.34,-0.03,High Risk
U485,2024,6,262526.0,Salary Increases & Fixed Expenses Remain Stable,180786,75520.0,108276,183796.0,-3010.0,-1.66,-0.04,High Risk
U485,2024,7,259516.0,Salary Increases & Fixed Expenses Remain Stable,180786,75520.0,72482,148002.0,32784.0,18.13,0.0,Medium Risk
U485,2024,8,292300.0,Salary Increases & Fixed Expenses Remain Stable,180786,75520.0,93722,169242.0,11544.0,6.39,0.01,High Risk
U485,2024,9,303844.0,Salary Increases & Fixed Expenses Remain Stable,180786,75520.0,86196,161716.0,19070.0,10.55,0.05,High Risk
U485,2024,10,322914.0,Salary Increases & Fixed Expenses Remain Stable,180786,75520.0,100769,176289.0,4497.0,2.49,0.05,High Risk
U485,2024,11,327411.0,Salary Increases & Fixed Expenses Remain Stable,180786,75520.0,97442,172962.0,7824.0,4.33,-0.01,High Risk
U485,2024,12,335235.0,Salary Increases & Fixed Expenses Remain Stable,180786,75520.0,118414,193934.0,-13148.0,-7.27,-0.02,High Risk
U486,2024,1,208009.0,Stable Salary & Increasing Fixed Expenses,186072,62574.0,100335,162909.0,23163.0,12.45,0.04,High Risk
U486,2024,2,231172.0,Stable Salary & Increasing Fixed Expenses,186072,62574.0,109982,172556.0,13516.0,7.26,-0.04,High Risk
U486,2024,3,244688.0,Stable Salary & Increasing Fixed Expenses,186072,64023.0,124051,188074.0,-2002.0,-1.08,0.01,High Risk
U486,2024,4,242686.0,Stable Salary & Increasing Fixed Expenses,186072,64023.0,102301,166324.0,19748.0,10.61,-0.03,High Risk
U486,2024,5,262434.0,Stable Salary & Increasing Fixed Expenses,186072,64023.0,98057,162080.0,23992.0,12.89,0.01,High Risk
U486,2024,6,286426.0,Stable Salary & Increasing Fixed Expenses,186072,64023.0,83313,147336.0,38736.0,20.82,0.04,Medium Risk
U486,2024,7,325162.0,Stable Salary & Increasing Fixed Expenses,186072,64023.0,82875,146898.0,39174.0,21.05,0.04,Medium Risk
U486,2024,8,364336.0,Stable Salary & Increasing Fixed Expenses,186072,64023.0,96742,160765.0,25307.0,13.6,-0.03,High Risk
U486,2024,9,389643.0,Stable Salary & Increasing Fixed Expenses,186072,64023.0,109261,173284.0,12788.0,6.87,-0.01,High Risk
U486,2024,10,402431.0,Stable Salary & Increasing Fixed Expenses,186072,65143.0,112664,177807.0,8265.0,4.44,0.01,High Risk
U486,2024,11,410696.0,Stable Salary & Increasing Fixed Expenses,186072,65143.0,97026,162169.0,23903.0,12.85,-0.02,High Risk
U486,2024,12,434599.0,Stable Salary & Increasing Fixed Expenses,186072,65143.0,105550,170693.0,15379.0,8.27,0.02,High Risk
U487,2024,1,249687.0,Stable Salary & Stable Fixed Expenses,21926,18508.0,6823,25331.0,-3405.0,-15.53,-0.05,High Risk
U487,2024,2,246282.0,Stable Salary & Stable Fixed Expenses,21926,18508.0,7173,25681.0,-3755.0,-17.13,0.02,High Risk
U487,2024,3,242527.0,Stable Salary & Stable Fixed Expenses,21926,18508.0,8723,27231.0,-5305.0,-24.2,0.04,High Risk
U487,2024,4,237222.0,Stable Salary & Stable Fixed Expenses,21926,18508.0,8149,26657.0,-4731.0,-21.58,0.02,High Risk
U487,2024,5,232491.0,Stable Salary & Stable Fixed Expenses,21926,18508.0,8012,26520.0,-4594.0,-20.95,0.05,High Risk
U487,2024,6,227897.0,Stable Salary & Stable Fixed Expenses,21926,18508.0,7459,25967.0,-4041.0,-18.43,0.01,High Risk
U487,2024,7,223856.0,Stable Salary & Stable Fixed Expenses,21926,18508.0,7108,25616.0,-3690.0,-16.83,0.0,High Risk
U487,2024,8,220166.0,Stable Salary & Stable Fixed Expenses,21926,18508.0,8051,26559.0,-4633.0,-21.13,0.05,High Risk
U487,2024,9,215533.0,Stable Salary & Stable Fixed Expenses,21926,18508.0,8032,26540.0,-4614.0,-21.04,0.04,High Risk
U487,2024,10,210919.0,Stable Salary & Stable Fixed Expenses,21926,18508.0,8112,26620.0,-4694.0,-21.41,-0.0,High Risk
U487,2024,11,206225.0,Stable Salary & Stable Fixed Expenses,21926,18508.0,7272,25780.0,-3854.0,-17.58,-0.05,High Risk
U487,2024,12,202371.0,Stable Salary & Stable Fixed Expenses,21926,18508.0,6722,25230.0,-3304.0,-15.07,0.02,High Risk
U488,2024,1,210789.0,Salary Increases & Fixed Expenses Increase,171177,68940.0,63555,132495.0,38682.0,22.6,-0.04,Medium Risk
U488,2024,2,249471.0,Salary Increases & Fixed Expenses Increase,171177,68940.0,64314,133254.0,37923.0,22.15,0.02,Medium Risk
U488,2024,3,287394.0,Salary Increases & Fixed Expenses Increase,193123,68940.0,61709,130649.0,62474.0,32.35,0.03,Low Risk
U488,2024,4,349868.0,Salary Increases & Fixed Expenses Increase,193123,68940.0,59435,128375.0,64748.0,33.53,-0.03,Low Risk
U488,2024,5,414616.0,Salary Increases & Fixed Expenses Increase,193123,68940.0,64605,133545.0,59578.0,30.85,0.04,Low Risk
U488,2024,6,474194.0,Salary Increases & Fixed Expenses Increase,193123,68940.0,61496,130436.0,62687.0,32.46,0.03,Low Risk
U488,2024,7,536881.0,Salary Increases & Fixed Expenses Increase,193123,68940.0,67961,136901.0,56222.0,29.11,-0.01,Low Risk
U488,2024,8,593103.0,Salary Increases & Fixed Expenses Increase,193123,68940.0,67276,136216.0,56907.0,29.47,0.01,Low Risk
U488,2024,9,650010.0,Salary Increases & Fixed Expenses Increase,193123,68940.0,74932,143872.0,49251.0,25.5,0.03,Low Risk
U488,2024,10,699261.0,Salary Increases & Fixed Expenses Increase,193123,68940.0,61761,130701.0,62422.0,32.32,0.04,Low Risk
U488,2024,11,761683.0,Salary Increases & Fixed Expenses Increase,193123,68940.0,74825,143765.0,49358.0,25.56,0.02,Low Risk
U488,2024,12,811041.0,Salary Increases & Fixed Expenses Increase,193123,68940.0,62875,131815.0,61308.0,31.75,-0.02,Low Risk
U489,2024,1,244257.0,Stable Salary & Stable Fixed Expenses,24487,19493.0,12661,32154.0,-7667.0,-31.31,0.01,High Risk
U489,2024,2,236590.0,Stable Salary & Stable Fixed Expenses,24487,19493.0,14532,34025.0,-9538.0,-38.95,-0.03,High Risk
U489,2024,3,227052.0,Stable Salary & Stable Fixed Expenses,24487,19493.0,14298,33791.0,-9304.0,-38.0,-0.01,High Risk
U489,2024,4,217748.0,Stable Salary & Stable Fixed Expenses,24487,19493.0,11122,30615.0,-6128.0,-25.03,-0.04,High Risk
U489,2024,5,211620.0,Stable Salary & Stable Fixed Expenses,24487,19493.0,10635,30128.0,-5641.0,-23.04,-0.01,High Risk
U489,2024,6,205979.0,Stable Salary & Stable Fixed Expenses,24487,19493.0,13234,32727.0,-8240.0,-33.65,0.04,High Risk
U489,2024,7,197739.0,Stable Salary & Stable Fixed Expenses,24487,19493.0,10071,29564.0,-5077.0,-20.73,0.03,High Risk
U489,2024,8,192662.0,Stable Salary & Stable Fixed Expenses,24487,19493.0,10478,29971.0,-5484.0,-22.4,-0.01,High Risk
U489,2024,9,187178.0,Stable Salary & Stable Fixed Expenses,24487,19493.0,9887,29380.0,-4893.0,-19.98,0.03,High Risk
U489,2024,10,182285.0,Stable Salary & Stable Fixed Expenses,24487,19493.0,13535,33028.0,-8541.0,-34.88,-0.05,High Risk
U489,2024,11,173744.0,Stable Salary & Stable Fixed Expenses,24487,19493.0,10654,30147.0,-5660.0,-23.11,-0.0,High Risk
U489,2024,12,168084.0,Stable Salary & Stable Fixed Expenses,24487,19493.0,13461,32954.0,-8467.0,-34.58,-0.05,High Risk
U490,2024,1,219550.0,Stable Salary & Stable Fixed Expenses,269866,75875.0,138028,213903.0,55963.0,20.74,0.05,Medium Risk
U490,2024,2,275513.0,Stable Salary & Stable Fixed Expenses,269866,75875.0,152520,228395.0,41471.0,15.37,0.0,Medium Risk
U490,2024,3,316984.0,Stable Salary & Stable Fixed Expenses,269866,75875.0,138402,214277.0,55589.0,20.6,0.03,Medium Risk
U490,2024,4,372573.0,Stable Salary & Stable Fixed Expenses,269866,75875.0,157858,233733.0,36133.0,13.39,0.04,High Risk
U490,2024,5,408706.0,Stable Salary & Stable Fixed Expenses,269866,75875.0,109032,184907.0,84959.0,31.48,-0.01,Low Risk
U490,2024,6,493665.0,Stable Salary & Stable Fixed Expenses,269866,75875.0,122967,198842.0,71024.0,26.32,0.04,Low Risk
U490,2024,7,564689.0,Stable Salary & Stable Fixed Expenses,269866,75875.0,148125,224000.0,45866.0,17.0,-0.03,Medium Risk
U490,2024,8,610555.0,Stable Salary & Stable Fixed Expenses,269866,75875.0,113633,189508.0,80358.0,29.78,-0.0,Low Risk
U490,2024,9,690913.0,Stable Salary & Stable Fixed Expenses,269866,75875.0,135901,211776.0,58090.0,21.53,-0.01,Medium Risk
U490,2024,10,749003.0,Stable Salary & Stable Fixed Expenses,269866,75875.0,123599,199474.0,70392.0,26.08,-0.05,Low Risk
U490,2024,11,819395.0,Stable Salary & Stable Fixed Expenses,269866,75875.0,108584,184459.0,85407.0,31.65,-0.03,Low Risk
U490,2024,12,904802.0,Stable Salary & Stable Fixed Expenses,269866,75875.0,120438,196313.0,73553.0,27.26,-0.02,Low Risk
U491,2024,1,209802.0,Salary Increases & Fixed Expenses Remain Stable,198682,72335.0,94887,167222.0,31460.0,15.83,-0.02,Medium Risk
U491,2024,2,241262.0,Salary Increases & Fixed Expenses Remain Stable,198682,72335.0,104450,176785.0,21897.0,11.02,0.02,High Risk
U491,2024,3,263159.0,Salary Increases & Fixed Expenses Remain Stable,198682,72335.0,89217,161552.0,37130.0,18.69,0.03,Medium Risk
U491,2024,4,300289.0,Salary Increases & Fixed Expenses Remain Stable,219988,72335.0,104550,176885.0,43103.0,19.59,0.03,Medium Risk
U491,2024,5,343392.0,Salary Increases & Fixed Expenses Remain Stable,219988,72335.0,114929,187264.0,32724.0,14.88,-0.01,High Risk
U491,2024,6,376116.0,Salary Increases & Fixed Expenses Remain Stable,219988,72335.0,105201,177536.0,42452.0,19.3,0.0,Medium Risk
U491,2024,7,418568.0,Salary Increases & Fixed Expenses Remain Stable,219988,72335.0,92327,164662.0,55326.0,25.15,0.04,Low Risk
U491,2024,8,473894.0,Salary Increases & Fixed Expenses Remain Stable,219988,72335.0,94065,166400.0,53588.0,24.36,-0.01,Medium Risk
U491,2024,9,527482.0,Salary Increases & Fixed Expenses Remain Stable,219988,72335.0,88575,160910.0,59078.0,26.86,0.0,Low Risk
U491,2024,10,586560.0,Salary Increases & Fixed Expenses Remain Stable,219988,72335.0,110219,182554.0,37434.0,17.02,0.05,Medium Risk
U491,2024,11,623994.0,Salary Increases & Fixed Expenses Remain Stable,219988,72335.0,113821,186156.0,33832.0,15.38,0.03,Medium Risk
U491,2024,12,657826.0,Salary Increases & Fixed Expenses Remain Stable,219988,72335.0,90558,162893.0,57095.0,25.95,-0.02,Low Risk
U492,2024,1,228126.0,Stable Salary & Stable Fixed Expenses,168049,79674.0,74964,154638.0,13411.0,7.98,0.04,High Risk
U492,2024,2,241537.0,Stable Salary & Stable Fixed Expenses,168049,79674.0,89721,169395.0,-1346.0,-0.8,-0.02,High Risk
U492,2024,3,240191.0,Stable Salary & Stable Fixed Expenses,168049,79674.0,98953,178627.0,-10578.0,-6.29,0.01,High Risk
U492,2024,4,229613.0,Stable Salary & Stable Fixed Expenses,168049,79674.0,71478,151152.0,16897.0,10.05,-0.03,High Risk
U492,2024,5,246510.0,Stable Salary & Stable Fixed Expenses,168049,79674.0,93706,173380.0,-5331.0,-3.17,-0.01,High Risk
U492,2024,6,241179.0,Stable Salary & Stable Fixed Expenses,168049,79674.0,78835,158509.0,9540.0,5.68,-0.03,High Risk
U492,2024,7,250719.0,Stable Salary & Stable Fixed Expenses,168049,79674.0,91765,171439.0,-3390.0,-2.02,0.04,High Risk
U492,2024,8,247329.0,Stable Salary & Stable Fixed Expenses,168049,79674.0,73628,153302.0,14747.0,8.78,0.04,High Risk
U492,2024,9,262076.0,Stable Salary & Stable Fixed Expenses,168049,79674.0,82279,161953.0,6096.0,3.63,-0.0,High Risk
U492,2024,10,268172.0,Stable Salary & Stable Fixed Expenses,168049,79674.0,112790,192464.0,-24415.0,-14.53,-0.02,High Risk
U492,2024,11,243757.0,Stable Salary & Stable Fixed Expenses,168049,79674.0,100425,180099.0,-12050.0,-7.17,0.02,High Risk
U492,2024,12,231707.0,Stable Salary & Stable Fixed Expenses,168049,79674.0,78369,158043.0,10006.0,5.95,0.01,High Risk
U493,2024,1,206343.0,Stable Salary & Stable Fixed Expenses,95489,26318.0,61073,87391.0,8098.0,8.48,0.03,High Risk
U493,2024,2,214441.0,Stable Salary & Stable Fixed Expenses,95489,26318.0,75955,102273.0,-6784.0,-7.1,-0.05,High Risk
U493,2024,3,207657.0,Stable Salary & Stable Fixed Expenses,95489,26318.0,58247,84565.0,10924.0,11.44,-0.01,High Risk
U493,2024,4,218581.0,Stable Salary & Stable Fixed Expenses,95489,26318.0,67572,93890.0,1599.0,1.67,0.03,High Risk
U493,2024,5,220180.0,Stable Salary & Stable Fixed Expenses,95489,26318.0,67224,93542.0,1947.0,2.04,-0.01,High Risk
U493,2024,6,222127.0,Stable Salary & Stable Fixed Expenses,95489,26318.0,68982,95300.0,189.0,0.2,0.05,High Risk
U493,2024,7,222316.0,Stable Salary & Stable Fixed Expenses,95489,26318.0,70314,96632.0,-1143.0,-1.2,-0.04,High Risk
U493,2024,8,221173.0,Stable Salary & Stable Fixed Expenses,95489,26318.0,73484,99802.0,-4313.0,-4.52,0.02,High Risk
U493,2024,9,216860.0,Stable Salary & Stable Fixed Expenses,95489,26318.0,69342,95660.0,-171.0,-0.18,0.04,High Risk
U493,2024,10,216689.0,Stable Salary & Stable Fixed Expenses,95489,26318.0,65707,92025.0,3464.0,3.63,0.03,High Risk
U493,2024,11,220153.0,Stable Salary & Stable Fixed Expenses,95489,26318.0,75532,101850.0,-6361.0,-6.66,-0.04,High Risk
U493,2024,12,213792.0,Stable Salary & Stable Fixed Expenses,95489,26318.0,57405,83723.0,11766.0,12.32,0.01,High Risk
U494,2024,1,214015.0,Salary Increases & Fixed Expenses Remain Stable,99131,32422.0,63212,95634.0,3497.0,3.53,-0.01,High Risk
U494,2024,2,217512.0,Salary Increases & Fixed Expenses Remain Stable,99131,32422.0,62960,95382.0,3749.0,3.78,0.02,High Risk
U494,2024,3,221261.0,Salary Increases & Fixed Expenses Remain Stable,99131,32422.0,98372,130794.0,-31663.0,-31.94,0.05,High Risk
U494,2024,4,189598.0,Salary Increases & Fixed Expenses Remain Stable,99131,32422.0,77137,109559.0,-10428.0,-10.52,0.03,High Risk
U494,2024,5,179170.0,Salary Increases & Fixed Expenses Remain Stable,112664,32422.0,82029,114451.0,-1787.0,-1.59,0.05,High Risk
U494,2024,6,177383.0,Salary Increases & Fixed Expenses Remain Stable,112664,32422.0,73673,106095.0,6569.0,5.83,-0.05,High Risk
U494,2024,7,183952.0,Salary Increases & Fixed Expenses Remain Stable,112664,32422.0,85067,117489.0,-4825.0,-4.28,-0.02,High Risk
U494,2024,8,179127.0,Salary Increases & Fixed Expenses Remain Stable,112664,32422.0,89254,121676.0,-9012.0,-8.0,0.03,High Risk
U494,2024,9,170115.0,Salary Increases & Fixed Expenses Remain Stable,112664,32422.0,87132,119554.0,-6890.0,-6.12,-0.03,High Risk
U494,2024,10,163225.0,Salary Increases & Fixed Expenses Remain Stable,112664,32422.0,84689,117111.0,-4447.0,-3.95,0.0,High Risk
U494,2024,11,158778.0,Salary Increases & Fixed Expenses Remain Stable,112664,32422.0,81291,113713.0,-1049.0,-0.93,0.05,High Risk
U494,2024,12,157729.0,Salary Increases & Fixed Expenses Remain Stable,112664,32422.0,67962,100384.0,12280.0,10.9,0.04,High Risk
U495,2024,1,200025.0,Stable Salary & Stable Fixed Expenses,187537,77722.0,89546,167268.0,20269.0,10.81,0.02,High Risk
U495,2024,2,220294.0,Stable Salary & Stable Fixed Expenses,187537,77722.0,87284,165006.0,22531.0,12.01,0.03,High Risk
U495,2024,3,242825.0,Stable Salary & Stable Fixed Expenses,187537,77722.0,84791,162513.0,25024.0,13.34,0.03,High Risk
U495,2024,4,267849.0,Stable Salary & Stable Fixed Expenses,187537,77722.0,96910,174632.0,12905.0,6.88,0.01,High Risk
U495,2024,5,280754.0,Stable Salary & Stable Fixed Expenses,187537,77722.0,100089,177811.0,9726.0,5.19,-0.0,High Risk
U495,2024,6,290480.0,Stable Salary & Stable Fixed Expenses,187537,77722.0,86845,164567.0,22970.0,12.25,-0.0,High Risk
U495,2024,7,313450.0,Stable Salary & Stable Fixed Expenses,187537,77722.0,80406,158128.0,29409.0,15.68,-0.02,Medium Risk
U495,2024,8,342859.0,Stable Salary & Stable Fixed Expenses,187537,77722.0,91582,169304.0,18233.0,9.72,-0.03,High Risk
U495,2024,9,361092.0,Stable Salary & Stable Fixed Expenses,187537,77722.0,103843,181565.0,5972.0,3.18,0.0,High Risk
U495,2024,10,367064.0,Stable Salary & Stable Fixed Expenses,187537,77722.0,99004,176726.0,10811.0,5.76,-0.04,High Risk
U495,2024,11,377875.0,Stable Salary & Stable Fixed Expenses,187537,77722.0,86981,164703.0,22834.0,12.18,0.01,High Risk
U495,2024,12,400709.0,Stable Salary & Stable Fixed Expenses,187537,77722.0,95885,173607.0,13930.0,7.43,-0.0,High Risk
U496,2024,1,247221.0,Stable Salary & Stable Fixed Expenses,39990,12865.0,22652,35517.0,4473.0,11.19,0.02,High Risk
U496,2024,2,251694.0,Stable Salary & Stable Fixed Expenses,39990,12865.0,20597,33462.0,6528.0,16.32,-0.05,Medium Risk
U496,2024,3,258222.0,Stable Salary & Stable Fixed Expenses,39990,12865.0,20387,33252.0,6738.0,16.85,-0.04,Medium Risk
U496,2024,4,264960.0,Stable Salary & Stable Fixed Expenses,39990,12865.0,20401,33266.0,6724.0,16.81,0.0,Medium Risk
U496,2024,5,271684.0,Stable Salary & Stable Fixed Expenses,39990,12865.0,19213,32078.0,7912.0,19.78,0.03,Medium Risk
U496,2024,6,279596.0,Stable Salary & Stable Fixed Expenses,39990,12865.0,16035,28900.0,11090.0,27.73,0.04,Low Risk
U496,2024,7,290686.0,Stable Salary & Stable Fixed Expenses,39990,12865.0,18620,31485.0,8505.0,21.27,0.0,Medium Risk
U496,2024,8,299191.0,Stable Salary & Stable Fixed Expenses,39990,12865.0,20081,32946.0,7044.0,17.61,0.05,Medium Risk
U496,2024,9,306235.0,Stable Salary & Stable Fixed Expenses,39990,12865.0,18802,31667.0,8323.0,20.81,0.02,Medium Risk
U496,2024,10,314558.0,Stable Salary & Stable Fixed Expenses,39990,12865.0,19910,32775.0,7215.0,18.04,-0.04,Medium Risk
U496,2024,11,321773.0,Stable Salary & Stable Fixed Expenses,39990,12865.0,19190,32055.0,7935.0,19.84,-0.0,Medium Risk
U496,2024,12,329708.0,Stable Salary & Stable Fixed Expenses,39990,12865.0,16388,29253.0,10737.0,26.85,0.0,Low Risk
U497,2024,1,201878.0,Stable Salary & Increasing Fixed Expenses,262290,76098.0,111756,187854.0,74436.0,28.38,0.0,Low Risk
U497,2024,2,276314.0,Stable Salary & Increasing Fixed Expenses,262290,76098.0,132830,208928.0,53362.0,20.34,0.01,Medium Risk
U497,2024,3,329676.0,Stable Salary & Increasing Fixed Expenses,262290,76098.0,177206,253304.0,8986.0,3.43,0.03,High Risk
U497,2024,4,338662.0,Stable Salary & Increasing Fixed Expenses,262290,76098.0,105518,181616.0,80674.0,30.76,-0.01,Low Risk
U497,2024,5,419336.0,Stable Salary & Increasing Fixed Expenses,262290,76098.0,154263,230361.0,31929.0,12.17,0.03,High Risk
U497,2024,6,451265.0,Stable Salary & Increasing Fixed Expenses,262290,76098.0,115994,192092.0,70198.0,26.76,-0.0,Low Risk
U497,2024,7,521463.0,Stable Salary & Increasing Fixed Expenses,262290,76098.0,153383,229481.0,32809.0,12.51,-0.05,High Risk
U497,2024,8,554272.0,Stable Salary & Increasing Fixed Expenses,262290,76098.0,136402,212500.0,49790.0,18.98,0.02,Medium Risk
U497,2024,9,604062.0,Stable Salary & Increasing Fixed Expenses,262290,76098.0,133539,209637.0,52653.0,20.07,0.04,Medium Risk
U497,2024,10,656715.0,Stable Salary & Increasing Fixed Expenses,262290,76098.0,173383,249481.0,12809.0,4.88,-0.04,High Risk
U497,2024,11,669524.0,Stable Salary & Increasing Fixed Expenses,262290,76098.0,150074,226172.0,36118.0,13.77,0.04,High Risk
U497,2024,12,705642.0,Stable Salary & Increasing Fixed Expenses,262290,76098.0,131650,207748.0,54542.0,20.79,0.04,Medium Risk
U498,2024,1,237727.0,Stable Salary & Increasing Fixed Expenses,60325,24344.0,24933,49277.0,11048.0,18.31,0.03,Medium Risk
U498,2024,2,248775.0,Stable Salary & Increasing Fixed Expenses,60325,24344.0,24465,48809.0,11516.0,19.09,0.01,Medium Risk
U498,2024,3,260291.0,Stable Salary & Increasing Fixed Expenses,60325,24344.0,38992,63336.0,-3011.0,-4.99,0.05,High Risk
U498,2024,4,257280.0,Stable Salary & Increasing Fixed Expenses,60325,24344.0,28596,52940.0,7385.0,12.24,0.02,High Risk
U498,2024,5,264665.0,Stable Salary & Increasing Fixed Expenses,60325,24344.0,27290,51634.0,8691.0,14.41,-0.01,High Risk
U498,2024,6,273356.0,Stable Salary & Increasing Fixed Expenses,60325,24344.0,35784,60128.0,197.0,0.33,0.05,High Risk
U498,2024,7,273553.0,Stable Salary & Increasing Fixed Expenses,60325,24344.0,29565,53909.0,6416.0,10.64,-0.03,High Risk
U498,2024,8,279969.0,Stable Salary & Increasing Fixed Expenses,60325,24344.0,33685,58029.0,2296.0,3.81,-0.01,High Risk
U498,2024,9,282265.0,Stable Salary & Increasing Fixed Expenses,60325,24344.0,33222,57566.0,2759.0,4.57,0.04,High Risk
U498,2024,10,285024.0,Stable Salary & Increasing Fixed Expenses,60325,24344.0,41924,66268.0,-5943.0,-9.85,-0.03,High Risk
U498,2024,11,279081.0,Stable Salary & Increasing Fixed Expenses,60325,25506.0,33164,58670.0,1655.0,2.74,0.03,High Risk
U498,2024,12,280736.0,Stable Salary & Increasing Fixed Expenses,60325,25506.0,34493,59999.0,326.0,0.54,0.02,High Risk
U499,2024,1,208824.0,Stable Salary & Stable Fixed Expenses,64369,28724.0,31934,60658.0,3711.0,5.77,0.0,High Risk
U499,2024,2,212535.0,Stable Salary & Stable Fixed Expenses,64369,28724.0,33982,62706.0,1663.0,2.58,-0.01,High Risk
U499,2024,3,214198.0,Stable Salary & Stable Fixed Expenses,64369,28724.0,37655,66379.0,-2010.0,-3.12,0.04,High Risk
U499,2024,4,212188.0,Stable Salary & Stable Fixed Expenses,64369,28724.0,27626,56350.0,8019.0,12.46,0.02,High Risk
U499,2024,5,220207.0,Stable Salary & Stable Fixed Expenses,64369,28724.0,38254,66978.0,-2609.0,-4.05,0.01,High Risk
U499,2024,6,217598.0,Stable Salary & Stable Fixed Expenses,64369,28724.0,37683,66407.0,-2038.0,-3.17,-0.03,High Risk
U499,2024,7,215560.0,Stable Salary & Stable Fixed Expenses,64369,28724.0,33835,62559.0,1810.0,2.81,0.03,High Risk
U499,2024,8,217370.0,Stable Salary & Stable Fixed Expenses,64369,28724.0,32757,61481.0,2888.0,4.49,0.03,High Risk
U499,2024,9,220258.0,Stable Salary & Stable Fixed Expenses,64369,28724.0,26044,54768.0,9601.0,14.92,-0.05,High Risk
U499,2024,10,229859.0,Stable Salary & Stable Fixed Expenses,64369,28724.0,40058,68782.0,-4413.0,-6.86,0.05,High Risk
U499,2024,11,225446.0,Stable Salary & Stable Fixed Expenses,64369,28724.0,29482,58206.0,6163.0,9.57,-0.0,High Risk
U499,2024,12,231609.0,Stable Salary & Stable Fixed Expenses,64369,28724.0,37261,65985.0,-1616.0,-2.51,-0.01,High Risk
U500,2024,1,225484.0,Salary Increases & Fixed Expenses Increase,227747,96797.0,86047,182844.0,44903.0,19.72,-0.04,Medium Risk
U500,2024,2,270387.0,Salary Increases & Fixed Expenses Increase,227747,96797.0,87495,184292.0,43455.0,19.08,-0.03,Medium Risk
U500,2024,3,313842.0,Salary Increases & Fixed Expenses Increase,227747,96797.0,85231,182028.0,45719.0,20.07,0.02,Medium Risk
U500,2024,4,359561.0,Salary Increases & Fixed Expenses Increase,227747,96797.0,81216,178013.0,49734.0,21.84,-0.02,Medium Risk
U500,2024,5,409295.0,Salary Increases & Fixed Expenses Increase,227747,96797.0,70982,167779.0,59968.0,26.33,-0.02,Low Risk
U500,2024,6,469263.0,Salary Increases & Fixed Expenses Increase,227747,96797.0,72886,169683.0,58064.0,25.49,0.04,Low Risk
U500,2024,7,527327.0,Salary Increases & Fixed Expenses Increase,227747,98009.0,73043,171052.0,56695.0,24.89,0.03,Medium Risk
U500,2024,8,584022.0,Salary Increases & Fixed Expenses Increase,241085,98009.0,90943,188952.0,52133.0,21.62,-0.01,Medium Risk
U500,2024,9,636155.0,Salary Increases & Fixed Expenses Increase,241085,98009.0,106080,204089.0,36996.0,15.35,0.03,Medium Risk
U500,2024,10,673151.0,Salary Increases & Fixed Expenses Increase,241085,98590.0,118518,217108.0,23977.0,9.95,-0.04,High Risk
U500,2024,11,697128.0,Salary Increases & Fixed Expenses Increase,241085,98590.0,106830,205420.0,35665.0,14.79,-0.02,High Risk
U500,2024,12,732793.0,Salary Increases & Fixed Expenses Increase,241085,98590.0,108539,207129.0,33956.0,14.08,0.02,High Risk
U501,2024,1,239232.0,Stable Salary & Increasing Fixed Expenses,77488,36113.0,35746,71859.0,5629.0,7.26,-0.04,High Risk
U501,2024,2,244861.0,Stable Salary & Increasing Fixed Expenses,77488,36113.0,35232,71345.0,6143.0,7.93,-0.05,High Risk
U501,2024,3,251004.0,Stable Salary & Increasing Fixed Expenses,77488,36113.0,39079,75192.0,2296.0,2.96,0.02,High Risk
U501,2024,4,253300.0,Stable Salary & Increasing Fixed Expenses,77488,36113.0,42414,78527.0,-1039.0,-1.34,-0.04,High Risk
U501,2024,5,252261.0,Stable Salary & Increasing Fixed Expenses,77488,36113.0,46152,82265.0,-4777.0,-6.16,0.03,High Risk
U501,2024,6,247484.0,Stable Salary & Increasing Fixed Expenses,77488,36113.0,37407,73520.0,3968.0,5.12,-0.04,High Risk
U501,2024,7,251452.0,Stable Salary & Increasing Fixed Expenses,77488,36113.0,41741,77854.0,-366.0,-0.47,-0.03,High Risk
U501,2024,8,251086.0,Stable Salary & Increasing Fixed Expenses,77488,36113.0,35843,71956.0,5532.0,7.14,0.03,High Risk
U501,2024,9,256618.0,Stable Salary & Increasing Fixed Expenses,77488,36113.0,36895,73008.0,4480.0,5.78,-0.05,High Risk
U501,2024,10,261098.0,Stable Salary & Increasing Fixed Expenses,77488,36113.0,32428,68541.0,8947.0,11.55,0.04,High Risk
U501,2024,11,270045.0,Stable Salary & Increasing Fixed Expenses,77488,36113.0,42162,78275.0,-787.0,-1.02,0.03,High Risk
U501,2024,12,269258.0,Stable Salary & Increasing Fixed Expenses,77488,36113.0,45449,81562.0,-4074.0,-5.26,0.04,High Risk
U502,2024,1,225895.0,Stable Salary & Stable Fixed Expenses,164251,41938.0,123093,165031.0,-780.0,-0.47,0.0,High Risk
U502,2024,2,225115.0,Stable Salary & Stable Fixed Expenses,164251,41938.0,113890,155828.0,8423.0,5.13,0.02,High Risk
U502,2024,3,233538.0,Stable Salary & Stable Fixed Expenses,164251,41938.0,114940,156878.0,7373.0,4.49,-0.01,High Risk
U502,2024,4,240911.0,Stable Salary & Stable Fixed Expenses,164251,41938.0,98980,140918.0,23333.0,14.21,-0.01,High Risk
U502,2024,5,264244.0,Stable Salary & Stable Fixed Expenses,164251,41938.0,124386,166324.0,-2073.0,-1.26,-0.03,High Risk
U502,2024,6,262171.0,Stable Salary & Stable Fixed Expenses,164251,41938.0,110660,152598.0,11653.0,7.09,-0.03,High Risk
U502,2024,7,273824.0,Stable Salary & Stable Fixed Expenses,164251,41938.0,114619,156557.0,7694.0,4.68,0.01,High Risk
U502,2024,8,281518.0,Stable Salary & Stable Fixed Expenses,164251,41938.0,110353,152291.0,11960.0,7.28,-0.01,High Risk
U502,2024,9,293478.0,Stable Salary & Stable Fixed Expenses,164251,41938.0,107150,149088.0,15163.0,9.23,-0.01,High Risk
U502,2024,10,308641.0,Stable Salary & Stable Fixed Expenses,164251,41938.0,146186,188124.0,-23873.0,-14.53,0.04,High Risk
U502,2024,11,284768.0,Stable Salary & Stable Fixed Expenses,164251,41938.0,122108,164046.0,205.0,0.12,-0.04,High Risk
U502,2024,12,284973.0,Stable Salary & Stable Fixed Expenses,164251,41938.0,106880,148818.0,15433.0,9.4,0.0,High Risk
U503,2024,1,237069.0,Stable Salary & Stable Fixed Expenses,36482,21276.0,18321,39597.0,-3115.0,-8.54,-0.01,High Risk
U503,2024,2,233954.0,Stable Salary & Stable Fixed Expenses,36482,21276.0,19766,41042.0,-4560.0,-12.5,0.05,High Risk
U503,2024,3,229394.0,Stable Salary & Stable Fixed Expenses,36482,21276.0,21301,42577.0,-6095.0,-16.71,-0.05,High Risk
U503,2024,4,223299.0,Stable Salary & Stable Fixed Expenses,36482,21276.0,21553,42829.0,-6347.0,-17.4,-0.02,High Risk
U503,2024,5,216952.0,Stable Salary & Stable Fixed Expenses,36482,21276.0,18777,40053.0,-3571.0,-9.79,0.01,High Risk
U503,2024,6,213381.0,Stable Salary & Stable Fixed Expenses,36482,21276.0,21422,42698.0,-6216.0,-17.04,-0.02,High Risk
U503,2024,7,207165.0,Stable Salary & Stable Fixed Expenses,36482,21276.0,19895,41171.0,-4689.0,-12.85,-0.04,High Risk
U503,2024,8,202476.0,Stable Salary & Stable Fixed Expenses,36482,21276.0,16243,37519.0,-1037.0,-2.84,-0.03,High Risk
U503,2024,9,201439.0,Stable Salary & Stable Fixed Expenses,36482,21276.0,18637,39913.0,-3431.0,-9.4,0.04,High Risk
U503,2024,10,198008.0,Stable Salary & Stable Fixed Expenses,36482,21276.0,18452,39728.0,-3246.0,-8.9,-0.03,High Risk
U503,2024,11,194762.0,Stable Salary & Stable Fixed Expenses,36482,21276.0,17973,39249.0,-2767.0,-7.58,-0.02,High Risk
U503,2024,12,191995.0,Stable Salary & Stable Fixed Expenses,36482,21276.0,19945,41221.0,-4739.0,-12.99,-0.03,High Risk
U504,2024,1,214203.0,Stable Salary & Increasing Fixed Expenses,281106,81410.0,141732,223142.0,57964.0,20.62,0.03,Medium Risk
U504,2024,2,272167.0,Stable Salary & Increasing Fixed Expenses,281106,81410.0,159526,240936.0,40170.0,14.29,0.04,High Risk
U504,2024,3,312337.0,Stable Salary & Increasing Fixed Expenses,281106,81410.0,140271,221681.0,59425.0,21.14,-0.0,Medium Risk
U504,2024,4,371762.0,Stable Salary & Increasing Fixed Expenses,281106,81410.0,121284,202694.0,78412.0,27.89,0.03,Low Risk
U504,2024,5,450174.0,Stable Salary & Increasing Fixed Expenses,281106,81410.0,150379,231789.0,49317.0,17.54,0.05,Medium Risk
U504,2024,6,499491.0,Stable Salary & Increasing Fixed Expenses,281106,81410.0,149732,231142.0,49964.0,17.77,-0.04,Medium Risk
U504,2024,7,549455.0,Stable Salary & Increasing Fixed Expenses,281106,81410.0,113789,195199.0,85907.0,30.56,-0.02,Low Risk
U504,2024,8,635362.0,Stable Salary & Increasing Fixed Expenses,281106,81410.0,115709,197119.0,83987.0,29.88,0.02,Low Risk
U504,2024,9,719349.0,Stable Salary & Increasing Fixed Expenses,281106,81410.0,134144,215554.0,65552.0,23.32,0.01,Medium Risk
U504,2024,10,784901.0,Stable Salary & Increasing Fixed Expenses,281106,81410.0,184470,265880.0,15226.0,5.42,-0.02,High Risk
U504,2024,11,800127.0,Stable Salary & Increasing Fixed Expenses,281106,81410.0,165808,247218.0,33888.0,12.06,0.04,High Risk
U504,2024,12,834015.0,Stable Salary & Increasing Fixed Expenses,281106,81410.0,155265,236675.0,44431.0,15.81,0.01,Medium Risk
U505,2024,1,242230.0,Salary Increases & Fixed Expenses Decrease,249232,75333.0,116878,192211.0,57021.0,22.88,0.02,Medium Risk
U505,2024,2,299251.0,Salary Increases & Fixed Expenses Decrease,249232,75333.0,128341,203674.0,45558.0,18.28,-0.01,Medium Risk
U505,2024,3,344809.0,Salary Increases & Fixed Expenses Decrease,249232,75333.0,191979,267312.0,-18080.0,-7.25,-0.02,High Risk
U505,2024,4,326729.0,Salary Increases & Fixed Expenses Decrease,268672,75333.0,150175,225508.0,43164.0,16.07,-0.05,Medium Risk
U505,2024,5,369893.0,Salary Increases & Fixed Expenses Decrease,268672,75333.0,154266,229599.0,39073.0,14.54,0.01,High Risk
U505,2024,6,408966.0,Salary Increases & Fixed Expenses Decrease,268672,75333.0,124702,200035.0,68637.0,25.55,-0.02,Low Risk
U505,2024,7,477603.0,Salary Increases & Fixed Expenses Decrease,268672,75333.0,131715,207048.0,61624.0,22.94,0.01,Medium Risk
U505,2024,8,539227.0,Salary Increases & Fixed Expenses Decrease,268672,75333.0,107577,182910.0,85762.0,31.92,0.0,Low Risk
U505,2024,9,624989.0,Salary Increases & Fixed Expenses Decrease,268672,75333.0,110221,185554.0,83118.0,30.94,-0.02,Low Risk
U505,2024,10,708107.0,Salary Increases & Fixed Expenses Decrease,268672,75333.0,141236,216569.0,52103.0,19.39,0.01,Medium Risk
U505,2024,11,760210.0,Salary Increases & Fixed Expenses Decrease,268672,75333.0,124369,199702.0,68970.0,25.67,-0.01,Low Risk
U505,2024,12,829180.0,Salary Increases & Fixed Expenses Decrease,268672,75333.0,128086,203419.0,65253.0,24.29,-0.01,Medium Risk
U506,2024,1,207970.0,Stable Salary & Stable Fixed Expenses,75712,25712.0,22843,48555.0,27157.0,35.87,0.01,Low Risk
U506,2024,2,235127.0,Stable Salary & Stable Fixed Expenses,75712,25712.0,26900,52612.0,23100.0,30.51,0.02,Low Risk
U506,2024,3,258227.0,Stable Salary & Stable Fixed Expenses,75712,25712.0,29111,54823.0,20889.0,27.59,0.04,Low Risk
U506,2024,4,279116.0,Stable Salary & Stable Fixed Expenses,75712,25712.0,29018,54730.0,20982.0,27.71,0.01,Low Risk
U506,2024,5,300098.0,Stable Salary & Stable Fixed Expenses,75712,25712.0,25363,51075.0,24637.0,32.54,0.05,Low Risk
U506,2024,6,324735.0,Stable Salary & Stable Fixed Expenses,75712,25712.0,29934,55646.0,20066.0,26.5,-0.02,Low Risk
U506,2024,7,344801.0,Stable Salary & Stable Fixed Expenses,75712,25712.0,28878,54590.0,21122.0,27.9,0.02,Low Risk
U506,2024,8,365923.0,Stable Salary & Stable Fixed Expenses,75712,25712.0,25182,50894.0,24818.0,32.78,-0.01,Low Risk
U506,2024,9,390741.0,Stable Salary & Stable Fixed Expenses,75712,25712.0,24440,50152.0,25560.0,33.76,0.01,Low Risk
U506,2024,10,416301.0,Stable Salary & Stable Fixed Expenses,75712,25712.0,24160,49872.0,25840.0,34.13,0.04,Low Risk
U506,2024,11,442141.0,Stable Salary & Stable Fixed Expenses,75712,25712.0,29194,54906.0,20806.0,27.48,-0.01,Low Risk
U506,2024,12,462947.0,Stable Salary & Stable Fixed Expenses,75712,25712.0,28011,53723.0,21989.0,29.04,-0.04,Low Risk
U507,2024,1,221770.0,Salary Increases & Fixed Expenses Remain Stable,97113,33607.0,37676,71283.0,25830.0,26.6,-0.03,Low Risk
U507,2024,2,247600.0,Salary Increases & Fixed Expenses Remain Stable,97113,33607.0,34271,67878.0,29235.0,30.1,-0.02,Low Risk
U507,2024,3,276835.0,Salary Increases & Fixed Expenses Remain Stable,97113,33607.0,38812,72419.0,24694.0,25.43,-0.03,Low Risk
U507,2024,4,301529.0,Salary Increases & Fixed Expenses Remain Stable,116898,33607.0,42524,76131.0,40767.0,34.87,-0.03,Low Risk
U507,2024,5,342296.0,Salary Increases & Fixed Expenses Remain Stable,116898,33607.0,42039,75646.0,41252.0,35.29,-0.03,Low Risk
U507,2024,6,383548.0,Salary Increases & Fixed Expenses Remain Stable,116898,33607.0,36970,70577.0,46321.0,39.63,-0.03,Low Risk
U507,2024,7,429869.0,Salary Increases & Fixed Expenses Remain Stable,116898,33607.0,45849,79456.0,37442.0,32.03,-0.0,Low Risk
U507,2024,8,467311.0,Salary Increases & Fixed Expenses Remain Stable,116898,33607.0,44376,77983.0,38915.0,33.29,0.01,Low Risk
U507,2024,9,506226.0,Salary Increases & Fixed Expenses Remain Stable,116898,33607.0,45909,79516.0,37382.0,31.98,0.04,Low Risk
U507,2024,10,543608.0,Salary Increases & Fixed Expenses Remain Stable,116898,33607.0,57299,90906.0,25992.0,22.23,-0.01,Medium Risk
U507,2024,11,569600.0,Salary Increases & Fixed Expenses Remain Stable,116898,33607.0,38608,72215.0,44683.0,38.22,-0.05,Low Risk
U507,2024,12,614283.0,Salary Increases & Fixed Expenses Remain Stable,116898,33607.0,45825,79432.0,37466.0,32.05,-0.04,Low Risk
U508,2024,1,232933.0,Salary Increases & Fixed Expenses Remain Stable,172402,79758.0,90087,169845.0,2557.0,1.48,0.01,High Risk
U508,2024,2,235490.0,Salary Increases & Fixed Expenses Remain Stable,172402,79758.0,95441,175199.0,-2797.0,-1.62,-0.04,High Risk
U508,2024,3,232693.0,Salary Increases & Fixed Expenses Remain Stable,172402,79758.0,90949,170707.0,1695.0,0.98,0.02,High Risk
U508,2024,4,234388.0,Salary Increases & Fixed Expenses Remain Stable,172402,79758.0,75489,155247.0,17155.0,9.95,-0.04,High Risk
U508,2024,5,251543.0,Salary Increases & Fixed Expenses Remain Stable,172402,79758.0,84434,164192.0,8210.0,4.76,-0.02,High Risk
U508,2024,6,259753.0,Salary Increases & Fixed Expenses Remain Stable,172402,79758.0,75095,154853.0,17549.0,10.18,-0.02,High Risk
U508,2024,7,277302.0,Salary Increases & Fixed Expenses Remain Stable,202336,79758.0,92364,172122.0,30214.0,14.93,-0.03,High Risk
U508,2024,8,307516.0,Salary Increases & Fixed Expenses Remain Stable,202336,79758.0,115613,195371.0,6965.0,3.44,0.0,High Risk
U508,2024,9,314481.0,Salary Increases & Fixed Expenses Remain Stable,202336,79758.0,90013,169771.0,32565.0,16.09,0.04,Medium Risk
U508,2024,10,347046.0,Salary Increases & Fixed Expenses Remain Stable,202336,79758.0,120795,200553.0,1783.0,0.88,-0.01,High Risk
U508,2024,11,348829.0,Salary Increases & Fixed Expenses Remain Stable,202336,79758.0,118000,197758.0,4578.0,2.26,0.0,High Risk
U508,2024,12,353407.0,Salary Increases & Fixed Expenses Remain Stable,202336,79758.0,106173,185931.0,16405.0,8.11,0.05,High Risk
U509,2024,1,204181.0,Salary Increases & Fixed Expenses Increase,189959,74956.0,141836,216792.0,-26833.0,-14.13,-0.03,High Risk
U509,2024,2,177348.0,Salary Increases & Fixed Expenses Increase,189959,74956.0,114356,189312.0,647.0,0.34,0.0,High Risk
U509,2024,3,177995.0,Salary Increases & Fixed Expenses Increase,189959,74956.0,182269,257225.0,-67266.0,-35.41,0.01,High Risk
U509,2024,4,110729.0,Salary Increases & Fixed Expenses Increase,189959,74956.0,126793,201749.0,-11790.0,-6.21,-0.05,High Risk
U509,2024,5,98939.0,Salary Increases & Fixed Expenses Increase,219434,75805.0,158209,234014.0,-14580.0,-6.64,-0.03,High Risk
U509,2024,6,84359.0,Salary Increases & Fixed Expenses Increase,219434,75805.0,152564,228369.0,-8935.0,-4.07,-0.01,High Risk
U509,2024,7,75424.0,Salary Increases & Fixed Expenses Increase,219434,76661.0,155195,231856.0,-12422.0,-5.66,0.03,High Risk
U509,2024,8,63002.0,Salary Increases & Fixed Expenses Increase,219434,77722.0,132967,210689.0,8745.0,3.99,-0.01,High Risk
U509,2024,9,71747.0,Salary Increases & Fixed Expenses Increase,219434,79392.0,157765,237157.0,-17723.0,-8.08,0.01,High Risk
U509,2024,10,54024.0,Salary Increases & Fixed Expenses Increase,219434,79392.0,171234,250626.0,-31192.0,-14.21,0.05,High Risk
U509,2024,11,22832.0,Salary Increases & Fixed Expenses Increase,219434,79392.0,198957,278349.0,-58915.0,-26.85,0.02,High Risk
U509,2024,12,-36083.0,Salary Increases & Fixed Expenses Increase,219434,79392.0,185589,264981.0,-45547.0,-20.76,-0.04,High Risk
U510,2024,1,249597.0,Stable Salary & Stable Fixed Expenses,95100,24045.0,32482,56527.0,38573.0,40.56,-0.05,Low Risk
U510,2024,2,288170.0,Stable Salary & Stable Fixed Expenses,95100,24045.0,32591,56636.0,38464.0,40.45,0.01,Low Risk
U510,2024,3,326634.0,Stable Salary & Stable Fixed Expenses,95100,24045.0,37382,61427.0,33673.0,35.41,-0.01,Low Risk
U510,2024,4,360307.0,Stable Salary & Stable Fixed Expenses,95100,24045.0,33758,57803.0,37297.0,39.22,-0.01,Low Risk
U510,2024,5,397604.0,Stable Salary & Stable Fixed Expenses,95100,24045.0,28980,53025.0,42075.0,44.24,0.01,Low Risk
U510,2024,6,439679.0,Stable Salary & Stable Fixed Expenses,95100,24045.0,30913,54958.0,40142.0,42.21,-0.03,Low Risk
U510,2024,7,479821.0,Stable Salary & Stable Fixed Expenses,95100,24045.0,28893,52938.0,42162.0,44.33,0.03,Low Risk
U510,2024,8,521983.0,Stable Salary & Stable Fixed Expenses,95100,24045.0,34851,58896.0,36204.0,38.07,0.04,Low Risk
U510,2024,9,558187.0,Stable Salary & Stable Fixed Expenses,95100,24045.0,33020,57065.0,38035.0,39.99,0.04,Low Risk
U510,2024,10,596222.0,Stable Salary & Stable Fixed Expenses,95100,24045.0,32904,56949.0,38151.0,40.12,-0.05,Low Risk
U510,2024,11,634373.0,Stable Salary & Stable Fixed Expenses,95100,24045.0,36823,60868.0,34232.0,36.0,-0.05,Low Risk
U510,2024,12,668605.0,Stable Salary & Stable Fixed Expenses,95100,24045.0,34691,58736.0,36364.0,38.24,0.05,Low Risk
U511,2024,1,224001.0,Stable Salary & Stable Fixed Expenses,277822,100560.0,179631,280191.0,-2369.0,-0.85,0.05,High Risk
U511,2024,2,221632.0,Stable Salary & Stable Fixed Expenses,277822,100560.0,185626,286186.0,-8364.0,-3.01,-0.04,High Risk
U511,2024,3,213268.0,Stable Salary & Stable Fixed Expenses,277822,100560.0,222386,322946.0,-45124.0,-16.24,0.02,High Risk
U511,2024,4,168144.0,Stable Salary & Stable Fixed Expenses,277822,100560.0,210387,310947.0,-33125.0,-11.92,0.05,High Risk
U511,2024,5,135019.0,Stable Salary & Stable Fixed Expenses,277822,100560.0,220661,321221.0,-43399.0,-15.62,0.01,High Risk
U511,2024,6,91620.0,Stable Salary & Stable Fixed Expenses,277822,100560.0,206468,307028.0,-29206.0,-10.51,-0.0,High Risk
U511,2024,7,62414.0,Stable Salary & Stable Fixed Expenses,277822,100560.0,214710,315270.0,-37448.0,-13.48,-0.0,High Risk
U511,2024,8,24966.0,Stable Salary & Stable Fixed Expenses,277822,100560.0,215053,315613.0,-37791.0,-13.6,-0.02,High Risk
U511,2024,9,-12825.0,Stable Salary & Stable Fixed Expenses,277822,100560.0,190942,291502.0,-13680.0,-4.92,0.05,High Risk
U511,2024,10,-26505.0,Stable Salary & Stable Fixed Expenses,277822,100560.0,204971,305531.0,-27709.0,-9.97,-0.05,High Risk
U511,2024,11,-54214.0,Stable Salary & Stable Fixed Expenses,277822,100560.0,169170,269730.0,8092.0,2.91,-0.02,High Risk
U511,2024,12,-46122.0,Stable Salary & Stable Fixed Expenses,277822,100560.0,190714,291274.0,-13452.0,-4.84,-0.01,High Risk
U512,2024,1,216970.0,Stable Salary & Increasing Fixed Expenses,170109,40267.0,63011,103278.0,66831.0,39.29,0.04,Low Risk
U512,2024,2,283801.0,Stable Salary & Increasing Fixed Expenses,170109,40267.0,52201,92468.0,77641.0,45.64,0.03,Low Risk
U512,2024,3,361442.0,Stable Salary & Increasing Fixed Expenses,170109,40267.0,66704,106971.0,63138.0,37.12,0.05,Low Risk
U512,2024,4,424580.0,Stable Salary & Increasing Fixed Expenses,170109,40267.0,58375,98642.0,71467.0,42.01,-0.03,Low Risk
U512,2024,5,496047.0,Stable Salary & Increasing Fixed Expenses,170109,40267.0,61608,101875.0,68234.0,40.11,-0.04,Low Risk
U512,2024,6,564281.0,Stable Salary & Increasing Fixed Expenses,170109,40267.0,65138,105405.0,64704.0,38.04,-0.05,Low Risk
U512,2024,7,628985.0,Stable Salary & Increasing Fixed Expenses,170109,40267.0,66728,106995.0,63114.0,37.1,0.0,Low Risk
U512,2024,8,692099.0,Stable Salary & Increasing Fixed Expenses,170109,40267.0,53398,93665.0,76444.0,44.94,0.01,Low Risk
U512,2024,9,768543.0,Stable Salary & Increasing Fixed Expenses,170109,41238.0,61235,102473.0,67636.0,39.76,0.02,Low Risk
U512,2024,10,836179.0,Stable Salary & Increasing Fixed Expenses,170109,41238.0,76198,117436.0,52673.0,30.96,-0.04,Low Risk
U512,2024,11,888852.0,Stable Salary & Increasing Fixed Expenses,170109,41238.0,53048,94286.0,75823.0,44.57,0.04,Low Risk
U512,2024,12,964675.0,Stable Salary & Increasing Fixed Expenses,170109,41238.0,63427,104665.0,65444.0,38.47,0.04,Low Risk
U513,2024,1,234975.0,Stable Salary & Increasing Fixed Expenses,50349,35746.0,20235,55981.0,-5632.0,-11.19,-0.01,High Risk
U513,2024,2,229343.0,Stable Salary & Increasing Fixed Expenses,50349,35746.0,22135,57881.0,-7532.0,-14.96,-0.04,High Risk
U513,2024,3,221811.0,Stable Salary & Increasing Fixed Expenses,50349,35746.0,35164,70910.0,-20561.0,-40.84,-0.04,High Risk
U513,2024,4,201250.0,Stable Salary & Increasing Fixed Expenses,50349,35746.0,26376,62122.0,-11773.0,-23.38,0.01,High Risk
U513,2024,5,189477.0,Stable Salary & Increasing Fixed Expenses,50349,36587.0,20589,57176.0,-6827.0,-13.56,-0.02,High Risk
U513,2024,6,182650.0,Stable Salary & Increasing Fixed Expenses,50349,36587.0,21342,57929.0,-7580.0,-15.05,-0.02,High Risk
U513,2024,7,175070.0,Stable Salary & Increasing Fixed Expenses,50349,36587.0,22095,58682.0,-8333.0,-16.55,0.03,High Risk
U513,2024,8,166737.0,Stable Salary & Increasing Fixed Expenses,50349,36587.0,25167,61754.0,-11405.0,-22.65,-0.02,High Risk
U513,2024,9,155332.0,Stable Salary & Increasing Fixed Expenses,50349,36587.0,24756,61343.0,-10994.0,-21.84,-0.04,High Risk
U513,2024,10,144338.0,Stable Salary & Increasing Fixed Expenses,50349,36587.0,38502,75089.0,-24740.0,-49.14,0.0,High Risk
U513,2024,11,119598.0,Stable Salary & Increasing Fixed Expenses,50349,36587.0,23805,60392.0,-10043.0,-19.95,-0.04,High Risk
U513,2024,12,109555.0,Stable Salary & Increasing Fixed Expenses,50349,36587.0,22140,58727.0,-8378.0,-16.64,-0.0,High Risk
U514,2024,1,242662.0,Salary Increases & Fixed Expenses Remain Stable,82888,30893.0,34104,64997.0,17891.0,21.58,0.04,Medium Risk
U514,2024,2,260553.0,Salary Increases & Fixed Expenses Remain Stable,82888,30893.0,44806,75699.0,7189.0,8.67,-0.02,High Risk
U514,2024,3,267742.0,Salary Increases & Fixed Expenses Remain Stable,82888,30893.0,59222,90115.0,-7227.0,-8.72,0.0,High Risk
U514,2024,4,260515.0,Salary Increases & Fixed Expenses Remain Stable,82888,30893.0,33434,64327.0,18561.0,22.39,-0.0,Medium Risk
U514,2024,5,279076.0,Salary Increases & Fixed Expenses Remain Stable,82888,30893.0,48605,79498.0,3390.0,4.09,-0.04,High Risk
U514,2024,6,282466.0,Salary Increases & Fixed Expenses Remain Stable,93091,30893.0,51377,82270.0,10821.0,11.62,-0.02,High Risk
U514,2024,7,293287.0,Salary Increases & Fixed Expenses Remain Stable,93091,30893.0,44453,75346.0,17745.0,19.06,0.03,Medium Risk
U514,2024,8,311032.0,Salary Increases & Fixed Expenses Remain Stable,93091,30893.0,42697,73590.0,19501.0,20.95,-0.03,Medium Risk
U514,2024,9,330533.0,Salary Increases & Fixed Expenses Remain Stable,93091,30893.0,52956,83849.0,9242.0,9.93,0.03,High Risk
U514,2024,10,339775.0,Salary Increases & Fixed Expenses Remain Stable,93091,30893.0,52067,82960.0,10131.0,10.88,-0.03,High Risk
U514,2024,11,349906.0,Salary Increases & Fixed Expenses Remain Stable,93091,30893.0,48738,79631.0,13460.0,14.46,0.04,High Risk
U514,2024,12,363366.0,Salary Increases & Fixed Expenses Remain Stable,93091,30893.0,65106,95999.0,-2908.0,-3.12,-0.02,High Risk
U515,2024,1,229740.0,Stable Salary & Stable Fixed Expenses,45670,11238.0,29533,40771.0,4899.0,10.73,-0.01,High Risk
U515,2024,2,234639.0,Stable Salary & Stable Fixed Expenses,45670,11238.0,28666,39904.0,5766.0,12.63,-0.03,High Risk
U515,2024,3,240405.0,Stable Salary & Stable Fixed Expenses,45670,11238.0,30073,41311.0,4359.0,9.54,-0.04,High Risk
U515,2024,4,244764.0,Stable Salary & Stable Fixed Expenses,45670,11238.0,33659,44897.0,773.0,1.69,-0.0,High Risk
U515,2024,5,245537.0,Stable Salary & Stable Fixed Expenses,45670,11238.0,32788,44026.0,1644.0,3.6,-0.02,High Risk
U515,2024,6,247181.0,Stable Salary & Stable Fixed Expenses,45670,11238.0,29759,40997.0,4673.0,10.23,0.02,High Risk
U515,2024,7,251854.0,Stable Salary & Stable Fixed Expenses,45670,11238.0,32696,43934.0,1736.0,3.8,0.0,High Risk
U515,2024,8,253590.0,Stable Salary & Stable Fixed Expenses,45670,11238.0,32917,44155.0,1515.0,3.32,0.01,High Risk
U515,2024,9,255105.0,Stable Salary & Stable Fixed Expenses,45670,11238.0,33762,45000.0,670.0,1.47,0.04,High Risk
U515,2024,10,255775.0,Stable Salary & Stable Fixed Expenses,45670,11238.0,33066,44304.0,1366.0,2.99,-0.04,High Risk
U515,2024,11,257141.0,Stable Salary & Stable Fixed Expenses,45670,11238.0,28418,39656.0,6014.0,13.17,-0.03,High Risk
U515,2024,12,263155.0,Stable Salary & Stable Fixed Expenses,45670,11238.0,33459,44697.0,973.0,2.13,0.0,High Risk
U516,2024,1,246151.0,Salary Increases & Fixed Expenses Increase,113718,45253.0,80038,125291.0,-11573.0,-10.18,0.02,High Risk
U516,2024,2,234578.0,Salary Increases & Fixed Expenses Increase,113718,45253.0,79694,124947.0,-11229.0,-9.87,0.03,High Risk
U516,2024,3,223349.0,Salary Increases & Fixed Expenses Increase,113718,45253.0,104722,149975.0,-36257.0,-31.88,-0.02,High Risk
U516,2024,4,187092.0,Salary Increases & Fixed Expenses Increase,113718,45253.0,89755,135008.0,-21290.0,-18.72,0.03,High Risk
U516,2024,5,165802.0,Salary Increases & Fixed Expenses Increase,134078,45253.0,82297,127550.0,6528.0,4.87,-0.03,High Risk
U516,2024,6,172330.0,Salary Increases & Fixed Expenses Increase,134078,46674.0,97112,143786.0,-9708.0,-7.24,-0.04,High Risk
U516,2024,7,162622.0,Salary Increases & Fixed Expenses Increase,134078,46674.0,82447,129121.0,4957.0,3.7,-0.03,High Risk
U516,2024,8,167579.0,Salary Increases & Fixed Expenses Increase,134078,46674.0,96485,143159.0,-9081.0,-6.77,-0.04,High Risk
U516,2024,9,158498.0,Salary Increases & Fixed Expenses Increase,134078,47928.0,90647,138575.0,-4497.0,-3.35,0.0,High Risk
U516,2024,10,154001.0,Salary Increases & Fixed Expenses Increase,134078,47928.0,115287,163215.0,-29137.0,-21.73,0.03,High Risk
U516,2024,11,124864.0,Salary Increases & Fixed Expenses Increase,134078,47928.0,98033,145961.0,-11883.0,-8.86,-0.03,High Risk
U516,2024,12,112981.0,Salary Increases & Fixed Expenses Increase,134078,47928.0,118242,166170.0,-32092.0,-23.94,0.03,High Risk
U517,2024,1,244456.0,Salary Increases & Fixed Expenses Remain Stable,259697,89966.0,125648,215614.0,44083.0,16.97,0.03,Medium Risk
U517,2024,2,288539.0,Salary Increases & Fixed Expenses Remain Stable,259697,89966.0,151265,241231.0,18466.0,7.11,-0.0,High Risk
U517,2024,3,307005.0,Salary Increases & Fixed Expenses Remain Stable,259697,89966.0,114500,204466.0,55231.0,21.27,-0.0,Medium Risk
U517,2024,4,362236.0,Salary Increases & Fixed Expenses Remain Stable,289329,89966.0,168175,258141.0,31188.0,10.78,0.04,High Risk
U517,2024,5,393424.0,Salary Increases & Fixed Expenses Remain Stable,289329,89966.0,129602,219568.0,69761.0,24.11,-0.03,Medium Risk
U517,2024,6,463185.0,Salary Increases & Fixed Expenses Remain Stable,289329,89966.0,156901,246867.0,42462.0,14.68,-0.0,High Risk
U517,2024,7,505647.0,Salary Increases & Fixed Expenses Remain Stable,289329,89966.0,130079,220045.0,69284.0,23.95,0.05,Medium Risk
U517,2024,8,574931.0,Salary Increases & Fixed Expenses Remain Stable,289329,89966.0,162703,252669.0,36660.0,12.67,0.02,High Risk
U517,2024,9,611591.0,Salary Increases & Fixed Expenses Remain Stable,289329,89966.0,125164,215130.0,74199.0,25.65,0.04,Low Risk
U517,2024,10,685790.0,Salary Increases & Fixed Expenses Remain Stable,289329,89966.0,156778,246744.0,42585.0,14.72,-0.01,High Risk
U517,2024,11,728375.0,Salary Increases & Fixed Expenses Remain Stable,289329,89966.0,126771,216737.0,72592.0,25.09,0.03,Low Risk
U517,2024,12,800967.0,Salary Increases & Fixed Expenses Remain Stable,289329,89966.0,166379,256345.0,32984.0,11.4,-0.04,High Risk
U518,2024,1,229475.0,Stable Salary & Increasing Fixed Expenses,214550,118978.0,80392,199370.0,15180.0,7.08,0.05,High Risk
U518,2024,2,244655.0,Stable Salary & Increasing Fixed Expenses,214550,118978.0,85752,204730.0,9820.0,4.58,-0.05,High Risk
U518,2024,3,254475.0,Stable Salary & Increasing Fixed Expenses,214550,118978.0,90011,208989.0,5561.0,2.59,0.04,High Risk
U518,2024,4,260036.0,Stable Salary & Increasing Fixed Expenses,214550,118978.0,71611,190589.0,23961.0,11.17,-0.03,High Risk
U518,2024,5,283997.0,Stable Salary & Increasing Fixed Expenses,214550,118978.0,77837,196815.0,17735.0,8.27,0.05,High Risk
U518,2024,6,301732.0,Stable Salary & Increasing Fixed Expenses,214550,118978.0,81650,200628.0,13922.0,6.49,-0.01,High Risk
U518,2024,7,315654.0,Stable Salary & Increasing Fixed Expenses,214550,118978.0,72606,191584.0,22966.0,10.7,-0.05,High Risk
U518,2024,8,338620.0,Stable Salary & Increasing Fixed Expenses,214550,118978.0,79937,198915.0,15635.0,7.29,-0.01,High Risk
U518,2024,9,354255.0,Stable Salary & Increasing Fixed Expenses,214550,118978.0,69419,188397.0,26153.0,12.19,0.02,High Risk
U518,2024,10,380408.0,Stable Salary & Increasing Fixed Expenses,214550,118978.0,72464,191442.0,23108.0,10.77,0.01,High Risk
U518,2024,11,403516.0,Stable Salary & Increasing Fixed Expenses,214550,118978.0,76197,195175.0,19375.0,9.03,0.01,High Risk
U518,2024,12,422891.0,Stable Salary & Increasing Fixed Expenses,214550,118978.0,76485,195463.0,19087.0,8.9,0.02,High Risk
U519,2024,1,231206.0,Stable Salary & Increasing Fixed Expenses,164004,73511.0,93153,166664.0,-2660.0,-1.62,-0.03,High Risk
U519,2024,2,228546.0,Stable Salary & Increasing Fixed Expenses,164004,73511.0,94264,167775.0,-3771.0,-2.3,-0.03,High Risk
U519,2024,3,224775.0,Stable Salary & Increasing Fixed Expenses,164004,73511.0,107715,181226.0,-17222.0,-10.5,-0.05,High Risk
U519,2024,4,207553.0,Stable Salary & Increasing Fixed Expenses,164004,73511.0,88078,161589.0,2415.0,1.47,0.03,High Risk
U519,2024,5,209968.0,Stable Salary & Increasing Fixed Expenses,164004,73511.0,66102,139613.0,24391.0,14.87,-0.01,High Risk
U519,2024,6,234359.0,Stable Salary & Increasing Fixed Expenses,164004,73511.0,95589,169100.0,-5096.0,-3.11,0.01,High Risk
U519,2024,7,229263.0,Stable Salary & Increasing Fixed Expenses,164004,73511.0,66188,139699.0,24305.0,14.82,-0.04,High Risk
U519,2024,8,253568.0,Stable Salary & Increasing Fixed Expenses,164004,73511.0,73544,147055.0,16949.0,10.33,0.0,High Risk
U519,2024,9,270517.0,Stable Salary & Increasing Fixed Expenses,164004,73511.0,81861,155372.0,8632.0,5.26,0.0,High Risk
U519,2024,10,279149.0,Stable Salary & Increasing Fixed Expenses,164004,73511.0,101426,174937.0,-10933.0,-6.67,-0.04,High Risk
U519,2024,11,268216.0,Stable Salary & Increasing Fixed Expenses,164004,74838.0,97013,171851.0,-7847.0,-4.78,-0.04,High Risk
U519,2024,12,260369.0,Stable Salary & Increasing Fixed Expenses,164004,74838.0,95428,170266.0,-6262.0,-3.82,-0.04,High Risk
U520,2024,1,218464.0,Stable Salary & Stable Fixed Expenses,206293,113883.0,136947,250830.0,-44537.0,-21.59,-0.01,High Risk
U520,2024,2,173927.0,Stable Salary & Stable Fixed Expenses,206293,113883.0,144107,257990.0,-51697.0,-25.06,0.05,High Risk
U520,2024,3,122230.0,Stable Salary & Stable Fixed Expenses,206293,113883.0,148382,262265.0,-55972.0,-27.13,0.0,High Risk
U520,2024,4,66258.0,Stable Salary & Stable Fixed Expenses,206293,113883.0,137028,250911.0,-44618.0,-21.63,0.04,High Risk
U520,2024,5,21640.0,Stable Salary & Stable Fixed Expenses,206293,113883.0,132884,246767.0,-40474.0,-19.62,-0.0,High Risk
U520,2024,6,-18834.0,Stable Salary & Stable Fixed Expenses,206293,113883.0,151366,265249.0,-58956.0,-28.58,0.04,High Risk
U520,2024,7,-77790.0,Stable Salary & Stable Fixed Expenses,206293,113883.0,130598,244481.0,-38188.0,-18.51,-0.02,High Risk
U520,2024,8,-115978.0,Stable Salary & Stable Fixed Expenses,206293,113883.0,150803,264686.0,-58393.0,-28.31,-0.02,High Risk
U520,2024,9,-174371.0,Stable Salary & Stable Fixed Expenses,206293,113883.0,153195,267078.0,-60785.0,-29.47,0.0,High Risk
U520,2024,10,-235156.0,Stable Salary & Stable Fixed Expenses,206293,113883.0,147884,261767.0,-55474.0,-26.89,-0.03,High Risk
U520,2024,11,-290630.0,Stable Salary & Stable Fixed Expenses,206293,113883.0,141726,255609.0,-49316.0,-23.91,-0.02,High Risk
U520,2024,12,-339946.0,Stable Salary & Stable Fixed Expenses,206293,113883.0,125733,239616.0,-33323.0,-16.15,0.0,High Risk
U521,2024,1,214513.0,Salary Increases & Fixed Expenses Remain Stable,168262,53572.0,61504,115076.0,53186.0,31.61,-0.05,Low Risk
U521,2024,2,267699.0,Salary Increases & Fixed Expenses Remain Stable,168262,53572.0,51840,105412.0,62850.0,37.35,-0.02,Low Risk
U521,2024,3,330549.0,Salary Increases & Fixed Expenses Remain Stable,168262,53572.0,68671,122243.0,46019.0,27.35,-0.02,Low Risk
U521,2024,4,376568.0,Salary Increases & Fixed Expenses Remain Stable,168262,53572.0,57062,110634.0,57628.0,34.25,0.03,Low Risk
U521,2024,5,434196.0,Salary Increases & Fixed Expenses Remain Stable,190094,53572.0,59485,113057.0,77037.0,40.53,-0.04,Low Risk
U521,2024,6,511233.0,Salary Increases & Fixed Expenses Remain Stable,190094,53572.0,69190,122762.0,67332.0,35.42,0.04,Low Risk
U521,2024,7,578565.0,Salary Increases & Fixed Expenses Remain Stable,190094,53572.0,72425,125997.0,64097.0,33.72,-0.02,Low Risk
U521,2024,8,642662.0,Salary Increases & Fixed Expenses Remain Stable,190094,53572.0,69282,122854.0,67240.0,35.37,-0.04,Low Risk
U521,2024,9,709902.0,Salary Increases & Fixed Expenses Remain Stable,190094,53572.0,70355,123927.0,66167.0,34.81,-0.03,Low Risk
U521,2024,10,776069.0,Salary Increases & Fixed Expenses Remain Stable,190094,53572.0,85200,138772.0,51322.0,27.0,-0.02,Low Risk
U521,2024,11,827391.0,Salary Increases & Fixed Expenses Remain Stable,190094,53572.0,70309,123881.0,66213.0,34.83,-0.05,Low Risk
U521,2024,12,893604.0,Salary Increases & Fixed Expenses Remain Stable,190094,53572.0,62911,116483.0,73611.0,38.72,0.02,Low Risk
U522,2024,1,248079.0,Stable Salary & Stable Fixed Expenses,243209,77787.0,127565,205352.0,37857.0,15.57,0.05,Medium Risk
U522,2024,2,285936.0,Stable Salary & Stable Fixed Expenses,243209,77787.0,98505,176292.0,66917.0,27.51,-0.03,Low Risk
U522,2024,3,352853.0,Stable Salary & Stable Fixed Expenses,243209,77787.0,153421,231208.0,12001.0,4.93,-0.01,High Risk
U522,2024,4,364854.0,Stable Salary & Stable Fixed Expenses,243209,77787.0,125848,203635.0,39574.0,16.27,0.03,Medium Risk
U522,2024,5,404428.0,Stable Salary & Stable Fixed Expenses,243209,77787.0,106102,183889.0,59320.0,24.39,0.04,Medium Risk
U522,2024,6,463748.0,Stable Salary & Stable Fixed Expenses,243209,77787.0,110458,188245.0,54964.0,22.6,0.01,Medium Risk
U522,2024,7,518712.0,Stable Salary & Stable Fixed Expenses,243209,77787.0,107261,185048.0,58161.0,23.91,0.01,Medium Risk
U522,2024,8,576873.0,Stable Salary & Stable Fixed Expenses,243209,77787.0,132633,210420.0,32789.0,13.48,0.04,High Risk
U522,2024,9,609662.0,Stable Salary & Stable Fixed Expenses,243209,77787.0,112622,190409.0,52800.0,21.71,-0.02,Medium Risk
U522,2024,10,662462.0,Stable Salary & Stable Fixed Expenses,243209,77787.0,178235,256022.0,-12813.0,-5.27,-0.0,High Risk
U522,2024,11,649649.0,Stable Salary & Stable Fixed Expenses,243209,77787.0,137876,215663.0,27546.0,11.33,-0.01,High Risk
U522,2024,12,677195.0,Stable Salary & Stable Fixed Expenses,243209,77787.0,145220,223007.0,20202.0,8.31,-0.01,High Risk
U523,2024,1,209732.0,Salary Increases & Fixed Expenses Remain Stable,186184,70534.0,69269,139803.0,46381.0,24.91,0.02,Medium Risk
U523,2024,2,256113.0,Salary Increases & Fixed Expenses Remain Stable,186184,70534.0,63783,134317.0,51867.0,27.86,0.04,Low Risk
U523,2024,3,307980.0,Salary Increases & Fixed Expenses Remain Stable,186184,70534.0,86380,156914.0,29270.0,15.72,0.03,Medium Risk
U523,2024,4,337250.0,Salary Increases & Fixed Expenses Remain Stable,186184,70534.0,60353,130887.0,55297.0,29.7,0.0,Low Risk
U523,2024,5,392547.0,Salary Increases & Fixed Expenses Remain Stable,200540,70534.0,69815,140349.0,60191.0,30.01,-0.03,Low Risk
U523,2024,6,452738.0,Salary Increases & Fixed Expenses Remain Stable,200540,70534.0,60306,130840.0,69700.0,34.76,-0.0,Low Risk
U523,2024,7,522438.0,Salary Increases & Fixed Expenses Remain Stable,200540,70534.0,65583,136117.0,64423.0,32.12,-0.04,Low Risk
U523,2024,8,586861.0,Salary Increases & Fixed Expenses Remain Stable,200540,70534.0,68943,139477.0,61063.0,30.45,-0.03,Low Risk
U523,2024,9,647924.0,Salary Increases & Fixed Expenses Remain Stable,200540,70534.0,84702,155236.0,45304.0,22.59,-0.01,Medium Risk
U523,2024,10,693228.0,Salary Increases & Fixed Expenses Remain Stable,200540,70534.0,85324,155858.0,44682.0,22.28,-0.04,Medium Risk
U523,2024,11,737910.0,Salary Increases & Fixed Expenses Remain Stable,200540,70534.0,76820,147354.0,53186.0,26.52,0.02,Low Risk
U523,2024,12,791096.0,Salary Increases & Fixed Expenses Remain Stable,200540,70534.0,89124,159658.0,40882.0,20.39,0.01,Medium Risk
U524,2024,1,210669.0,Salary Increases & Fixed Expenses Decrease,101927,78877.0,48044,126921.0,-24994.0,-24.52,0.02,High Risk
U524,2024,2,185675.0,Salary Increases & Fixed Expenses Decrease,101927,78877.0,51973,130850.0,-28923.0,-28.38,-0.01,High Risk
U524,2024,3,156752.0,Salary Increases & Fixed Expenses Decrease,101927,78877.0,55166,134043.0,-32116.0,-31.51,-0.04,High Risk
U524,2024,4,124636.0,Salary Increases & Fixed Expenses Decrease,101927,78877.0,54134,133011.0,-31084.0,-30.5,0.04,High Risk
U524,2024,5,93552.0,Salary Increases & Fixed Expenses Decrease,101927,78129.0,50820,128949.0,-27022.0,-26.51,-0.02,High Risk
U524,2024,6,66530.0,Salary Increases & Fixed Expenses Decrease,101927,78129.0,58834,136963.0,-35036.0,-34.37,-0.0,High Risk
U524,2024,7,31494.0,Salary Increases & Fixed Expenses Decrease,127797,78129.0,75943,154072.0,-26275.0,-20.56,-0.04,High Risk
U524,2024,8,5219.0,Salary Increases & Fixed Expenses Decrease,127797,78129.0,75294,153423.0,-25626.0,-20.05,-0.02,High Risk
U524,2024,9,-20407.0,Salary Increases & Fixed Expenses Decrease,127797,78129.0,73238,151367.0,-23570.0,-18.44,0.04,High Risk
U524,2024,10,-43977.0,Salary Increases & Fixed Expenses Decrease,127797,78129.0,74083,152212.0,-24415.0,-19.1,-0.03,High Risk
U524,2024,11,-68392.0,Salary Increases & Fixed Expenses Decrease,127797,78129.0,68310,146439.0,-18642.0,-14.59,-0.02,High Risk
U524,2024,12,-87034.0,Salary Increases & Fixed Expenses Decrease,127797,78129.0,93247,171376.0,-43579.0,-34.1,0.03,High Risk
U525,2024,1,208590.0,Stable Salary & Stable Fixed Expenses,137347,40314.0,94677,134991.0,2356.0,1.72,0.02,High Risk
U525,2024,2,210946.0,Stable Salary & Stable Fixed Expenses,137347,40314.0,89702,130016.0,7331.0,5.34,0.03,High Risk
U525,2024,3,218277.0,Stable Salary & Stable Fixed Expenses,137347,40314.0,91263,131577.0,5770.0,4.2,0.05,High Risk
U525,2024,4,224047.0,Stable Salary & Stable Fixed Expenses,137347,40314.0,109058,149372.0,-12025.0,-8.76,-0.03,High Risk
U525,2024,5,212022.0,Stable Salary & Stable Fixed Expenses,137347,40314.0,97773,138087.0,-740.0,-0.54,-0.01,High Risk
U525,2024,6,211282.0,Stable Salary & Stable Fixed Expenses,137347,40314.0,107657,147971.0,-10624.0,-7.74,-0.04,High Risk
U525,2024,7,200658.0,Stable Salary & Stable Fixed Expenses,137347,40314.0,93424,133738.0,3609.0,2.63,0.01,High Risk
U525,2024,8,204267.0,Stable Salary & Stable Fixed Expenses,137347,40314.0,85649,125963.0,11384.0,8.29,0.03,High Risk
U525,2024,9,215651.0,Stable Salary & Stable Fixed Expenses,137347,40314.0,99845,140159.0,-2812.0,-2.05,-0.02,High Risk
U525,2024,10,212839.0,Stable Salary & Stable Fixed Expenses,137347,40314.0,107453,147767.0,-10420.0,-7.59,-0.04,High Risk
U525,2024,11,202419.0,Stable Salary & Stable Fixed Expenses,137347,40314.0,104528,144842.0,-7495.0,-5.46,-0.05,High Risk
U525,2024,12,194924.0,Stable Salary & Stable Fixed Expenses,137347,40314.0,101658,141972.0,-4625.0,-3.37,0.03,High Risk
U526,2024,1,243946.0,Stable Salary & Increasing Fixed Expenses,199890,60465.0,118807,179272.0,20618.0,10.31,0.01,High Risk
U526,2024,2,264564.0,Stable Salary & Increasing Fixed Expenses,199890,60465.0,100729,161194.0,38696.0,19.36,-0.01,Medium Risk
U526,2024,3,303260.0,Stable Salary & Increasing Fixed Expenses,199890,60465.0,115664,176129.0,23761.0,11.89,-0.04,High Risk
U526,2024,4,327021.0,Stable Salary & Increasing Fixed Expenses,199890,60465.0,86131,146596.0,53294.0,26.66,-0.03,Low Risk
U526,2024,5,380315.0,Stable Salary & Increasing Fixed Expenses,199890,60465.0,99393,159858.0,40032.0,20.03,-0.0,Medium Risk
U526,2024,6,420347.0,Stable Salary & Increasing Fixed Expenses,199890,61703.0,111992,173695.0,26195.0,13.1,-0.02,High Risk
U526,2024,7,446542.0,Stable Salary & Increasing Fixed Expenses,199890,62851.0,98968,161819.0,38071.0,19.05,0.01,Medium Risk
U526,2024,8,484613.0,Stable Salary & Increasing Fixed Expenses,199890,64645.0,118634,183279.0,16611.0,8.31,-0.02,High Risk
U526,2024,9,501224.0,Stable Salary & Increasing Fixed Expenses,199890,66087.0,93152,159239.0,40651.0,20.34,0.02,Medium Risk
U526,2024,10,541875.0,Stable Salary & Increasing Fixed Expenses,199890,66087.0,101041,167128.0,32762.0,16.39,0.03,Medium Risk
U526,2024,11,574637.0,Stable Salary & Increasing Fixed Expenses,199890,68012.0,111563,179575.0,20315.0,10.16,-0.03,High Risk
U526,2024,12,594952.0,Stable Salary & Increasing Fixed Expenses,199890,68936.0,109857,178793.0,21097.0,10.55,0.01,High Risk
U527,2024,1,230369.0,Stable Salary & Increasing Fixed Expenses,121622,74009.0,90559,164568.0,-42946.0,-35.31,0.01,High Risk
U527,2024,2,187423.0,Stable Salary & Increasing Fixed Expenses,121622,74009.0,75058,149067.0,-27445.0,-22.57,0.05,High Risk
U527,2024,3,159978.0,Stable Salary & Increasing Fixed Expenses,121622,74009.0,98179,172188.0,-50566.0,-41.58,0.03,High Risk
U527,2024,4,109412.0,Stable Salary & Increasing Fixed Expenses,121622,74009.0,73582,147591.0,-25969.0,-21.35,-0.04,High Risk
U527,2024,5,83443.0,Stable Salary & Increasing Fixed Expenses,121622,74009.0,84248,158257.0,-36635.0,-30.12,-0.04,High Risk
U527,2024,6,46808.0,Stable Salary & Increasing Fixed Expenses,121622,74009.0,87378,161387.0,-39765.0,-32.7,-0.05,High Risk
U527,2024,7,7043.0,Stable Salary & Increasing Fixed Expenses,121622,74009.0,91868,165877.0,-44255.0,-36.39,0.03,High Risk
U527,2024,8,-37212.0,Stable Salary & Increasing Fixed Expenses,121622,74009.0,75515,149524.0,-27902.0,-22.94,0.04,High Risk
U527,2024,9,-65114.0,Stable Salary & Increasing Fixed Expenses,121622,74009.0,82312,156321.0,-34699.0,-28.53,0.02,High Risk
U527,2024,10,-99813.0,Stable Salary & Increasing Fixed Expenses,121622,74009.0,87390,161399.0,-39777.0,-32.71,0.01,High Risk
U527,2024,11,-139590.0,Stable Salary & Increasing Fixed Expenses,121622,75202.0,93615,168817.0,-47195.0,-38.8,0.02,High Risk
U527,2024,12,-186785.0,Stable Salary & Increasing Fixed Expenses,121622,76914.0,81880,158794.0,-37172.0,-30.56,0.01,High Risk
U528,2024,1,242878.0,Salary Increases & Fixed Expenses Remain Stable,120201,76903.0,67127,144030.0,-23829.0,-19.82,-0.03,High Risk
U528,2024,2,219049.0,Salary Increases & Fixed Expenses Remain Stable,120201,76903.0,63448,140351.0,-20150.0,-16.76,0.01,High Risk
U528,2024,3,198899.0,Salary Increases & Fixed Expenses Remain Stable,136172,76903.0,61530,138433.0,-2261.0,-1.66,0.01,High Risk
U528,2024,4,196638.0,Salary Increases & Fixed Expenses Remain Stable,136172,76903.0,60047,136950.0,-778.0,-0.57,0.04,High Risk
U528,2024,5,195860.0,Salary Increases & Fixed Expenses Remain Stable,136172,76903.0,55913,132816.0,3356.0,2.46,-0.02,High Risk
U528,2024,6,199216.0,Salary Increases & Fixed Expenses Remain Stable,136172,76903.0,76116,153019.0,-16847.0,-12.37,0.0,High Risk
U528,2024,7,182369.0,Salary Increases & Fixed Expenses Remain Stable,136172,76903.0,70617,147520.0,-11348.0,-8.33,0.02,High Risk
U528,2024,8,171021.0,Salary Increases & Fixed Expenses Remain Stable,136172,76903.0,63162,140065.0,-3893.0,-2.86,0.01,High Risk
U528,2024,9,167128.0,Salary Increases & Fixed Expenses Remain Stable,136172,76903.0,60050,136953.0,-781.0,-0.57,0.01,High Risk
U528,2024,10,166347.0,Salary Increases & Fixed Expenses Remain Stable,136172,76903.0,71526,148429.0,-12257.0,-9.0,0.02,High Risk
U528,2024,11,154090.0,Salary Increases & Fixed Expenses Remain Stable,136172,76903.0,69710,146613.0,-10441.0,-7.67,0.02,High Risk
U528,2024,12,143649.0,Salary Increases & Fixed Expenses Remain Stable,136172,76903.0,58366,135269.0,903.0,0.66,-0.03,High Risk
U529,2024,1,248325.0,Salary Increases & Fixed Expenses Increase,112109,59185.0,58645,117830.0,-5721.0,-5.1,0.02,High Risk
U529,2024,2,242604.0,Salary Increases & Fixed Expenses Increase,112109,60337.0,50080,110417.0,1692.0,1.51,-0.04,High Risk
U529,2024,3,244296.0,Salary Increases & Fixed Expenses Increase,112109,61150.0,73125,134275.0,-22166.0,-19.77,-0.05,High Risk
U529,2024,4,222130.0,Salary Increases & Fixed Expenses Increase,112109,61150.0,64777,125927.0,-13818.0,-12.33,0.01,High Risk
U529,2024,5,208312.0,Salary Increases & Fixed Expenses Increase,112109,61150.0,54092,115242.0,-3133.0,-2.79,0.02,High Risk
U529,2024,6,205179.0,Salary Increases & Fixed Expenses Increase,112109,61150.0,66247,127397.0,-15288.0,-13.64,0.02,High Risk
U529,2024,7,189891.0,Salary Increases & Fixed Expenses Increase,112109,61150.0,49676,110826.0,1283.0,1.14,0.02,High Risk
U529,2024,8,191174.0,Salary Increases & Fixed Expenses Increase,131032,62221.0,68949,131170.0,-138.0,-0.11,0.03,High Risk
U529,2024,9,191036.0,Salary Increases & Fixed Expenses Increase,131032,62221.0,64066,126287.0,4745.0,3.62,0.05,High Risk
U529,2024,10,195781.0,Salary Increases & Fixed Expenses Increase,131032,62221.0,75171,137392.0,-6360.0,-4.85,0.01,High Risk
U529,2024,11,189421.0,Salary Increases & Fixed Expenses Increase,131032,62221.0,76972,139193.0,-8161.0,-6.23,-0.04,High Risk
U529,2024,12,181260.0,Salary Increases & Fixed Expenses Increase,131032,62221.0,78421,140642.0,-9610.0,-7.33,0.01,High Risk
U530,2024,1,244856.0,Salary Increases & Fixed Expenses Increase,105673,76919.0,39213,116132.0,-10459.0,-9.9,0.01,High Risk
U530,2024,2,234397.0,Salary Increases & Fixed Expenses Increase,105673,76919.0,33106,110025.0,-4352.0,-4.12,-0.03,High Risk
U530,2024,3,230045.0,Salary Increases & Fixed Expenses Increase,105673,76919.0,51499,128418.0,-22745.0,-21.52,0.02,High Risk
U530,2024,4,207300.0,Salary Increases & Fixed Expenses Increase,105673,76919.0,39817,116736.0,-11063.0,-10.47,0.05,High Risk
U530,2024,5,196237.0,Salary Increases & Fixed Expenses Increase,105673,76919.0,41537,118456.0,-12783.0,-12.1,0.0,High Risk
U530,2024,6,183454.0,Salary Increases & Fixed Expenses Increase,105673,76919.0,32321,109240.0,-3567.0,-3.38,0.01,High Risk
U530,2024,7,179887.0,Salary Increases & Fixed Expenses Increase,118560,77711.0,37998,115709.0,2851.0,2.4,0.0,High Risk
U530,2024,8,182738.0,Salary Increases & Fixed Expenses Increase,118560,77711.0,36665,114376.0,4184.0,3.53,-0.01,High Risk
U530,2024,9,186922.0,Salary Increases & Fixed Expenses Increase,118560,78264.0,44753,123017.0,-4457.0,-3.76,-0.04,High Risk
U530,2024,10,182465.0,Salary Increases & Fixed Expenses Increase,118560,78264.0,54103,132367.0,-13807.0,-11.65,-0.04,High Risk
U530,2024,11,168658.0,Salary Increases & Fixed Expenses Increase,118560,78264.0,44835,123099.0,-4539.0,-3.83,0.05,High Risk
U530,2024,12,164119.0,Salary Increases & Fixed Expenses Increase,118560,79403.0,44554,123957.0,-5397.0,-4.55,-0.02,High Risk
U531,2024,1,229398.0,Salary Increases & Fixed Expenses Increase,297562,82634.0,103954,186588.0,110974.0,37.29,0.02,Low Risk
U531,2024,2,340372.0,Salary Increases & Fixed Expenses Increase,297562,82634.0,107062,189696.0,107866.0,36.25,0.03,Low Risk
U531,2024,3,448238.0,Salary Increases & Fixed Expenses Increase,297562,82634.0,136071,218705.0,78857.0,26.5,0.01,Low Risk
U531,2024,4,527095.0,Salary Increases & Fixed Expenses Increase,297562,83904.0,95343,179247.0,118315.0,39.76,0.04,Low Risk
U531,2024,5,645410.0,Salary Increases & Fixed Expenses Increase,297562,83904.0,104784,188688.0,108874.0,36.59,0.04,Low Risk
U531,2024,6,754284.0,Salary Increases & Fixed Expenses Increase,297562,83904.0,98439,182343.0,115219.0,38.72,0.02,Low Risk
U531,2024,7,869503.0,Salary Increases & Fixed Expenses Increase,297562,83904.0,118683,202587.0,94975.0,31.92,-0.02,Low Risk
U531,2024,8,964478.0,Salary Increases & Fixed Expenses Increase,322285,83904.0,103519,187423.0,134862.0,41.85,0.04,Low Risk
U531,2024,9,1099340.0,Salary Increases & Fixed Expenses Increase,322285,83904.0,120276,204180.0,118105.0,36.65,0.03,Low Risk
U531,2024,10,1217445.0,Salary Increases & Fixed Expenses Increase,322285,83904.0,116969,200873.0,121412.0,37.67,0.04,Low Risk
U531,2024,11,1338857.0,Salary Increases & Fixed Expenses Increase,322285,83904.0,110533,194437.0,127848.0,39.67,0.05,Low Risk
U531,2024,12,1466705.0,Salary Increases & Fixed Expenses Increase,322285,84872.0,126308,211180.0,111105.0,34.47,0.01,Low Risk
U532,2024,1,244984.0,Stable Salary & Decreasing Fixed Expenses,271896,63110.0,134229,197339.0,74557.0,27.42,0.03,Low Risk
U532,2024,2,319541.0,Stable Salary & Decreasing Fixed Expenses,271896,63110.0,130249,193359.0,78537.0,28.88,0.01,Low Risk
U532,2024,3,398078.0,Stable Salary & Decreasing Fixed Expenses,271896,63110.0,184111,247221.0,24675.0,9.08,-0.04,High Risk
U532,2024,4,422753.0,Stable Salary & Decreasing Fixed Expenses,271896,63110.0,151343,214453.0,57443.0,21.13,-0.0,Medium Risk
U532,2024,5,480196.0,Stable Salary & Decreasing Fixed Expenses,271896,63110.0,119045,182155.0,89741.0,33.01,-0.02,Low Risk
U532,2024,6,569937.0,Stable Salary & Decreasing Fixed Expenses,271896,63110.0,148825,211935.0,59961.0,22.05,-0.03,Medium Risk
U532,2024,7,629898.0,Stable Salary & Decreasing Fixed Expenses,271896,63110.0,135780,198890.0,73006.0,26.85,-0.04,Low Risk
U532,2024,8,702904.0,Stable Salary & Decreasing Fixed Expenses,271896,63110.0,125723,188833.0,83063.0,30.55,-0.02,Low Risk
U532,2024,9,785967.0,Stable Salary & Decreasing Fixed Expenses,271896,63110.0,124306,187416.0,84480.0,31.07,-0.02,Low Risk
U532,2024,10,870447.0,Stable Salary & Decreasing Fixed Expenses,271896,63110.0,162133,225243.0,46653.0,17.16,0.02,Medium Risk
U532,2024,11,917100.0,Stable Salary & Decreasing Fixed Expenses,271896,63110.0,132226,195336.0,76560.0,28.16,-0.02,Low Risk
U532,2024,12,993660.0,Stable Salary & Decreasing Fixed Expenses,271896,61269.0,170692,231961.0,39935.0,14.69,-0.0,High Risk
U533,2024,1,236611.0,Stable Salary & Stable Fixed Expenses,128151,59009.0,68476,127485.0,666.0,0.52,-0.01,High Risk
U533,2024,2,237277.0,Stable Salary & Stable Fixed Expenses,128151,59009.0,69215,128224.0,-73.0,-0.06,0.04,High Risk
U533,2024,3,237204.0,Stable Salary & Stable Fixed Expenses,128151,59009.0,80958,139967.0,-11816.0,-9.22,0.03,High Risk
U533,2024,4,225388.0,Stable Salary & Stable Fixed Expenses,128151,59009.0,58703,117712.0,10439.0,8.15,-0.01,High Risk
U533,2024,5,235827.0,Stable Salary & Stable Fixed Expenses,128151,59009.0,70801,129810.0,-1659.0,-1.29,0.01,High Risk
U533,2024,6,234168.0,Stable Salary & Stable Fixed Expenses,128151,59009.0,60203,119212.0,8939.0,6.98,0.05,High Risk
U533,2024,7,243107.0,Stable Salary & Stable Fixed Expenses,128151,59009.0,68097,127106.0,1045.0,0.82,-0.03,High Risk
U533,2024,8,244152.0,Stable Salary & Stable Fixed Expenses,128151,59009.0,71496,130505.0,-2354.0,-1.84,-0.0,High Risk
U533,2024,9,241798.0,Stable Salary & Stable Fixed Expenses,128151,59009.0,58208,117217.0,10934.0,8.53,0.04,High Risk
U533,2024,10,252732.0,Stable Salary & Stable Fixed Expenses,128151,59009.0,75471,134480.0,-6329.0,-4.94,0.05,High Risk
U533,2024,11,246403.0,Stable Salary & Stable Fixed Expenses,128151,59009.0,66854,125863.0,2288.0,1.79,0.0,High Risk
U533,2024,12,248691.0,Stable Salary & Stable Fixed Expenses,128151,59009.0,64233,123242.0,4909.0,3.83,-0.03,High Risk
U534,2024,1,223873.0,Stable Salary & Stable Fixed Expenses,207138,105162.0,76341,181503.0,25635.0,12.38,-0.0,High Risk
U534,2024,2,249508.0,Stable Salary & Stable Fixed Expenses,207138,105162.0,64079,169241.0,37897.0,18.3,-0.05,Medium Risk
U534,2024,3,287405.0,Stable Salary & Stable Fixed Expenses,207138,105162.0,90047,195209.0,11929.0,5.76,-0.0,High Risk
U534,2024,4,299334.0,Stable Salary & Stable Fixed Expenses,207138,105162.0,82695,187857.0,19281.0,9.31,-0.01,High Risk
U534,2024,5,318615.0,Stable Salary & Stable Fixed Expenses,207138,105162.0,69251,174413.0,32725.0,15.8,0.05,Medium Risk
U534,2024,6,351340.0,Stable Salary & Stable Fixed Expenses,207138,105162.0,62256,167418.0,39720.0,19.18,0.02,Medium Risk
U534,2024,7,391060.0,Stable Salary & Stable Fixed Expenses,207138,105162.0,67016,172178.0,34960.0,16.88,0.04,Medium Risk
U534,2024,8,426020.0,Stable Salary & Stable Fixed Expenses,207138,105162.0,78047,183209.0,23929.0,11.55,-0.01,High Risk
U534,2024,9,449949.0,Stable Salary & Stable Fixed Expenses,207138,105162.0,70081,175243.0,31895.0,15.4,0.05,Medium Risk
U534,2024,10,481844.0,Stable Salary & Stable Fixed Expenses,207138,105162.0,96117,201279.0,5859.0,2.83,0.03,High Risk
U534,2024,11,487703.0,Stable Salary & Stable Fixed Expenses,207138,105162.0,75692,180854.0,26284.0,12.69,-0.02,High Risk
U534,2024,12,513987.0,Stable Salary & Stable Fixed Expenses,207138,105162.0,97921,203083.0,4055.0,1.96,0.01,High Risk
U535,2024,1,203362.0,Stable Salary & Stable Fixed Expenses,140229,68235.0,93827,162062.0,-21833.0,-15.57,-0.04,High Risk
U535,2024,2,181529.0,Stable Salary & Stable Fixed Expenses,140229,68235.0,91599,159834.0,-19605.0,-13.98,0.04,High Risk
U535,2024,3,161924.0,Stable Salary & Stable Fixed Expenses,140229,68235.0,106864,175099.0,-34870.0,-24.87,0.0,High Risk
U535,2024,4,127054.0,Stable Salary & Stable Fixed Expenses,140229,68235.0,88905,157140.0,-16911.0,-12.06,0.04,High Risk
U535,2024,5,110143.0,Stable Salary & Stable Fixed Expenses,140229,68235.0,110227,178462.0,-38233.0,-27.26,-0.01,High Risk
U535,2024,6,71910.0,Stable Salary & Stable Fixed Expenses,140229,68235.0,106856,175091.0,-34862.0,-24.86,-0.01,High Risk
U535,2024,7,37048.0,Stable Salary & Stable Fixed Expenses,140229,68235.0,102323,170558.0,-30329.0,-21.63,-0.01,High Risk
U535,2024,8,6719.0,Stable Salary & Stable Fixed Expenses,140229,68235.0,89857,158092.0,-17863.0,-12.74,0.0,High Risk
U535,2024,9,-11144.0,Stable Salary & Stable Fixed Expenses,140229,68235.0,110226,178461.0,-38232.0,-27.26,0.03,High Risk
U535,2024,10,-49376.0,Stable Salary & Stable Fixed Expenses,140229,68235.0,88574,156809.0,-16580.0,-11.82,0.03,High Risk
U535,2024,11,-65956.0,Stable Salary & Stable Fixed Expenses,140229,68235.0,101964,170199.0,-29970.0,-21.37,0.04,High Risk
U535,2024,12,-95926.0,Stable Salary & Stable Fixed Expenses,140229,68235.0,92529,160764.0,-20535.0,-14.64,0.02,High Risk
U536,2024,1,233304.0,Salary Increases & Fixed Expenses Remain Stable,202360,108956.0,104403,213359.0,-10999.0,-5.44,-0.03,High Risk
U536,2024,2,222305.0,Salary Increases & Fixed Expenses Remain Stable,202360,108956.0,120971,229927.0,-27567.0,-13.62,-0.05,High Risk
U536,2024,3,194738.0,Salary Increases & Fixed Expenses Remain Stable,202360,108956.0,132293,241249.0,-38889.0,-19.22,0.04,High Risk
U536,2024,4,155849.0,Salary Increases & Fixed Expenses Remain Stable,202360,108956.0,83200,192156.0,10204.0,5.04,-0.04,High Risk
U536,2024,5,166053.0,Salary Increases & Fixed Expenses Remain Stable,212018,108956.0,121936,230892.0,-18874.0,-8.9,-0.03,High Risk
U536,2024,6,147179.0,Salary Increases & Fixed Expenses Remain Stable,212018,108956.0,99537,208493.0,3525.0,1.66,-0.04,High Risk
U536,2024,7,150704.0,Salary Increases & Fixed Expenses Remain Stable,212018,108956.0,105499,214455.0,-2437.0,-1.15,-0.03,High Risk
U536,2024,8,148267.0,Salary Increases & Fixed Expenses Remain Stable,212018,108956.0,118503,227459.0,-15441.0,-7.28,0.01,High Risk
U536,2024,9,132826.0,Salary Increases & Fixed Expenses Remain Stable,212018,108956.0,86315,195271.0,16747.0,7.9,0.04,High Risk
U536,2024,10,149573.0,Salary Increases & Fixed Expenses Remain Stable,212018,108956.0,150396,259352.0,-47334.0,-22.33,-0.01,High Risk
U536,2024,11,102239.0,Salary Increases & Fixed Expenses Remain Stable,212018,108956.0,111781,220737.0,-8719.0,-4.11,0.04,High Risk
U536,2024,12,93520.0,Salary Increases & Fixed Expenses Remain Stable,212018,108956.0,103167,212123.0,-105.0,-0.05,-0.01,High Risk
U537,2024,1,218870.0,Salary Increases & Fixed Expenses Remain Stable,90918,27410.0,45133,72543.0,18375.0,20.21,-0.02,Medium Risk
U537,2024,2,237245.0,Salary Increases & Fixed Expenses Remain Stable,90918,27410.0,49681,77091.0,13827.0,15.21,0.02,Medium Risk
U537,2024,3,251072.0,Salary Increases & Fixed Expenses Remain Stable,96957,27410.0,47185,74595.0,22362.0,23.06,-0.04,Medium Risk
U537,2024,4,273434.0,Salary Increases & Fixed Expenses Remain Stable,96957,27410.0,40847,68257.0,28700.0,29.6,0.05,Low Risk
U537,2024,5,302134.0,Salary Increases & Fixed Expenses Remain Stable,96957,27410.0,58101,85511.0,11446.0,11.81,0.02,High Risk
U537,2024,6,313580.0,Salary Increases & Fixed Expenses Remain Stable,96957,27410.0,39185,66595.0,30362.0,31.31,0.02,Low Risk
U537,2024,7,343942.0,Salary Increases & Fixed Expenses Remain Stable,96957,27410.0,39623,67033.0,29924.0,30.86,0.01,Low Risk
U537,2024,8,373866.0,Salary Increases & Fixed Expenses Remain Stable,96957,27410.0,42766,70176.0,26781.0,27.62,-0.01,Low Risk
U537,2024,9,400647.0,Salary Increases & Fixed Expenses Remain Stable,96957,27410.0,55710,83120.0,13837.0,14.27,0.0,High Risk
U537,2024,10,414484.0,Salary Increases & Fixed Expenses Remain Stable,96957,27410.0,44075,71485.0,25472.0,26.27,0.03,Low Risk
U537,2024,11,439956.0,Salary Increases & Fixed Expenses Remain Stable,96957,27410.0,53275,80685.0,16272.0,16.78,-0.03,Medium Risk
U537,2024,12,456228.0,Salary Increases & Fixed Expenses Remain Stable,96957,27410.0,53979,81389.0,15568.0,16.06,-0.03,Medium Risk
U538,2024,1,211145.0,Stable Salary & Decreasing Fixed Expenses,238477,76135.0,76289,152424.0,86053.0,36.08,-0.05,Low Risk
U538,2024,2,297198.0,Stable Salary & Decreasing Fixed Expenses,238477,76135.0,85263,161398.0,77079.0,32.32,-0.03,Low Risk
U538,2024,3,374277.0,Stable Salary & Decreasing Fixed Expenses,238477,76135.0,108111,184246.0,54231.0,22.74,0.02,Medium Risk
U538,2024,4,428508.0,Stable Salary & Decreasing Fixed Expenses,238477,76135.0,81853,157988.0,80489.0,33.75,0.05,Low Risk
U538,2024,5,508997.0,Stable Salary & Decreasing Fixed Expenses,238477,76135.0,88437,164572.0,73905.0,30.99,-0.01,Low Risk
U538,2024,6,582902.0,Stable Salary & Decreasing Fixed Expenses,238477,76135.0,91698,167833.0,70644.0,29.62,0.01,Low Risk
U538,2024,7,653546.0,Stable Salary & Decreasing Fixed Expenses,238477,76135.0,83894,160029.0,78448.0,32.9,-0.03,Low Risk
U538,2024,8,731994.0,Stable Salary & Decreasing Fixed Expenses,238477,76135.0,84522,160657.0,77820.0,32.63,-0.01,Low Risk
U538,2024,9,809814.0,Stable Salary & Decreasing Fixed Expenses,238477,76135.0,89962,166097.0,72380.0,30.35,0.0,Low Risk
U538,2024,10,882194.0,Stable Salary & Decreasing Fixed Expenses,238477,76135.0,116774,192909.0,45568.0,19.11,0.02,Medium Risk
U538,2024,11,927762.0,Stable Salary & Decreasing Fixed Expenses,238477,76135.0,72344,148479.0,89998.0,37.74,0.02,Low Risk
U538,2024,12,1017760.0,Stable Salary & Decreasing Fixed Expenses,238477,76135.0,81974,158109.0,80368.0,33.7,0.04,Low Risk
U539,2024,1,246145.0,Salary Increases & Fixed Expenses Remain Stable,266003,111454.0,139889,251343.0,14660.0,5.51,-0.03,High Risk
U539,2024,2,260805.0,Salary Increases & Fixed Expenses Remain Stable,266003,111454.0,149680,261134.0,4869.0,1.83,0.01,High Risk
U539,2024,3,265674.0,Salary Increases & Fixed Expenses Remain Stable,266003,111454.0,153795,265249.0,754.0,0.28,0.05,High Risk
U539,2024,4,266428.0,Salary Increases & Fixed Expenses Remain Stable,266003,111454.0,110411,221865.0,44138.0,16.59,-0.04,Medium Risk
U539,2024,5,310566.0,Salary Increases & Fixed Expenses Remain Stable,266003,111454.0,143655,255109.0,10894.0,4.1,0.0,High Risk
U539,2024,6,321460.0,Salary Increases & Fixed Expenses Remain Stable,266003,111454.0,125946,237400.0,28603.0,10.75,-0.01,High Risk
U539,2024,7,350063.0,Salary Increases & Fixed Expenses Remain Stable,266003,111454.0,114491,225945.0,40058.0,15.06,-0.04,Medium Risk
U539,2024,8,390121.0,Salary Increases & Fixed Expenses Remain Stable,272862,111454.0,156493,267947.0,4915.0,1.8,-0.02,High Risk
U539,2024,9,395036.0,Salary Increases & Fixed Expenses Remain Stable,272862,111454.0,177199,288653.0,-15791.0,-5.79,0.04,High Risk
U539,2024,10,379245.0,Salary Increases & Fixed Expenses Remain Stable,272862,111454.0,132994,244448.0,28414.0,10.41,0.04,High Risk
U539,2024,11,407659.0,Salary Increases & Fixed Expenses Remain Stable,272862,111454.0,180179,291633.0,-18771.0,-6.88,-0.01,High Risk
U539,2024,12,388888.0,Salary Increases & Fixed Expenses Remain Stable,272862,111454.0,166802,278256.0,-5394.0,-1.98,-0.03,High Risk
U540,2024,1,239821.0,Salary Increases & Fixed Expenses Remain Stable,85506,32110.0,31587,63697.0,21809.0,25.51,-0.01,Low Risk
U540,2024,2,261630.0,Salary Increases & Fixed Expenses Remain Stable,85506,32110.0,31043,63153.0,22353.0,26.14,0.01,Low Risk
U540,2024,3,283983.0,Salary Increases & Fixed Expenses Remain Stable,85506,32110.0,34341,66451.0,19055.0,22.28,-0.05,Medium Risk
U540,2024,4,303038.0,Salary Increases & Fixed Expenses Remain Stable,85506,32110.0,32995,65105.0,20401.0,23.86,-0.01,Medium Risk
U540,2024,5,323439.0,Salary Increases & Fixed Expenses Remain Stable,85506,32110.0,29334,61444.0,24062.0,28.14,-0.04,Low Risk
U540,2024,6,347501.0,Salary Increases & Fixed Expenses Remain Stable,112459,32110.0,44231,76341.0,36118.0,32.12,0.02,Low Risk
U540,2024,7,383619.0,Salary Increases & Fixed Expenses Remain Stable,112459,32110.0,41713,73823.0,38636.0,34.36,0.04,Low Risk
U540,2024,8,422255.0,Salary Increases & Fixed Expenses Remain Stable,112459,32110.0,38149,70259.0,42200.0,37.52,0.02,Low Risk
U540,2024,9,464455.0,Salary Increases & Fixed Expenses Remain Stable,112459,32110.0,38706,70816.0,41643.0,37.03,-0.01,Low Risk
U540,2024,10,506098.0,Salary Increases & Fixed Expenses Remain Stable,112459,32110.0,44665,76775.0,35684.0,31.73,0.01,Low Risk
U540,2024,11,541782.0,Salary Increases & Fixed Expenses Remain Stable,112459,32110.0,44200,76310.0,36149.0,32.14,-0.03,Low Risk
U540,2024,12,577931.0,Salary Increases & Fixed Expenses Remain Stable,112459,32110.0,38109,70219.0,42240.0,37.56,-0.01,Low Risk
U541,2024,1,203630.0,Salary Increases & Fixed Expenses Increase,290306,112228.0,125149,237377.0,52929.0,18.23,0.04,Medium Risk
U541,2024,2,256559.0,Salary Increases & Fixed Expenses Increase,290306,112228.0,138600,250828.0,39478.0,13.6,-0.03,High Risk
U541,2024,3,296037.0,Salary Increases & Fixed Expenses Increase,290306,112228.0,144139,256367.0,33939.0,11.69,0.04,High Risk
U541,2024,4,329976.0,Salary Increases & Fixed Expenses Increase,290306,112228.0,116979,229207.0,61099.0,21.05,-0.04,Medium Risk
U541,2024,5,391075.0,Salary Increases & Fixed Expenses Increase,290306,112228.0,152860,265088.0,25218.0,8.69,0.01,High Risk
U541,2024,6,416293.0,Salary Increases & Fixed Expenses Increase,290306,112228.0,117955,230183.0,60123.0,20.71,0.02,Medium Risk
U541,2024,7,476416.0,Salary Increases & Fixed Expenses Increase,290306,112228.0,150409,262637.0,27669.0,9.53,-0.01,High Risk
U541,2024,8,504085.0,Salary Increases & Fixed Expenses Increase,316303,112228.0,174088,286316.0,29987.0,9.48,0.02,High Risk
U541,2024,9,534072.0,Salary Increases & Fixed Expenses Increase,316303,112228.0,128915,241143.0,75160.0,23.76,-0.02,Medium Risk
U541,2024,10,609232.0,Salary Increases & Fixed Expenses Increase,316303,112228.0,186929,299157.0,17146.0,5.42,0.02,High Risk
U541,2024,11,626378.0,Salary Increases & Fixed Expenses Increase,316303,112228.0,140292,252520.0,63783.0,20.17,-0.01,Medium Risk
U541,2024,12,690161.0,Salary Increases & Fixed Expenses Increase,316303,112228.0,129974,242202.0,74101.0,23.43,-0.05,Medium Risk
U542,2024,1,233594.0,Salary Increases & Fixed Expenses Remain Stable,160166,59850.0,68062,127912.0,32254.0,20.14,-0.05,Medium Risk
U542,2024,2,265848.0,Salary Increases & Fixed Expenses Remain Stable,160166,59850.0,82164,142014.0,18152.0,11.33,-0.05,High Risk
U542,2024,3,284000.0,Salary Increases & Fixed Expenses Remain Stable,160166,59850.0,92907,152757.0,7409.0,4.63,-0.03,High Risk
U542,2024,4,291409.0,Salary Increases & Fixed Expenses Remain Stable,176385,59850.0,100231,160081.0,16304.0,9.24,0.01,High Risk
U542,2024,5,307713.0,Salary Increases & Fixed Expenses Remain Stable,176385,59850.0,97809,157659.0,18726.0,10.62,0.0,High Risk
U542,2024,6,326439.0,Salary Increases & Fixed Expenses Remain Stable,176385,59850.0,80394,140244.0,36141.0,20.49,-0.02,Medium Risk
U542,2024,7,362580.0,Salary Increases & Fixed Expenses Remain Stable,176385,59850.0,80760,140610.0,35775.0,20.28,-0.02,Medium Risk
U542,2024,8,398355.0,Salary Increases & Fixed Expenses Remain Stable,176385,59850.0,98992,158842.0,17543.0,9.95,0.01,High Risk
U542,2024,9,415898.0,Salary Increases & Fixed Expenses Remain Stable,176385,59850.0,96029,155879.0,20506.0,11.63,0.03,High Risk
U542,2024,10,436404.0,Salary Increases & Fixed Expenses Remain Stable,176385,59850.0,85465,145315.0,31070.0,17.61,-0.03,Medium Risk
U542,2024,11,467474.0,Salary Increases & Fixed Expenses Remain Stable,176385,59850.0,85720,145570.0,30815.0,17.47,-0.03,Medium Risk
U542,2024,12,498289.0,Salary Increases & Fixed Expenses Remain Stable,176385,59850.0,90171,150021.0,26364.0,14.95,-0.05,High Risk
U543,2024,1,226764.0,Salary Increases & Fixed Expenses Remain Stable,221225,119197.0,147404,266601.0,-45376.0,-20.51,-0.04,High Risk
U543,2024,2,181388.0,Salary Increases & Fixed Expenses Remain Stable,221225,119197.0,175564,294761.0,-73536.0,-33.24,-0.01,High Risk
U543,2024,3,107852.0,Salary Increases & Fixed Expenses Remain Stable,221225,119197.0,155644,274841.0,-53616.0,-24.24,-0.04,High Risk
U543,2024,4,54236.0,Salary Increases & Fixed Expenses Remain Stable,221225,119197.0,133028,252225.0,-31000.0,-14.01,-0.01,High Risk
U543,2024,5,23236.0,Salary Increases & Fixed Expenses Remain Stable,221225,119197.0,142043,261240.0,-40015.0,-18.09,0.05,High Risk
U543,2024,6,-16779.0,Salary Increases & Fixed Expenses Remain Stable,221225,119197.0,150361,269558.0,-48333.0,-21.85,0.04,High Risk
U543,2024,7,-65112.0,Salary Increases & Fixed Expenses Remain Stable,221225,119197.0,150184,269381.0,-48156.0,-21.77,0.02,High Risk
U543,2024,8,-113268.0,Salary Increases & Fixed Expenses Remain Stable,247257,119197.0,153243,272440.0,-25183.0,-10.18,0.04,High Risk
U543,2024,9,-138451.0,Salary Increases & Fixed Expenses Remain Stable,247257,119197.0,175993,295190.0,-47933.0,-19.39,-0.03,High Risk
U543,2024,10,-186384.0,Salary Increases & Fixed Expenses Remain Stable,247257,119197.0,167935,287132.0,-39875.0,-16.13,0.03,High Risk
U543,2024,11,-226259.0,Salary Increases & Fixed Expenses Remain Stable,247257,119197.0,179076,298273.0,-51016.0,-20.63,-0.01,High Risk
U543,2024,12,-277275.0,Salary Increases & Fixed Expenses Remain Stable,247257,119197.0,182146,301343.0,-54086.0,-21.87,0.02,High Risk
U544,2024,1,246372.0,Salary Increases & Fixed Expenses Decrease,136721,65775.0,62567,128342.0,8379.0,6.13,0.01,High Risk
U544,2024,2,254751.0,Salary Increases & Fixed Expenses Decrease,136721,65775.0,80798,146573.0,-9852.0,-7.21,-0.04,High Risk
U544,2024,3,244899.0,Salary Increases & Fixed Expenses Decrease,136721,65775.0,67654,133429.0,3292.0,2.41,0.03,High Risk
U544,2024,4,248191.0,Salary Increases & Fixed Expenses Decrease,136721,65775.0,66541,132316.0,4405.0,3.22,-0.01,High Risk
U544,2024,5,252596.0,Salary Increases & Fixed Expenses Decrease,136721,65775.0,71148,136923.0,-202.0,-0.15,-0.01,High Risk
U544,2024,6,252394.0,Salary Increases & Fixed Expenses Decrease,136721,65775.0,68487,134262.0,2459.0,1.8,-0.02,High Risk
U544,2024,7,254853.0,Salary Increases & Fixed Expenses Decrease,136721,65775.0,75190,140965.0,-4244.0,-3.1,-0.02,High Risk
U544,2024,8,250609.0,Salary Increases & Fixed Expenses Decrease,154300,65775.0,82016,147791.0,6509.0,4.22,0.03,High Risk
U544,2024,9,257118.0,Salary Increases & Fixed Expenses Decrease,154300,65775.0,87365,153140.0,1160.0,0.75,0.04,High Risk
U544,2024,10,258278.0,Salary Increases & Fixed Expenses Decrease,154300,65775.0,75500,141275.0,13025.0,8.44,0.03,High Risk
U544,2024,11,271303.0,Salary Increases & Fixed Expenses Decrease,154300,64649.0,68322,132971.0,21329.0,13.82,0.03,High Risk
U544,2024,12,292632.0,Salary Increases & Fixed Expenses Decrease,154300,64649.0,67296,131945.0,22355.0,14.49,0.0,High Risk
U545,2024,1,237154.0,Salary Increases & Fixed Expenses Increase,55099,24973.0,19599,44572.0,10527.0,19.11,-0.04,Medium Risk
U545,2024,2,247681.0,Salary Increases & Fixed Expenses Increase,55099,24973.0,19429,44402.0,10697.0,19.41,0.04,Medium Risk
U545,2024,3,258378.0,Salary Increases & Fixed Expenses Increase,65589,24973.0,20639,45612.0,19977.0,30.46,-0.03,Low Risk
U545,2024,4,278355.0,Salary Increases & Fixed Expenses Increase,65589,24973.0,20338,45311.0,20278.0,30.92,-0.04,Low Risk
U545,2024,5,298633.0,Salary Increases & Fixed Expenses Increase,65589,24973.0,20486,45459.0,20130.0,30.69,-0.0,Low Risk
U545,2024,6,318763.0,Salary Increases & Fixed Expenses Increase,65589,24973.0,26157,51130.0,14459.0,22.04,-0.05,Medium Risk
U545,2024,7,333222.0,Salary Increases & Fixed Expenses Increase,65589,26394.0,19866,46260.0,19329.0,29.47,0.03,Low Risk
U545,2024,8,352551.0,Salary Increases & Fixed Expenses Increase,65589,26394.0,19942,46336.0,19253.0,29.35,-0.02,Low Risk
U545,2024,9,371804.0,Salary Increases & Fixed Expenses Increase,65589,27530.0,23967,51497.0,14092.0,21.49,-0.03,Medium Risk
U545,2024,10,385896.0,Salary Increases & Fixed Expenses Increase,65589,27530.0,20839,48369.0,17220.0,26.25,0.04,Low Risk
U545,2024,11,403116.0,Salary Increases & Fixed Expenses Increase,65589,28809.0,23501,52310.0,13279.0,20.25,0.01,Medium Risk
U545,2024,12,416395.0,Salary Increases & Fixed Expenses Increase,65589,30063.0,22826,52889.0,12700.0,19.36,0.04,Medium Risk
U546,2024,1,248276.0,Stable Salary & Stable Fixed Expenses,207436,119354.0,83283,202637.0,4799.0,2.31,0.0,High Risk
U546,2024,2,253075.0,Stable Salary & Stable Fixed Expenses,207436,119354.0,110731,230085.0,-22649.0,-10.92,-0.0,High Risk
U546,2024,3,230426.0,Stable Salary & Stable Fixed Expenses,207436,119354.0,106898,226252.0,-18816.0,-9.07,-0.01,High Risk
U546,2024,4,211610.0,Stable Salary & Stable Fixed Expenses,207436,119354.0,94006,213360.0,-5924.0,-2.86,-0.02,High Risk
U546,2024,5,205686.0,Stable Salary & Stable Fixed Expenses,207436,119354.0,86001,205355.0,2081.0,1.0,-0.02,High Risk
U546,2024,6,207767.0,Stable Salary & Stable Fixed Expenses,207436,119354.0,107905,227259.0,-19823.0,-9.56,-0.03,High Risk
U546,2024,7,187944.0,Stable Salary & Stable Fixed Expenses,207436,119354.0,97149,216503.0,-9067.0,-4.37,0.04,High Risk
U546,2024,8,178877.0,Stable Salary & Stable Fixed Expenses,207436,119354.0,103356,222710.0,-15274.0,-7.36,-0.05,High Risk
U546,2024,9,163603.0,Stable Salary & Stable Fixed Expenses,207436,119354.0,117115,236469.0,-29033.0,-14.0,0.04,High Risk
U546,2024,10,134570.0,Stable Salary & Stable Fixed Expenses,207436,119354.0,153655,273009.0,-65573.0,-31.61,0.04,High Risk
U546,2024,11,68997.0,Stable Salary & Stable Fixed Expenses,207436,119354.0,112187,231541.0,-24105.0,-11.62,0.02,High Risk
U546,2024,12,44892.0,Stable Salary & Stable Fixed Expenses,207436,119354.0,84624,203978.0,3458.0,1.67,-0.03,High Risk
U547,2024,1,227126.0,Stable Salary & Increasing Fixed Expenses,206707,115813.0,105900,221713.0,-15006.0,-7.26,0.05,High Risk
U547,2024,2,212120.0,Stable Salary & Increasing Fixed Expenses,206707,115813.0,109506,225319.0,-18612.0,-9.0,-0.01,High Risk
U547,2024,3,193508.0,Stable Salary & Increasing Fixed Expenses,206707,115813.0,86775,202588.0,4119.0,1.99,0.05,High Risk
U547,2024,4,197627.0,Stable Salary & Increasing Fixed Expenses,206707,115813.0,111469,227282.0,-20575.0,-9.95,-0.02,High Risk
U547,2024,5,177052.0,Stable Salary & Increasing Fixed Expenses,206707,115813.0,111573,227386.0,-20679.0,-10.0,0.04,High Risk
U547,2024,6,156373.0,Stable Salary & Increasing Fixed Expenses,206707,115813.0,117054,232867.0,-26160.0,-12.66,0.03,High Risk
U547,2024,7,130213.0,Stable Salary & Increasing Fixed Expenses,206707,115813.0,99924,215737.0,-9030.0,-4.37,-0.01,High Risk
U547,2024,8,121183.0,Stable Salary & Increasing Fixed Expenses,206707,115813.0,111042,226855.0,-20148.0,-9.75,-0.01,High Risk
U547,2024,9,101035.0,Stable Salary & Increasing Fixed Expenses,206707,115813.0,91844,207657.0,-950.0,-0.46,0.02,High Risk
U547,2024,10,100085.0,Stable Salary & Increasing Fixed Expenses,206707,115813.0,112900,228713.0,-22006.0,-10.65,0.05,High Risk
U547,2024,11,78079.0,Stable Salary & Increasing Fixed Expenses,206707,115813.0,96328,212141.0,-5434.0,-2.63,0.04,High Risk
U547,2024,12,72645.0,Stable Salary & Increasing Fixed Expenses,206707,115813.0,100365,216178.0,-9471.0,-4.58,0.05,High Risk
U548,2024,1,230196.0,Salary Increases & Fixed Expenses Decrease,124149,49077.0,72715,121792.0,2357.0,1.9,-0.05,High Risk
U548,2024,2,232553.0,Salary Increases & Fixed Expenses Decrease,124149,49077.0,74355,123432.0,717.0,0.58,0.04,High Risk
U548,2024,3,233270.0,Salary Increases & Fixed Expenses Decrease,124149,49077.0,60677,109754.0,14395.0,11.59,-0.04,High Risk
U548,2024,4,247665.0,Salary Increases & Fixed Expenses Decrease,124149,49077.0,67844,116921.0,7228.0,5.82,-0.04,High Risk
U548,2024,5,254893.0,Salary Increases & Fixed Expenses Decrease,140693,49077.0,73717,122794.0,17899.0,12.72,0.03,High Risk
U548,2024,6,272792.0,Salary Increases & Fixed Expenses Decrease,140693,49077.0,80185,129262.0,11431.0,8.12,-0.02,High Risk
U548,2024,7,284223.0,Salary Increases & Fixed Expenses Decrease,140693,49077.0,78811,127888.0,12805.0,9.1,-0.02,High Risk
U548,2024,8,297028.0,Salary Increases & Fixed Expenses Decrease,140693,49077.0,69134,118211.0,22482.0,15.98,0.01,Medium Risk
U548,2024,9,319510.0,Salary Increases & Fixed Expenses Decrease,140693,49077.0,67556,116633.0,24060.0,17.1,-0.02,Medium Risk
U548,2024,10,343570.0,Salary Increases & Fixed Expenses Decrease,140693,49077.0,93577,142654.0,-1961.0,-1.39,0.04,High Risk
U548,2024,11,341609.0,Salary Increases & Fixed Expenses Decrease,140693,49077.0,78202,127279.0,13414.0,9.53,-0.03,High Risk
U548,2024,12,355023.0,Salary Increases & Fixed Expenses Decrease,140693,49077.0,81812,130889.0,9804.0,6.97,-0.01,High Risk
U549,2024,1,205572.0,Salary Increases & Fixed Expenses Decrease,251195,90063.0,122153,212216.0,38979.0,15.52,0.04,Medium Risk
U549,2024,2,244551.0,Salary Increases & Fixed Expenses Decrease,251195,90063.0,100820,190883.0,60312.0,24.01,0.04,Medium Risk
U549,2024,3,304863.0,Salary Increases & Fixed Expenses Decrease,251195,90063.0,154515,244578.0,6617.0,2.63,0.0,High Risk
U549,2024,4,311480.0,Salary Increases & Fixed Expenses Decrease,270372,90063.0,146421,236484.0,33888.0,12.53,0.01,High Risk
U549,2024,5,345368.0,Salary Increases & Fixed Expenses Decrease,270372,90063.0,134746,224809.0,45563.0,16.85,0.05,Medium Risk
U549,2024,6,390931.0,Salary Increases & Fixed Expenses Decrease,270372,90063.0,152069,242132.0,28240.0,10.44,-0.04,High Risk
U549,2024,7,419171.0,Salary Increases & Fixed Expenses Decrease,270372,90063.0,136744,226807.0,43565.0,16.11,0.03,Medium Risk
U549,2024,8,462736.0,Salary Increases & Fixed Expenses Decrease,270372,90063.0,133736,223799.0,46573.0,17.23,-0.04,Medium Risk
U549,2024,9,509309.0,Salary Increases & Fixed Expenses Decrease,270372,90063.0,177396,267459.0,2913.0,1.08,-0.04,High Risk
U549,2024,10,512222.0,Salary Increases & Fixed Expenses Decrease,270372,90063.0,184828,274891.0,-4519.0,-1.67,0.02,High Risk
U549,2024,11,507703.0,Salary Increases & Fixed Expenses Decrease,270372,90063.0,143376,233439.0,36933.0,13.66,0.04,High Risk
U549,2024,12,544636.0,Salary Increases & Fixed Expenses Decrease,270372,90063.0,209172,299235.0,-28863.0,-10.68,-0.03,High Risk
U550,2024,1,202728.0,Salary Increases & Fixed Expenses Decrease,265917,74420.0,173527,247947.0,17970.0,6.76,-0.01,High Risk
U550,2024,2,220698.0,Salary Increases & Fixed Expenses Decrease,265917,74420.0,168836,243256.0,22661.0,8.52,0.03,High Risk
U550,2024,3,243359.0,Salary Increases & Fixed Expenses Decrease,265917,74420.0,207595,282015.0,-16098.0,-6.05,-0.05,High Risk
U550,2024,4,227261.0,Salary Increases & Fixed Expenses Decrease,265917,74420.0,199565,273985.0,-8068.0,-3.03,0.03,High Risk
U550,2024,5,219193.0,Salary Increases & Fixed Expenses Decrease,265917,74420.0,163647,238067.0,27850.0,10.47,-0.01,High Risk
U550,2024,6,247043.0,Salary Increases & Fixed Expenses Decrease,265917,74420.0,200245,274665.0,-8748.0,-3.29,0.04,High Risk
U550,2024,7,238295.0,Salary Increases & Fixed Expenses Decrease,278382,74420.0,187253,261673.0,16709.0,6.0,0.04,High Risk
U550,2024,8,255004.0,Salary Increases & Fixed Expenses Decrease,278382,74420.0,177151,251571.0,26811.0,9.63,0.03,High Risk
U550,2024,9,281815.0,Salary Increases & Fixed Expenses Decrease,278382,74420.0,190328,264748.0,13634.0,4.9,0.02,High Risk
U550,2024,10,295449.0,Salary Increases & Fixed Expenses Decrease,278382,74420.0,216708,291128.0,-12746.0,-4.58,0.01,High Risk
U550,2024,11,282703.0,Salary Increases & Fixed Expenses Decrease,278382,74420.0,194008,268428.0,9954.0,3.58,0.05,High Risk
U550,2024,12,292657.0,Salary Increases & Fixed Expenses Decrease,278382,74420.0,192260,266680.0,11702.0,4.2,-0.04,High Risk
U551,2024,1,249142.0,Stable Salary & Stable Fixed Expenses,297961,115846.0,122234,238080.0,59881.0,20.1,0.02,Medium Risk
U551,2024,2,309023.0,Stable Salary & Stable Fixed Expenses,297961,115846.0,154392,270238.0,27723.0,9.3,-0.02,High Risk
U551,2024,3,336746.0,Stable Salary & Stable Fixed Expenses,297961,115846.0,161244,277090.0,20871.0,7.0,-0.03,High Risk
U551,2024,4,357617.0,Stable Salary & Stable Fixed Expenses,297961,115846.0,138109,253955.0,44006.0,14.77,0.01,High Risk
U551,2024,5,401623.0,Stable Salary & Stable Fixed Expenses,297961,115846.0,133844,249690.0,48271.0,16.2,0.0,Medium Risk
U551,2024,6,449894.0,Stable Salary & Stable Fixed Expenses,297961,115846.0,125528,241374.0,56587.0,18.99,-0.01,Medium Risk
U551,2024,7,506481.0,Stable Salary & Stable Fixed Expenses,297961,115846.0,148397,264243.0,33718.0,11.32,0.03,High Risk
U551,2024,8,540199.0,Stable Salary & Stable Fixed Expenses,297961,115846.0,145272,261118.0,36843.0,12.37,-0.02,High Risk
U551,2024,9,577042.0,Stable Salary & Stable Fixed Expenses,297961,115846.0,171254,287100.0,10861.0,3.65,-0.02,High Risk
U551,2024,10,587903.0,Stable Salary & Stable Fixed Expenses,297961,115846.0,150518,266364.0,31597.0,10.6,0.04,High Risk
U551,2024,11,619500.0,Stable Salary & Stable Fixed Expenses,297961,115846.0,140550,256396.0,41565.0,13.95,0.03,High Risk
U551,2024,12,661065.0,Stable Salary & Stable Fixed Expenses,297961,115846.0,176301,292147.0,5814.0,1.95,0.03,High Risk
U552,2024,1,202048.0,Stable Salary & Stable Fixed Expenses,36656,18729.0,22926,41655.0,-4999.0,-13.64,-0.04,High Risk
U552,2024,2,197049.0,Stable Salary & Stable Fixed Expenses,36656,18729.0,27872,46601.0,-9945.0,-27.13,0.05,High Risk
U552,2024,3,187104.0,Stable Salary & Stable Fixed Expenses,36656,18729.0,27217,45946.0,-9290.0,-25.34,-0.03,High Risk
U552,2024,4,177814.0,Stable Salary & Stable Fixed Expenses,36656,18729.0,28673,47402.0,-10746.0,-29.32,-0.04,High Risk
U552,2024,5,167068.0,Stable Salary & Stable Fixed Expenses,36656,18729.0,26631,45360.0,-8704.0,-23.75,0.01,High Risk
U552,2024,6,158364.0,Stable Salary & Stable Fixed Expenses,36656,18729.0,28498,47227.0,-10571.0,-28.84,-0.04,High Risk
U552,2024,7,147793.0,Stable Salary & Stable Fixed Expenses,36656,18729.0,28281,47010.0,-10354.0,-28.25,0.04,High Risk
U552,2024,8,137439.0,Stable Salary & Stable Fixed Expenses,36656,18729.0,24558,43287.0,-6631.0,-18.09,-0.03,High Risk
U552,2024,9,130808.0,Stable Salary & Stable Fixed Expenses,36656,18729.0,27716,46445.0,-9789.0,-26.71,-0.01,High Risk
U552,2024,10,121019.0,Stable Salary & Stable Fixed Expenses,36656,18729.0,30849,49578.0,-12922.0,-35.25,0.01,High Risk
U552,2024,11,108097.0,Stable Salary & Stable Fixed Expenses,36656,18729.0,28113,46842.0,-10186.0,-27.79,-0.04,High Risk
U552,2024,12,97911.0,Stable Salary & Stable Fixed Expenses,36656,18729.0,27878,46607.0,-9951.0,-27.15,0.02,High Risk
U553,2024,1,232936.0,Salary Increases & Fixed Expenses Remain Stable,93906,37806.0,35064,72870.0,21036.0,22.4,0.03,Medium Risk
U553,2024,2,253972.0,Salary Increases & Fixed Expenses Remain Stable,93906,37806.0,35854,73660.0,20246.0,21.56,-0.0,Medium Risk
U553,2024,3,274218.0,Salary Increases & Fixed Expenses Remain Stable,93906,37806.0,38605,76411.0,17495.0,18.63,-0.04,Medium Risk
U553,2024,4,291713.0,Salary Increases & Fixed Expenses Remain Stable,93906,37806.0,29215,67021.0,26885.0,28.63,-0.05,Low Risk
U553,2024,5,318598.0,Salary Increases & Fixed Expenses Remain Stable,93906,37806.0,30890,68696.0,25210.0,26.85,-0.04,Low Risk
U553,2024,6,343808.0,Salary Increases & Fixed Expenses Remain Stable,93906,37806.0,36615,74421.0,19485.0,20.75,-0.04,Medium Risk
U553,2024,7,363293.0,Salary Increases & Fixed Expenses Remain Stable,101921,37806.0,34068,71874.0,30047.0,29.48,-0.03,Low Risk
U553,2024,8,393340.0,Salary Increases & Fixed Expenses Remain Stable,101921,37806.0,31445,69251.0,32670.0,32.05,-0.05,Low Risk
U553,2024,9,426010.0,Salary Increases & Fixed Expenses Remain Stable,101921,37806.0,35252,73058.0,28863.0,28.32,0.03,Low Risk
U553,2024,10,454873.0,Salary Increases & Fixed Expenses Remain Stable,101921,37806.0,35342,73148.0,28773.0,28.23,0.05,Low Risk
U553,2024,11,483646.0,Salary Increases & Fixed Expenses Remain Stable,101921,37806.0,39306,77112.0,24809.0,24.34,-0.04,Medium Risk
U553,2024,12,508455.0,Salary Increases & Fixed Expenses Remain Stable,101921,37806.0,37109,74915.0,27006.0,26.5,-0.02,Low Risk
U554,2024,1,244404.0,Salary Increases & Fixed Expenses Remain Stable,62242,29034.0,40709,69743.0,-7501.0,-12.05,0.05,High Risk
U554,2024,2,236903.0,Salary Increases & Fixed Expenses Remain Stable,62242,29034.0,39540,68574.0,-6332.0,-10.17,-0.01,High Risk
U554,2024,3,230571.0,Salary Increases & Fixed Expenses Remain Stable,62242,29034.0,44379,73413.0,-11171.0,-17.95,0.04,High Risk
U554,2024,4,219400.0,Salary Increases & Fixed Expenses Remain Stable,62242,29034.0,44357,73391.0,-11149.0,-17.91,0.03,High Risk
U554,2024,5,208251.0,Salary Increases & Fixed Expenses Remain Stable,90664,29034.0,64742,93776.0,-3112.0,-3.43,0.04,High Risk
U554,2024,6,205139.0,Salary Increases & Fixed Expenses Remain Stable,90664,29034.0,61232,90266.0,398.0,0.44,-0.05,High Risk
U554,2024,7,205537.0,Salary Increases & Fixed Expenses Remain Stable,90664,29034.0,64010,93044.0,-2380.0,-2.63,0.01,High Risk
U554,2024,8,203157.0,Salary Increases & Fixed Expenses Remain Stable,90664,29034.0,62976,92010.0,-1346.0,-1.48,0.03,High Risk
U554,2024,9,201811.0,Salary Increases & Fixed Expenses Remain Stable,90664,29034.0,66378,95412.0,-4748.0,-5.24,-0.05,High Risk
U554,2024,10,197063.0,Salary Increases & Fixed Expenses Remain Stable,90664,29034.0,61424,90458.0,206.0,0.23,-0.02,High Risk
U554,2024,11,197269.0,Salary Increases & Fixed Expenses Remain Stable,90664,29034.0,66122,95156.0,-4492.0,-4.95,0.05,High Risk
U554,2024,12,192777.0,Salary Increases & Fixed Expenses Remain Stable,90664,29034.0,71511,100545.0,-9881.0,-10.9,-0.02,High Risk
U555,2024,1,227509.0,Salary Increases & Fixed Expenses Increase,38832,11814.0,18848,30662.0,8170.0,21.04,0.0,Medium Risk
U555,2024,2,235679.0,Salary Increases & Fixed Expenses Increase,38832,11814.0,21937,33751.0,5081.0,13.08,-0.0,High Risk
U555,2024,3,240760.0,Salary Increases & Fixed Expenses Increase,38832,13413.0,16674,30087.0,8745.0,22.52,-0.03,Medium Risk
U555,2024,4,249505.0,Salary Increases & Fixed Expenses Increase,38832,13973.0,17927,31900.0,6932.0,17.85,0.04,Medium Risk
U555,2024,5,256437.0,Salary Increases & Fixed Expenses Increase,38832,13973.0,15889,29862.0,8970.0,23.1,-0.0,Medium Risk
U555,2024,6,265407.0,Salary Increases & Fixed Expenses Increase,38832,13973.0,18239,32212.0,6620.0,17.05,-0.02,Medium Risk
U555,2024,7,272027.0,Salary Increases & Fixed Expenses Increase,38832,13973.0,15591,29564.0,9268.0,23.87,-0.04,Medium Risk
U555,2024,8,281295.0,Salary Increases & Fixed Expenses Increase,57691,13973.0,29024,42997.0,14694.0,25.47,0.0,Low Risk
U555,2024,9,295989.0,Salary Increases & Fixed Expenses Increase,57691,13973.0,32109,46082.0,11609.0,20.12,-0.02,Medium Risk
U555,2024,10,307598.0,Salary Increases & Fixed Expenses Increase,57691,13973.0,30094,44067.0,13624.0,23.62,-0.04,Medium Risk
U555,2024,11,321222.0,Salary Increases & Fixed Expenses Increase,57691,15237.0,34605,49842.0,7849.0,13.61,0.03,High Risk
U555,2024,12,329071.0,Salary Increases & Fixed Expenses Increase,57691,15237.0,30007,45244.0,12447.0,21.58,0.04,Medium Risk
U556,2024,1,205356.0,Salary Increases & Fixed Expenses Remain Stable,124094,51165.0,81385,132550.0,-8456.0,-6.81,-0.03,High Risk
U556,2024,2,196900.0,Salary Increases & Fixed Expenses Remain Stable,124094,51165.0,88806,139971.0,-15877.0,-12.79,0.05,High Risk
U556,2024,3,181023.0,Salary Increases & Fixed Expenses Remain Stable,124094,51165.0,109561,160726.0,-36632.0,-29.52,0.02,High Risk
U556,2024,4,144391.0,Salary Increases & Fixed Expenses Remain Stable,133100,51165.0,84220,135385.0,-2285.0,-1.72,0.0,High Risk
U556,2024,5,142106.0,Salary Increases & Fixed Expenses Remain Stable,133100,51165.0,97308,148473.0,-15373.0,-11.55,-0.03,High Risk
U556,2024,6,126733.0,Salary Increases & Fixed Expenses Remain Stable,133100,51165.0,81705,132870.0,230.0,0.17,0.01,High Risk
U556,2024,7,126963.0,Salary Increases & Fixed Expenses Remain Stable,133100,51165.0,103066,154231.0,-21131.0,-15.88,-0.0,High Risk
U556,2024,8,105832.0,Salary Increases & Fixed Expenses Remain Stable,133100,51165.0,83421,134586.0,-1486.0,-1.12,0.05,High Risk
U556,2024,9,104346.0,Salary Increases & Fixed Expenses Remain Stable,133100,51165.0,90901,142066.0,-8966.0,-6.74,0.03,High Risk
U556,2024,10,95380.0,Salary Increases & Fixed Expenses Remain Stable,133100,51165.0,94963,146128.0,-13028.0,-9.79,-0.03,High Risk
U556,2024,11,82352.0,Salary Increases & Fixed Expenses Remain Stable,133100,51165.0,97649,148814.0,-15714.0,-11.81,-0.03,High Risk
U556,2024,12,66638.0,Salary Increases & Fixed Expenses Remain Stable,133100,51165.0,82755,133920.0,-820.0,-0.62,0.01,High Risk
U557,2024,1,231045.0,Salary Increases & Fixed Expenses Increase,180224,67676.0,102960,170636.0,9588.0,5.32,-0.0,High Risk
U557,2024,2,240633.0,Salary Increases & Fixed Expenses Increase,180224,67676.0,92064,159740.0,20484.0,11.37,0.03,High Risk
U557,2024,3,261117.0,Salary Increases & Fixed Expenses Increase,180224,67676.0,109005,176681.0,3543.0,1.97,-0.03,High Risk
U557,2024,4,264660.0,Salary Increases & Fixed Expenses Increase,180224,67676.0,83863,151539.0,28685.0,15.92,-0.02,Medium Risk
U557,2024,5,293345.0,Salary Increases & Fixed Expenses Increase,180224,67676.0,72982,140658.0,39566.0,21.95,-0.02,Medium Risk
U557,2024,6,332911.0,Salary Increases & Fixed Expenses Increase,180224,67676.0,94689,162365.0,17859.0,9.91,0.0,High Risk
U557,2024,7,350770.0,Salary Increases & Fixed Expenses Increase,206436,67676.0,107255,174931.0,31505.0,15.26,-0.04,Medium Risk
U557,2024,8,382275.0,Salary Increases & Fixed Expenses Increase,206436,67676.0,83408,151084.0,55352.0,26.81,-0.04,Low Risk
U557,2024,9,437627.0,Salary Increases & Fixed Expenses Increase,206436,67676.0,94466,162142.0,44294.0,21.46,-0.03,Medium Risk
U557,2024,10,481921.0,Salary Increases & Fixed Expenses Increase,206436,67676.0,99607,167283.0,39153.0,18.97,0.02,Medium Risk
U557,2024,11,521074.0,Salary Increases & Fixed Expenses Increase,206436,67676.0,111788,179464.0,26972.0,13.07,0.02,High Risk
U557,2024,12,548046.0,Salary Increases & Fixed Expenses Increase,206436,67676.0,95436,163112.0,43324.0,20.99,-0.01,Medium Risk
U558,2024,1,228770.0,Salary Increases & Fixed Expenses Increase,115727,48479.0,51854,100333.0,15394.0,13.3,0.03,High Risk
U558,2024,2,244164.0,Salary Increases & Fixed Expenses Increase,115727,48479.0,58316,106795.0,8932.0,7.72,0.01,High Risk
U558,2024,3,253096.0,Salary Increases & Fixed Expenses Increase,115727,48479.0,78270,126749.0,-11022.0,-9.52,-0.04,High Risk
U558,2024,4,242074.0,Salary Increases & Fixed Expenses Increase,115727,48479.0,68049,116528.0,-801.0,-0.69,-0.04,High Risk
U558,2024,5,241273.0,Salary Increases & Fixed Expenses Increase,115727,48479.0,57815,106294.0,9433.0,8.15,0.01,High Risk
U558,2024,6,250706.0,Salary Increases & Fixed Expenses Increase,115727,48479.0,47158,95637.0,20090.0,17.36,0.01,Medium Risk
U558,2024,7,270796.0,Salary Increases & Fixed Expenses Increase,115727,49740.0,51930,101670.0,14057.0,12.15,0.03,High Risk
U558,2024,8,284853.0,Salary Increases & Fixed Expenses Increase,124504,49740.0,59162,108902.0,15602.0,12.53,0.01,High Risk
U558,2024,9,300455.0,Salary Increases & Fixed Expenses Increase,124504,49740.0,84054,133794.0,-9290.0,-7.46,-0.02,High Risk
U558,2024,10,291165.0,Salary Increases & Fixed Expenses Increase,124504,49740.0,91257,140997.0,-16493.0,-13.25,0.04,High Risk
U558,2024,11,274672.0,Salary Increases & Fixed Expenses Increase,124504,49740.0,57792,107532.0,16972.0,13.63,0.05,High Risk
U558,2024,12,291644.0,Salary Increases & Fixed Expenses Increase,124504,49740.0,69264,119004.0,5500.0,4.42,-0.01,High Risk
U559,2024,1,243242.0,Salary Increases & Fixed Expenses Remain Stable,115468,69925.0,37587,107512.0,7956.0,6.89,-0.01,High Risk
U559,2024,2,251198.0,Salary Increases & Fixed Expenses Remain Stable,115468,69925.0,42624,112549.0,2919.0,2.53,0.04,High Risk
U559,2024,3,254117.0,Salary Increases & Fixed Expenses Remain Stable,115468,69925.0,48006,117931.0,-2463.0,-2.13,-0.04,High Risk
U559,2024,4,251654.0,Salary Increases & Fixed Expenses Remain Stable,115468,69925.0,38421,108346.0,7122.0,6.17,-0.01,High Risk
U559,2024,5,258776.0,Salary Increases & Fixed Expenses Remain Stable,122150,69925.0,43661,113586.0,8564.0,7.01,-0.03,High Risk
U559,2024,6,267340.0,Salary Increases & Fixed Expenses Remain Stable,122150,69925.0,47749,117674.0,4476.0,3.66,0.0,High Risk
U559,2024,7,271816.0,Salary Increases & Fixed Expenses Remain Stable,122150,69925.0,43301,113226.0,8924.0,7.31,-0.01,High Risk
U559,2024,8,280740.0,Salary Increases & Fixed Expenses Remain Stable,122150,69925.0,44480,114405.0,7745.0,6.34,-0.02,High Risk
U559,2024,9,288485.0,Salary Increases & Fixed Expenses Remain Stable,122150,69925.0,47070,116995.0,5155.0,4.22,-0.04,High Risk
U559,2024,10,293640.0,Salary Increases & Fixed Expenses Remain Stable,122150,69925.0,54050,123975.0,-1825.0,-1.49,0.02,High Risk
U559,2024,11,291815.0,Salary Increases & Fixed Expenses Remain Stable,122150,69925.0,38079,108004.0,14146.0,11.58,-0.01,High Risk
U559,2024,12,305961.0,Salary Increases & Fixed Expenses Remain Stable,122150,69925.0,43944,113869.0,8281.0,6.78,0.01,High Risk
U560,2024,1,241909.0,Salary Increases & Fixed Expenses Increase,255922,64636.0,112962,177598.0,78324.0,30.6,-0.01,Low Risk
U560,2024,2,320233.0,Salary Increases & Fixed Expenses Increase,255922,64636.0,127905,192541.0,63381.0,24.77,0.03,Medium Risk
U560,2024,3,383614.0,Salary Increases & Fixed Expenses Increase,267358,64636.0,159865,224501.0,42857.0,16.03,0.0,Medium Risk
U560,2024,4,426471.0,Salary Increases & Fixed Expenses Increase,267358,64636.0,137250,201886.0,65472.0,24.49,0.02,Medium Risk
U560,2024,5,491943.0,Salary Increases & Fixed Expenses Increase,267358,64636.0,127766,192402.0,74956.0,28.04,-0.03,Low Risk
U560,2024,6,566899.0,Salary Increases & Fixed Expenses Increase,267358,64636.0,141493,206129.0,61229.0,22.9,-0.02,Medium Risk
U560,2024,7,628128.0,Salary Increases & Fixed Expenses Increase,267358,64636.0,110726,175362.0,91996.0,34.41,0.01,Low Risk
U560,2024,8,720124.0,Salary Increases & Fixed Expenses Increase,267358,64636.0,124937,189573.0,77785.0,29.09,0.04,Low Risk
U560,2024,9,797909.0,Salary Increases & Fixed Expenses Increase,267358,64636.0,118514,183150.0,84208.0,31.5,-0.03,Low Risk
U560,2024,10,882117.0,Salary Increases & Fixed Expenses Increase,267358,64636.0,133347,197983.0,69375.0,25.95,0.01,Low Risk
U560,2024,11,951492.0,Salary Increases & Fixed Expenses Increase,267358,65977.0,123359,189336.0,78022.0,29.18,-0.04,Low Risk
U560,2024,12,1029514.0,Salary Increases & Fixed Expenses Increase,267358,65977.0,135259,201236.0,66122.0,24.73,0.04,Medium Risk
U561,2024,1,243804.0,Stable Salary & Increasing Fixed Expenses,83871,35105.0,38269,73374.0,10497.0,12.52,0.03,High Risk
U561,2024,2,254301.0,Stable Salary & Increasing Fixed Expenses,83871,35105.0,36898,72003.0,11868.0,14.15,0.0,High Risk
U561,2024,3,266169.0,Stable Salary & Increasing Fixed Expenses,83871,35105.0,46502,81607.0,2264.0,2.7,0.04,High Risk
U561,2024,4,268433.0,Stable Salary & Increasing Fixed Expenses,83871,36727.0,41551,78278.0,5593.0,6.67,-0.04,High Risk
U561,2024,5,274026.0,Stable Salary & Increasing Fixed Expenses,83871,36727.0,34194,70921.0,12950.0,15.44,-0.04,Medium Risk
U561,2024,6,286976.0,Stable Salary & Increasing Fixed Expenses,83871,36727.0,42079,78806.0,5065.0,6.04,0.04,High Risk
U561,2024,7,292041.0,Stable Salary & Increasing Fixed Expenses,83871,37335.0,46169,83504.0,367.0,0.44,0.03,High Risk
U561,2024,8,292408.0,Stable Salary & Increasing Fixed Expenses,83871,37335.0,44669,82004.0,1867.0,2.23,0.03,High Risk
U561,2024,9,294275.0,Stable Salary & Increasing Fixed Expenses,83871,38928.0,49085,88013.0,-4142.0,-4.94,-0.04,High Risk
U561,2024,10,290133.0,Stable Salary & Increasing Fixed Expenses,83871,38928.0,42721,81649.0,2222.0,2.65,0.01,High Risk
U561,2024,11,292355.0,Stable Salary & Increasing Fixed Expenses,83871,38928.0,43007,81935.0,1936.0,2.31,0.04,High Risk
U561,2024,12,294291.0,Stable Salary & Increasing Fixed Expenses,83871,40634.0,43833,84467.0,-596.0,-0.71,-0.05,High Risk
U562,2024,1,214379.0,Stable Salary & Stable Fixed Expenses,94969,24057.0,30156,54213.0,40756.0,42.92,-0.04,Low Risk
U562,2024,2,255135.0,Stable Salary & Stable Fixed Expenses,94969,24057.0,30308,54365.0,40604.0,42.76,0.04,Low Risk
U562,2024,3,295739.0,Stable Salary & Stable Fixed Expenses,94969,24057.0,34809,58866.0,36103.0,38.02,-0.05,Low Risk
U562,2024,4,331842.0,Stable Salary & Stable Fixed Expenses,94969,24057.0,34348,58405.0,36564.0,38.5,0.05,Low Risk
U562,2024,5,368406.0,Stable Salary & Stable Fixed Expenses,94969,24057.0,33754,57811.0,37158.0,39.13,-0.05,Low Risk
U562,2024,6,405564.0,Stable Salary & Stable Fixed Expenses,94969,24057.0,32157,56214.0,38755.0,40.81,-0.01,Low Risk
U562,2024,7,444319.0,Stable Salary & Stable Fixed Expenses,94969,24057.0,29119,53176.0,41793.0,44.01,0.04,Low Risk
U562,2024,8,486112.0,Stable Salary & Stable Fixed Expenses,94969,24057.0,34304,58361.0,36608.0,38.55,0.02,Low Risk
U562,2024,9,522720.0,Stable Salary & Stable Fixed Expenses,94969,24057.0,33223,57280.0,37689.0,39.69,-0.02,Low Risk
U562,2024,10,560409.0,Stable Salary & Stable Fixed Expenses,94969,24057.0,47515,71572.0,23397.0,24.64,-0.02,Medium Risk
U562,2024,11,583806.0,Stable Salary & Stable Fixed Expenses,94969,24057.0,38281,62338.0,32631.0,34.36,-0.0,Low Risk
U562,2024,12,616437.0,Stable Salary & Stable Fixed Expenses,94969,24057.0,35843,59900.0,35069.0,36.93,-0.04,Low Risk
U563,2024,1,236322.0,Stable Salary & Stable Fixed Expenses,45514,15122.0,18940,34062.0,11452.0,25.16,-0.04,Low Risk
U563,2024,2,247774.0,Stable Salary & Stable Fixed Expenses,45514,15122.0,21903,37025.0,8489.0,18.65,0.01,Medium Risk
U563,2024,3,256263.0,Stable Salary & Stable Fixed Expenses,45514,15122.0,25151,40273.0,5241.0,11.52,0.0,High Risk
U563,2024,4,261504.0,Stable Salary & Stable Fixed Expenses,45514,15122.0,25059,40181.0,5333.0,11.72,0.01,High Risk
U563,2024,5,266837.0,Stable Salary & Stable Fixed Expenses,45514,15122.0,26110,41232.0,4282.0,9.41,-0.03,High Risk
U563,2024,6,271119.0,Stable Salary & Stable Fixed Expenses,45514,15122.0,20742,35864.0,9650.0,21.2,0.01,Medium Risk
U563,2024,7,280769.0,Stable Salary & Stable Fixed Expenses,45514,15122.0,22292,37414.0,8100.0,17.8,-0.01,Medium Risk
U563,2024,8,288869.0,Stable Salary & Stable Fixed Expenses,45514,15122.0,25583,40705.0,4809.0,10.57,-0.01,High Risk
U563,2024,9,293678.0,Stable Salary & Stable Fixed Expenses,45514,15122.0,22462,37584.0,7930.0,17.42,-0.02,Medium Risk
U563,2024,10,301608.0,Stable Salary & Stable Fixed Expenses,45514,15122.0,24944,40066.0,5448.0,11.97,0.02,High Risk
U563,2024,11,307056.0,Stable Salary & Stable Fixed Expenses,45514,15122.0,22417,37539.0,7975.0,17.52,-0.0,Medium Risk
U563,2024,12,315031.0,Stable Salary & Stable Fixed Expenses,45514,15122.0,28853,43975.0,1539.0,3.38,-0.01,High Risk
U564,2024,1,249436.0,Salary Increases & Fixed Expenses Increase,201608,117356.0,96626,213982.0,-12374.0,-6.14,-0.01,High Risk
U564,2024,2,237062.0,Salary Increases & Fixed Expenses Increase,201608,117356.0,119082,236438.0,-34830.0,-17.28,0.04,High Risk
U564,2024,3,202232.0,Salary Increases & Fixed Expenses Increase,201608,119033.0,101363,220396.0,-18788.0,-9.32,-0.03,High Risk
U564,2024,4,183444.0,Salary Increases & Fixed Expenses Increase,201608,119033.0,110406,229439.0,-27831.0,-13.8,0.02,High Risk
U564,2024,5,155613.0,Salary Increases & Fixed Expenses Increase,217527,119033.0,128785,247818.0,-30291.0,-13.93,0.02,High Risk
U564,2024,6,125322.0,Salary Increases & Fixed Expenses Increase,217527,119033.0,112971,232004.0,-14477.0,-6.66,0.02,High Risk
U564,2024,7,110845.0,Salary Increases & Fixed Expenses Increase,217527,120708.0,99637,220345.0,-2818.0,-1.3,0.02,High Risk
U564,2024,8,108027.0,Salary Increases & Fixed Expenses Increase,217527,120708.0,97336,218044.0,-517.0,-0.24,-0.01,High Risk
U564,2024,9,107510.0,Salary Increases & Fixed Expenses Increase,217527,120708.0,123088,243796.0,-26269.0,-12.08,0.01,High Risk
U564,2024,10,81241.0,Salary Increases & Fixed Expenses Increase,217527,120708.0,124761,245469.0,-27942.0,-12.85,0.03,High Risk
U564,2024,11,53299.0,Salary Increases & Fixed Expenses Increase,217527,120708.0,121464,242172.0,-24645.0,-11.33,-0.03,High Risk
U564,2024,12,28654.0,Salary Increases & Fixed Expenses Increase,217527,120708.0,89570,210278.0,7249.0,3.33,-0.02,High Risk
U565,2024,1,226248.0,Salary Increases & Fixed Expenses Increase,271811,89078.0,115010,204088.0,67723.0,24.92,0.0,Medium Risk
U565,2024,2,293971.0,Salary Increases & Fixed Expenses Increase,271811,89078.0,159584,248662.0,23149.0,8.52,0.0,High Risk
U565,2024,3,317120.0,Salary Increases & Fixed Expenses Increase,271811,90748.0,177300,268048.0,3763.0,1.38,-0.01,High Risk
U565,2024,4,320883.0,Salary Increases & Fixed Expenses Increase,271811,90748.0,144236,234984.0,36827.0,13.55,0.0,High Risk
U565,2024,5,357710.0,Salary Increases & Fixed Expenses Increase,271811,90748.0,128389,219137.0,52674.0,19.38,-0.03,Medium Risk
U565,2024,6,410384.0,Salary Increases & Fixed Expenses Increase,271811,90748.0,111497,202245.0,69566.0,25.59,0.02,Low Risk
U565,2024,7,479950.0,Salary Increases & Fixed Expenses Increase,282671,90748.0,113181,203929.0,78742.0,27.86,-0.04,Low Risk
U565,2024,8,558692.0,Salary Increases & Fixed Expenses Increase,282671,90748.0,121762,212510.0,70161.0,24.82,-0.0,Medium Risk
U565,2024,9,628853.0,Salary Increases & Fixed Expenses Increase,282671,90748.0,144950,235698.0,46973.0,16.62,-0.0,Medium Risk
U565,2024,10,675826.0,Salary Increases & Fixed Expenses Increase,282671,90748.0,192026,282774.0,-103.0,-0.04,0.04,High Risk
U565,2024,11,675723.0,Salary Increases & Fixed Expenses Increase,282671,90748.0,145432,236180.0,46491.0,16.45,0.03,Medium Risk
U565,2024,12,722214.0,Salary Increases & Fixed Expenses Increase,282671,90748.0,155482,246230.0,36441.0,12.89,-0.02,High Risk
U566,2024,1,215359.0,Stable Salary & Decreasing Fixed Expenses,32202,18426.0,9855,28281.0,3921.0,12.18,-0.04,High Risk
U566,2024,2,219280.0,Stable Salary & Decreasing Fixed Expenses,32202,18426.0,12552,30978.0,1224.0,3.8,0.02,High Risk
U566,2024,3,220504.0,Stable Salary & Decreasing Fixed Expenses,32202,18426.0,11535,29961.0,2241.0,6.96,-0.04,High Risk
U566,2024,4,222745.0,Stable Salary & Decreasing Fixed Expenses,32202,18426.0,11179,29605.0,2597.0,8.06,0.03,High Risk
U566,2024,5,225342.0,Stable Salary & Decreasing Fixed Expenses,32202,18426.0,10876,29302.0,2900.0,9.01,0.02,High Risk
U566,2024,6,228242.0,Stable Salary & Decreasing Fixed Expenses,32202,18426.0,12871,31297.0,905.0,2.81,-0.01,High Risk
U566,2024,7,229147.0,Stable Salary & Decreasing Fixed Expenses,32202,18426.0,12137,30563.0,1639.0,5.09,-0.03,High Risk
U566,2024,8,230786.0,Stable Salary & Decreasing Fixed Expenses,32202,18426.0,10585,29011.0,3191.0,9.91,0.01,High Risk
U566,2024,9,233977.0,Stable Salary & Decreasing Fixed Expenses,32202,18426.0,10828,29254.0,2948.0,9.15,0.01,High Risk
U566,2024,10,236925.0,Stable Salary & Decreasing Fixed Expenses,32202,18426.0,16142,34568.0,-2366.0,-7.35,-0.0,High Risk
U566,2024,11,234559.0,Stable Salary & Decreasing Fixed Expenses,32202,18426.0,10395,28821.0,3381.0,10.5,-0.01,High Risk
U566,2024,12,237940.0,Stable Salary & Decreasing Fixed Expenses,32202,18426.0,11121,29547.0,2655.0,8.24,0.02,High Risk
U567,2024,1,249117.0,Salary Increases & Fixed Expenses Increase,111603,49901.0,36543,86444.0,25159.0,22.54,-0.04,Medium Risk
U567,2024,2,274276.0,Salary Increases & Fixed Expenses Increase,111603,49901.0,33793,83694.0,27909.0,25.01,-0.01,Low Risk
U567,2024,3,302185.0,Salary Increases & Fixed Expenses Increase,111603,49901.0,41656,91557.0,20046.0,17.96,-0.03,Medium Risk
U567,2024,4,322231.0,Salary Increases & Fixed Expenses Increase,111603,49901.0,44323,94224.0,17379.0,15.57,-0.04,Medium Risk
U567,2024,5,339610.0,Salary Increases & Fixed Expenses Increase,126090,49901.0,39443,89344.0,36746.0,29.14,0.03,Low Risk
U567,2024,6,376356.0,Salary Increases & Fixed Expenses Increase,126090,49901.0,40774,90675.0,35415.0,28.09,-0.05,Low Risk
U567,2024,7,411771.0,Salary Increases & Fixed Expenses Increase,126090,50938.0,48241,99179.0,26911.0,21.34,-0.01,Medium Risk
U567,2024,8,438682.0,Salary Increases & Fixed Expenses Increase,126090,50938.0,39775,90713.0,35377.0,28.06,0.02,Low Risk
U567,2024,9,474059.0,Salary Increases & Fixed Expenses Increase,126090,50938.0,40343,91281.0,34809.0,27.61,0.01,Low Risk
U567,2024,10,508868.0,Salary Increases & Fixed Expenses Increase,126090,50938.0,48207,99145.0,26945.0,21.37,0.0,Medium Risk
U567,2024,11,535813.0,Salary Increases & Fixed Expenses Increase,126090,50938.0,40124,91062.0,35028.0,27.78,0.03,Low Risk
U567,2024,12,570841.0,Salary Increases & Fixed Expenses Increase,126090,50938.0,44144,95082.0,31008.0,24.59,0.02,Medium Risk
U568,2024,1,202002.0,Salary Increases & Fixed Expenses Remain Stable,84121,35054.0,28910,63964.0,20157.0,23.96,-0.01,Medium Risk
U568,2024,2,222159.0,Salary Increases & Fixed Expenses Remain Stable,84121,35054.0,32117,67171.0,16950.0,20.15,0.0,Medium Risk
U568,2024,3,239109.0,Salary Increases & Fixed Expenses Remain Stable,84121,35054.0,30479,65533.0,18588.0,22.1,0.02,Medium Risk
U568,2024,4,257697.0,Salary Increases & Fixed Expenses Remain Stable,84121,35054.0,26844,61898.0,22223.0,26.42,-0.04,Low Risk
U568,2024,5,279920.0,Salary Increases & Fixed Expenses Remain Stable,84121,35054.0,26354,61408.0,22713.0,27.0,-0.0,Low Risk
U568,2024,6,302633.0,Salary Increases & Fixed Expenses Remain Stable,94853,35054.0,36031,71085.0,23768.0,25.06,0.03,Low Risk
U568,2024,7,326401.0,Salary Increases & Fixed Expenses Remain Stable,94853,35054.0,37675,72729.0,22124.0,23.32,-0.04,Medium Risk
U568,2024,8,348525.0,Salary Increases & Fixed Expenses Remain Stable,94853,35054.0,30925,65979.0,28874.0,30.44,-0.03,Low Risk
U568,2024,9,377399.0,Salary Increases & Fixed Expenses Remain Stable,94853,35054.0,30614,65668.0,29185.0,30.77,0.01,Low Risk
U568,2024,10,406584.0,Salary Increases & Fixed Expenses Remain Stable,94853,35054.0,31850,66904.0,27949.0,29.47,0.0,Low Risk
U568,2024,11,434533.0,Salary Increases & Fixed Expenses Remain Stable,94853,35054.0,37422,72476.0,22377.0,23.59,-0.05,Medium Risk
U568,2024,12,456910.0,Salary Increases & Fixed Expenses Remain Stable,94853,35054.0,33845,68899.0,25954.0,27.36,-0.02,Low Risk
U569,2024,1,246218.0,Stable Salary & Increasing Fixed Expenses,297889,80798.0,172784,253582.0,44307.0,14.87,0.04,High Risk
U569,2024,2,290525.0,Stable Salary & Increasing Fixed Expenses,297889,81357.0,148760,230117.0,67772.0,22.75,0.02,Medium Risk
U569,2024,3,358297.0,Stable Salary & Increasing Fixed Expenses,297889,81357.0,146417,227774.0,70115.0,23.54,0.03,Medium Risk
U569,2024,4,428412.0,Stable Salary & Increasing Fixed Expenses,297889,81357.0,151809,233166.0,64723.0,21.73,0.02,Medium Risk
U569,2024,5,493135.0,Stable Salary & Increasing Fixed Expenses,297889,81357.0,140067,221424.0,76465.0,25.67,0.03,Low Risk
U569,2024,6,569600.0,Stable Salary & Increasing Fixed Expenses,297889,81357.0,126967,208324.0,89565.0,30.07,-0.04,Low Risk
U569,2024,7,659165.0,Stable Salary & Increasing Fixed Expenses,297889,81357.0,168239,249596.0,48293.0,16.21,-0.04,Medium Risk
U569,2024,8,707458.0,Stable Salary & Increasing Fixed Expenses,297889,81357.0,166360,247717.0,50172.0,16.84,-0.03,Medium Risk
U569,2024,9,757630.0,Stable Salary & Increasing Fixed Expenses,297889,81357.0,120618,201975.0,95914.0,32.2,-0.03,Low Risk
U569,2024,10,853544.0,Stable Salary & Increasing Fixed Expenses,297889,81357.0,189196,270553.0,27336.0,9.18,0.02,High Risk
U569,2024,11,880880.0,Stable Salary & Increasing Fixed Expenses,297889,82646.0,171096,253742.0,44147.0,14.82,-0.01,High Risk
U569,2024,12,925027.0,Stable Salary & Increasing Fixed Expenses,297889,82646.0,160513,243159.0,54730.0,18.37,0.04,Medium Risk
U570,2024,1,210242.0,Salary Increases & Fixed Expenses Remain Stable,253236,92019.0,141799,233818.0,19418.0,7.67,0.01,High Risk
U570,2024,2,229660.0,Salary Increases & Fixed Expenses Remain Stable,253236,92019.0,104314,196333.0,56903.0,22.47,-0.01,Medium Risk
U570,2024,3,286563.0,Salary Increases & Fixed Expenses Remain Stable,253236,92019.0,124848,216867.0,36369.0,14.36,-0.05,High Risk
U570,2024,4,322932.0,Salary Increases & Fixed Expenses Remain Stable,253236,92019.0,130441,222460.0,30776.0,12.15,0.02,High Risk
U570,2024,5,353708.0,Salary Increases & Fixed Expenses Remain Stable,265501,92019.0,132582,224601.0,40900.0,15.4,-0.02,Medium Risk
U570,2024,6,394608.0,Salary Increases & Fixed Expenses Remain Stable,265501,92019.0,117483,209502.0,55999.0,21.09,-0.03,Medium Risk
U570,2024,7,450607.0,Salary Increases & Fixed Expenses Remain Stable,265501,92019.0,147219,239238.0,26263.0,9.89,-0.02,High Risk
U570,2024,8,476870.0,Salary Increases & Fixed Expenses Remain Stable,265501,92019.0,138309,230328.0,35173.0,13.25,0.02,High Risk
U570,2024,9,512043.0,Salary Increases & Fixed Expenses Remain Stable,265501,92019.0,120668,212687.0,52814.0,19.89,-0.0,Medium Risk
U570,2024,10,564857.0,Salary Increases & Fixed Expenses Remain Stable,265501,92019.0,136906,228925.0,36576.0,13.78,-0.03,High Risk
U570,2024,11,601433.0,Salary Increases & Fixed Expenses Remain Stable,265501,92019.0,163232,255251.0,10250.0,3.86,-0.03,High Risk
U570,2024,12,611683.0,Salary Increases & Fixed Expenses Remain Stable,265501,92019.0,130093,222112.0,43389.0,16.34,0.01,Medium Risk
U571,2024,1,224364.0,Salary Increases & Fixed Expenses Remain Stable,280277,65359.0,122928,188287.0,91990.0,32.82,-0.04,Low Risk
U571,2024,2,316354.0,Salary Increases & Fixed Expenses Remain Stable,280277,65359.0,144194,209553.0,70724.0,25.23,-0.03,Low Risk
U571,2024,3,387078.0,Salary Increases & Fixed Expenses Remain Stable,280277,65359.0,142606,207965.0,72312.0,25.8,-0.04,Low Risk
U571,2024,4,459390.0,Salary Increases & Fixed Expenses Remain Stable,280277,65359.0,156312,221671.0,58606.0,20.91,-0.04,Medium Risk
U571,2024,5,517996.0,Salary Increases & Fixed Expenses Remain Stable,280277,65359.0,151112,216471.0,63806.0,22.77,0.02,Medium Risk
U571,2024,6,581802.0,Salary Increases & Fixed Expenses Remain Stable,280277,65359.0,144593,209952.0,70325.0,25.09,0.04,Low Risk
U571,2024,7,652127.0,Salary Increases & Fixed Expenses Remain Stable,280277,65359.0,139782,205141.0,75136.0,26.81,-0.02,Low Risk
U571,2024,8,727263.0,Salary Increases & Fixed Expenses Remain Stable,287978,65359.0,140083,205442.0,82536.0,28.66,0.02,Low Risk
U571,2024,9,809799.0,Salary Increases & Fixed Expenses Remain Stable,287978,65359.0,148498,213857.0,74121.0,25.74,0.04,Low Risk
U571,2024,10,883920.0,Salary Increases & Fixed Expenses Remain Stable,287978,65359.0,186225,251584.0,36394.0,12.64,0.02,High Risk
U571,2024,11,920314.0,Salary Increases & Fixed Expenses Remain Stable,287978,65359.0,168050,233409.0,54569.0,18.95,0.03,Medium Risk
U571,2024,12,974883.0,Salary Increases & Fixed Expenses Remain Stable,287978,65359.0,171635,236994.0,50984.0,17.7,-0.04,Medium Risk
U572,2024,1,241286.0,Stable Salary & Increasing Fixed Expenses,52948,35873.0,24347,60220.0,-7272.0,-13.73,-0.03,High Risk
U572,2024,2,234014.0,Stable Salary & Increasing Fixed Expenses,52948,35873.0,25950,61823.0,-8875.0,-16.76,-0.02,High Risk
U572,2024,3,225139.0,Stable Salary & Increasing Fixed Expenses,52948,35873.0,28791,64664.0,-11716.0,-22.13,0.0,High Risk
U572,2024,4,213423.0,Stable Salary & Increasing Fixed Expenses,52948,35873.0,27389,63262.0,-10314.0,-19.48,-0.04,High Risk
U572,2024,5,203109.0,Stable Salary & Increasing Fixed Expenses,52948,37255.0,25898,63153.0,-10205.0,-19.27,0.02,High Risk
U572,2024,6,192904.0,Stable Salary & Increasing Fixed Expenses,52948,37255.0,26400,63655.0,-10707.0,-20.22,0.03,High Risk
U572,2024,7,182197.0,Stable Salary & Increasing Fixed Expenses,52948,37255.0,31221,68476.0,-15528.0,-29.33,-0.02,High Risk
U572,2024,8,166669.0,Stable Salary & Increasing Fixed Expenses,52948,37255.0,22975,60230.0,-7282.0,-13.75,-0.02,High Risk
U572,2024,9,159387.0,Stable Salary & Increasing Fixed Expenses,52948,37255.0,23769,61024.0,-8076.0,-15.25,-0.05,High Risk
U572,2024,10,151311.0,Stable Salary & Increasing Fixed Expenses,52948,37255.0,29583,66838.0,-13890.0,-26.23,0.05,High Risk
U572,2024,11,137421.0,Stable Salary & Increasing Fixed Expenses,52948,37255.0,27694,64949.0,-12001.0,-22.67,-0.01,High Risk
U572,2024,12,125420.0,Stable Salary & Increasing Fixed Expenses,52948,37255.0,27148,64403.0,-11455.0,-21.63,0.04,High Risk
U573,2024,1,207686.0,Salary Increases & Fixed Expenses Decrease,201324,78733.0,94369,173102.0,28222.0,14.02,0.01,High Risk
U573,2024,2,235908.0,Salary Increases & Fixed Expenses Decrease,201324,78733.0,96282,175015.0,26309.0,13.07,-0.01,High Risk
U573,2024,3,262217.0,Salary Increases & Fixed Expenses Decrease,220396,78733.0,99722,178455.0,41941.0,19.03,0.05,Medium Risk
U573,2024,4,304158.0,Salary Increases & Fixed Expenses Decrease,220396,78733.0,102714,181447.0,38949.0,17.67,0.02,Medium Risk
U573,2024,5,343107.0,Salary Increases & Fixed Expenses Decrease,220396,78733.0,117701,196434.0,23962.0,10.87,-0.04,High Risk
U573,2024,6,367069.0,Salary Increases & Fixed Expenses Decrease,220396,78733.0,92083,170816.0,49580.0,22.5,-0.04,Medium Risk
U573,2024,7,416649.0,Salary Increases & Fixed Expenses Decrease,220396,78733.0,99827,178560.0,41836.0,18.98,-0.01,Medium Risk
U573,2024,8,458485.0,Salary Increases & Fixed Expenses Decrease,220396,78733.0,118400,197133.0,23263.0,10.56,-0.04,High Risk
U573,2024,9,481748.0,Salary Increases & Fixed Expenses Decrease,220396,78733.0,94150,172883.0,47513.0,21.56,-0.0,Medium Risk
U573,2024,10,529261.0,Salary Increases & Fixed Expenses Decrease,220396,78733.0,119113,197846.0,22550.0,10.23,0.01,High Risk
U573,2024,11,551811.0,Salary Increases & Fixed Expenses Decrease,220396,78733.0,122662,201395.0,19001.0,8.62,0.05,High Risk
U573,2024,12,570812.0,Salary Increases & Fixed Expenses Decrease,220396,78733.0,117428,196161.0,24235.0,11.0,-0.02,High Risk
U574,2024,1,213753.0,Stable Salary & Increasing Fixed Expenses,220190,60074.0,169059,229133.0,-8943.0,-4.06,-0.03,High Risk
U574,2024,2,204810.0,Stable Salary & Increasing Fixed Expenses,220190,61552.0,154071,215623.0,4567.0,2.07,-0.02,High Risk
U574,2024,3,209377.0,Stable Salary & Increasing Fixed Expenses,220190,61552.0,198765,260317.0,-40127.0,-18.22,-0.02,High Risk
U574,2024,4,169250.0,Stable Salary & Increasing Fixed Expenses,220190,61552.0,140433,201985.0,18205.0,8.27,0.04,High Risk
U574,2024,5,187455.0,Stable Salary & Increasing Fixed Expenses,220190,61552.0,146774,208326.0,11864.0,5.39,0.01,High Risk
U574,2024,6,199319.0,Stable Salary & Increasing Fixed Expenses,220190,61552.0,147772,209324.0,10866.0,4.93,0.02,High Risk
U574,2024,7,210185.0,Stable Salary & Increasing Fixed Expenses,220190,61552.0,135217,196769.0,23421.0,10.64,0.01,High Risk
U574,2024,8,233606.0,Stable Salary & Increasing Fixed Expenses,220190,61552.0,172115,233667.0,-13477.0,-6.12,-0.05,High Risk
U574,2024,9,220129.0,Stable Salary & Increasing Fixed Expenses,220190,61552.0,143677,205229.0,14961.0,6.79,0.01,High Risk
U574,2024,10,235090.0,Stable Salary & Increasing Fixed Expenses,220190,61552.0,206227,267779.0,-47589.0,-21.61,-0.03,High Risk
U574,2024,11,187501.0,Stable Salary & Increasing Fixed Expenses,220190,61552.0,172919,234471.0,-14281.0,-6.49,-0.01,High Risk
U574,2024,12,173220.0,Stable Salary & Increasing Fixed Expenses,220190,61552.0,173261,234813.0,-14623.0,-6.64,-0.02,High Risk
U575,2024,1,219709.0,Stable Salary & Stable Fixed Expenses,172129,71615.0,112341,183956.0,-11827.0,-6.87,0.04,High Risk
U575,2024,2,207882.0,Stable Salary & Stable Fixed Expenses,172129,71615.0,136618,208233.0,-36104.0,-20.97,-0.05,High Risk
U575,2024,3,171778.0,Stable Salary & Stable Fixed Expenses,172129,71615.0,124869,196484.0,-24355.0,-14.15,0.01,High Risk
U575,2024,4,147423.0,Stable Salary & Stable Fixed Expenses,172129,71615.0,121225,192840.0,-20711.0,-12.03,0.01,High Risk
U575,2024,5,126712.0,Stable Salary & Stable Fixed Expenses,172129,71615.0,118493,190108.0,-17979.0,-10.45,-0.02,High Risk
U575,2024,6,108733.0,Stable Salary & Stable Fixed Expenses,172129,71615.0,105060,176675.0,-4546.0,-2.64,0.04,High Risk
U575,2024,7,104187.0,Stable Salary & Stable Fixed Expenses,172129,71615.0,131552,203167.0,-31038.0,-18.03,0.05,High Risk
U575,2024,8,73149.0,Stable Salary & Stable Fixed Expenses,172129,71615.0,109622,181237.0,-9108.0,-5.29,-0.05,High Risk
U575,2024,9,64041.0,Stable Salary & Stable Fixed Expenses,172129,71615.0,131290,202905.0,-30776.0,-17.88,0.04,High Risk
U575,2024,10,33265.0,Stable Salary & Stable Fixed Expenses,172129,71615.0,130329,201944.0,-29815.0,-17.32,0.0,High Risk
U575,2024,11,3450.0,Stable Salary & Stable Fixed Expenses,172129,71615.0,108000,179615.0,-7486.0,-4.35,-0.01,High Risk
U575,2024,12,-4036.0,Stable Salary & Stable Fixed Expenses,172129,71615.0,127524,199139.0,-27010.0,-15.69,-0.03,High Risk
U576,2024,1,245572.0,Salary Increases & Fixed Expenses Remain Stable,20030,15864.0,7403,23267.0,-3237.0,-16.16,0.02,High Risk
U576,2024,2,242335.0,Salary Increases & Fixed Expenses Remain Stable,20030,15864.0,6093,21957.0,-1927.0,-9.62,-0.02,High Risk
U576,2024,3,240408.0,Salary Increases & Fixed Expenses Remain Stable,20030,15864.0,6893,22757.0,-2727.0,-13.61,0.0,High Risk
U576,2024,4,237681.0,Salary Increases & Fixed Expenses Remain Stable,20030,15864.0,6276,22140.0,-2110.0,-10.53,-0.05,High Risk
U576,2024,5,235571.0,Salary Increases & Fixed Expenses Remain Stable,31182,15864.0,10434,26298.0,4884.0,15.66,-0.01,Medium Risk
U576,2024,6,240455.0,Salary Increases & Fixed Expenses Remain Stable,31182,15864.0,11381,27245.0,3937.0,12.63,-0.05,High Risk
U576,2024,7,244392.0,Salary Increases & Fixed Expenses Remain Stable,31182,15864.0,10445,26309.0,4873.0,15.63,0.02,Medium Risk
U576,2024,8,249265.0,Salary Increases & Fixed Expenses Remain Stable,31182,15864.0,11420,27284.0,3898.0,12.5,0.03,High Risk
U576,2024,9,253163.0,Salary Increases & Fixed Expenses Remain Stable,31182,15864.0,12282,28146.0,3036.0,9.74,0.03,High Risk
U576,2024,10,256199.0,Salary Increases & Fixed Expenses Remain Stable,31182,15864.0,12079,27943.0,3239.0,10.39,-0.02,High Risk
U576,2024,11,259438.0,Salary Increases & Fixed Expenses Remain Stable,31182,15864.0,12026,27890.0,3292.0,10.56,-0.0,High Risk
U576,2024,12,262730.0,Salary Increases & Fixed Expenses Remain Stable,31182,15864.0,12227,28091.0,3091.0,9.91,-0.01,High Risk
U577,2024,1,226957.0,Stable Salary & Stable Fixed Expenses,63666,36204.0,40785,76989.0,-13323.0,-20.93,0.01,High Risk
U577,2024,2,213634.0,Stable Salary & Stable Fixed Expenses,63666,36204.0,39745,75949.0,-12283.0,-19.29,0.03,High Risk
U577,2024,3,201351.0,Stable Salary & Stable Fixed Expenses,63666,36204.0,52065,88269.0,-24603.0,-38.64,-0.03,High Risk
U577,2024,4,176748.0,Stable Salary & Stable Fixed Expenses,63666,36204.0,50193,86397.0,-22731.0,-35.7,-0.02,High Risk
U577,2024,5,154017.0,Stable Salary & Stable Fixed Expenses,63666,36204.0,39810,76014.0,-12348.0,-19.39,-0.04,High Risk
U577,2024,6,141669.0,Stable Salary & Stable Fixed Expenses,63666,36204.0,49994,86198.0,-22532.0,-35.39,-0.05,High Risk
U577,2024,7,119137.0,Stable Salary & Stable Fixed Expenses,63666,36204.0,47433,83637.0,-19971.0,-31.37,0.0,High Risk
U577,2024,8,99166.0,Stable Salary & Stable Fixed Expenses,63666,36204.0,49774,85978.0,-22312.0,-35.05,0.04,High Risk
U577,2024,9,76854.0,Stable Salary & Stable Fixed Expenses,63666,36204.0,48536,84740.0,-21074.0,-33.1,0.0,High Risk
U577,2024,10,55780.0,Stable Salary & Stable Fixed Expenses,63666,36204.0,59219,95423.0,-31757.0,-49.88,-0.03,High Risk
U577,2024,11,24023.0,Stable Salary & Stable Fixed Expenses,63666,36204.0,43342,79546.0,-15880.0,-24.94,0.02,High Risk
U577,2024,12,8143.0,Stable Salary & Stable Fixed Expenses,63666,36204.0,43504,79708.0,-16042.0,-25.2,0.01,High Risk
U578,2024,1,231712.0,Stable Salary & Increasing Fixed Expenses,190669,40715.0,74504,115219.0,75450.0,39.57,0.03,Low Risk
U578,2024,2,307162.0,Stable Salary & Increasing Fixed Expenses,190669,40715.0,61692,102407.0,88262.0,46.29,0.01,Low Risk
U578,2024,3,395424.0,Stable Salary & Increasing Fixed Expenses,190669,40715.0,74216,114931.0,75738.0,39.72,0.02,Low Risk
U578,2024,4,471162.0,Stable Salary & Increasing Fixed Expenses,190669,40715.0,66996,107711.0,82958.0,43.51,0.02,Low Risk
U578,2024,5,554120.0,Stable Salary & Increasing Fixed Expenses,190669,40715.0,59126,99841.0,90828.0,47.64,0.03,Low Risk
U578,2024,6,644948.0,Stable Salary & Increasing Fixed Expenses,190669,40715.0,69509,110224.0,80445.0,42.19,-0.04,Low Risk
U578,2024,7,725393.0,Stable Salary & Increasing Fixed Expenses,190669,40715.0,64545,105260.0,85409.0,44.79,-0.05,Low Risk
U578,2024,8,810802.0,Stable Salary & Increasing Fixed Expenses,190669,40715.0,65610,106325.0,84344.0,44.24,-0.04,Low Risk
U578,2024,9,895146.0,Stable Salary & Increasing Fixed Expenses,190669,40715.0,60155,100870.0,89799.0,47.1,0.04,Low Risk
U578,2024,10,984945.0,Stable Salary & Increasing Fixed Expenses,190669,40715.0,69101,109816.0,80853.0,42.4,0.02,Low Risk
U578,2024,11,1065798.0,Stable Salary & Increasing Fixed Expenses,190669,40715.0,61109,101824.0,88845.0,46.6,-0.02,Low Risk
U578,2024,12,1154643.0,Stable Salary & Increasing Fixed Expenses,190669,42362.0,70408,112770.0,77899.0,40.86,0.04,Low Risk
U579,2024,1,235934.0,Stable Salary & Stable Fixed Expenses,71341,30040.0,21721,51761.0,19580.0,27.45,-0.02,Low Risk
U579,2024,2,255514.0,Stable Salary & Stable Fixed Expenses,71341,30040.0,23808,53848.0,17493.0,24.52,0.02,Medium Risk
U579,2024,3,273007.0,Stable Salary & Stable Fixed Expenses,71341,30040.0,34455,64495.0,6846.0,9.6,-0.03,High Risk
U579,2024,4,279853.0,Stable Salary & Stable Fixed Expenses,71341,30040.0,21913,51953.0,19388.0,27.18,0.03,Low Risk
U579,2024,5,299241.0,Stable Salary & Stable Fixed Expenses,71341,30040.0,26979,57019.0,14322.0,20.08,0.02,Medium Risk
U579,2024,6,313563.0,Stable Salary & Stable Fixed Expenses,71341,30040.0,24872,54912.0,16429.0,23.03,0.03,Medium Risk
U579,2024,7,329992.0,Stable Salary & Stable Fixed Expenses,71341,30040.0,24620,54660.0,16681.0,23.38,0.01,Medium Risk
U579,2024,8,346673.0,Stable Salary & Stable Fixed Expenses,71341,30040.0,23901,53941.0,17400.0,24.39,0.03,Medium Risk
U579,2024,9,364073.0,Stable Salary & Stable Fixed Expenses,71341,30040.0,25702,55742.0,15599.0,21.87,-0.04,Medium Risk
U579,2024,10,379672.0,Stable Salary & Stable Fixed Expenses,71341,30040.0,27095,57135.0,14206.0,19.91,0.03,Medium Risk
U579,2024,11,393878.0,Stable Salary & Stable Fixed Expenses,71341,30040.0,22928,52968.0,18373.0,25.75,-0.0,Low Risk
U579,2024,12,412251.0,Stable Salary & Stable Fixed Expenses,71341,30040.0,24624,54664.0,16677.0,23.38,0.03,Medium Risk
U580,2024,1,230612.0,Salary Increases & Fixed Expenses Increase,227030,85491.0,95838,181329.0,45701.0,20.13,0.02,Medium Risk
U580,2024,2,276313.0,Salary Increases & Fixed Expenses Increase,227030,87122.0,110668,197790.0,29240.0,12.88,-0.03,High Risk
U580,2024,3,305553.0,Salary Increases & Fixed Expenses Increase,227030,87122.0,159530,246652.0,-19622.0,-8.64,-0.0,High Risk
U580,2024,4,285931.0,Salary Increases & Fixed Expenses Increase,253470,87122.0,132811,219933.0,33537.0,13.23,-0.01,High Risk
U580,2024,5,319468.0,Salary Increases & Fixed Expenses Increase,253470,88276.0,106869,195145.0,58325.0,23.01,-0.04,Medium Risk
U580,2024,6,377793.0,Salary Increases & Fixed Expenses Increase,253470,88276.0,143253,231529.0,21941.0,8.66,-0.03,High Risk
U580,2024,7,399734.0,Salary Increases & Fixed Expenses Increase,253470,88276.0,141500,229776.0,23694.0,9.35,0.05,High Risk
U580,2024,8,423428.0,Salary Increases & Fixed Expenses Increase,253470,89686.0,132679,222365.0,31105.0,12.27,-0.04,High Risk
U580,2024,9,454533.0,Salary Increases & Fixed Expenses Increase,253470,90812.0,133236,224048.0,29422.0,11.61,0.01,High Risk
U580,2024,10,483955.0,Salary Increases & Fixed Expenses Increase,253470,90812.0,171739,262551.0,-9081.0,-3.58,-0.04,High Risk
U580,2024,11,474874.0,Salary Increases & Fixed Expenses Increase,253470,90812.0,135692,226504.0,26966.0,10.64,-0.01,High Risk
U580,2024,12,501840.0,Salary Increases & Fixed Expenses Increase,253470,90812.0,147719,238531.0,14939.0,5.89,-0.0,High Risk
U581,2024,1,221587.0,Salary Increases & Fixed Expenses Remain Stable,182607,54955.0,78985,133940.0,48667.0,26.65,-0.02,Low Risk
U581,2024,2,270254.0,Salary Increases & Fixed Expenses Remain Stable,182607,54955.0,91248,146203.0,36404.0,19.94,-0.0,Medium Risk
U581,2024,3,306658.0,Salary Increases & Fixed Expenses Remain Stable,182607,54955.0,138971,193926.0,-11319.0,-6.2,-0.02,High Risk
U581,2024,4,295339.0,Salary Increases & Fixed Expenses Remain Stable,182607,54955.0,96675,151630.0,30977.0,16.96,0.0,Medium Risk
U581,2024,5,326316.0,Salary Increases & Fixed Expenses Remain Stable,182607,54955.0,100253,155208.0,27399.0,15.0,-0.05,Medium Risk
U581,2024,6,353715.0,Salary Increases & Fixed Expenses Remain Stable,182607,54955.0,81981,136936.0,45671.0,25.01,-0.05,Low Risk
U581,2024,7,399386.0,Salary Increases & Fixed Expenses Remain Stable,182607,54955.0,100772,155727.0,26880.0,14.72,-0.05,High Risk
U581,2024,8,426266.0,Salary Increases & Fixed Expenses Remain Stable,197976,54955.0,118078,173033.0,24943.0,12.6,-0.02,High Risk
U581,2024,9,451209.0,Salary Increases & Fixed Expenses Remain Stable,197976,54955.0,121931,176886.0,21090.0,10.65,-0.01,High Risk
U581,2024,10,472299.0,Salary Increases & Fixed Expenses Remain Stable,197976,54955.0,142836,197791.0,185.0,0.09,-0.03,High Risk
U581,2024,11,472484.0,Salary Increases & Fixed Expenses Remain Stable,197976,54955.0,99623,154578.0,43398.0,21.92,0.0,Medium Risk
U581,2024,12,515882.0,Salary Increases & Fixed Expenses Remain Stable,197976,54955.0,125896,180851.0,17125.0,8.65,0.04,High Risk
U582,2024,1,247978.0,Salary Increases & Fixed Expenses Remain Stable,158062,64425.0,115380,179805.0,-21743.0,-13.76,-0.01,High Risk
U582,2024,2,226235.0,Salary Increases & Fixed Expenses Remain Stable,158062,64425.0,114866,179291.0,-21229.0,-13.43,-0.04,High Risk
U582,2024,3,205006.0,Salary Increases & Fixed Expenses Remain Stable,158062,64425.0,132431,196856.0,-38794.0,-24.54,0.01,High Risk
U582,2024,4,166212.0,Salary Increases & Fixed Expenses Remain Stable,158062,64425.0,104314,168739.0,-10677.0,-6.75,0.01,High Risk
U582,2024,5,155535.0,Salary Increases & Fixed Expenses Remain Stable,185401,64425.0,117002,181427.0,3974.0,2.14,0.04,High Risk
U582,2024,6,159509.0,Salary Increases & Fixed Expenses Remain Stable,185401,64425.0,127095,191520.0,-6119.0,-3.3,0.01,High Risk
U582,2024,7,153390.0,Salary Increases & Fixed Expenses Remain Stable,185401,64425.0,139555,203980.0,-18579.0,-10.02,0.05,High Risk
U582,2024,8,134811.0,Salary Increases & Fixed Expenses Remain Stable,185401,64425.0,130400,194825.0,-9424.0,-5.08,0.0,High Risk
U582,2024,9,125387.0,Salary Increases & Fixed Expenses Remain Stable,185401,64425.0,120118,184543.0,858.0,0.46,0.03,High Risk
U582,2024,10,126245.0,Salary Increases & Fixed Expenses Remain Stable,185401,64425.0,163046,227471.0,-42070.0,-22.69,0.02,High Risk
U582,2024,11,84175.0,Salary Increases & Fixed Expenses Remain Stable,185401,64425.0,138808,203233.0,-17832.0,-9.62,-0.01,High Risk
U582,2024,12,66343.0,Salary Increases & Fixed Expenses Remain Stable,185401,64425.0,125995,190420.0,-5019.0,-2.71,0.05,High Risk
U583,2024,1,204761.0,Salary Increases & Fixed Expenses Remain Stable,237037,82979.0,149804,232783.0,4254.0,1.79,0.02,High Risk
U583,2024,2,209015.0,Salary Increases & Fixed Expenses Remain Stable,237037,82979.0,149565,232544.0,4493.0,1.9,-0.04,High Risk
U583,2024,3,213508.0,Salary Increases & Fixed Expenses Remain Stable,237037,82979.0,215002,297981.0,-60944.0,-25.71,-0.04,High Risk
U583,2024,4,152564.0,Salary Increases & Fixed Expenses Remain Stable,237037,82979.0,173171,256150.0,-19113.0,-8.06,-0.01,High Risk
U583,2024,5,133451.0,Salary Increases & Fixed Expenses Remain Stable,261334,82979.0,194302,277281.0,-15947.0,-6.1,0.0,High Risk
U583,2024,6,117504.0,Salary Increases & Fixed Expenses Remain Stable,261334,82979.0,194719,277698.0,-16364.0,-6.26,-0.04,High Risk
U583,2024,7,101140.0,Salary Increases & Fixed Expenses Remain Stable,261334,82979.0,158931,241910.0,19424.0,7.43,0.01,High Risk
U583,2024,8,120564.0,Salary Increases & Fixed Expenses Remain Stable,261334,82979.0,199369,282348.0,-21014.0,-8.04,0.05,High Risk
U583,2024,9,99550.0,Salary Increases & Fixed Expenses Remain Stable,261334,82979.0,187717,270696.0,-9362.0,-3.58,-0.04,High Risk
U583,2024,10,90188.0,Salary Increases & Fixed Expenses Remain Stable,261334,82979.0,225177,308156.0,-46822.0,-17.92,0.02,High Risk
U583,2024,11,43366.0,Salary Increases & Fixed Expenses Remain Stable,261334,82979.0,179992,262971.0,-1637.0,-0.63,0.03,High Risk
U583,2024,12,41729.0,Salary Increases & Fixed Expenses Remain Stable,261334,82979.0,177454,260433.0,901.0,0.34,0.0,High Risk
U584,2024,1,207616.0,Salary Increases & Fixed Expenses Decrease,25052,16519.0,12585,29104.0,-4052.0,-16.17,0.02,High Risk
U584,2024,2,203564.0,Salary Increases & Fixed Expenses Decrease,25052,16519.0,13635,30154.0,-5102.0,-20.37,-0.01,High Risk
U584,2024,3,198462.0,Salary Increases & Fixed Expenses Decrease,25052,16519.0,17815,34334.0,-9282.0,-37.05,0.02,High Risk
U584,2024,4,189180.0,Salary Increases & Fixed Expenses Decrease,51104,16519.0,21846,38365.0,12739.0,24.93,-0.03,Medium Risk
U584,2024,5,201919.0,Salary Increases & Fixed Expenses Decrease,51104,16519.0,24734,41253.0,9851.0,19.28,0.0,Medium Risk
U584,2024,6,211770.0,Salary Increases & Fixed Expenses Decrease,51104,16519.0,28042,44561.0,6543.0,12.8,0.02,High Risk
U584,2024,7,218313.0,Salary Increases & Fixed Expenses Decrease,51104,16519.0,30571,47090.0,4014.0,7.85,0.03,High Risk
U584,2024,8,222327.0,Salary Increases & Fixed Expenses Decrease,51104,16519.0,28000,44519.0,6585.0,12.89,0.05,High Risk
U584,2024,9,228912.0,Salary Increases & Fixed Expenses Decrease,51104,16519.0,24527,41046.0,10058.0,19.68,-0.02,Medium Risk
U584,2024,10,238970.0,Salary Increases & Fixed Expenses Decrease,51104,16519.0,32601,49120.0,1984.0,3.88,0.0,High Risk
U584,2024,11,240954.0,Salary Increases & Fixed Expenses Decrease,51104,16519.0,29885,46404.0,4700.0,9.2,0.03,High Risk
U584,2024,12,245654.0,Salary Increases & Fixed Expenses Decrease,51104,16519.0,23688,40207.0,10897.0,21.32,0.04,Medium Risk
U585,2024,1,232320.0,Stable Salary & Stable Fixed Expenses,165352,76273.0,59927,136200.0,29152.0,17.63,0.03,Medium Risk
U585,2024,2,261472.0,Stable Salary & Stable Fixed Expenses,165352,76273.0,49856,126129.0,39223.0,23.72,-0.01,Medium Risk
U585,2024,3,300695.0,Stable Salary & Stable Fixed Expenses,165352,76273.0,59458,135731.0,29621.0,17.91,-0.0,Medium Risk
U585,2024,4,330316.0,Stable Salary & Stable Fixed Expenses,165352,76273.0,52407,128680.0,36672.0,22.18,0.01,Medium Risk
U585,2024,5,366988.0,Stable Salary & Stable Fixed Expenses,165352,76273.0,61125,137398.0,27954.0,16.91,0.02,Medium Risk
U585,2024,6,394942.0,Stable Salary & Stable Fixed Expenses,165352,76273.0,56611,132884.0,32468.0,19.64,-0.02,Medium Risk
U585,2024,7,427410.0,Stable Salary & Stable Fixed Expenses,165352,76273.0,52825,129098.0,36254.0,21.93,-0.01,Medium Risk
U585,2024,8,463664.0,Stable Salary & Stable Fixed Expenses,165352,76273.0,57394,133667.0,31685.0,19.16,0.0,Medium Risk
U585,2024,9,495349.0,Stable Salary & Stable Fixed Expenses,165352,76273.0,51304,127577.0,37775.0,22.85,-0.03,Medium Risk
U585,2024,10,533124.0,Stable Salary & Stable Fixed Expenses,165352,76273.0,64679,140952.0,24400.0,14.76,0.04,High Risk
U585,2024,11,557524.0,Stable Salary & Stable Fixed Expenses,165352,76273.0,62564,138837.0,26515.0,16.04,0.04,Medium Risk
U585,2024,12,584039.0,Stable Salary & Stable Fixed Expenses,165352,76273.0,53595,129868.0,35484.0,21.46,-0.05,Medium Risk
U586,2024,1,228867.0,Stable Salary & Increasing Fixed Expenses,241983,98340.0,99713,198053.0,43930.0,18.15,0.05,Medium Risk
U586,2024,2,272797.0,Stable Salary & Increasing Fixed Expenses,241983,98340.0,128771,227111.0,14872.0,6.15,0.03,High Risk
U586,2024,3,287669.0,Stable Salary & Increasing Fixed Expenses,241983,98340.0,161753,260093.0,-18110.0,-7.48,-0.01,High Risk
U586,2024,4,269559.0,Stable Salary & Increasing Fixed Expenses,241983,98340.0,141919,240259.0,1724.0,0.71,0.02,High Risk
U586,2024,5,271283.0,Stable Salary & Increasing Fixed Expenses,241983,98340.0,102277,200617.0,41366.0,17.09,0.04,Medium Risk
U586,2024,6,312649.0,Stable Salary & Increasing Fixed Expenses,241983,98340.0,144229,242569.0,-586.0,-0.24,-0.04,High Risk
U586,2024,7,312063.0,Stable Salary & Increasing Fixed Expenses,241983,98340.0,106576,204916.0,37067.0,15.32,0.0,Medium Risk
U586,2024,8,349130.0,Stable Salary & Increasing Fixed Expenses,241983,99920.0,115309,215229.0,26754.0,11.06,0.02,High Risk
U586,2024,9,375884.0,Stable Salary & Increasing Fixed Expenses,241983,99920.0,124095,224015.0,17968.0,7.43,0.02,High Risk
U586,2024,10,393852.0,Stable Salary & Increasing Fixed Expenses,241983,99920.0,166765,266685.0,-24702.0,-10.21,-0.04,High Risk
U586,2024,11,369150.0,Stable Salary & Increasing Fixed Expenses,241983,99920.0,134979,234899.0,7084.0,2.93,-0.0,High Risk
U586,2024,12,376234.0,Stable Salary & Increasing Fixed Expenses,241983,99920.0,164464,264384.0,-22401.0,-9.26,-0.04,High Risk
U587,2024,1,240352.0,Salary Increases & Fixed Expenses Remain Stable,227418,67488.0,158986,226474.0,944.0,0.42,-0.03,High Risk
U587,2024,2,241296.0,Salary Increases & Fixed Expenses Remain Stable,227418,67488.0,144430,211918.0,15500.0,6.82,-0.0,High Risk
U587,2024,3,256796.0,Salary Increases & Fixed Expenses Remain Stable,233618,67488.0,186005,253493.0,-19875.0,-8.51,-0.03,High Risk
U587,2024,4,236921.0,Salary Increases & Fixed Expenses Remain Stable,233618,67488.0,143155,210643.0,22975.0,9.83,-0.02,High Risk
U587,2024,5,259896.0,Salary Increases & Fixed Expenses Remain Stable,233618,67488.0,165771,233259.0,359.0,0.15,-0.0,High Risk
U587,2024,6,260255.0,Salary Increases & Fixed Expenses Remain Stable,233618,67488.0,169916,237404.0,-3786.0,-1.62,-0.03,High Risk
U587,2024,7,256469.0,Salary Increases & Fixed Expenses Remain Stable,233618,67488.0,171790,239278.0,-5660.0,-2.42,-0.04,High Risk
U587,2024,8,250809.0,Salary Increases & Fixed Expenses Remain Stable,233618,67488.0,156849,224337.0,9281.0,3.97,-0.04,High Risk
U587,2024,9,260090.0,Salary Increases & Fixed Expenses Remain Stable,233618,67488.0,166222,233710.0,-92.0,-0.04,0.03,High Risk
U587,2024,10,259998.0,Salary Increases & Fixed Expenses Remain Stable,233618,67488.0,183937,251425.0,-17807.0,-7.62,0.05,High Risk
U587,2024,11,242191.0,Salary Increases & Fixed Expenses Remain Stable,233618,67488.0,164981,232469.0,1149.0,0.49,-0.03,High Risk
U587,2024,12,243340.0,Salary Increases & Fixed Expenses Remain Stable,233618,67488.0,172969,240457.0,-6839.0,-2.93,0.03,High Risk
U588,2024,1,205686.0,Salary Increases & Fixed Expenses Increase,203119,75837.0,61874,137711.0,65408.0,32.2,-0.02,Low Risk
U588,2024,2,271094.0,Salary Increases & Fixed Expenses Increase,203119,75837.0,68671,144508.0,58611.0,28.86,-0.04,Low Risk
U588,2024,3,329705.0,Salary Increases & Fixed Expenses Increase,209385,77000.0,72397,149397.0,59988.0,28.65,0.01,Low Risk
U588,2024,4,389693.0,Salary Increases & Fixed Expenses Increase,209385,77000.0,79350,156350.0,53035.0,25.33,0.02,Low Risk
U588,2024,5,442728.0,Salary Increases & Fixed Expenses Increase,209385,77000.0,80317,157317.0,52068.0,24.87,-0.04,Medium Risk
U588,2024,6,494796.0,Salary Increases & Fixed Expenses Increase,209385,77000.0,69297,146297.0,63088.0,30.13,0.02,Low Risk
U588,2024,7,557884.0,Salary Increases & Fixed Expenses Increase,209385,77000.0,76090,153090.0,56295.0,26.89,0.04,Low Risk
U588,2024,8,614179.0,Salary Increases & Fixed Expenses Increase,209385,77000.0,80072,157072.0,52313.0,24.98,-0.03,Medium Risk
U588,2024,9,666492.0,Salary Increases & Fixed Expenses Increase,209385,77000.0,75250,152250.0,57135.0,27.29,0.0,Low Risk
U588,2024,10,723627.0,Salary Increases & Fixed Expenses Increase,209385,77000.0,97160,174160.0,35225.0,16.82,-0.04,Medium Risk
U588,2024,11,758852.0,Salary Increases & Fixed Expenses Increase,209385,77000.0,64722,141722.0,67663.0,32.32,-0.05,Low Risk
U588,2024,12,826515.0,Salary Increases & Fixed Expenses Increase,209385,77855.0,64650,142505.0,66880.0,31.94,-0.03,Low Risk
U589,2024,1,223935.0,Salary Increases & Fixed Expenses Remain Stable,123167,41833.0,62844,104677.0,18490.0,15.01,0.01,Medium Risk
U589,2024,2,242425.0,Salary Increases & Fixed Expenses Remain Stable,123167,41833.0,64382,106215.0,16952.0,13.76,0.0,High Risk
U589,2024,3,259377.0,Salary Increases & Fixed Expenses Remain Stable,123167,41833.0,79243,121076.0,2091.0,1.7,-0.03,High Risk
U589,2024,4,261468.0,Salary Increases & Fixed Expenses Remain Stable,123167,41833.0,53491,95324.0,27843.0,22.61,-0.0,Medium Risk
U589,2024,5,289311.0,Salary Increases & Fixed Expenses Remain Stable,123167,41833.0,63633,105466.0,17701.0,14.37,-0.01,High Risk
U589,2024,6,307012.0,Salary Increases & Fixed Expenses Remain Stable,146577,41833.0,76342,118175.0,28402.0,19.38,0.02,Medium Risk
U589,2024,7,335414.0,Salary Increases & Fixed Expenses Remain Stable,146577,41833.0,78858,120691.0,25886.0,17.66,0.03,Medium Risk
U589,2024,8,361300.0,Salary Increases & Fixed Expenses Remain Stable,146577,41833.0,62942,104775.0,41802.0,28.52,-0.01,Low Risk
U589,2024,9,403102.0,Salary Increases & Fixed Expenses Remain Stable,146577,41833.0,66529,108362.0,38215.0,26.07,0.01,Low Risk
U589,2024,10,441317.0,Salary Increases & Fixed Expenses Remain Stable,146577,41833.0,74849,116682.0,29895.0,20.4,-0.03,Medium Risk
U589,2024,11,471212.0,Salary Increases & Fixed Expenses Remain Stable,146577,41833.0,66075,107908.0,38669.0,26.38,0.02,Low Risk
U589,2024,12,509881.0,Salary Increases & Fixed Expenses Remain Stable,146577,41833.0,75598,117431.0,29146.0,19.88,0.02,Medium Risk
U590,2024,1,242503.0,Stable Salary & Stable Fixed Expenses,210749,118443.0,66794,185237.0,25512.0,12.11,-0.04,High Risk
U590,2024,2,268015.0,Stable Salary & Stable Fixed Expenses,210749,118443.0,77975,196418.0,14331.0,6.8,-0.03,High Risk
U590,2024,3,282346.0,Stable Salary & Stable Fixed Expenses,210749,118443.0,96182,214625.0,-3876.0,-1.84,-0.03,High Risk
U590,2024,4,278470.0,Stable Salary & Stable Fixed Expenses,210749,118443.0,65123,183566.0,27183.0,12.9,0.04,High Risk
U590,2024,5,305653.0,Stable Salary & Stable Fixed Expenses,210749,118443.0,76245,194688.0,16061.0,7.62,0.01,High Risk
U590,2024,6,321714.0,Stable Salary & Stable Fixed Expenses,210749,118443.0,74401,192844.0,17905.0,8.5,0.05,High Risk
U590,2024,7,339619.0,Stable Salary & Stable Fixed Expenses,210749,118443.0,66454,184897.0,25852.0,12.27,0.02,High Risk
U590,2024,8,365471.0,Stable Salary & Stable Fixed Expenses,210749,118443.0,75251,193694.0,17055.0,8.09,0.02,High Risk
U590,2024,9,382526.0,Stable Salary & Stable Fixed Expenses,210749,118443.0,63692,182135.0,28614.0,13.58,0.01,High Risk
U590,2024,10,411140.0,Stable Salary & Stable Fixed Expenses,210749,118443.0,93211,211654.0,-905.0,-0.43,-0.03,High Risk
U590,2024,11,410235.0,Stable Salary & Stable Fixed Expenses,210749,118443.0,73317,191760.0,18989.0,9.01,-0.03,High Risk
U590,2024,12,429224.0,Stable Salary & Stable Fixed Expenses,210749,118443.0,78109,196552.0,14197.0,6.74,-0.03,High Risk
U591,2024,1,246614.0,Stable Salary & Increasing Fixed Expenses,104542,40739.0,54693,95432.0,9110.0,8.71,0.04,High Risk
U591,2024,2,255724.0,Stable Salary & Increasing Fixed Expenses,104542,40739.0,42053,82792.0,21750.0,20.81,-0.01,Medium Risk
U591,2024,3,277474.0,Stable Salary & Increasing Fixed Expenses,104542,40739.0,63009,103748.0,794.0,0.76,-0.01,High Risk
U591,2024,4,278268.0,Stable Salary & Increasing Fixed Expenses,104542,40739.0,62426,103165.0,1377.0,1.32,0.0,High Risk
U591,2024,5,279645.0,Stable Salary & Increasing Fixed Expenses,104542,41617.0,62614,104231.0,311.0,0.3,-0.04,High Risk
U591,2024,6,279956.0,Stable Salary & Increasing Fixed Expenses,104542,43183.0,46831,90014.0,14528.0,13.9,0.02,High Risk
U591,2024,7,294484.0,Stable Salary & Increasing Fixed Expenses,104542,43183.0,56035,99218.0,5324.0,5.09,0.05,High Risk
U591,2024,8,299808.0,Stable Salary & Increasing Fixed Expenses,104542,44860.0,50724,95584.0,8958.0,8.57,-0.02,High Risk
U591,2024,9,308766.0,Stable Salary & Increasing Fixed Expenses,104542,44860.0,56257,101117.0,3425.0,3.28,-0.04,High Risk
U591,2024,10,312191.0,Stable Salary & Increasing Fixed Expenses,104542,44860.0,50617,95477.0,9065.0,8.67,0.01,High Risk
U591,2024,11,321256.0,Stable Salary & Increasing Fixed Expenses,104542,44860.0,45902,90762.0,13780.0,13.18,-0.01,High Risk
U591,2024,12,335036.0,Stable Salary & Increasing Fixed Expenses,104542,45628.0,53495,99123.0,5419.0,5.18,-0.02,High Risk
U592,2024,1,223506.0,Stable Salary & Stable Fixed Expenses,231323,110073.0,101937,212010.0,19313.0,8.35,0.04,High Risk
U592,2024,2,242819.0,Stable Salary & Stable Fixed Expenses,231323,110073.0,138322,248395.0,-17072.0,-7.38,-0.04,High Risk
U592,2024,3,225747.0,Stable Salary & Stable Fixed Expenses,231323,110073.0,127151,237224.0,-5901.0,-2.55,0.0,High Risk
U592,2024,4,219846.0,Stable Salary & Stable Fixed Expenses,231323,110073.0,117350,227423.0,3900.0,1.69,-0.01,High Risk
U592,2024,5,223746.0,Stable Salary & Stable Fixed Expenses,231323,110073.0,136801,246874.0,-15551.0,-6.72,-0.02,High Risk
U592,2024,6,208195.0,Stable Salary & Stable Fixed Expenses,231323,110073.0,115265,225338.0,5985.0,2.59,0.05,High Risk
U592,2024,7,214180.0,Stable Salary & Stable Fixed Expenses,231323,110073.0,130051,240124.0,-8801.0,-3.8,-0.03,High Risk
U592,2024,8,205379.0,Stable Salary & Stable Fixed Expenses,231323,110073.0,95244,205317.0,26006.0,11.24,0.05,High Risk
U592,2024,9,231385.0,Stable Salary & Stable Fixed Expenses,231323,110073.0,132677,242750.0,-11427.0,-4.94,0.01,High Risk
U592,2024,10,219958.0,Stable Salary & Stable Fixed Expenses,231323,110073.0,138456,248529.0,-17206.0,-7.44,-0.03,High Risk
U592,2024,11,202752.0,Stable Salary & Stable Fixed Expenses,231323,110073.0,95072,205145.0,26178.0,11.32,-0.0,High Risk
U592,2024,12,228930.0,Stable Salary & Stable Fixed Expenses,231323,110073.0,110051,220124.0,11199.0,4.84,0.0,High Risk
U593,2024,1,232511.0,Salary Increases & Fixed Expenses Remain Stable,226148,89723.0,130048,219771.0,6377.0,2.82,-0.01,High Risk
U593,2024,2,238888.0,Salary Increases & Fixed Expenses Remain Stable,226148,89723.0,97688,187411.0,38737.0,17.13,0.0,Medium Risk
U593,2024,3,277625.0,Salary Increases & Fixed Expenses Remain Stable,226148,89723.0,142454,232177.0,-6029.0,-2.67,0.01,High Risk
U593,2024,4,271596.0,Salary Increases & Fixed Expenses Remain Stable,226148,89723.0,135340,225063.0,1085.0,0.48,0.03,High Risk
U593,2024,5,272681.0,Salary Increases & Fixed Expenses Remain Stable,226148,89723.0,114682,204405.0,21743.0,9.61,-0.03,High Risk
U593,2024,6,294424.0,Salary Increases & Fixed Expenses Remain Stable,246140,89723.0,104585,194308.0,51832.0,21.06,0.03,Medium Risk
U593,2024,7,346256.0,Salary Increases & Fixed Expenses Remain Stable,246140,89723.0,108785,198508.0,47632.0,19.35,0.01,Medium Risk
U593,2024,8,393888.0,Salary Increases & Fixed Expenses Remain Stable,246140,89723.0,126319,216042.0,30098.0,12.23,0.03,High Risk
U593,2024,9,423986.0,Salary Increases & Fixed Expenses Remain Stable,246140,89723.0,125883,215606.0,30534.0,12.41,-0.03,High Risk
U593,2024,10,454520.0,Salary Increases & Fixed Expenses Remain Stable,246140,89723.0,146344,236067.0,10073.0,4.09,-0.03,High Risk
U593,2024,11,464593.0,Salary Increases & Fixed Expenses Remain Stable,246140,89723.0,127314,217037.0,29103.0,11.82,-0.01,High Risk
U593,2024,12,493696.0,Salary Increases & Fixed Expenses Remain Stable,246140,89723.0,145145,234868.0,11272.0,4.58,-0.01,High Risk
U594,2024,1,228218.0,Stable Salary & Stable Fixed Expenses,51234,36757.0,21100,57857.0,-6623.0,-12.93,-0.0,High Risk
U594,2024,2,221595.0,Stable Salary & Stable Fixed Expenses,51234,36757.0,22880,59637.0,-8403.0,-16.4,-0.03,High Risk
U594,2024,3,213192.0,Stable Salary & Stable Fixed Expenses,51234,36757.0,26983,63740.0,-12506.0,-24.41,0.01,High Risk
U594,2024,4,200686.0,Stable Salary & Stable Fixed Expenses,51234,36757.0,21826,58583.0,-7349.0,-14.34,-0.02,High Risk
U594,2024,5,193337.0,Stable Salary & Stable Fixed Expenses,51234,36757.0,29851,66608.0,-15374.0,-30.01,-0.02,High Risk
U594,2024,6,177963.0,Stable Salary & Stable Fixed Expenses,51234,36757.0,27951,64708.0,-13474.0,-26.3,-0.03,High Risk
U594,2024,7,164489.0,Stable Salary & Stable Fixed Expenses,51234,36757.0,27511,64268.0,-13034.0,-25.44,0.04,High Risk
U594,2024,8,151455.0,Stable Salary & Stable Fixed Expenses,51234,36757.0,24943,61700.0,-10466.0,-20.43,0.04,High Risk
U594,2024,9,140989.0,Stable Salary & Stable Fixed Expenses,51234,36757.0,33048,69805.0,-18571.0,-36.25,-0.04,High Risk
U594,2024,10,122418.0,Stable Salary & Stable Fixed Expenses,51234,36757.0,24919,61676.0,-10442.0,-20.38,0.02,High Risk
U594,2024,11,111976.0,Stable Salary & Stable Fixed Expenses,51234,36757.0,27288,64045.0,-12811.0,-25.0,-0.01,High Risk
U594,2024,12,99165.0,Stable Salary & Stable Fixed Expenses,51234,36757.0,24004,60761.0,-9527.0,-18.6,0.01,High Risk
U595,2024,1,246083.0,Salary Increases & Fixed Expenses Increase,273979,67657.0,130230,197887.0,76092.0,27.77,-0.01,Low Risk
U595,2024,2,322175.0,Salary Increases & Fixed Expenses Increase,273979,67657.0,136779,204436.0,69543.0,25.38,0.0,Low Risk
U595,2024,3,391718.0,Salary Increases & Fixed Expenses Increase,273979,67657.0,166380,234037.0,39942.0,14.58,0.02,High Risk
U595,2024,4,431660.0,Salary Increases & Fixed Expenses Increase,273979,67657.0,135239,202896.0,71083.0,25.94,0.02,Low Risk
U595,2024,5,502743.0,Salary Increases & Fixed Expenses Increase,273979,67657.0,142959,210616.0,63363.0,23.13,0.01,Medium Risk
U595,2024,6,566106.0,Salary Increases & Fixed Expenses Increase,273979,67657.0,129739,197396.0,76583.0,27.95,0.04,Low Risk
U595,2024,7,642689.0,Salary Increases & Fixed Expenses Increase,273979,69314.0,162954,232268.0,41711.0,15.22,0.01,Medium Risk
U595,2024,8,684400.0,Salary Increases & Fixed Expenses Increase,301541,69314.0,136067,205381.0,96160.0,31.89,-0.01,Low Risk
U595,2024,9,780560.0,Salary Increases & Fixed Expenses Increase,301541,69314.0,157599,226913.0,74628.0,24.75,-0.01,Medium Risk
U595,2024,10,855188.0,Salary Increases & Fixed Expenses Increase,301541,69996.0,167633,237629.0,63912.0,21.2,-0.03,Medium Risk
U595,2024,11,919100.0,Salary Increases & Fixed Expenses Increase,301541,69996.0,150399,220395.0,81146.0,26.91,-0.01,Low Risk
U595,2024,12,1000246.0,Salary Increases & Fixed Expenses Increase,301541,69996.0,167209,237205.0,64336.0,21.34,-0.01,Medium Risk
U596,2024,1,222839.0,Stable Salary & Stable Fixed Expenses,128082,48305.0,50155,98460.0,29622.0,23.13,-0.01,Medium Risk
U596,2024,2,252461.0,Stable Salary & Stable Fixed Expenses,128082,48305.0,45426,93731.0,34351.0,26.82,0.04,Low Risk
U596,2024,3,286812.0,Stable Salary & Stable Fixed Expenses,128082,48305.0,44846,93151.0,34931.0,27.27,-0.01,Low Risk
U596,2024,4,321743.0,Stable Salary & Stable Fixed Expenses,128082,48305.0,39629,87934.0,40148.0,31.35,0.04,Low Risk
U596,2024,5,361891.0,Stable Salary & Stable Fixed Expenses,128082,48305.0,49912,98217.0,29865.0,23.32,0.0,Medium Risk
U596,2024,6,391756.0,Stable Salary & Stable Fixed Expenses,128082,48305.0,42175,90480.0,37602.0,29.36,0.0,Low Risk
U596,2024,7,429358.0,Stable Salary & Stable Fixed Expenses,128082,48305.0,49381,97686.0,30396.0,23.73,0.02,Medium Risk
U596,2024,8,459754.0,Stable Salary & Stable Fixed Expenses,128082,48305.0,39802,88107.0,39975.0,31.21,-0.03,Low Risk
U596,2024,9,499729.0,Stable Salary & Stable Fixed Expenses,128082,48305.0,43582,91887.0,36195.0,28.26,-0.04,Low Risk
U596,2024,10,535924.0,Stable Salary & Stable Fixed Expenses,128082,48305.0,40769,89074.0,39008.0,30.46,-0.04,Low Risk
U596,2024,11,574932.0,Stable Salary & Stable Fixed Expenses,128082,48305.0,43418,91723.0,36359.0,28.39,-0.01,Low Risk
U596,2024,12,611291.0,Stable Salary & Stable Fixed Expenses,128082,48305.0,48051,96356.0,31726.0,24.77,0.0,Medium Risk
U597,2024,1,219423.0,Salary Increases & Fixed Expenses Increase,267579,112541.0,128281,240822.0,26757.0,10.0,0.0,High Risk
U597,2024,2,246180.0,Salary Increases & Fixed Expenses Increase,267579,112541.0,122032,234573.0,33006.0,12.34,0.02,High Risk
U597,2024,3,279186.0,Salary Increases & Fixed Expenses Increase,293168,112541.0,219210,331751.0,-38583.0,-13.16,0.0,High Risk
U597,2024,4,240603.0,Salary Increases & Fixed Expenses Increase,293168,112541.0,145585,258126.0,35042.0,11.95,-0.03,High Risk
U597,2024,5,275645.0,Salary Increases & Fixed Expenses Increase,293168,112541.0,161569,274110.0,19058.0,6.5,-0.05,High Risk
U597,2024,6,294703.0,Salary Increases & Fixed Expenses Increase,293168,112541.0,164714,277255.0,15913.0,5.43,-0.03,High Risk
U597,2024,7,310616.0,Salary Increases & Fixed Expenses Increase,293168,112541.0,160276,272817.0,20351.0,6.94,-0.02,High Risk
U597,2024,8,330967.0,Salary Increases & Fixed Expenses Increase,293168,114383.0,146114,260497.0,32671.0,11.14,-0.01,High Risk
U597,2024,9,363638.0,Salary Increases & Fixed Expenses Increase,293168,114951.0,146803,261754.0,31414.0,10.72,0.01,High Risk
U597,2024,10,395052.0,Salary Increases & Fixed Expenses Increase,293168,114951.0,142538,257489.0,35679.0,12.17,-0.03,High Risk
U597,2024,11,430731.0,Salary Increases & Fixed Expenses Increase,293168,114951.0,169448,284399.0,8769.0,2.99,0.05,High Risk
U597,2024,12,439500.0,Salary Increases & Fixed Expenses Increase,293168,114951.0,135176,250127.0,43041.0,14.68,0.04,High Risk
U598,2024,1,217316.0,Salary Increases & Fixed Expenses Increase,155178,69369.0,66468,135837.0,19341.0,12.46,-0.02,High Risk
U598,2024,2,236657.0,Salary Increases & Fixed Expenses Increase,155178,69369.0,78031,147400.0,7778.0,5.01,0.02,High Risk
U598,2024,3,244435.0,Salary Increases & Fixed Expenses Increase,155178,70557.0,100170,170727.0,-15549.0,-10.02,0.01,High Risk
U598,2024,4,228886.0,Salary Increases & Fixed Expenses Increase,155178,70557.0,91181,161738.0,-6560.0,-4.23,-0.0,High Risk
U598,2024,5,222326.0,Salary Increases & Fixed Expenses Increase,172213,71469.0,97937,169406.0,2807.0,1.63,0.01,High Risk
U598,2024,6,225133.0,Salary Increases & Fixed Expenses Increase,172213,71469.0,72502,143971.0,28242.0,16.4,0.03,Medium Risk
U598,2024,7,253375.0,Salary Increases & Fixed Expenses Increase,172213,71469.0,86533,158002.0,14211.0,8.25,0.01,High Risk
U598,2024,8,267586.0,Salary Increases & Fixed Expenses Increase,172213,71469.0,101421,172890.0,-677.0,-0.39,0.04,High Risk
U598,2024,9,266909.0,Salary Increases & Fixed Expenses Increase,172213,73323.0,99981,173304.0,-1091.0,-0.63,0.02,High Risk
U598,2024,10,265818.0,Salary Increases & Fixed Expenses Increase,172213,73323.0,117196,190519.0,-18306.0,-10.63,-0.02,High Risk
U598,2024,11,247512.0,Salary Increases & Fixed Expenses Increase,172213,73323.0,98228,171551.0,662.0,0.38,-0.03,High Risk
U598,2024,12,248174.0,Salary Increases & Fixed Expenses Increase,172213,73323.0,93509,166832.0,5381.0,3.12,0.01,High Risk
U599,2024,1,226415.0,Stable Salary & Increasing Fixed Expenses,255681,106908.0,164998,271906.0,-16225.0,-6.35,-0.0,High Risk
U599,2024,2,210190.0,Stable Salary & Increasing Fixed Expenses,255681,107767.0,183216,290983.0,-35302.0,-13.81,-0.0,High Risk
U599,2024,3,174888.0,Stable Salary & Increasing Fixed Expenses,255681,107767.0,193352,301119.0,-45438.0,-17.77,-0.02,High Risk
U599,2024,4,129450.0,Stable Salary & Increasing Fixed Expenses,255681,107767.0,174865,282632.0,-26951.0,-10.54,-0.02,High Risk
U599,2024,5,102499.0,Stable Salary & Increasing Fixed Expenses,255681,107767.0,194725,302492.0,-46811.0,-18.31,0.02,High Risk
U599,2024,6,55688.0,Stable Salary & Increasing Fixed Expenses,255681,107767.0,161779,269546.0,-13865.0,-5.42,-0.04,High Risk
U599,2024,7,41823.0,Stable Salary & Increasing Fixed Expenses,255681,108375.0,188427,296802.0,-41121.0,-16.08,0.04,High Risk
U599,2024,8,702.0,Stable Salary & Increasing Fixed Expenses,255681,109575.0,169948,279523.0,-23842.0,-9.32,0.02,High Risk
U599,2024,9,-23140.0,Stable Salary & Increasing Fixed Expenses,255681,109575.0,158659,268234.0,-12553.0,-4.91,-0.01,High Risk
U599,2024,10,-35693.0,Stable Salary & Increasing Fixed Expenses,255681,109575.0,185216,294791.0,-39110.0,-15.3,0.05,High Risk
U599,2024,11,-74803.0,Stable Salary & Increasing Fixed Expenses,255681,109575.0,158541,268116.0,-12435.0,-4.86,0.04,High Risk
U599,2024,12,-87238.0,Stable Salary & Increasing Fixed Expenses,255681,109575.0,165595,275170.0,-19489.0,-7.62,-0.01,High Risk
U600,2024,1,215438.0,Salary Increases & Fixed Expenses Increase,152580,47982.0,84282,132264.0,20316.0,13.31,-0.03,High Risk
U600,2024,2,235754.0,Salary Increases & Fixed Expenses Increase,152580,48943.0,85224,134167.0,18413.0,12.07,-0.02,High Risk
U600,2024,3,254167.0,Salary Increases & Fixed Expenses Increase,152580,48943.0,98959,147902.0,4678.0,3.07,0.02,High Risk
U600,2024,4,258845.0,Salary Increases & Fixed Expenses Increase,152580,48943.0,86678,135621.0,16959.0,11.11,0.05,High Risk
U600,2024,5,275804.0,Salary Increases & Fixed Expenses Increase,152580,48943.0,76568,125511.0,27069.0,17.74,0.03,Medium Risk
U600,2024,6,302873.0,Salary Increases & Fixed Expenses Increase,152580,48943.0,68101,117044.0,35536.0,23.29,0.05,Medium Risk
U600,2024,7,338409.0,Salary Increases & Fixed Expenses Increase,162269,48943.0,71160,120103.0,42166.0,25.99,0.01,Low Risk
U600,2024,8,380575.0,Salary Increases & Fixed Expenses Increase,162269,48943.0,90311,139254.0,23015.0,14.18,0.04,High Risk
U600,2024,9,403590.0,Salary Increases & Fixed Expenses Increase,162269,48943.0,94887,143830.0,18439.0,11.36,-0.02,High Risk
U600,2024,10,422029.0,Salary Increases & Fixed Expenses Increase,162269,48943.0,94314,143257.0,19012.0,11.72,0.03,High Risk
U600,2024,11,441041.0,Salary Increases & Fixed Expenses Increase,162269,48943.0,88887,137830.0,24439.0,15.06,-0.0,Medium Risk
U600,2024,12,465480.0,Salary Increases & Fixed Expenses Increase,162269,48943.0,86833,135776.0,26493.0,16.33,-0.02,Medium Risk
U601,2024,1,204022.0,Salary Increases & Fixed Expenses Remain Stable,234419,61649.0,74727,136376.0,98043.0,41.82,-0.02,Low Risk
U601,2024,2,302065.0,Salary Increases & Fixed Expenses Remain Stable,234419,61649.0,90724,152373.0,82046.0,35.0,0.02,Low Risk
U601,2024,3,384111.0,Salary Increases & Fixed Expenses Remain Stable,234419,61649.0,96785,158434.0,75985.0,32.41,0.03,Low Risk
U601,2024,4,460096.0,Salary Increases & Fixed Expenses Remain Stable,234419,61649.0,92960,154609.0,79810.0,34.05,0.04,Low Risk
U601,2024,5,539906.0,Salary Increases & Fixed Expenses Remain Stable,234419,61649.0,76094,137743.0,96676.0,41.24,0.02,Low Risk
U601,2024,6,636582.0,Salary Increases & Fixed Expenses Remain Stable,234419,61649.0,80548,142197.0,92222.0,39.34,-0.05,Low Risk
U601,2024,7,728804.0,Salary Increases & Fixed Expenses Remain Stable,234419,61649.0,70429,132078.0,102341.0,43.66,-0.03,Low Risk
U601,2024,8,831145.0,Salary Increases & Fixed Expenses Remain Stable,247011,61649.0,75186,136835.0,110176.0,44.6,-0.02,Low Risk
U601,2024,9,941321.0,Salary Increases & Fixed Expenses Remain Stable,247011,61649.0,77422,139071.0,107940.0,43.7,0.04,Low Risk
U601,2024,10,1049261.0,Salary Increases & Fixed Expenses Remain Stable,247011,61649.0,82824,144473.0,102538.0,41.51,0.04,Low Risk
U601,2024,11,1151799.0,Salary Increases & Fixed Expenses Remain Stable,247011,61649.0,87197,148846.0,98165.0,39.74,-0.04,Low Risk
U601,2024,12,1249964.0,Salary Increases & Fixed Expenses Remain Stable,247011,61649.0,91961,153610.0,93401.0,37.81,0.02,Low Risk
U602,2024,1,240697.0,Salary Increases & Fixed Expenses Remain Stable,145840,71176.0,73039,144215.0,1625.0,1.11,-0.05,High Risk
U602,2024,2,242322.0,Salary Increases & Fixed Expenses Remain Stable,145840,71176.0,77854,149030.0,-3190.0,-2.19,-0.0,High Risk
U602,2024,3,239132.0,Salary Increases & Fixed Expenses Remain Stable,174914,71176.0,109717,180893.0,-5979.0,-3.42,0.01,High Risk
U602,2024,4,233153.0,Salary Increases & Fixed Expenses Remain Stable,174914,71176.0,73357,144533.0,30381.0,17.37,0.02,Medium Risk
U602,2024,5,263534.0,Salary Increases & Fixed Expenses Remain Stable,174914,71176.0,86062,157238.0,17676.0,10.11,0.02,High Risk
U602,2024,6,281210.0,Salary Increases & Fixed Expenses Remain Stable,174914,71176.0,102820,173996.0,918.0,0.52,0.04,High Risk
U602,2024,7,282128.0,Salary Increases & Fixed Expenses Remain Stable,174914,71176.0,89861,161037.0,13877.0,7.93,0.01,High Risk
U602,2024,8,296005.0,Salary Increases & Fixed Expenses Remain Stable,174914,71176.0,74872,146048.0,28866.0,16.5,0.05,Medium Risk
U602,2024,9,324871.0,Salary Increases & Fixed Expenses Remain Stable,174914,71176.0,83495,154671.0,20243.0,11.57,-0.02,High Risk
U602,2024,10,345114.0,Salary Increases & Fixed Expenses Remain Stable,174914,71176.0,114197,185373.0,-10459.0,-5.98,0.0,High Risk
U602,2024,11,334655.0,Salary Increases & Fixed Expenses Remain Stable,174914,71176.0,79907,151083.0,23831.0,13.62,-0.05,High Risk
U602,2024,12,358486.0,Salary Increases & Fixed Expenses Remain Stable,174914,71176.0,110041,181217.0,-6303.0,-3.6,-0.03,High Risk
U603,2024,1,213206.0,Stable Salary & Stable Fixed Expenses,251346,83507.0,197552,281059.0,-29713.0,-11.82,0.03,High Risk
U603,2024,2,183493.0,Stable Salary & Stable Fixed Expenses,251346,83507.0,179062,262569.0,-11223.0,-4.47,-0.05,High Risk
U603,2024,3,172270.0,Stable Salary & Stable Fixed Expenses,251346,83507.0,180437,263944.0,-12598.0,-5.01,-0.02,High Risk
U603,2024,4,159672.0,Stable Salary & Stable Fixed Expenses,251346,83507.0,167564,251071.0,275.0,0.11,0.02,High Risk
U603,2024,5,159947.0,Stable Salary & Stable Fixed Expenses,251346,83507.0,187906,271413.0,-20067.0,-7.98,-0.04,High Risk
U603,2024,6,139880.0,Stable Salary & Stable Fixed Expenses,251346,83507.0,156184,239691.0,11655.0,4.64,0.03,High Risk
U603,2024,7,151535.0,Stable Salary & Stable Fixed Expenses,251346,83507.0,152226,235733.0,15613.0,6.21,0.03,High Risk
U603,2024,8,167148.0,Stable Salary & Stable Fixed Expenses,251346,83507.0,195878,279385.0,-28039.0,-11.16,-0.03,High Risk
U603,2024,9,139109.0,Stable Salary & Stable Fixed Expenses,251346,83507.0,164315,247822.0,3524.0,1.4,-0.01,High Risk
U603,2024,10,142633.0,Stable Salary & Stable Fixed Expenses,251346,83507.0,233189,316696.0,-65350.0,-26.0,-0.03,High Risk
U603,2024,11,77283.0,Stable Salary & Stable Fixed Expenses,251346,83507.0,168956,252463.0,-1117.0,-0.44,-0.02,High Risk
U603,2024,12,76166.0,Stable Salary & Stable Fixed Expenses,251346,83507.0,164477,247984.0,3362.0,1.34,0.03,High Risk
U604,2024,1,234205.0,Salary Increases & Fixed Expenses Increase,118915,52649.0,87731,140380.0,-21465.0,-18.05,0.04,High Risk
U604,2024,2,212740.0,Salary Increases & Fixed Expenses Increase,118915,54439.0,85919,140358.0,-21443.0,-18.03,-0.05,High Risk
U604,2024,3,191297.0,Salary Increases & Fixed Expenses Increase,118915,54439.0,87217,141656.0,-22741.0,-19.12,0.04,High Risk
U604,2024,4,168556.0,Salary Increases & Fixed Expenses Increase,118915,54439.0,74760,129199.0,-10284.0,-8.65,0.03,High Risk
U604,2024,5,158272.0,Salary Increases & Fixed Expenses Increase,126387,54439.0,86554,140993.0,-14606.0,-11.56,-0.02,High Risk
U604,2024,6,143666.0,Salary Increases & Fixed Expenses Increase,126387,54439.0,89171,143610.0,-17223.0,-13.63,-0.01,High Risk
U604,2024,7,126443.0,Salary Increases & Fixed Expenses Increase,126387,54439.0,99996,154435.0,-28048.0,-22.19,-0.05,High Risk
U604,2024,8,98395.0,Salary Increases & Fixed Expenses Increase,126387,54439.0,85775,140214.0,-13827.0,-10.94,-0.0,High Risk
U604,2024,9,84568.0,Salary Increases & Fixed Expenses Increase,126387,54439.0,80078,134517.0,-8130.0,-6.43,-0.02,High Risk
U604,2024,10,76438.0,Salary Increases & Fixed Expenses Increase,126387,54439.0,91476,145915.0,-19528.0,-15.45,-0.05,High Risk
U604,2024,11,56910.0,Salary Increases & Fixed Expenses Increase,126387,54439.0,93883,148322.0,-21935.0,-17.36,0.04,High Risk
U604,2024,12,34975.0,Salary Increases & Fixed Expenses Increase,126387,54439.0,95252,149691.0,-23304.0,-18.44,-0.05,High Risk
U605,2024,1,229268.0,Stable Salary & Stable Fixed Expenses,282512,88593.0,165649,254242.0,28270.0,10.01,-0.02,High Risk
U605,2024,2,257538.0,Stable Salary & Stable Fixed Expenses,282512,88593.0,126978,215571.0,66941.0,23.69,0.04,Medium Risk
U605,2024,3,324479.0,Stable Salary & Stable Fixed Expenses,282512,88593.0,143895,232488.0,50024.0,17.71,-0.01,Medium Risk
U605,2024,4,374503.0,Stable Salary & Stable Fixed Expenses,282512,88593.0,144134,232727.0,49785.0,17.62,0.0,Medium Risk
U605,2024,5,424288.0,Stable Salary & Stable Fixed Expenses,282512,88593.0,161445,250038.0,32474.0,11.49,0.01,High Risk
U605,2024,6,456762.0,Stable Salary & Stable Fixed Expenses,282512,88593.0,154431,243024.0,39488.0,13.98,-0.02,High Risk
U605,2024,7,496250.0,Stable Salary & Stable Fixed Expenses,282512,88593.0,155843,244436.0,38076.0,13.48,-0.03,High Risk
U605,2024,8,534326.0,Stable Salary & Stable Fixed Expenses,282512,88593.0,126879,215472.0,67040.0,23.73,-0.02,Medium Risk
U605,2024,9,601366.0,Stable Salary & Stable Fixed Expenses,282512,88593.0,157847,246440.0,36072.0,12.77,-0.04,High Risk
U605,2024,10,637438.0,Stable Salary & Stable Fixed Expenses,282512,88593.0,190138,278731.0,3781.0,1.34,-0.02,High Risk
U605,2024,11,641219.0,Stable Salary & Stable Fixed Expenses,282512,88593.0,150812,239405.0,43107.0,15.26,-0.02,Medium Risk
U605,2024,12,684326.0,Stable Salary & Stable Fixed Expenses,282512,88593.0,166648,255241.0,27271.0,9.65,-0.03,High Risk
U606,2024,1,219672.0,Stable Salary & Stable Fixed Expenses,77613,29887.0,39173,69060.0,8553.0,11.02,0.03,High Risk
U606,2024,2,228225.0,Stable Salary & Stable Fixed Expenses,77613,29887.0,35747,65634.0,11979.0,15.43,0.02,Medium Risk
U606,2024,3,240204.0,Stable Salary & Stable Fixed Expenses,77613,29887.0,46033,75920.0,1693.0,2.18,0.03,High Risk
U606,2024,4,241897.0,Stable Salary & Stable Fixed Expenses,77613,29887.0,35241,65128.0,12485.0,16.09,0.02,Medium Risk
U606,2024,5,254382.0,Stable Salary & Stable Fixed Expenses,77613,29887.0,39669,69556.0,8057.0,10.38,0.02,High Risk
U606,2024,6,262439.0,Stable Salary & Stable Fixed Expenses,77613,29887.0,40152,70039.0,7574.0,9.76,0.03,High Risk
U606,2024,7,270013.0,Stable Salary & Stable Fixed Expenses,77613,29887.0,39153,69040.0,8573.0,11.05,0.0,High Risk
U606,2024,8,278586.0,Stable Salary & Stable Fixed Expenses,77613,29887.0,36310,66197.0,11416.0,14.71,-0.03,High Risk
U606,2024,9,290002.0,Stable Salary & Stable Fixed Expenses,77613,29887.0,43050,72937.0,4676.0,6.02,0.01,High Risk
U606,2024,10,294678.0,Stable Salary & Stable Fixed Expenses,77613,29887.0,40323,70210.0,7403.0,9.54,0.03,High Risk
U606,2024,11,302081.0,Stable Salary & Stable Fixed Expenses,77613,29887.0,36163,66050.0,11563.0,14.9,0.02,High Risk
U606,2024,12,313644.0,Stable Salary & Stable Fixed Expenses,77613,29887.0,35117,65004.0,12609.0,16.25,0.03,Medium Risk
U607,2024,1,206192.0,Stable Salary & Stable Fixed Expenses,221784,69278.0,118372,187650.0,34134.0,15.39,0.04,Medium Risk
U607,2024,2,240326.0,Stable Salary & Stable Fixed Expenses,221784,69278.0,126427,195705.0,26079.0,11.76,0.01,High Risk
U607,2024,3,266405.0,Stable Salary & Stable Fixed Expenses,221784,69278.0,109067,178345.0,43439.0,19.59,0.0,Medium Risk
U607,2024,4,309844.0,Stable Salary & Stable Fixed Expenses,221784,69278.0,132525,201803.0,19981.0,9.01,0.0,High Risk
U607,2024,5,329825.0,Stable Salary & Stable Fixed Expenses,221784,69278.0,90497,159775.0,62009.0,27.96,-0.02,Low Risk
U607,2024,6,391834.0,Stable Salary & Stable Fixed Expenses,221784,69278.0,122124,191402.0,30382.0,13.7,-0.02,High Risk
U607,2024,7,422216.0,Stable Salary & Stable Fixed Expenses,221784,69278.0,97030,166308.0,55476.0,25.01,0.05,Low Risk
U607,2024,8,477692.0,Stable Salary & Stable Fixed Expenses,221784,69278.0,109399,178677.0,43107.0,19.44,0.05,Medium Risk
U607,2024,9,520799.0,Stable Salary & Stable Fixed Expenses,221784,69278.0,121980,191258.0,30526.0,13.76,-0.01,High Risk
U607,2024,10,551325.0,Stable Salary & Stable Fixed Expenses,221784,69278.0,125624,194902.0,26882.0,12.12,-0.05,High Risk
U607,2024,11,578207.0,Stable Salary & Stable Fixed Expenses,221784,69278.0,110971,180249.0,41535.0,18.73,-0.0,Medium Risk
U607,2024,12,619742.0,Stable Salary & Stable Fixed Expenses,221784,69278.0,120481,189759.0,32025.0,14.44,-0.03,High Risk
U608,2024,1,215586.0,Salary Increases & Fixed Expenses Remain Stable,284661,66374.0,125231,191605.0,93056.0,32.69,0.03,Low Risk
U608,2024,2,308642.0,Salary Increases & Fixed Expenses Remain Stable,284661,66374.0,145358,211732.0,72929.0,25.62,-0.04,Low Risk
U608,2024,3,381571.0,Salary Increases & Fixed Expenses Remain Stable,302675,66374.0,145552,211926.0,90749.0,29.98,-0.05,Low Risk
U608,2024,4,472320.0,Salary Increases & Fixed Expenses Remain Stable,302675,66374.0,139197,205571.0,97104.0,32.08,0.03,Low Risk
U608,2024,5,569424.0,Salary Increases & Fixed Expenses Remain Stable,302675,66374.0,125321,191695.0,110980.0,36.67,-0.02,Low Risk
U608,2024,6,680404.0,Salary Increases & Fixed Expenses Remain Stable,302675,66374.0,168891,235265.0,67410.0,22.27,-0.02,Medium Risk
U608,2024,7,747814.0,Salary Increases & Fixed Expenses Remain Stable,302675,66374.0,134705,201079.0,101596.0,33.57,0.02,Low Risk
U608,2024,8,849410.0,Salary Increases & Fixed Expenses Remain Stable,302675,66374.0,130076,196450.0,106225.0,35.1,0.02,Low Risk
U608,2024,9,955635.0,Salary Increases & Fixed Expenses Remain Stable,302675,66374.0,124533,190907.0,111768.0,36.93,0.02,Low Risk
U608,2024,10,1067403.0,Salary Increases & Fixed Expenses Remain Stable,302675,66374.0,163394,229768.0,72907.0,24.09,0.03,Medium Risk
U608,2024,11,1140310.0,Salary Increases & Fixed Expenses Remain Stable,302675,66374.0,176386,242760.0,59915.0,19.8,-0.05,Medium Risk
U608,2024,12,1200225.0,Salary Increases & Fixed Expenses Remain Stable,302675,66374.0,154483,220857.0,81818.0,27.03,0.03,Low Risk
U609,2024,1,217681.0,Stable Salary & Increasing Fixed Expenses,143246,77931.0,59882,137813.0,5433.0,3.79,0.03,High Risk
U609,2024,2,223114.0,Stable Salary & Increasing Fixed Expenses,143246,77931.0,79635,157566.0,-14320.0,-10.0,0.03,High Risk
U609,2024,3,208794.0,Stable Salary & Increasing Fixed Expenses,143246,79352.0,92468,171820.0,-28574.0,-19.95,0.02,High Risk
U609,2024,4,180220.0,Stable Salary & Increasing Fixed Expenses,143246,80466.0,69742,150208.0,-6962.0,-4.86,0.04,High Risk
U609,2024,5,173258.0,Stable Salary & Increasing Fixed Expenses,143246,80466.0,70712,151178.0,-7932.0,-5.54,-0.04,High Risk
U609,2024,6,165326.0,Stable Salary & Increasing Fixed Expenses,143246,80466.0,78839,159305.0,-16059.0,-11.21,-0.03,High Risk
U609,2024,7,149267.0,Stable Salary & Increasing Fixed Expenses,143246,80466.0,79071,159537.0,-16291.0,-11.37,-0.01,High Risk
U609,2024,8,132976.0,Stable Salary & Increasing Fixed Expenses,143246,80466.0,83366,163832.0,-20586.0,-14.37,0.03,High Risk
U609,2024,9,112390.0,Stable Salary & Increasing Fixed Expenses,143246,80466.0,66457,146923.0,-3677.0,-2.57,0.01,High Risk
U609,2024,10,108713.0,Stable Salary & Increasing Fixed Expenses,143246,80466.0,84513,164979.0,-21733.0,-15.17,-0.01,High Risk
U609,2024,11,86980.0,Stable Salary & Increasing Fixed Expenses,143246,80466.0,70495,150961.0,-7715.0,-5.39,-0.04,High Risk
U609,2024,12,79265.0,Stable Salary & Increasing Fixed Expenses,143246,80466.0,70032,150498.0,-7252.0,-5.06,-0.02,High Risk
U610,2024,1,237544.0,Salary Increases & Fixed Expenses Increase,164577,56581.0,53449,110030.0,54547.0,33.14,-0.02,Low Risk
U610,2024,2,292091.0,Salary Increases & Fixed Expenses Increase,164577,56581.0,64483,121064.0,43513.0,26.44,0.02,Low Risk
U610,2024,3,335604.0,Salary Increases & Fixed Expenses Increase,182731,56581.0,68304,124885.0,57846.0,31.66,0.01,Low Risk
U610,2024,4,393450.0,Salary Increases & Fixed Expenses Increase,182731,56581.0,56161,112742.0,69989.0,38.3,0.04,Low Risk
U610,2024,5,463439.0,Salary Increases & Fixed Expenses Increase,182731,56581.0,66913,123494.0,59237.0,32.42,-0.02,Low Risk
U610,2024,6,522676.0,Salary Increases & Fixed Expenses Increase,182731,56581.0,55736,112317.0,70414.0,38.53,-0.05,Low Risk
U610,2024,7,593090.0,Salary Increases & Fixed Expenses Increase,182731,56581.0,58069,114650.0,68081.0,37.26,-0.0,Low Risk
U610,2024,8,661171.0,Salary Increases & Fixed Expenses Increase,182731,56581.0,71234,127815.0,54916.0,30.05,-0.02,Low Risk
U610,2024,9,716087.0,Salary Increases & Fixed Expenses Increase,182731,56581.0,62465,119046.0,63685.0,34.85,-0.01,Low Risk
U610,2024,10,779772.0,Salary Increases & Fixed Expenses Increase,182731,56581.0,70480,127061.0,55670.0,30.47,-0.02,Low Risk
U610,2024,11,835442.0,Salary Increases & Fixed Expenses Increase,182731,56581.0,62081,118662.0,64069.0,35.06,-0.05,Low Risk
U610,2024,12,899511.0,Salary Increases & Fixed Expenses Increase,182731,56581.0,56618,113199.0,69532.0,38.05,-0.03,Low Risk
U611,2024,1,223629.0,Stable Salary & Stable Fixed Expenses,117070,48851.0,87896,136747.0,-19677.0,-16.81,-0.03,High Risk
U611,2024,2,203952.0,Stable Salary & Stable Fixed Expenses,117070,48851.0,75109,123960.0,-6890.0,-5.89,0.0,High Risk
U611,2024,3,197062.0,Stable Salary & Stable Fixed Expenses,117070,48851.0,80360,129211.0,-12141.0,-10.37,-0.04,High Risk
U611,2024,4,184921.0,Stable Salary & Stable Fixed Expenses,117070,48851.0,91104,139955.0,-22885.0,-19.55,-0.0,High Risk
U611,2024,5,162036.0,Stable Salary & Stable Fixed Expenses,117070,48851.0,77488,126339.0,-9269.0,-7.92,-0.03,High Risk
U611,2024,6,152767.0,Stable Salary & Stable Fixed Expenses,117070,48851.0,81965,130816.0,-13746.0,-11.74,-0.02,High Risk
U611,2024,7,139021.0,Stable Salary & Stable Fixed Expenses,117070,48851.0,79715,128566.0,-11496.0,-9.82,0.03,High Risk
U611,2024,8,127525.0,Stable Salary & Stable Fixed Expenses,117070,48851.0,82590,131441.0,-14371.0,-12.28,-0.0,High Risk
U611,2024,9,113154.0,Stable Salary & Stable Fixed Expenses,117070,48851.0,87279,136130.0,-19060.0,-16.28,0.04,High Risk
U611,2024,10,94094.0,Stable Salary & Stable Fixed Expenses,117070,48851.0,72764,121615.0,-4545.0,-3.88,-0.02,High Risk
U611,2024,11,89549.0,Stable Salary & Stable Fixed Expenses,117070,48851.0,92508,141359.0,-24289.0,-20.75,0.04,High Risk
U611,2024,12,65260.0,Stable Salary & Stable Fixed Expenses,117070,48851.0,84828,133679.0,-16609.0,-14.19,-0.05,High Risk
U612,2024,1,244072.0,Salary Increases & Fixed Expenses Remain Stable,91483,28322.0,53834,82156.0,9327.0,10.2,0.03,High Risk
U612,2024,2,253399.0,Salary Increases & Fixed Expenses Remain Stable,91483,28322.0,37688,66010.0,25473.0,27.84,-0.03,Low Risk
U612,2024,3,278872.0,Salary Increases & Fixed Expenses Remain Stable,91483,28322.0,52312,80634.0,10849.0,11.86,0.05,High Risk
U612,2024,4,289721.0,Salary Increases & Fixed Expenses Remain Stable,97172,28322.0,44195,72517.0,24655.0,25.37,-0.02,Low Risk
U612,2024,5,314376.0,Salary Increases & Fixed Expenses Remain Stable,97172,28322.0,43247,71569.0,25603.0,26.35,0.01,Low Risk
U612,2024,6,339979.0,Salary Increases & Fixed Expenses Remain Stable,97172,28322.0,48357,76679.0,20493.0,21.09,-0.03,Medium Risk
U612,2024,7,360472.0,Salary Increases & Fixed Expenses Remain Stable,97172,28322.0,54393,82715.0,14457.0,14.88,0.01,High Risk
U612,2024,8,374929.0,Salary Increases & Fixed Expenses Remain Stable,97172,28322.0,44316,72638.0,24534.0,25.25,0.01,Low Risk
U612,2024,9,399463.0,Salary Increases & Fixed Expenses Remain Stable,97172,28322.0,56351,84673.0,12499.0,12.86,0.03,High Risk
U612,2024,10,411962.0,Salary Increases & Fixed Expenses Remain Stable,97172,28322.0,52819,81141.0,16031.0,16.5,0.02,Medium Risk
U612,2024,11,427993.0,Salary Increases & Fixed Expenses Remain Stable,97172,28322.0,48086,76408.0,20764.0,21.37,-0.0,Medium Risk
U612,2024,12,448757.0,Salary Increases & Fixed Expenses Remain Stable,97172,28322.0,47724,76046.0,21126.0,21.74,0.05,Medium Risk
U613,2024,1,237770.0,Stable Salary & Decreasing Fixed Expenses,60561,33050.0,31957,65007.0,-4446.0,-7.34,-0.03,High Risk
U613,2024,2,233324.0,Stable Salary & Decreasing Fixed Expenses,60561,33050.0,29061,62111.0,-1550.0,-2.56,-0.04,High Risk
U613,2024,3,231774.0,Stable Salary & Decreasing Fixed Expenses,60561,33050.0,37458,70508.0,-9947.0,-16.42,0.04,High Risk
U613,2024,4,221827.0,Stable Salary & Decreasing Fixed Expenses,60561,33050.0,32032,65082.0,-4521.0,-7.47,-0.0,High Risk
U613,2024,5,217306.0,Stable Salary & Decreasing Fixed Expenses,60561,33050.0,26903,59953.0,608.0,1.0,-0.04,High Risk
U613,2024,6,217914.0,Stable Salary & Decreasing Fixed Expenses,60561,33050.0,32208,65258.0,-4697.0,-7.76,0.01,High Risk
U613,2024,7,213217.0,Stable Salary & Decreasing Fixed Expenses,60561,33050.0,33085,66135.0,-5574.0,-9.2,0.04,High Risk
U613,2024,8,207643.0,Stable Salary & Decreasing Fixed Expenses,60561,33050.0,35839,68889.0,-8328.0,-13.75,-0.01,High Risk
U613,2024,9,199315.0,Stable Salary & Decreasing Fixed Expenses,60561,33050.0,36153,69203.0,-8642.0,-14.27,-0.05,High Risk
U613,2024,10,190673.0,Stable Salary & Decreasing Fixed Expenses,60561,32117.0,29418,61535.0,-974.0,-1.61,-0.04,High Risk
U613,2024,11,189699.0,Stable Salary & Decreasing Fixed Expenses,60561,32117.0,29937,62054.0,-1493.0,-2.47,-0.04,High Risk
U613,2024,12,188206.0,Stable Salary & Decreasing Fixed Expenses,60561,32117.0,25231,57348.0,3213.0,5.31,0.01,High Risk
U614,2024,1,248132.0,Stable Salary & Increasing Fixed Expenses,209663,87860.0,158487,246347.0,-36684.0,-17.5,-0.01,High Risk
U614,2024,2,211448.0,Stable Salary & Increasing Fixed Expenses,209663,89445.0,151135,240580.0,-30917.0,-14.75,0.01,High Risk
U614,2024,3,180531.0,Stable Salary & Increasing Fixed Expenses,209663,89445.0,153389,242834.0,-33171.0,-15.82,0.04,High Risk
U614,2024,4,147360.0,Stable Salary & Increasing Fixed Expenses,209663,91104.0,148071,239175.0,-29512.0,-14.08,0.02,High Risk
U614,2024,5,117848.0,Stable Salary & Increasing Fixed Expenses,209663,91104.0,132656,223760.0,-14097.0,-6.72,-0.02,High Risk
U614,2024,6,103751.0,Stable Salary & Increasing Fixed Expenses,209663,91104.0,128522,219626.0,-9963.0,-4.75,0.04,High Risk
U614,2024,7,93788.0,Stable Salary & Increasing Fixed Expenses,209663,93059.0,166922,259981.0,-50318.0,-24.0,0.01,High Risk
U614,2024,8,43470.0,Stable Salary & Increasing Fixed Expenses,209663,93059.0,143114,236173.0,-26510.0,-12.64,-0.03,High Risk
U614,2024,9,16960.0,Stable Salary & Increasing Fixed Expenses,209663,93059.0,129161,222220.0,-12557.0,-5.99,-0.02,High Risk
U614,2024,10,4403.0,Stable Salary & Increasing Fixed Expenses,209663,93059.0,127695,220754.0,-11091.0,-5.29,-0.03,High Risk
U614,2024,11,-6688.0,Stable Salary & Increasing Fixed Expenses,209663,93059.0,165933,258992.0,-49329.0,-23.53,0.04,High Risk
U614,2024,12,-56017.0,Stable Salary & Increasing Fixed Expenses,209663,93059.0,150024,243083.0,-33420.0,-15.94,0.02,High Risk
U615,2024,1,227847.0,Salary Increases & Fixed Expenses Remain Stable,196011,41297.0,134320,175617.0,20394.0,10.4,-0.02,High Risk
U615,2024,2,248241.0,Salary Increases & Fixed Expenses Remain Stable,196011,41297.0,129058,170355.0,25656.0,13.09,-0.03,High Risk
U615,2024,3,273897.0,Salary Increases & Fixed Expenses Remain Stable,196011,41297.0,186157,227454.0,-31443.0,-16.04,-0.03,High Risk
U615,2024,4,242454.0,Salary Increases & Fixed Expenses Remain Stable,196011,41297.0,131028,172325.0,23686.0,12.08,-0.01,High Risk
U615,2024,5,266140.0,Salary Increases & Fixed Expenses Remain Stable,196011,41297.0,121451,162748.0,33263.0,16.97,0.03,Medium Risk
U615,2024,6,299403.0,Salary Increases & Fixed Expenses Remain Stable,196011,41297.0,131595,172892.0,23119.0,11.79,0.0,High Risk
U615,2024,7,322522.0,Salary Increases & Fixed Expenses Remain Stable,221647,41297.0,146442,187739.0,33908.0,15.3,0.04,Medium Risk
U615,2024,8,356430.0,Salary Increases & Fixed Expenses Remain Stable,221647,41297.0,175472,216769.0,4878.0,2.2,-0.04,High Risk
U615,2024,9,361308.0,Salary Increases & Fixed Expenses Remain Stable,221647,41297.0,149371,190668.0,30979.0,13.98,-0.02,High Risk
U615,2024,10,392287.0,Salary Increases & Fixed Expenses Remain Stable,221647,41297.0,165661,206958.0,14689.0,6.63,0.02,High Risk
U615,2024,11,406976.0,Salary Increases & Fixed Expenses Remain Stable,221647,41297.0,165398,206695.0,14952.0,6.75,-0.05,High Risk
U615,2024,12,421928.0,Salary Increases & Fixed Expenses Remain Stable,221647,41297.0,145509,186806.0,34841.0,15.72,0.05,Medium Risk
U616,2024,1,202486.0,Stable Salary & Increasing Fixed Expenses,123132,52005.0,64666,116671.0,6461.0,5.25,-0.05,High Risk
U616,2024,2,208947.0,Stable Salary & Increasing Fixed Expenses,123132,52005.0,55239,107244.0,15888.0,12.9,-0.0,High Risk
U616,2024,3,224835.0,Stable Salary & Increasing Fixed Expenses,123132,52005.0,82880,134885.0,-11753.0,-9.55,-0.04,High Risk
U616,2024,4,213082.0,Stable Salary & Increasing Fixed Expenses,123132,52005.0,63360,115365.0,7767.0,6.31,-0.02,High Risk
U616,2024,5,220849.0,Stable Salary & Increasing Fixed Expenses,123132,52005.0,49286,101291.0,21841.0,17.74,0.04,Medium Risk
U616,2024,6,242690.0,Stable Salary & Increasing Fixed Expenses,123132,52005.0,52355,104360.0,18772.0,15.25,-0.05,Medium Risk
U616,2024,7,261462.0,Stable Salary & Increasing Fixed Expenses,123132,52005.0,57956,109961.0,13171.0,10.7,-0.04,High Risk
U616,2024,8,274633.0,Stable Salary & Increasing Fixed Expenses,123132,52005.0,70289,122294.0,838.0,0.68,-0.05,High Risk
U616,2024,9,275471.0,Stable Salary & Increasing Fixed Expenses,123132,53835.0,52234,106069.0,17063.0,13.86,-0.05,High Risk
U616,2024,10,292534.0,Stable Salary & Increasing Fixed Expenses,123132,53835.0,78699,132534.0,-9402.0,-7.64,0.04,High Risk
U616,2024,11,283132.0,Stable Salary & Increasing Fixed Expenses,123132,53835.0,68752,122587.0,545.0,0.44,-0.03,High Risk
U616,2024,12,283677.0,Stable Salary & Increasing Fixed Expenses,123132,53835.0,58211,112046.0,11086.0,9.0,-0.02,High Risk
U617,2024,1,212798.0,Stable Salary & Stable Fixed Expenses,150502,58919.0,56128,115047.0,35455.0,23.56,0.02,Medium Risk
U617,2024,2,248253.0,Stable Salary & Stable Fixed Expenses,150502,58919.0,47204,106123.0,44379.0,29.49,-0.01,Low Risk
U617,2024,3,292632.0,Stable Salary & Stable Fixed Expenses,150502,58919.0,51212,110131.0,40371.0,26.82,0.02,Low Risk
U617,2024,4,333003.0,Stable Salary & Stable Fixed Expenses,150502,58919.0,48820,107739.0,42763.0,28.41,0.03,Low Risk
U617,2024,5,375766.0,Stable Salary & Stable Fixed Expenses,150502,58919.0,50370,109289.0,41213.0,27.38,0.0,Low Risk
U617,2024,6,416979.0,Stable Salary & Stable Fixed Expenses,150502,58919.0,55535,114454.0,36048.0,23.95,0.03,Medium Risk
U617,2024,7,453027.0,Stable Salary & Stable Fixed Expenses,150502,58919.0,46550,105469.0,45033.0,29.92,-0.05,Low Risk
U617,2024,8,498060.0,Stable Salary & Stable Fixed Expenses,150502,58919.0,55441,114360.0,36142.0,24.01,-0.01,Medium Risk
U617,2024,9,534202.0,Stable Salary & Stable Fixed Expenses,150502,58919.0,52982,111901.0,38601.0,25.65,0.04,Low Risk
U617,2024,10,572803.0,Stable Salary & Stable Fixed Expenses,150502,58919.0,62695,121614.0,28888.0,19.19,-0.02,Medium Risk
U617,2024,11,601691.0,Stable Salary & Stable Fixed Expenses,150502,58919.0,54547,113466.0,37036.0,24.61,-0.03,Medium Risk
U617,2024,12,638727.0,Stable Salary & Stable Fixed Expenses,150502,58919.0,57863,116782.0,33720.0,22.41,-0.05,Medium Risk
U618,2024,1,237775.0,Salary Increases & Fixed Expenses Remain Stable,267906,69067.0,199417,268484.0,-578.0,-0.22,-0.05,High Risk
U618,2024,2,237197.0,Salary Increases & Fixed Expenses Remain Stable,267906,69067.0,204018,273085.0,-5179.0,-1.93,-0.04,High Risk
U618,2024,3,232018.0,Salary Increases & Fixed Expenses Remain Stable,267906,69067.0,197798,266865.0,1041.0,0.39,0.05,High Risk
U618,2024,4,233059.0,Salary Increases & Fixed Expenses Remain Stable,267906,69067.0,167444,236511.0,31395.0,11.72,0.02,High Risk
U618,2024,5,264454.0,Salary Increases & Fixed Expenses Remain Stable,267906,69067.0,192002,261069.0,6837.0,2.55,0.02,High Risk
U618,2024,6,271291.0,Salary Increases & Fixed Expenses Remain Stable,283173,69067.0,207480,276547.0,6626.0,2.34,-0.02,High Risk
U618,2024,7,277917.0,Salary Increases & Fixed Expenses Remain Stable,283173,69067.0,185701,254768.0,28405.0,10.03,0.01,High Risk
U618,2024,8,306322.0,Salary Increases & Fixed Expenses Remain Stable,283173,69067.0,225745,294812.0,-11639.0,-4.11,0.01,High Risk
U618,2024,9,294683.0,Salary Increases & Fixed Expenses Remain Stable,283173,69067.0,216290,285357.0,-2184.0,-0.77,0.05,High Risk
U618,2024,10,292499.0,Salary Increases & Fixed Expenses Remain Stable,283173,69067.0,267703,336770.0,-53597.0,-18.93,0.03,High Risk
U618,2024,11,238902.0,Salary Increases & Fixed Expenses Remain Stable,283173,69067.0,224413,293480.0,-10307.0,-3.64,-0.03,High Risk
U618,2024,12,228595.0,Salary Increases & Fixed Expenses Remain Stable,283173,69067.0,209721,278788.0,4385.0,1.55,-0.05,High Risk
U619,2024,1,211304.0,Stable Salary & Decreasing Fixed Expenses,230090,65555.0,109721,175276.0,54814.0,23.82,0.02,Medium Risk
U619,2024,2,266118.0,Stable Salary & Decreasing Fixed Expenses,230090,65555.0,137468,203023.0,27067.0,11.76,0.01,High Risk
U619,2024,3,293185.0,Stable Salary & Decreasing Fixed Expenses,230090,64192.0,106139,170331.0,59759.0,25.97,0.04,Low Risk
U619,2024,4,352944.0,Stable Salary & Decreasing Fixed Expenses,230090,64192.0,106872,171064.0,59026.0,25.65,0.04,Low Risk
U619,2024,5,411970.0,Stable Salary & Decreasing Fixed Expenses,230090,64192.0,134288,198480.0,31610.0,13.74,0.01,High Risk
U619,2024,6,443580.0,Stable Salary & Decreasing Fixed Expenses,230090,64192.0,122994,187186.0,42904.0,18.65,0.02,Medium Risk
U619,2024,7,486484.0,Stable Salary & Decreasing Fixed Expenses,230090,64192.0,128398,192590.0,37500.0,16.3,-0.04,Medium Risk
U619,2024,8,523984.0,Stable Salary & Decreasing Fixed Expenses,230090,64192.0,137366,201558.0,28532.0,12.4,-0.04,High Risk
U619,2024,9,552516.0,Stable Salary & Decreasing Fixed Expenses,230090,64192.0,104689,168881.0,61209.0,26.6,0.05,Low Risk
U619,2024,10,613725.0,Stable Salary & Decreasing Fixed Expenses,230090,64192.0,137876,202068.0,28022.0,12.18,-0.02,High Risk
U619,2024,11,641747.0,Stable Salary & Decreasing Fixed Expenses,230090,64192.0,108947,173139.0,56951.0,24.75,0.05,Medium Risk
U619,2024,12,698698.0,Stable Salary & Decreasing Fixed Expenses,230090,64192.0,121686,185878.0,44212.0,19.22,-0.02,Medium Risk
U620,2024,1,247072.0,Salary Increases & Fixed Expenses Increase,169478,58938.0,71857,130795.0,38683.0,22.82,0.05,Medium Risk
U620,2024,2,285755.0,Salary Increases & Fixed Expenses Increase,169478,58938.0,80848,139786.0,29692.0,17.52,-0.05,Medium Risk
U620,2024,3,315447.0,Salary Increases & Fixed Expenses Increase,183952,58938.0,88609,147547.0,36405.0,19.79,-0.0,Medium Risk
U620,2024,4,351852.0,Salary Increases & Fixed Expenses Increase,183952,60712.0,96733,157445.0,26507.0,14.41,-0.03,High Risk
U620,2024,5,378359.0,Salary Increases & Fixed Expenses Increase,183952,60712.0,85597,146309.0,37643.0,20.46,0.0,Medium Risk
U620,2024,6,416002.0,Salary Increases & Fixed Expenses Increase,183952,60712.0,78452,139164.0,44788.0,24.35,-0.04,Medium Risk
U620,2024,7,460790.0,Salary Increases & Fixed Expenses Increase,183952,60712.0,95007,155719.0,28233.0,15.35,0.01,Medium Risk
U620,2024,8,489023.0,Salary Increases & Fixed Expenses Increase,183952,60712.0,94686,155398.0,28554.0,15.52,0.02,Medium Risk
U620,2024,9,517577.0,Salary Increases & Fixed Expenses Increase,183952,60712.0,99213,159925.0,24027.0,13.06,-0.02,High Risk
U620,2024,10,541604.0,Salary Increases & Fixed Expenses Increase,183952,62054.0,115179,177233.0,6719.0,3.65,-0.0,High Risk
U620,2024,11,548323.0,Salary Increases & Fixed Expenses Increase,183952,63240.0,118025,181265.0,2687.0,1.46,0.03,High Risk
U620,2024,12,551010.0,Salary Increases & Fixed Expenses Increase,183952,63240.0,114846,178086.0,5866.0,3.19,-0.05,High Risk
U621,2024,1,223170.0,Salary Increases & Fixed Expenses Remain Stable,106206,50691.0,50216,100907.0,5299.0,4.99,0.03,High Risk
U621,2024,2,228469.0,Salary Increases & Fixed Expenses Remain Stable,106206,50691.0,58366,109057.0,-2851.0,-2.68,0.01,High Risk
U621,2024,3,225618.0,Salary Increases & Fixed Expenses Remain Stable,106206,50691.0,54141,104832.0,1374.0,1.29,-0.01,High Risk
U621,2024,4,226992.0,Salary Increases & Fixed Expenses Remain Stable,116623,50691.0,48097,98788.0,17835.0,15.29,0.01,Medium Risk
U621,2024,5,244827.0,Salary Increases & Fixed Expenses Remain Stable,116623,50691.0,53237,103928.0,12695.0,10.89,0.05,High Risk
U621,2024,6,257522.0,Salary Increases & Fixed Expenses Remain Stable,116623,50691.0,46735,97426.0,19197.0,16.46,-0.02,Medium Risk
U621,2024,7,276719.0,Salary Increases & Fixed Expenses Remain Stable,116623,50691.0,60805,111496.0,5127.0,4.4,-0.0,High Risk
U621,2024,8,281846.0,Salary Increases & Fixed Expenses Remain Stable,116623,50691.0,47537,98228.0,18395.0,15.77,-0.03,Medium Risk
U621,2024,9,300241.0,Salary Increases & Fixed Expenses Remain Stable,116623,50691.0,53844,104535.0,12088.0,10.37,0.01,High Risk
U621,2024,10,312329.0,Salary Increases & Fixed Expenses Remain Stable,116623,50691.0,78014,128705.0,-12082.0,-10.36,-0.02,High Risk
U621,2024,11,300247.0,Salary Increases & Fixed Expenses Remain Stable,116623,50691.0,62688,113379.0,3244.0,2.78,0.04,High Risk
U621,2024,12,303491.0,Salary Increases & Fixed Expenses Remain Stable,116623,50691.0,63310,114001.0,2622.0,2.25,0.02,High Risk
U622,2024,1,209593.0,Salary Increases & Fixed Expenses Remain Stable,114687,63039.0,68790,131829.0,-17142.0,-14.95,-0.03,High Risk
U622,2024,2,192451.0,Salary Increases & Fixed Expenses Remain Stable,114687,63039.0,60410,123449.0,-8762.0,-7.64,-0.04,High Risk
U622,2024,3,183689.0,Salary Increases & Fixed Expenses Remain Stable,121274,63039.0,68080,131119.0,-9845.0,-8.12,-0.01,High Risk
U622,2024,4,173844.0,Salary Increases & Fixed Expenses Remain Stable,121274,63039.0,60694,123733.0,-2459.0,-2.03,0.04,High Risk
U622,2024,5,171385.0,Salary Increases & Fixed Expenses Remain Stable,121274,63039.0,71461,134500.0,-13226.0,-10.91,0.04,High Risk
U622,2024,6,158159.0,Salary Increases & Fixed Expenses Remain Stable,121274,63039.0,48526,111565.0,9709.0,8.01,-0.04,High Risk
U622,2024,7,167868.0,Salary Increases & Fixed Expenses Remain Stable,121274,63039.0,71022,134061.0,-12787.0,-10.54,0.04,High Risk
U622,2024,8,155081.0,Salary Increases & Fixed Expenses Remain Stable,121274,63039.0,55461,118500.0,2774.0,2.29,-0.02,High Risk
U622,2024,9,157855.0,Salary Increases & Fixed Expenses Remain Stable,121274,63039.0,65861,128900.0,-7626.0,-6.29,0.03,High Risk
U622,2024,10,150229.0,Salary Increases & Fixed Expenses Remain Stable,121274,63039.0,63717,126756.0,-5482.0,-4.52,0.05,High Risk
U622,2024,11,144747.0,Salary Increases & Fixed Expenses Remain Stable,121274,63039.0,51160,114199.0,7075.0,5.83,0.04,High Risk
U622,2024,12,151822.0,Salary Increases & Fixed Expenses Remain Stable,121274,63039.0,64695,127734.0,-6460.0,-5.33,0.04,High Risk
U623,2024,1,231347.0,Stable Salary & Decreasing Fixed Expenses,242964,86212.0,86194,172406.0,70558.0,29.04,0.03,Low Risk
U623,2024,2,301905.0,Stable Salary & Decreasing Fixed Expenses,242964,86212.0,96613,182825.0,60139.0,24.75,0.01,Medium Risk
U623,2024,3,362044.0,Stable Salary & Decreasing Fixed Expenses,242964,86212.0,101280,187492.0,55472.0,22.83,-0.04,Medium Risk
U623,2024,4,417516.0,Stable Salary & Decreasing Fixed Expenses,242964,86212.0,95840,182052.0,60912.0,25.07,0.05,Low Risk
U623,2024,5,478428.0,Stable Salary & Decreasing Fixed Expenses,242964,86212.0,84617,170829.0,72135.0,29.69,-0.04,Low Risk
U623,2024,6,550563.0,Stable Salary & Decreasing Fixed Expenses,242964,86212.0,74725,160937.0,82027.0,33.76,0.03,Low Risk
U623,2024,7,632590.0,Stable Salary & Decreasing Fixed Expenses,242964,86212.0,79072,165284.0,77680.0,31.97,0.05,Low Risk
U623,2024,8,710270.0,Stable Salary & Decreasing Fixed Expenses,242964,84413.0,96876,181289.0,61675.0,25.38,-0.03,Low Risk
U623,2024,9,771945.0,Stable Salary & Decreasing Fixed Expenses,242964,84413.0,86115,170528.0,72436.0,29.81,0.02,Low Risk
U623,2024,10,844381.0,Stable Salary & Decreasing Fixed Expenses,242964,84413.0,88950,173363.0,69601.0,28.65,0.05,Low Risk
U623,2024,11,913982.0,Stable Salary & Decreasing Fixed Expenses,242964,84413.0,101507,185920.0,57044.0,23.48,0.05,Medium Risk
U623,2024,12,971026.0,Stable Salary & Decreasing Fixed Expenses,242964,84413.0,123590,208003.0,34961.0,14.39,0.04,High Risk
U624,2024,1,238499.0,Salary Increases & Fixed Expenses Increase,153443,43940.0,60577,104517.0,48926.0,31.89,0.02,Low Risk
U624,2024,2,287425.0,Salary Increases & Fixed Expenses Increase,153443,43940.0,50173,94113.0,59330.0,38.67,-0.02,Low Risk
U624,2024,3,346755.0,Salary Increases & Fixed Expenses Increase,153443,43940.0,59619,103559.0,49884.0,32.51,0.04,Low Risk
U624,2024,4,396639.0,Salary Increases & Fixed Expenses Increase,153443,43940.0,47605,91545.0,61898.0,40.34,0.04,Low Risk
U624,2024,5,458537.0,Salary Increases & Fixed Expenses Increase,153443,45715.0,61094,106809.0,46634.0,30.39,0.04,Low Risk
U624,2024,6,505171.0,Salary Increases & Fixed Expenses Increase,153443,45715.0,50897,96612.0,56831.0,37.04,0.01,Low Risk
U624,2024,7,562002.0,Salary Increases & Fixed Expenses Increase,166683,46506.0,56237,102743.0,63940.0,38.36,0.04,Low Risk
U624,2024,8,625942.0,Salary Increases & Fixed Expenses Increase,166683,46506.0,60881,107387.0,59296.0,35.57,-0.01,Low Risk
U624,2024,9,685238.0,Salary Increases & Fixed Expenses Increase,166683,46506.0,61126,107632.0,59051.0,35.43,0.05,Low Risk
U624,2024,10,744289.0,Salary Increases & Fixed Expenses Increase,166683,46506.0,64633,111139.0,55544.0,33.32,-0.02,Low Risk
U624,2024,11,799833.0,Salary Increases & Fixed Expenses Increase,166683,46506.0,56866,103372.0,63311.0,37.98,-0.02,Low Risk
U624,2024,12,863144.0,Salary Increases & Fixed Expenses Increase,166683,46506.0,65789,112295.0,54388.0,32.63,-0.04,Low Risk
U625,2024,1,212694.0,Stable Salary & Stable Fixed Expenses,293297,79096.0,210874,289970.0,3327.0,1.13,0.01,High Risk
U625,2024,2,216021.0,Stable Salary & Stable Fixed Expenses,293297,79096.0,203091,282187.0,11110.0,3.79,-0.05,High Risk
U625,2024,3,227131.0,Stable Salary & Stable Fixed Expenses,293297,79096.0,269718,348814.0,-55517.0,-18.93,0.02,High Risk
U625,2024,4,171614.0,Stable Salary & Stable Fixed Expenses,293297,79096.0,181166,260262.0,33035.0,11.26,0.05,High Risk
U625,2024,5,204649.0,Stable Salary & Stable Fixed Expenses,293297,79096.0,227233,306329.0,-13032.0,-4.44,0.03,High Risk
U625,2024,6,191617.0,Stable Salary & Stable Fixed Expenses,293297,79096.0,196751,275847.0,17450.0,5.95,0.02,High Risk
U625,2024,7,209067.0,Stable Salary & Stable Fixed Expenses,293297,79096.0,185215,264311.0,28986.0,9.88,-0.04,High Risk
U625,2024,8,238053.0,Stable Salary & Stable Fixed Expenses,293297,79096.0,214680,293776.0,-479.0,-0.16,-0.01,High Risk
U625,2024,9,237574.0,Stable Salary & Stable Fixed Expenses,293297,79096.0,210453,289549.0,3748.0,1.28,-0.0,High Risk
U625,2024,10,241322.0,Stable Salary & Stable Fixed Expenses,293297,79096.0,279918,359014.0,-65717.0,-22.41,-0.04,High Risk
U625,2024,11,175605.0,Stable Salary & Stable Fixed Expenses,293297,79096.0,209644,288740.0,4557.0,1.55,0.05,High Risk
U625,2024,12,180162.0,Stable Salary & Stable Fixed Expenses,293297,79096.0,178977,258073.0,35224.0,12.01,0.04,High Risk
U626,2024,1,233188.0,Salary Increases & Fixed Expenses Remain Stable,258791,99028.0,102860,201888.0,56903.0,21.99,0.03,Medium Risk
U626,2024,2,290091.0,Salary Increases & Fixed Expenses Remain Stable,258791,99028.0,87175,186203.0,72588.0,28.05,-0.02,Low Risk
U626,2024,3,362679.0,Salary Increases & Fixed Expenses Remain Stable,258791,99028.0,111530,210558.0,48233.0,18.64,-0.03,Medium Risk
U626,2024,4,410912.0,Salary Increases & Fixed Expenses Remain Stable,258791,99028.0,83485,182513.0,76278.0,29.47,0.0,Low Risk
U626,2024,5,487190.0,Salary Increases & Fixed Expenses Remain Stable,272517,99028.0,96634,195662.0,76855.0,28.2,0.0,Low Risk
U626,2024,6,564045.0,Salary Increases & Fixed Expenses Remain Stable,272517,99028.0,89266,188294.0,84223.0,30.91,0.01,Low Risk
U626,2024,7,648268.0,Salary Increases & Fixed Expenses Remain Stable,272517,99028.0,84836,183864.0,88653.0,32.53,-0.03,Low Risk
U626,2024,8,736921.0,Salary Increases & Fixed Expenses Remain Stable,272517,99028.0,94524,193552.0,78965.0,28.98,-0.01,Low Risk
U626,2024,9,815886.0,Salary Increases & Fixed Expenses Remain Stable,272517,99028.0,106615,205643.0,66874.0,24.54,0.02,Medium Risk
U626,2024,10,882760.0,Salary Increases & Fixed Expenses Remain Stable,272517,99028.0,109393,208421.0,64096.0,23.52,0.05,Medium Risk
U626,2024,11,946856.0,Salary Increases & Fixed Expenses Remain Stable,272517,99028.0,111391,210419.0,62098.0,22.79,-0.04,Medium Risk
U626,2024,12,1008954.0,Salary Increases & Fixed Expenses Remain Stable,272517,99028.0,99425,198453.0,74064.0,27.18,-0.04,Low Risk
U627,2024,1,228742.0,Salary Increases & Fixed Expenses Increase,101366,69511.0,55569,125080.0,-23714.0,-23.39,-0.02,High Risk
U627,2024,2,205028.0,Salary Increases & Fixed Expenses Increase,101366,69511.0,48529,118040.0,-16674.0,-16.45,-0.03,High Risk
U627,2024,3,188354.0,Salary Increases & Fixed Expenses Increase,101366,69511.0,66193,135704.0,-34338.0,-33.88,-0.05,High Risk
U627,2024,4,154016.0,Salary Increases & Fixed Expenses Increase,101366,69511.0,53662,123173.0,-21807.0,-21.51,0.02,High Risk
U627,2024,5,132209.0,Salary Increases & Fixed Expenses Increase,117848,69511.0,55297,124808.0,-6960.0,-5.91,0.03,High Risk
U627,2024,6,125249.0,Salary Increases & Fixed Expenses Increase,117848,69511.0,51683,121194.0,-3346.0,-2.84,0.02,High Risk
U627,2024,7,121903.0,Salary Increases & Fixed Expenses Increase,117848,71198.0,67205,138403.0,-20555.0,-17.44,-0.03,High Risk
U627,2024,8,101348.0,Salary Increases & Fixed Expenses Increase,117848,71198.0,57318,128516.0,-10668.0,-9.05,0.04,High Risk
U627,2024,9,90680.0,Salary Increases & Fixed Expenses Increase,117848,71198.0,68229,139427.0,-21579.0,-18.31,-0.03,High Risk
U627,2024,10,69101.0,Salary Increases & Fixed Expenses Increase,117848,71198.0,64617,135815.0,-17967.0,-15.25,-0.01,High Risk
U627,2024,11,51134.0,Salary Increases & Fixed Expenses Increase,117848,71198.0,72515,143713.0,-25865.0,-21.95,-0.0,High Risk
U627,2024,12,25269.0,Salary Increases & Fixed Expenses Increase,117848,72342.0,56605,128947.0,-11099.0,-9.42,-0.04,High Risk
U628,2024,1,246265.0,Salary Increases & Fixed Expenses Increase,28731,22026.0,17561,39587.0,-10856.0,-37.78,0.01,High Risk
U628,2024,2,235409.0,Salary Increases & Fixed Expenses Increase,28731,22026.0,20125,42151.0,-13420.0,-46.71,0.03,High Risk
U628,2024,3,221989.0,Salary Increases & Fixed Expenses Increase,28731,22026.0,26315,48341.0,-19610.0,-68.25,0.03,High Risk
U628,2024,4,202379.0,Salary Increases & Fixed Expenses Increase,28731,22999.0,18510,41509.0,-12778.0,-44.47,0.04,High Risk
U628,2024,5,189601.0,Salary Increases & Fixed Expenses Increase,28731,22999.0,18968,41967.0,-13236.0,-46.07,0.04,High Risk
U628,2024,6,176365.0,Salary Increases & Fixed Expenses Increase,28731,24576.0,18045,42621.0,-13890.0,-48.34,-0.01,High Risk
U628,2024,7,162475.0,Salary Increases & Fixed Expenses Increase,35575,24576.0,21760,46336.0,-10761.0,-30.25,-0.0,High Risk
U628,2024,8,151714.0,Salary Increases & Fixed Expenses Increase,35575,26026.0,28372,54398.0,-18823.0,-52.91,-0.03,High Risk
U628,2024,9,132891.0,Salary Increases & Fixed Expenses Increase,35575,27711.0,26691,54402.0,-18827.0,-52.92,0.03,High Risk
U628,2024,10,114064.0,Salary Increases & Fixed Expenses Increase,35575,27711.0,26378,54089.0,-18514.0,-52.04,-0.02,High Risk
U628,2024,11,95550.0,Salary Increases & Fixed Expenses Increase,35575,27711.0,27477,55188.0,-19613.0,-55.13,0.05,High Risk
U628,2024,12,75937.0,Salary Increases & Fixed Expenses Increase,35575,27711.0,27106,54817.0,-19242.0,-54.09,-0.03,High Risk
U629,2024,1,211000.0,Salary Increases & Fixed Expenses Remain Stable,272570,79290.0,195670,274960.0,-2390.0,-0.88,-0.03,High Risk
U629,2024,2,208610.0,Salary Increases & Fixed Expenses Remain Stable,272570,79290.0,208304,287594.0,-15024.0,-5.51,0.03,High Risk
U629,2024,3,193586.0,Salary Increases & Fixed Expenses Remain Stable,272570,79290.0,187629,266919.0,5651.0,2.07,0.04,High Risk
U629,2024,4,199237.0,Salary Increases & Fixed Expenses Remain Stable,272570,79290.0,183032,262322.0,10248.0,3.76,0.0,High Risk
U629,2024,5,209485.0,Salary Increases & Fixed Expenses Remain Stable,281368,79290.0,214700,293990.0,-12622.0,-4.49,0.03,High Risk
U629,2024,6,196863.0,Salary Increases & Fixed Expenses Remain Stable,281368,79290.0,183679,262969.0,18399.0,6.54,-0.02,High Risk
U629,2024,7,215262.0,Salary Increases & Fixed Expenses Remain Stable,281368,79290.0,200565,279855.0,1513.0,0.54,0.0,High Risk
U629,2024,8,216775.0,Salary Increases & Fixed Expenses Remain Stable,281368,79290.0,188407,267697.0,13671.0,4.86,-0.02,High Risk
U629,2024,9,230446.0,Salary Increases & Fixed Expenses Remain Stable,281368,79290.0,194855,274145.0,7223.0,2.57,-0.0,High Risk
U629,2024,10,237669.0,Salary Increases & Fixed Expenses Remain Stable,281368,79290.0,189642,268932.0,12436.0,4.42,-0.03,High Risk
U629,2024,11,250105.0,Salary Increases & Fixed Expenses Remain Stable,281368,79290.0,194930,274220.0,7148.0,2.54,0.03,High Risk
U629,2024,12,257253.0,Salary Increases & Fixed Expenses Remain Stable,281368,79290.0,200836,280126.0,1242.0,0.44,0.02,High Risk
U630,2024,1,213934.0,Stable Salary & Stable Fixed Expenses,69143,38951.0,36506,75457.0,-6314.0,-9.13,-0.03,High Risk
U630,2024,2,207620.0,Stable Salary & Stable Fixed Expenses,69143,38951.0,40966,79917.0,-10774.0,-15.58,0.04,High Risk
U630,2024,3,196846.0,Stable Salary & Stable Fixed Expenses,69143,38951.0,29785,68736.0,407.0,0.59,0.04,High Risk
U630,2024,4,197253.0,Stable Salary & Stable Fixed Expenses,69143,38951.0,31896,70847.0,-1704.0,-2.46,-0.02,High Risk
U630,2024,5,195549.0,Stable Salary & Stable Fixed Expenses,69143,38951.0,29092,68043.0,1100.0,1.59,-0.05,High Risk
U630,2024,6,196649.0,Stable Salary & Stable Fixed Expenses,69143,38951.0,29466,68417.0,726.0,1.05,-0.05,High Risk
U630,2024,7,197375.0,Stable Salary & Stable Fixed Expenses,69143,38951.0,28544,67495.0,1648.0,2.38,0.03,High Risk
U630,2024,8,199023.0,Stable Salary & Stable Fixed Expenses,69143,38951.0,31686,70637.0,-1494.0,-2.16,-0.02,High Risk
U630,2024,9,197529.0,Stable Salary & Stable Fixed Expenses,69143,38951.0,35424,74375.0,-5232.0,-7.57,-0.04,High Risk
U630,2024,10,192297.0,Stable Salary & Stable Fixed Expenses,69143,38951.0,39166,78117.0,-8974.0,-12.98,-0.01,High Risk
U630,2024,11,183323.0,Stable Salary & Stable Fixed Expenses,69143,38951.0,30323,69274.0,-131.0,-0.19,0.04,High Risk
U630,2024,12,183192.0,Stable Salary & Stable Fixed Expenses,69143,38951.0,29080,68031.0,1112.0,1.61,-0.01,High Risk
U631,2024,1,203614.0,Salary Increases & Fixed Expenses Remain Stable,276961,110116.0,151475,261591.0,15370.0,5.55,0.04,High Risk
U631,2024,2,218984.0,Salary Increases & Fixed Expenses Remain Stable,276961,110116.0,118775,228891.0,48070.0,17.36,-0.05,Medium Risk
U631,2024,3,267054.0,Salary Increases & Fixed Expenses Remain Stable,276961,110116.0,160152,270268.0,6693.0,2.42,0.04,High Risk
U631,2024,4,273747.0,Salary Increases & Fixed Expenses Remain Stable,276961,110116.0,161573,271689.0,5272.0,1.9,0.02,High Risk
U631,2024,5,279019.0,Salary Increases & Fixed Expenses Remain Stable,276961,110116.0,131962,242078.0,34883.0,12.59,0.02,High Risk
U631,2024,6,313902.0,Salary Increases & Fixed Expenses Remain Stable,298635,110116.0,150331,260447.0,38188.0,12.79,0.0,High Risk
U631,2024,7,352090.0,Salary Increases & Fixed Expenses Remain Stable,298635,110116.0,176520,286636.0,11999.0,4.02,-0.01,High Risk
U631,2024,8,364089.0,Salary Increases & Fixed Expenses Remain Stable,298635,110116.0,119998,230114.0,68521.0,22.94,-0.02,Medium Risk
U631,2024,9,432610.0,Salary Increases & Fixed Expenses Remain Stable,298635,110116.0,122143,232259.0,66376.0,22.23,-0.03,Medium Risk
U631,2024,10,498986.0,Salary Increases & Fixed Expenses Remain Stable,298635,110116.0,150492,260608.0,38027.0,12.73,-0.04,High Risk
U631,2024,11,537013.0,Salary Increases & Fixed Expenses Remain Stable,298635,110116.0,119889,230005.0,68630.0,22.98,-0.02,Medium Risk
U631,2024,12,605643.0,Salary Increases & Fixed Expenses Remain Stable,298635,110116.0,147719,257835.0,40800.0,13.66,-0.0,High Risk
U632,2024,1,229053.0,Stable Salary & Increasing Fixed Expenses,122254,47074.0,40374,87448.0,34806.0,28.47,0.03,Low Risk
U632,2024,2,263859.0,Stable Salary & Increasing Fixed Expenses,122254,47074.0,43509,90583.0,31671.0,25.91,0.02,Low Risk
U632,2024,3,295530.0,Stable Salary & Increasing Fixed Expenses,122254,48252.0,42123,90375.0,31879.0,26.08,-0.0,Low Risk
U632,2024,4,327409.0,Stable Salary & Increasing Fixed Expenses,122254,48252.0,40743,88995.0,33259.0,27.2,-0.03,Low Risk
U632,2024,5,360668.0,Stable Salary & Increasing Fixed Expenses,122254,48252.0,45751,94003.0,28251.0,23.11,0.04,Medium Risk
U632,2024,6,388919.0,Stable Salary & Increasing Fixed Expenses,122254,48252.0,38739,86991.0,35263.0,28.84,-0.05,Low Risk
U632,2024,7,424182.0,Stable Salary & Increasing Fixed Expenses,122254,48252.0,46410,94662.0,27592.0,22.57,0.0,Medium Risk
U632,2024,8,451774.0,Stable Salary & Increasing Fixed Expenses,122254,48794.0,37807,86601.0,35653.0,29.16,-0.0,Low Risk
U632,2024,9,487427.0,Stable Salary & Increasing Fixed Expenses,122254,48794.0,38707,87501.0,34753.0,28.43,0.0,Low Risk
U632,2024,10,522180.0,Stable Salary & Increasing Fixed Expenses,122254,48794.0,38891,87685.0,34569.0,28.28,0.03,Low Risk
U632,2024,11,556749.0,Stable Salary & Increasing Fixed Expenses,122254,48794.0,44740,93534.0,28720.0,23.49,-0.04,Medium Risk
U632,2024,12,585469.0,Stable Salary & Increasing Fixed Expenses,122254,48794.0,47061,95855.0,26399.0,21.59,0.05,Medium Risk
U633,2024,1,237213.0,Salary Increases & Fixed Expenses Decrease,243964,90742.0,79901,170643.0,73321.0,30.05,0.0,Low Risk
U633,2024,2,310534.0,Salary Increases & Fixed Expenses Decrease,243964,90742.0,82815,173557.0,70407.0,28.86,-0.02,Low Risk
U633,2024,3,380941.0,Salary Increases & Fixed Expenses Decrease,264111,90742.0,109375,200117.0,63994.0,24.23,-0.0,Medium Risk
U633,2024,4,444935.0,Salary Increases & Fixed Expenses Decrease,264111,90742.0,100966,191708.0,72403.0,27.41,-0.02,Low Risk
U633,2024,5,517338.0,Salary Increases & Fixed Expenses Decrease,264111,90742.0,87132,177874.0,86237.0,32.65,0.01,Low Risk
U633,2024,6,603575.0,Salary Increases & Fixed Expenses Decrease,264111,90742.0,93912,184654.0,79457.0,30.08,-0.02,Low Risk
U633,2024,7,683032.0,Salary Increases & Fixed Expenses Decrease,264111,90742.0,95431,186173.0,77938.0,29.51,0.02,Low Risk
U633,2024,8,760970.0,Salary Increases & Fixed Expenses Decrease,264111,90742.0,102407,193149.0,70962.0,26.87,0.01,Low Risk
U633,2024,9,831932.0,Salary Increases & Fixed Expenses Decrease,264111,90742.0,98506,189248.0,74863.0,28.35,-0.01,Low Risk
U633,2024,10,906795.0,Salary Increases & Fixed Expenses Decrease,264111,90742.0,105969,196711.0,67400.0,25.52,0.05,Low Risk
U633,2024,11,974195.0,Salary Increases & Fixed Expenses Decrease,264111,90742.0,104747,195489.0,68622.0,25.98,0.02,Low Risk
U633,2024,12,1042817.0,Salary Increases & Fixed Expenses Decrease,264111,90742.0,85234,175976.0,88135.0,33.37,-0.02,Low Risk
U634,2024,1,211987.0,Stable Salary & Increasing Fixed Expenses,82811,33312.0,56751,90063.0,-7252.0,-8.76,0.03,High Risk
U634,2024,2,204735.0,Stable Salary & Increasing Fixed Expenses,82811,33312.0,64452,97764.0,-14953.0,-18.06,-0.01,High Risk
U634,2024,3,189782.0,Stable Salary & Increasing Fixed Expenses,82811,33312.0,81630,114942.0,-32131.0,-38.8,0.01,High Risk
U634,2024,4,157651.0,Stable Salary & Increasing Fixed Expenses,82811,34836.0,53259,88095.0,-5284.0,-6.38,0.02,High Risk
U634,2024,5,152367.0,Stable Salary & Increasing Fixed Expenses,82811,34836.0,53365,88201.0,-5390.0,-6.51,0.0,High Risk
U634,2024,6,146977.0,Stable Salary & Increasing Fixed Expenses,82811,34836.0,55761,90597.0,-7786.0,-9.4,0.05,High Risk
U634,2024,7,139191.0,Stable Salary & Increasing Fixed Expenses,82811,34836.0,60284,95120.0,-12309.0,-14.86,-0.03,High Risk
U634,2024,8,126882.0,Stable Salary & Increasing Fixed Expenses,82811,34836.0,57370,92206.0,-9395.0,-11.35,-0.01,High Risk
U634,2024,9,117487.0,Stable Salary & Increasing Fixed Expenses,82811,34836.0,56817,91653.0,-8842.0,-10.68,0.03,High Risk
U634,2024,10,108645.0,Stable Salary & Increasing Fixed Expenses,82811,34836.0,68950,103786.0,-20975.0,-25.33,-0.01,High Risk
U634,2024,11,87670.0,Stable Salary & Increasing Fixed Expenses,82811,34836.0,61255,96091.0,-13280.0,-16.04,-0.03,High Risk
U634,2024,12,74390.0,Stable Salary & Increasing Fixed Expenses,82811,34836.0,55388,90224.0,-7413.0,-8.95,0.01,High Risk
U635,2024,1,230833.0,Salary Increases & Fixed Expenses Remain Stable,270620,92354.0,157753,250107.0,20513.0,7.58,-0.02,High Risk
U635,2024,2,251346.0,Salary Increases & Fixed Expenses Remain Stable,270620,92354.0,146098,238452.0,32168.0,11.89,0.03,High Risk
U635,2024,3,283514.0,Salary Increases & Fixed Expenses Remain Stable,270620,92354.0,168128,260482.0,10138.0,3.75,0.01,High Risk
U635,2024,4,293652.0,Salary Increases & Fixed Expenses Remain Stable,288553,92354.0,127779,220133.0,68420.0,23.71,0.01,Medium Risk
U635,2024,5,362072.0,Salary Increases & Fixed Expenses Remain Stable,288553,92354.0,133690,226044.0,62509.0,21.66,0.02,Medium Risk
U635,2024,6,424581.0,Salary Increases & Fixed Expenses Remain Stable,288553,92354.0,145401,237755.0,50798.0,17.6,-0.03,Medium Risk
U635,2024,7,475379.0,Salary Increases & Fixed Expenses Remain Stable,288553,92354.0,170538,262892.0,25661.0,8.89,-0.02,High Risk
U635,2024,8,501040.0,Salary Increases & Fixed Expenses Remain Stable,288553,92354.0,172059,264413.0,24140.0,8.37,0.01,High Risk
U635,2024,9,525180.0,Salary Increases & Fixed Expenses Remain Stable,288553,92354.0,153573,245927.0,42626.0,14.77,0.03,High Risk
U635,2024,10,567806.0,Salary Increases & Fixed Expenses Remain Stable,288553,92354.0,166615,258969.0,29584.0,10.25,-0.02,High Risk
U635,2024,11,597390.0,Salary Increases & Fixed Expenses Remain Stable,288553,92354.0,121019,213373.0,75180.0,26.05,-0.01,Low Risk
U635,2024,12,672570.0,Salary Increases & Fixed Expenses Remain Stable,288553,92354.0,158092,250446.0,38107.0,13.21,-0.02,High Risk
U636,2024,1,203034.0,Salary Increases & Fixed Expenses Increase,86170,25974.0,45419,71393.0,14777.0,17.15,0.01,Medium Risk
U636,2024,2,217811.0,Salary Increases & Fixed Expenses Increase,86170,25974.0,50656,76630.0,9540.0,11.07,0.0,High Risk
U636,2024,3,227351.0,Salary Increases & Fixed Expenses Increase,97032,25974.0,63988,89962.0,7070.0,7.29,0.01,High Risk
U636,2024,4,234421.0,Salary Increases & Fixed Expenses Increase,97032,25974.0,48490,74464.0,22568.0,23.26,0.0,Medium Risk
U636,2024,5,256989.0,Salary Increases & Fixed Expenses Increase,97032,25974.0,44533,70507.0,26525.0,27.34,0.0,Low Risk
U636,2024,6,283514.0,Salary Increases & Fixed Expenses Increase,97032,25974.0,43552,69526.0,27506.0,28.35,-0.01,Low Risk
U636,2024,7,311020.0,Salary Increases & Fixed Expenses Increase,97032,25974.0,44859,70833.0,26199.0,27.0,0.03,Low Risk
U636,2024,8,337219.0,Salary Increases & Fixed Expenses Increase,97032,25974.0,52852,78826.0,18206.0,18.76,0.01,Medium Risk
U636,2024,9,355425.0,Salary Increases & Fixed Expenses Increase,97032,25974.0,53047,79021.0,18011.0,18.56,0.02,Medium Risk
U636,2024,10,373436.0,Salary Increases & Fixed Expenses Increase,97032,25974.0,58677,84651.0,12381.0,12.76,-0.01,High Risk
U636,2024,11,385817.0,Salary Increases & Fixed Expenses Increase,97032,25974.0,51011,76985.0,20047.0,20.66,-0.0,Medium Risk
U636,2024,12,405864.0,Salary Increases & Fixed Expenses Increase,97032,25974.0,53774,79748.0,17284.0,17.81,-0.03,Medium Risk
U637,2024,1,214807.0,Stable Salary & Stable Fixed Expenses,274250,91603.0,154309,245912.0,28338.0,10.33,0.02,High Risk
U637,2024,2,243145.0,Stable Salary & Stable Fixed Expenses,274250,91603.0,160760,252363.0,21887.0,7.98,0.05,High Risk
U637,2024,3,265032.0,Stable Salary & Stable Fixed Expenses,274250,91603.0,140984,232587.0,41663.0,15.19,-0.02,Medium Risk
U637,2024,4,306695.0,Stable Salary & Stable Fixed Expenses,274250,91603.0,136336,227939.0,46311.0,16.89,-0.05,Medium Risk
U637,2024,5,353006.0,Stable Salary & Stable Fixed Expenses,274250,91603.0,157606,249209.0,25041.0,9.13,-0.04,High Risk
U637,2024,6,378047.0,Stable Salary & Stable Fixed Expenses,274250,91603.0,160150,251753.0,22497.0,8.2,0.01,High Risk
U637,2024,7,400544.0,Stable Salary & Stable Fixed Expenses,274250,91603.0,157355,248958.0,25292.0,9.22,-0.0,High Risk
U637,2024,8,425836.0,Stable Salary & Stable Fixed Expenses,274250,91603.0,146509,238112.0,36138.0,13.18,0.04,High Risk
U637,2024,9,461974.0,Stable Salary & Stable Fixed Expenses,274250,91603.0,155033,246636.0,27614.0,10.07,0.0,High Risk
U637,2024,10,489588.0,Stable Salary & Stable Fixed Expenses,274250,91603.0,124730,216333.0,57917.0,21.12,-0.02,Medium Risk
U637,2024,11,547505.0,Stable Salary & Stable Fixed Expenses,274250,91603.0,134237,225840.0,48410.0,17.65,0.03,Medium Risk
U637,2024,12,595915.0,Stable Salary & Stable Fixed Expenses,274250,91603.0,123906,215509.0,58741.0,21.42,-0.03,Medium Risk
U638,2024,1,228370.0,Salary Increases & Fixed Expenses Remain Stable,153204,66055.0,81240,147295.0,5909.0,3.86,-0.02,High Risk
U638,2024,2,234279.0,Salary Increases & Fixed Expenses Remain Stable,153204,66055.0,78607,144662.0,8542.0,5.58,0.02,High Risk
U638,2024,3,242821.0,Salary Increases & Fixed Expenses Remain Stable,153204,66055.0,105976,172031.0,-18827.0,-12.29,-0.04,High Risk
U638,2024,4,223994.0,Salary Increases & Fixed Expenses Remain Stable,153204,66055.0,78398,144453.0,8751.0,5.71,0.02,High Risk
U638,2024,5,232745.0,Salary Increases & Fixed Expenses Remain Stable,171169,66055.0,71944,137999.0,33170.0,19.38,0.05,Medium Risk
U638,2024,6,265915.0,Salary Increases & Fixed Expenses Remain Stable,171169,66055.0,99498,165553.0,5616.0,3.28,0.02,High Risk
U638,2024,7,271531.0,Salary Increases & Fixed Expenses Remain Stable,171169,66055.0,101639,167694.0,3475.0,2.03,0.01,High Risk
U638,2024,8,275006.0,Salary Increases & Fixed Expenses Remain Stable,171169,66055.0,75440,141495.0,29674.0,17.34,-0.02,Medium Risk
U638,2024,9,304680.0,Salary Increases & Fixed Expenses Remain Stable,171169,66055.0,90872,156927.0,14242.0,8.32,-0.01,High Risk
U638,2024,10,318922.0,Salary Increases & Fixed Expenses Remain Stable,171169,66055.0,121906,187961.0,-16792.0,-9.81,-0.02,High Risk
U638,2024,11,302130.0,Salary Increases & Fixed Expenses Remain Stable,171169,66055.0,95369,161424.0,9745.0,5.69,0.03,High Risk
U638,2024,12,311875.0,Salary Increases & Fixed Expenses Remain Stable,171169,66055.0,91069,157124.0,14045.0,8.21,-0.03,High Risk
U639,2024,1,214545.0,Salary Increases & Fixed Expenses Remain Stable,271463,111717.0,156219,267936.0,3527.0,1.3,0.04,High Risk
U639,2024,2,218072.0,Salary Increases & Fixed Expenses Remain Stable,271463,111717.0,129258,240975.0,30488.0,11.23,-0.03,High Risk
U639,2024,3,248560.0,Salary Increases & Fixed Expenses Remain Stable,271463,111717.0,153269,264986.0,6477.0,2.39,0.03,High Risk
U639,2024,4,255037.0,Salary Increases & Fixed Expenses Remain Stable,271463,111717.0,142906,254623.0,16840.0,6.2,-0.01,High Risk
U639,2024,5,271877.0,Salary Increases & Fixed Expenses Remain Stable,271463,111717.0,116703,228420.0,43043.0,15.86,0.03,Medium Risk
U639,2024,6,314920.0,Salary Increases & Fixed Expenses Remain Stable,271463,111717.0,154505,266222.0,5241.0,1.93,-0.01,High Risk
U639,2024,7,320161.0,Salary Increases & Fixed Expenses Remain Stable,271463,111717.0,143264,254981.0,16482.0,6.07,0.04,High Risk
U639,2024,8,336643.0,Salary Increases & Fixed Expenses Remain Stable,282024,111717.0,139805,251522.0,30502.0,10.82,-0.03,High Risk
U639,2024,9,367145.0,Salary Increases & Fixed Expenses Remain Stable,282024,111717.0,135775,247492.0,34532.0,12.24,-0.02,High Risk
U639,2024,10,401677.0,Salary Increases & Fixed Expenses Remain Stable,282024,111717.0,127723,239440.0,42584.0,15.1,-0.03,Medium Risk
U639,2024,11,444261.0,Salary Increases & Fixed Expenses Remain Stable,282024,111717.0,141996,253713.0,28311.0,10.04,0.01,High Risk
U639,2024,12,472572.0,Salary Increases & Fixed Expenses Remain Stable,282024,111717.0,142937,254654.0,27370.0,9.7,-0.04,High Risk
U640,2024,1,245714.0,Stable Salary & Increasing Fixed Expenses,246462,94183.0,135131,229314.0,17148.0,6.96,-0.05,High Risk
U640,2024,2,262862.0,Stable Salary & Increasing Fixed Expenses,246462,94183.0,124771,218954.0,27508.0,11.16,0.02,High Risk
U640,2024,3,290370.0,Stable Salary & Increasing Fixed Expenses,246462,94183.0,146225,240408.0,6054.0,2.46,-0.05,High Risk
U640,2024,4,296424.0,Stable Salary & Increasing Fixed Expenses,246462,95422.0,117872,213294.0,33168.0,13.46,-0.01,High Risk
U640,2024,5,329592.0,Stable Salary & Increasing Fixed Expenses,246462,95422.0,143423,238845.0,7617.0,3.09,0.02,High Risk
U640,2024,6,337209.0,Stable Salary & Increasing Fixed Expenses,246462,95422.0,106268,201690.0,44772.0,18.17,-0.05,Medium Risk
U640,2024,7,381981.0,Stable Salary & Increasing Fixed Expenses,246462,95422.0,122181,217603.0,28859.0,11.71,0.01,High Risk
U640,2024,8,410840.0,Stable Salary & Increasing Fixed Expenses,246462,95422.0,137081,232503.0,13959.0,5.66,0.01,High Risk
U640,2024,9,424799.0,Stable Salary & Increasing Fixed Expenses,246462,95422.0,135961,231383.0,15079.0,6.12,-0.05,High Risk
U640,2024,10,439878.0,Stable Salary & Increasing Fixed Expenses,246462,95422.0,142654,238076.0,8386.0,3.4,0.01,High Risk
U640,2024,11,448264.0,Stable Salary & Increasing Fixed Expenses,246462,95422.0,111961,207383.0,39079.0,15.86,0.02,Medium Risk
U640,2024,12,487343.0,Stable Salary & Increasing Fixed Expenses,246462,95422.0,111789,207211.0,39251.0,15.93,-0.02,Medium Risk
U641,2024,1,210790.0,Salary Increases & Fixed Expenses Remain Stable,101206,58759.0,79420,138179.0,-36973.0,-36.53,0.02,High Risk
U641,2024,2,173817.0,Salary Increases & Fixed Expenses Remain Stable,101206,58759.0,77261,136020.0,-34814.0,-34.4,-0.01,High Risk
U641,2024,3,139003.0,Salary Increases & Fixed Expenses Remain Stable,109795,58759.0,77615,136374.0,-26579.0,-24.21,0.02,High Risk
U641,2024,4,112424.0,Salary Increases & Fixed Expenses Remain Stable,109795,58759.0,74930,133689.0,-23894.0,-21.76,-0.01,High Risk
U641,2024,5,88530.0,Salary Increases & Fixed Expenses Remain Stable,109795,58759.0,70996,129755.0,-19960.0,-18.18,0.05,High Risk
U641,2024,6,68570.0,Salary Increases & Fixed Expenses Remain Stable,109795,58759.0,72517,131276.0,-21481.0,-19.56,-0.03,High Risk
U641,2024,7,47089.0,Salary Increases & Fixed Expenses Remain Stable,109795,58759.0,78664,137423.0,-27628.0,-25.16,-0.0,High Risk
U641,2024,8,19461.0,Salary Increases & Fixed Expenses Remain Stable,109795,58759.0,85812,144571.0,-34776.0,-31.67,0.05,High Risk
U641,2024,9,-15315.0,Salary Increases & Fixed Expenses Remain Stable,109795,58759.0,74877,133636.0,-23841.0,-21.71,0.04,High Risk
U641,2024,10,-39156.0,Salary Increases & Fixed Expenses Remain Stable,109795,58759.0,72319,131078.0,-21283.0,-19.38,-0.03,High Risk
U641,2024,11,-60439.0,Salary Increases & Fixed Expenses Remain Stable,109795,58759.0,78069,136828.0,-27033.0,-24.62,0.04,High Risk
U641,2024,12,-87472.0,Salary Increases & Fixed Expenses Remain Stable,109795,58759.0,74038,132797.0,-23002.0,-20.95,0.04,High Risk
U642,2024,1,237224.0,Salary Increases & Fixed Expenses Remain Stable,247268,84349.0,148546,232895.0,14373.0,5.81,-0.0,High Risk
U642,2024,2,251597.0,Salary Increases & Fixed Expenses Remain Stable,247268,84349.0,190718,275067.0,-27799.0,-11.24,0.03,High Risk
U642,2024,3,223798.0,Salary Increases & Fixed Expenses Remain Stable,247268,84349.0,215390,299739.0,-52471.0,-21.22,0.03,High Risk
U642,2024,4,171327.0,Salary Increases & Fixed Expenses Remain Stable,266039,84349.0,211829,296178.0,-30139.0,-11.33,0.03,High Risk
U642,2024,5,141188.0,Salary Increases & Fixed Expenses Remain Stable,266039,84349.0,196266,280615.0,-14576.0,-5.48,0.02,High Risk
U642,2024,6,126612.0,Salary Increases & Fixed Expenses Remain Stable,266039,84349.0,205623,289972.0,-23933.0,-9.0,-0.0,High Risk
U642,2024,7,102679.0,Salary Increases & Fixed Expenses Remain Stable,266039,84349.0,207425,291774.0,-25735.0,-9.67,0.0,High Risk
U642,2024,8,76944.0,Salary Increases & Fixed Expenses Remain Stable,266039,84349.0,209593,293942.0,-27903.0,-10.49,0.04,High Risk
U642,2024,9,49041.0,Salary Increases & Fixed Expenses Remain Stable,266039,84349.0,201719,286068.0,-20029.0,-7.53,-0.02,High Risk
U642,2024,10,29012.0,Salary Increases & Fixed Expenses Remain Stable,266039,84349.0,193705,278054.0,-12015.0,-4.52,0.01,High Risk
U642,2024,11,16997.0,Salary Increases & Fixed Expenses Remain Stable,266039,84349.0,161178,245527.0,20512.0,7.71,0.04,High Risk
U642,2024,12,37509.0,Salary Increases & Fixed Expenses Remain Stable,266039,84349.0,196467,280816.0,-14777.0,-5.55,0.04,High Risk
U643,2024,1,202487.0,Salary Increases & Fixed Expenses Increase,280864,80468.0,125632,206100.0,74764.0,26.62,-0.01,Low Risk
U643,2024,2,277251.0,Salary Increases & Fixed Expenses Increase,280864,80468.0,162985,243453.0,37411.0,13.32,-0.03,High Risk
U643,2024,3,314662.0,Salary Increases & Fixed Expenses Increase,280864,80468.0,113675,194143.0,86721.0,30.88,0.02,Low Risk
U643,2024,4,401383.0,Salary Increases & Fixed Expenses Increase,280864,80468.0,163030,243498.0,37366.0,13.3,0.01,High Risk
U643,2024,5,438749.0,Salary Increases & Fixed Expenses Increase,280864,80468.0,137453,217921.0,62943.0,22.41,0.04,Medium Risk
U643,2024,6,501692.0,Salary Increases & Fixed Expenses Increase,280864,80468.0,139853,220321.0,60543.0,21.56,-0.03,Medium Risk
U643,2024,7,562235.0,Salary Increases & Fixed Expenses Increase,280864,81522.0,115250,196772.0,84092.0,29.94,-0.02,Low Risk
U643,2024,8,646327.0,Salary Increases & Fixed Expenses Increase,304008,82246.0,128489,210735.0,93273.0,30.68,0.02,Low Risk
U643,2024,9,739600.0,Salary Increases & Fixed Expenses Increase,304008,82246.0,178047,260293.0,43715.0,14.38,-0.04,High Risk
U643,2024,10,783315.0,Salary Increases & Fixed Expenses Increase,304008,82246.0,131444,213690.0,90318.0,29.71,0.02,Low Risk
U643,2024,11,873633.0,Salary Increases & Fixed Expenses Increase,304008,82246.0,171253,253499.0,50509.0,16.61,0.05,Medium Risk
U643,2024,12,924142.0,Salary Increases & Fixed Expenses Increase,304008,83091.0,146800,229891.0,74117.0,24.38,-0.05,Medium Risk
U644,2024,1,231402.0,Salary Increases & Fixed Expenses Remain Stable,185498,47920.0,147636,195556.0,-10058.0,-5.42,-0.04,High Risk
U644,2024,2,221344.0,Salary Increases & Fixed Expenses Remain Stable,185498,47920.0,148009,195929.0,-10431.0,-5.62,0.04,High Risk
U644,2024,3,210913.0,Salary Increases & Fixed Expenses Remain Stable,185498,47920.0,133869,181789.0,3709.0,2.0,-0.03,High Risk
U644,2024,4,214622.0,Salary Increases & Fixed Expenses Remain Stable,185498,47920.0,115053,162973.0,22525.0,12.14,-0.02,High Risk
U644,2024,5,237147.0,Salary Increases & Fixed Expenses Remain Stable,185498,47920.0,132608,180528.0,4970.0,2.68,0.04,High Risk
U644,2024,6,242117.0,Salary Increases & Fixed Expenses Remain Stable,185498,47920.0,142621,190541.0,-5043.0,-2.72,-0.04,High Risk
U644,2024,7,237074.0,Salary Increases & Fixed Expenses Remain Stable,185498,47920.0,139030,186950.0,-1452.0,-0.78,0.04,High Risk
U644,2024,8,235622.0,Salary Increases & Fixed Expenses Remain Stable,212458,47920.0,131243,179163.0,33295.0,15.67,-0.0,Medium Risk
U644,2024,9,268917.0,Salary Increases & Fixed Expenses Remain Stable,212458,47920.0,144358,192278.0,20180.0,9.5,-0.02,High Risk
U644,2024,10,289097.0,Salary Increases & Fixed Expenses Remain Stable,212458,47920.0,194591,242511.0,-30053.0,-14.15,0.01,High Risk
U644,2024,11,259044.0,Salary Increases & Fixed Expenses Remain Stable,212458,47920.0,168891,216811.0,-4353.0,-2.05,0.01,High Risk
U644,2024,12,254691.0,Salary Increases & Fixed Expenses Remain Stable,212458,47920.0,167537,215457.0,-2999.0,-1.41,0.02,High Risk
U645,2024,1,223827.0,Stable Salary & Decreasing Fixed Expenses,227586,63686.0,91904,155590.0,71996.0,31.63,-0.03,Low Risk
U645,2024,2,295823.0,Stable Salary & Decreasing Fixed Expenses,227586,63686.0,94068,157754.0,69832.0,30.68,0.04,Low Risk
U645,2024,3,365655.0,Stable Salary & Decreasing Fixed Expenses,227586,63686.0,145457,209143.0,18443.0,8.1,0.02,High Risk
U645,2024,4,384098.0,Stable Salary & Decreasing Fixed Expenses,227586,63686.0,130769,194455.0,33131.0,14.56,-0.01,High Risk
U645,2024,5,417229.0,Stable Salary & Decreasing Fixed Expenses,227586,63686.0,104338,168024.0,59562.0,26.17,0.04,Low Risk
U645,2024,6,476791.0,Stable Salary & Decreasing Fixed Expenses,227586,63686.0,127374,191060.0,36526.0,16.05,0.03,Medium Risk
U645,2024,7,513317.0,Stable Salary & Decreasing Fixed Expenses,227586,63686.0,110924,174610.0,52976.0,23.28,0.0,Medium Risk
U645,2024,8,566293.0,Stable Salary & Decreasing Fixed Expenses,227586,63686.0,132200,195886.0,31700.0,13.93,-0.04,High Risk
U645,2024,9,597993.0,Stable Salary & Decreasing Fixed Expenses,227586,63686.0,111823,175509.0,52077.0,22.88,-0.03,Medium Risk
U645,2024,10,650070.0,Stable Salary & Decreasing Fixed Expenses,227586,63686.0,119608,183294.0,44292.0,19.46,-0.04,Medium Risk
U645,2024,11,694362.0,Stable Salary & Decreasing Fixed Expenses,227586,63686.0,131657,195343.0,32243.0,14.17,0.01,High Risk
U645,2024,12,726605.0,Stable Salary & Decreasing Fixed Expenses,227586,63686.0,100867,164553.0,63033.0,27.7,-0.05,Low Risk
U646,2024,1,200309.0,Salary Increases & Fixed Expenses Remain Stable,28956,17741.0,14135,31876.0,-2920.0,-10.08,-0.03,High Risk
U646,2024,2,197389.0,Salary Increases & Fixed Expenses Remain Stable,28956,17741.0,13685,31426.0,-2470.0,-8.53,-0.02,High Risk
U646,2024,3,194919.0,Salary Increases & Fixed Expenses Remain Stable,28956,17741.0,17642,35383.0,-6427.0,-22.2,-0.04,High Risk
U646,2024,4,188492.0,Salary Increases & Fixed Expenses Remain Stable,28956,17741.0,13172,30913.0,-1957.0,-6.76,0.01,High Risk
U646,2024,5,186535.0,Salary Increases & Fixed Expenses Remain Stable,28956,17741.0,15464,33205.0,-4249.0,-14.67,0.01,High Risk
U646,2024,6,182286.0,Salary Increases & Fixed Expenses Remain Stable,28956,17741.0,12974,30715.0,-1759.0,-6.07,0.04,High Risk
U646,2024,7,180527.0,Salary Increases & Fixed Expenses Remain Stable,28956,17741.0,12961,30702.0,-1746.0,-6.03,-0.05,High Risk
U646,2024,8,178781.0,Salary Increases & Fixed Expenses Remain Stable,39505,17741.0,23699,41440.0,-1935.0,-4.9,0.04,High Risk
U646,2024,9,176846.0,Salary Increases & Fixed Expenses Remain Stable,39505,17741.0,23695,41436.0,-1931.0,-4.89,-0.01,High Risk
U646,2024,10,174915.0,Salary Increases & Fixed Expenses Remain Stable,39505,17741.0,18124,35865.0,3640.0,9.21,-0.03,High Risk
U646,2024,11,178555.0,Salary Increases & Fixed Expenses Remain Stable,39505,17741.0,18979,36720.0,2785.0,7.05,0.03,High Risk
U646,2024,12,181340.0,Salary Increases & Fixed Expenses Remain Stable,39505,17741.0,20593,38334.0,1171.0,2.96,-0.01,High Risk
U647,2024,1,215728.0,Salary Increases & Fixed Expenses Remain Stable,67151,31234.0,28855,60089.0,7062.0,10.52,-0.0,High Risk
U647,2024,2,222790.0,Salary Increases & Fixed Expenses Remain Stable,67151,31234.0,31868,63102.0,4049.0,6.03,-0.03,High Risk
U647,2024,3,226839.0,Salary Increases & Fixed Expenses Remain Stable,67151,31234.0,34106,65340.0,1811.0,2.7,0.0,High Risk
U647,2024,4,228650.0,Salary Increases & Fixed Expenses Remain Stable,67151,31234.0,27873,59107.0,8044.0,11.98,0.02,High Risk
U647,2024,5,236694.0,Salary Increases & Fixed Expenses Remain Stable,67151,31234.0,37352,68586.0,-1435.0,-2.14,-0.03,High Risk
U647,2024,6,235259.0,Salary Increases & Fixed Expenses Remain Stable,77297,31234.0,41262,72496.0,4801.0,6.21,0.03,High Risk
U647,2024,7,240060.0,Salary Increases & Fixed Expenses Remain Stable,77297,31234.0,37066,68300.0,8997.0,11.64,0.03,High Risk
U647,2024,8,249057.0,Salary Increases & Fixed Expenses Remain Stable,77297,31234.0,41023,72257.0,5040.0,6.52,-0.04,High Risk
U647,2024,9,254097.0,Salary Increases & Fixed Expenses Remain Stable,77297,31234.0,41878,73112.0,4185.0,5.41,0.03,High Risk
U647,2024,10,258282.0,Salary Increases & Fixed Expenses Remain Stable,77297,31234.0,37880,69114.0,8183.0,10.59,-0.04,High Risk
U647,2024,11,266465.0,Salary Increases & Fixed Expenses Remain Stable,77297,31234.0,32383,63617.0,13680.0,17.7,0.04,Medium Risk
U647,2024,12,280145.0,Salary Increases & Fixed Expenses Remain Stable,77297,31234.0,38956,70190.0,7107.0,9.19,0.05,High Risk
U648,2024,1,223605.0,Salary Increases & Fixed Expenses Remain Stable,87185,35664.0,39071,74735.0,12450.0,14.28,-0.0,High Risk
U648,2024,2,236055.0,Salary Increases & Fixed Expenses Remain Stable,87185,35664.0,46239,81903.0,5282.0,6.06,-0.01,High Risk
U648,2024,3,241337.0,Salary Increases & Fixed Expenses Remain Stable,87185,35664.0,59367,95031.0,-7846.0,-9.0,0.01,High Risk
U648,2024,4,233491.0,Salary Increases & Fixed Expenses Remain Stable,87185,35664.0,49992,85656.0,1529.0,1.75,-0.0,High Risk
U648,2024,5,235020.0,Salary Increases & Fixed Expenses Remain Stable,87185,35664.0,45816,81480.0,5705.0,6.54,-0.03,High Risk
U648,2024,6,240725.0,Salary Increases & Fixed Expenses Remain Stable,106176,35664.0,61741,97405.0,8771.0,8.26,-0.05,High Risk
U648,2024,7,249496.0,Salary Increases & Fixed Expenses Remain Stable,106176,35664.0,44868,80532.0,25644.0,24.15,0.03,Medium Risk
U648,2024,8,275140.0,Salary Increases & Fixed Expenses Remain Stable,106176,35664.0,42540,78204.0,27972.0,26.34,-0.01,Low Risk
U648,2024,9,303112.0,Salary Increases & Fixed Expenses Remain Stable,106176,35664.0,58596,94260.0,11916.0,11.22,-0.03,High Risk
U648,2024,10,315028.0,Salary Increases & Fixed Expenses Remain Stable,106176,35664.0,68506,104170.0,2006.0,1.89,-0.0,High Risk
U648,2024,11,317034.0,Salary Increases & Fixed Expenses Remain Stable,106176,35664.0,66199,101863.0,4313.0,4.06,-0.01,High Risk
U648,2024,12,321347.0,Salary Increases & Fixed Expenses Remain Stable,106176,35664.0,62066,97730.0,8446.0,7.95,-0.0,High Risk
U649,2024,1,242969.0,Stable Salary & Stable Fixed Expenses,190491,68391.0,69763,138154.0,52337.0,27.47,-0.04,Low Risk
U649,2024,2,295306.0,Stable Salary & Stable Fixed Expenses,190491,68391.0,69668,138059.0,52432.0,27.52,-0.0,Low Risk
U649,2024,3,347738.0,Stable Salary & Stable Fixed Expenses,190491,68391.0,63184,131575.0,58916.0,30.93,-0.02,Low Risk
U649,2024,4,406654.0,Stable Salary & Stable Fixed Expenses,190491,68391.0,71621,140012.0,50479.0,26.5,0.04,Low Risk
U649,2024,5,457133.0,Stable Salary & Stable Fixed Expenses,190491,68391.0,75240,143631.0,46860.0,24.6,0.05,Medium Risk
U649,2024,6,503993.0,Stable Salary & Stable Fixed Expenses,190491,68391.0,70532,138923.0,51568.0,27.07,-0.02,Low Risk
U649,2024,7,555561.0,Stable Salary & Stable Fixed Expenses,190491,68391.0,70133,138524.0,51967.0,27.28,-0.02,Low Risk
U649,2024,8,607528.0,Stable Salary & Stable Fixed Expenses,190491,68391.0,64390,132781.0,57710.0,30.3,-0.05,Low Risk
U649,2024,9,665238.0,Stable Salary & Stable Fixed Expenses,190491,68391.0,60663,129054.0,61437.0,32.25,-0.01,Low Risk
U649,2024,10,726675.0,Stable Salary & Stable Fixed Expenses,190491,68391.0,68811,137202.0,53289.0,27.97,-0.01,Low Risk
U649,2024,11,779964.0,Stable Salary & Stable Fixed Expenses,190491,68391.0,61805,130196.0,60295.0,31.65,-0.03,Low Risk
U649,2024,12,840259.0,Stable Salary & Stable Fixed Expenses,190491,68391.0,75614,144005.0,46486.0,24.4,0.01,Medium Risk
U650,2024,1,233841.0,Stable Salary & Stable Fixed Expenses,198319,52559.0,113050,165609.0,32710.0,16.49,0.04,Medium Risk
U650,2024,2,266551.0,Stable Salary & Stable Fixed Expenses,198319,52559.0,109637,162196.0,36123.0,18.21,-0.01,Medium Risk
U650,2024,3,302674.0,Stable Salary & Stable Fixed Expenses,198319,52559.0,103286,155845.0,42474.0,21.42,-0.01,Medium Risk
U650,2024,4,345148.0,Stable Salary & Stable Fixed Expenses,198319,52559.0,85850,138409.0,59910.0,30.21,0.0,Low Risk
U650,2024,5,405058.0,Stable Salary & Stable Fixed Expenses,198319,52559.0,105621,158180.0,40139.0,20.24,0.04,Medium Risk
U650,2024,6,445197.0,Stable Salary & Stable Fixed Expenses,198319,52559.0,79742,132301.0,66018.0,33.29,0.0,Low Risk
U650,2024,7,511215.0,Stable Salary & Stable Fixed Expenses,198319,52559.0,97277,149836.0,48483.0,24.45,0.03,Medium Risk
U650,2024,8,559698.0,Stable Salary & Stable Fixed Expenses,198319,52559.0,89775,142334.0,55985.0,28.23,-0.02,Low Risk
U650,2024,9,615683.0,Stable Salary & Stable Fixed Expenses,198319,52559.0,81140,133699.0,64620.0,32.58,-0.04,Low Risk
U650,2024,10,680303.0,Stable Salary & Stable Fixed Expenses,198319,52559.0,128140,180699.0,17620.0,8.88,0.05,High Risk
U650,2024,11,697923.0,Stable Salary & Stable Fixed Expenses,198319,52559.0,95764,148323.0,49996.0,25.21,0.05,Low Risk
U650,2024,12,747919.0,Stable Salary & Stable Fixed Expenses,198319,52559.0,111156,163715.0,34604.0,17.45,-0.04,Medium Risk
U651,2024,1,229033.0,Salary Increases & Fixed Expenses Remain Stable,195715,66272.0,89098,155370.0,40345.0,20.61,-0.01,Medium Risk
U651,2024,2,269378.0,Salary Increases & Fixed Expenses Remain Stable,195715,66272.0,110242,176514.0,19201.0,9.81,0.01,High Risk
U651,2024,3,288579.0,Salary Increases & Fixed Expenses Remain Stable,195715,66272.0,110714,176986.0,18729.0,9.57,-0.04,High Risk
U651,2024,4,307308.0,Salary Increases & Fixed Expenses Remain Stable,195715,66272.0,95601,161873.0,33842.0,17.29,0.03,Medium Risk
U651,2024,5,341150.0,Salary Increases & Fixed Expenses Remain Stable,195715,66272.0,104314,170586.0,25129.0,12.84,0.04,High Risk
U651,2024,6,366279.0,Salary Increases & Fixed Expenses Remain Stable,195715,66272.0,113891,180163.0,15552.0,7.95,-0.05,High Risk
U651,2024,7,381831.0,Salary Increases & Fixed Expenses Remain Stable,195715,66272.0,110359,176631.0,19084.0,9.75,-0.02,High Risk
U651,2024,8,400915.0,Salary Increases & Fixed Expenses Remain Stable,201511,66272.0,102705,168977.0,32534.0,16.15,0.03,Medium Risk
U651,2024,9,433449.0,Salary Increases & Fixed Expenses Remain Stable,201511,66272.0,98104,164376.0,37135.0,18.43,-0.03,Medium Risk
U651,2024,10,470584.0,Salary Increases & Fixed Expenses Remain Stable,201511,66272.0,141897,208169.0,-6658.0,-3.3,-0.01,High Risk
U651,2024,11,463926.0,Salary Increases & Fixed Expenses Remain Stable,201511,66272.0,95931,162203.0,39308.0,19.51,0.02,Medium Risk
U651,2024,12,503234.0,Salary Increases & Fixed Expenses Remain Stable,201511,66272.0,117447,183719.0,17792.0,8.83,0.05,High Risk
U652,2024,1,215337.0,Salary Increases & Fixed Expenses Decrease,112714,66638.0,60587,127225.0,-14511.0,-12.87,0.03,High Risk
U652,2024,2,200826.0,Salary Increases & Fixed Expenses Decrease,112714,66638.0,47465,114103.0,-1389.0,-1.23,0.04,High Risk
U652,2024,3,199437.0,Salary Increases & Fixed Expenses Decrease,135584,66638.0,72265,138903.0,-3319.0,-2.45,-0.03,High Risk
U652,2024,4,196118.0,Salary Increases & Fixed Expenses Decrease,135584,66638.0,57079,123717.0,11867.0,8.75,0.01,High Risk
U652,2024,5,207985.0,Salary Increases & Fixed Expenses Decrease,135584,66638.0,62411,129049.0,6535.0,4.82,-0.03,High Risk
U652,2024,6,214520.0,Salary Increases & Fixed Expenses Decrease,135584,66638.0,78188,144826.0,-9242.0,-6.82,0.02,High Risk
U652,2024,7,205278.0,Salary Increases & Fixed Expenses Decrease,135584,66638.0,80404,147042.0,-11458.0,-8.45,0.02,High Risk
U652,2024,8,193820.0,Salary Increases & Fixed Expenses Decrease,135584,66638.0,73503,140141.0,-4557.0,-3.36,0.0,High Risk
U652,2024,9,189263.0,Salary Increases & Fixed Expenses Decrease,135584,66638.0,74046,140684.0,-5100.0,-3.76,-0.04,High Risk
U652,2024,10,184163.0,Salary Increases & Fixed Expenses Decrease,135584,66638.0,86620,153258.0,-17674.0,-13.04,-0.03,High Risk
U652,2024,11,166489.0,Salary Increases & Fixed Expenses Decrease,135584,66638.0,58503,125141.0,10443.0,7.7,-0.02,High Risk
U652,2024,12,176932.0,Salary Increases & Fixed Expenses Decrease,135584,66638.0,76906,143544.0,-7960.0,-5.87,-0.0,High Risk
U653,2024,1,239968.0,Stable Salary & Stable Fixed Expenses,135250,42738.0,79505,122243.0,13007.0,9.62,-0.03,High Risk
U653,2024,2,252975.0,Stable Salary & Stable Fixed Expenses,135250,42738.0,68965,111703.0,23547.0,17.41,0.03,Medium Risk
U653,2024,3,276522.0,Stable Salary & Stable Fixed Expenses,135250,42738.0,98393,141131.0,-5881.0,-4.35,0.01,High Risk
U653,2024,4,270641.0,Stable Salary & Stable Fixed Expenses,135250,42738.0,58771,101509.0,33741.0,24.95,0.02,Medium Risk
U653,2024,5,304382.0,Stable Salary & Stable Fixed Expenses,135250,42738.0,80245,122983.0,12267.0,9.07,-0.05,High Risk
U653,2024,6,316649.0,Stable Salary & Stable Fixed Expenses,135250,42738.0,56706,99444.0,35806.0,26.47,-0.03,Low Risk
U653,2024,7,352455.0,Stable Salary & Stable Fixed Expenses,135250,42738.0,61488,104226.0,31024.0,22.94,0.02,Medium Risk
U653,2024,8,383479.0,Stable Salary & Stable Fixed Expenses,135250,42738.0,76599,119337.0,15913.0,11.77,0.03,High Risk
U653,2024,9,399392.0,Stable Salary & Stable Fixed Expenses,135250,42738.0,58318,101056.0,34194.0,25.28,0.01,Low Risk
U653,2024,10,433586.0,Stable Salary & Stable Fixed Expenses,135250,42738.0,92798,135536.0,-286.0,-0.21,-0.03,High Risk
U653,2024,11,433300.0,Stable Salary & Stable Fixed Expenses,135250,42738.0,65747,108485.0,26765.0,19.79,0.02,Medium Risk
U653,2024,12,460065.0,Stable Salary & Stable Fixed Expenses,135250,42738.0,80565,123303.0,11947.0,8.83,-0.05,High Risk
U654,2024,1,210998.0,Salary Increases & Fixed Expenses Increase,296096,77039.0,143953,220992.0,75104.0,25.36,-0.03,Low Risk
U654,2024,2,286102.0,Salary Increases & Fixed Expenses Increase,296096,77039.0,153084,230123.0,65973.0,22.28,-0.03,Medium Risk
U654,2024,3,352075.0,Salary Increases & Fixed Expenses Increase,296096,77039.0,163828,240867.0,55229.0,18.65,-0.01,Medium Risk
U654,2024,4,407304.0,Salary Increases & Fixed Expenses Increase,296096,78281.0,142058,220339.0,75757.0,25.59,0.02,Low Risk
U654,2024,5,483061.0,Salary Increases & Fixed Expenses Increase,296096,78281.0,140823,219104.0,76992.0,26.0,-0.05,Low Risk
U654,2024,6,560053.0,Salary Increases & Fixed Expenses Increase,296096,78281.0,138111,216392.0,79704.0,26.92,-0.01,Low Risk
U654,2024,7,639757.0,Salary Increases & Fixed Expenses Increase,296096,78281.0,138395,216676.0,79420.0,26.82,-0.03,Low Risk
U654,2024,8,719177.0,Salary Increases & Fixed Expenses Increase,305829,78281.0,150644,228925.0,76904.0,25.15,0.02,Low Risk
U654,2024,9,796081.0,Salary Increases & Fixed Expenses Increase,305829,78281.0,125170,203451.0,102378.0,33.48,-0.0,Low Risk
U654,2024,10,898459.0,Salary Increases & Fixed Expenses Increase,305829,78281.0,199777,278058.0,27771.0,9.08,0.04,High Risk
U654,2024,11,926230.0,Salary Increases & Fixed Expenses Increase,305829,78281.0,155627,233908.0,71921.0,23.52,0.02,Medium Risk
U654,2024,12,998151.0,Salary Increases & Fixed Expenses Increase,305829,78281.0,133838,212119.0,93710.0,30.64,-0.02,Low Risk
U655,2024,1,210365.0,Salary Increases & Fixed Expenses Remain Stable,284988,107315.0,105213,212528.0,72460.0,25.43,0.05,Low Risk
U655,2024,2,282825.0,Salary Increases & Fixed Expenses Remain Stable,284988,107315.0,113060,220375.0,64613.0,22.67,-0.04,Medium Risk
U655,2024,3,347438.0,Salary Increases & Fixed Expenses Remain Stable,284988,107315.0,111149,218464.0,66524.0,23.34,-0.01,Medium Risk
U655,2024,4,413962.0,Salary Increases & Fixed Expenses Remain Stable,312281,107315.0,99741,207056.0,105225.0,33.7,-0.03,Low Risk
U655,2024,5,519187.0,Salary Increases & Fixed Expenses Remain Stable,312281,107315.0,123773,231088.0,81193.0,26.0,-0.04,Low Risk
U655,2024,6,600380.0,Salary Increases & Fixed Expenses Remain Stable,312281,107315.0,94982,202297.0,109984.0,35.22,0.05,Low Risk
U655,2024,7,710364.0,Salary Increases & Fixed Expenses Remain Stable,312281,107315.0,120717,228032.0,84249.0,26.98,-0.04,Low Risk
U655,2024,8,794613.0,Salary Increases & Fixed Expenses Remain Stable,312281,107315.0,95186,202501.0,109780.0,35.15,-0.04,Low Risk
U655,2024,9,904393.0,Salary Increases & Fixed Expenses Remain Stable,312281,107315.0,107193,214508.0,97773.0,31.31,-0.05,Low Risk
U655,2024,10,1002166.0,Salary Increases & Fixed Expenses Remain Stable,312281,107315.0,122190,229505.0,82776.0,26.51,-0.05,Low Risk
U655,2024,11,1084942.0,Salary Increases & Fixed Expenses Remain Stable,312281,107315.0,124190,231505.0,80776.0,25.87,-0.0,Low Risk
U655,2024,12,1165718.0,Salary Increases & Fixed Expenses Remain Stable,312281,107315.0,135189,242504.0,69777.0,22.34,0.0,Medium Risk
U656,2024,1,207267.0,Salary Increases & Fixed Expenses Increase,116008,58136.0,43092,101228.0,14780.0,12.74,-0.04,High Risk
U656,2024,2,222047.0,Salary Increases & Fixed Expenses Increase,116008,58136.0,39454,97590.0,18418.0,15.88,0.04,Medium Risk
U656,2024,3,240465.0,Salary Increases & Fixed Expenses Increase,116008,58136.0,47387,105523.0,10485.0,9.04,-0.03,High Risk
U656,2024,4,250950.0,Salary Increases & Fixed Expenses Increase,126778,58663.0,45418,104081.0,22697.0,17.9,0.04,Medium Risk
U656,2024,5,273647.0,Salary Increases & Fixed Expenses Increase,126778,58663.0,44465,103128.0,23650.0,18.65,0.0,Medium Risk
U656,2024,6,297297.0,Salary Increases & Fixed Expenses Increase,126778,58663.0,41586,100249.0,26529.0,20.93,0.04,Medium Risk
U656,2024,7,323826.0,Salary Increases & Fixed Expenses Increase,126778,60134.0,41893,102027.0,24751.0,19.52,-0.03,Medium Risk
U656,2024,8,348577.0,Salary Increases & Fixed Expenses Increase,126778,60134.0,42715,102849.0,23929.0,18.87,0.0,Medium Risk
U656,2024,9,372506.0,Salary Increases & Fixed Expenses Increase,126778,60134.0,43190,103324.0,23454.0,18.5,-0.0,Medium Risk
U656,2024,10,395960.0,Salary Increases & Fixed Expenses Increase,126778,60134.0,58414,118548.0,8230.0,6.49,-0.03,High Risk
U656,2024,11,404190.0,Salary Increases & Fixed Expenses Increase,126778,61039.0,44583,105622.0,21156.0,16.69,0.01,Medium Risk
U656,2024,12,425346.0,Salary Increases & Fixed Expenses Increase,126778,61039.0,45009,106048.0,20730.0,16.35,0.02,Medium Risk
U657,2024,1,247157.0,Stable Salary & Stable Fixed Expenses,117214,61569.0,82327,143896.0,-26682.0,-22.76,0.02,High Risk
U657,2024,2,220475.0,Stable Salary & Stable Fixed Expenses,117214,61569.0,76373,137942.0,-20728.0,-17.68,0.04,High Risk
U657,2024,3,199747.0,Stable Salary & Stable Fixed Expenses,117214,61569.0,72341,133910.0,-16696.0,-14.24,-0.01,High Risk
U657,2024,4,183051.0,Stable Salary & Stable Fixed Expenses,117214,61569.0,88909,150478.0,-33264.0,-28.38,-0.05,High Risk
U657,2024,5,149787.0,Stable Salary & Stable Fixed Expenses,117214,61569.0,74489,136058.0,-18844.0,-16.08,0.04,High Risk
U657,2024,6,130943.0,Stable Salary & Stable Fixed Expenses,117214,61569.0,77161,138730.0,-21516.0,-18.36,0.03,High Risk
U657,2024,7,109427.0,Stable Salary & Stable Fixed Expenses,117214,61569.0,85474,147043.0,-29829.0,-25.45,-0.0,High Risk
U657,2024,8,79598.0,Stable Salary & Stable Fixed Expenses,117214,61569.0,88118,149687.0,-32473.0,-27.7,0.01,High Risk
U657,2024,9,47125.0,Stable Salary & Stable Fixed Expenses,117214,61569.0,86737,148306.0,-31092.0,-26.53,-0.05,High Risk
U657,2024,10,16033.0,Stable Salary & Stable Fixed Expenses,117214,61569.0,92764,154333.0,-37119.0,-31.67,0.04,High Risk
U657,2024,11,-21086.0,Stable Salary & Stable Fixed Expenses,117214,61569.0,83120,144689.0,-27475.0,-23.44,0.01,High Risk
U657,2024,12,-48561.0,Stable Salary & Stable Fixed Expenses,117214,61569.0,79353,140922.0,-23708.0,-20.23,-0.02,High Risk
U658,2024,1,245207.0,Stable Salary & Stable Fixed Expenses,25639,20638.0,9051,29689.0,-4050.0,-15.8,0.01,High Risk
U658,2024,2,241157.0,Stable Salary & Stable Fixed Expenses,25639,20638.0,10240,30878.0,-5239.0,-20.43,0.01,High Risk
U658,2024,3,235918.0,Stable Salary & Stable Fixed Expenses,25639,20638.0,10331,30969.0,-5330.0,-20.79,-0.01,High Risk
U658,2024,4,230588.0,Stable Salary & Stable Fixed Expenses,25639,20638.0,8911,29549.0,-3910.0,-15.25,0.02,High Risk
U658,2024,5,226678.0,Stable Salary & Stable Fixed Expenses,25639,20638.0,9837,30475.0,-4836.0,-18.86,0.03,High Risk
U658,2024,6,221842.0,Stable Salary & Stable Fixed Expenses,25639,20638.0,7903,28541.0,-2902.0,-11.32,-0.02,High Risk
U658,2024,7,218940.0,Stable Salary & Stable Fixed Expenses,25639,20638.0,8169,28807.0,-3168.0,-12.36,-0.03,High Risk
U658,2024,8,215772.0,Stable Salary & Stable Fixed Expenses,25639,20638.0,9348,29986.0,-4347.0,-16.95,-0.05,High Risk
U658,2024,9,211425.0,Stable Salary & Stable Fixed Expenses,25639,20638.0,8796,29434.0,-3795.0,-14.8,0.03,High Risk
U658,2024,10,207630.0,Stable Salary & Stable Fixed Expenses,25639,20638.0,12047,32685.0,-7046.0,-27.48,-0.04,High Risk
U658,2024,11,200584.0,Stable Salary & Stable Fixed Expenses,25639,20638.0,9130,29768.0,-4129.0,-16.1,0.04,High Risk
U658,2024,12,196455.0,Stable Salary & Stable Fixed Expenses,25639,20638.0,8298,28936.0,-3297.0,-12.86,0.03,High Risk
U659,2024,1,219203.0,Salary Increases & Fixed Expenses Remain Stable,280702,72726.0,166203,238929.0,41773.0,14.88,-0.03,High Risk
U659,2024,2,260976.0,Salary Increases & Fixed Expenses Remain Stable,280702,72726.0,115607,188333.0,92369.0,32.91,0.02,Low Risk
U659,2024,3,353345.0,Salary Increases & Fixed Expenses Remain Stable,280702,72726.0,135200,207926.0,72776.0,25.93,-0.04,Low Risk
U659,2024,4,426121.0,Salary Increases & Fixed Expenses Remain Stable,298770,72726.0,166647,239373.0,59397.0,19.88,0.03,Medium Risk
U659,2024,5,485518.0,Salary Increases & Fixed Expenses Remain Stable,298770,72726.0,137369,210095.0,88675.0,29.68,-0.01,Low Risk
U659,2024,6,574193.0,Salary Increases & Fixed Expenses Remain Stable,298770,72726.0,176005,248731.0,50039.0,16.75,-0.0,Medium Risk
U659,2024,7,624232.0,Salary Increases & Fixed Expenses Remain Stable,298770,72726.0,140608,213334.0,85436.0,28.6,-0.01,Low Risk
U659,2024,8,709668.0,Salary Increases & Fixed Expenses Remain Stable,298770,72726.0,147167,219893.0,78877.0,26.4,0.05,Low Risk
U659,2024,9,788545.0,Salary Increases & Fixed Expenses Remain Stable,298770,72726.0,160031,232757.0,66013.0,22.09,-0.02,Medium Risk
U659,2024,10,854558.0,Salary Increases & Fixed Expenses Remain Stable,298770,72726.0,119626,192352.0,106418.0,35.62,-0.05,Low Risk
U659,2024,11,960976.0,Salary Increases & Fixed Expenses Remain Stable,298770,72726.0,126783,199509.0,99261.0,33.22,0.01,Low Risk
U659,2024,12,1060237.0,Salary Increases & Fixed Expenses Remain Stable,298770,72726.0,156802,229528.0,69242.0,23.18,0.02,Medium Risk
U660,2024,1,226359.0,Salary Increases & Fixed Expenses Remain Stable,88818,28799.0,31859,60658.0,28160.0,31.71,0.01,Low Risk
U660,2024,2,254519.0,Salary Increases & Fixed Expenses Remain Stable,88818,28799.0,31736,60535.0,28283.0,31.84,-0.02,Low Risk
U660,2024,3,282802.0,Salary Increases & Fixed Expenses Remain Stable,88818,28799.0,31502,60301.0,28517.0,32.11,-0.01,Low Risk
U660,2024,4,311319.0,Salary Increases & Fixed Expenses Remain Stable,88818,28799.0,33364,62163.0,26655.0,30.01,0.04,Low Risk
U660,2024,5,337974.0,Salary Increases & Fixed Expenses Remain Stable,104769,28799.0,41049,69848.0,34921.0,33.33,0.02,Low Risk
U660,2024,6,372895.0,Salary Increases & Fixed Expenses Remain Stable,104769,28799.0,34544,63343.0,41426.0,39.54,0.02,Low Risk
U660,2024,7,414321.0,Salary Increases & Fixed Expenses Remain Stable,104769,28799.0,40426,69225.0,35544.0,33.93,-0.04,Low Risk
U660,2024,8,449865.0,Salary Increases & Fixed Expenses Remain Stable,104769,28799.0,33578,62377.0,42392.0,40.46,0.0,Low Risk
U660,2024,9,492257.0,Salary Increases & Fixed Expenses Remain Stable,104769,28799.0,31589,60388.0,44381.0,42.36,-0.01,Low Risk
U660,2024,10,536638.0,Salary Increases & Fixed Expenses Remain Stable,104769,28799.0,49713,78512.0,26257.0,25.06,-0.03,Low Risk
U660,2024,11,562895.0,Salary Increases & Fixed Expenses Remain Stable,104769,28799.0,36340,65139.0,39630.0,37.83,-0.0,Low Risk
U660,2024,12,602525.0,Salary Increases & Fixed Expenses Remain Stable,104769,28799.0,32916,61715.0,43054.0,41.09,-0.02,Low Risk
U661,2024,1,230928.0,Stable Salary & Stable Fixed Expenses,79018,29558.0,31845,61403.0,17615.0,22.29,-0.05,Medium Risk
U661,2024,2,248543.0,Stable Salary & Stable Fixed Expenses,79018,29558.0,36724,66282.0,12736.0,16.12,-0.0,Medium Risk
U661,2024,3,261279.0,Stable Salary & Stable Fixed Expenses,79018,29558.0,31703,61261.0,17757.0,22.47,-0.05,Medium Risk
U661,2024,4,279036.0,Stable Salary & Stable Fixed Expenses,79018,29558.0,35998,65556.0,13462.0,17.04,-0.0,Medium Risk
U661,2024,5,292498.0,Stable Salary & Stable Fixed Expenses,79018,29558.0,47400,76958.0,2060.0,2.61,-0.05,High Risk
U661,2024,6,294558.0,Stable Salary & Stable Fixed Expenses,79018,29558.0,46435,75993.0,3025.0,3.83,0.01,High Risk
U661,2024,7,297583.0,Stable Salary & Stable Fixed Expenses,79018,29558.0,45482,75040.0,3978.0,5.03,0.02,High Risk
U661,2024,8,301561.0,Stable Salary & Stable Fixed Expenses,79018,29558.0,34439,63997.0,15021.0,19.01,-0.0,Medium Risk
U661,2024,9,316582.0,Stable Salary & Stable Fixed Expenses,79018,29558.0,43988,73546.0,5472.0,6.93,-0.02,High Risk
U661,2024,10,322054.0,Stable Salary & Stable Fixed Expenses,79018,29558.0,46076,75634.0,3384.0,4.28,0.05,High Risk
U661,2024,11,325438.0,Stable Salary & Stable Fixed Expenses,79018,29558.0,38881,68439.0,10579.0,13.39,0.01,High Risk
U661,2024,12,336017.0,Stable Salary & Stable Fixed Expenses,79018,29558.0,41761,71319.0,7699.0,9.74,0.03,High Risk
U662,2024,1,226058.0,Stable Salary & Stable Fixed Expenses,279730,60464.0,140157,200621.0,79109.0,28.28,0.04,Low Risk
U662,2024,2,305167.0,Stable Salary & Stable Fixed Expenses,279730,60464.0,126217,186681.0,93049.0,33.26,-0.02,Low Risk
U662,2024,3,398216.0,Stable Salary & Stable Fixed Expenses,279730,60464.0,166985,227449.0,52281.0,18.69,-0.04,Medium Risk
U662,2024,4,450497.0,Stable Salary & Stable Fixed Expenses,279730,60464.0,147876,208340.0,71390.0,25.52,-0.04,Low Risk
U662,2024,5,521887.0,Stable Salary & Stable Fixed Expenses,279730,60464.0,140052,200516.0,79214.0,28.32,0.0,Low Risk
U662,2024,6,601101.0,Stable Salary & Stable Fixed Expenses,279730,60464.0,141301,201765.0,77965.0,27.87,-0.01,Low Risk
U662,2024,7,679066.0,Stable Salary & Stable Fixed Expenses,279730,60464.0,148627,209091.0,70639.0,25.25,0.04,Low Risk
U662,2024,8,749705.0,Stable Salary & Stable Fixed Expenses,279730,60464.0,125771,186235.0,93495.0,33.42,-0.01,Low Risk
U662,2024,9,843200.0,Stable Salary & Stable Fixed Expenses,279730,60464.0,160551,221015.0,58715.0,20.99,-0.01,Medium Risk
U662,2024,10,901915.0,Stable Salary & Stable Fixed Expenses,279730,60464.0,133169,193633.0,86097.0,30.78,-0.01,Low Risk
U662,2024,11,988012.0,Stable Salary & Stable Fixed Expenses,279730,60464.0,150112,210576.0,69154.0,24.72,0.03,Medium Risk
U662,2024,12,1057166.0,Stable Salary & Stable Fixed Expenses,279730,60464.0,127947,188411.0,91319.0,32.65,-0.02,Low Risk
U663,2024,1,204637.0,Salary Increases & Fixed Expenses Increase,103191,58104.0,56175,114279.0,-11088.0,-10.75,-0.03,High Risk
U663,2024,2,193549.0,Salary Increases & Fixed Expenses Increase,103191,58104.0,60101,118205.0,-15014.0,-14.55,-0.01,High Risk
U663,2024,3,178535.0,Salary Increases & Fixed Expenses Increase,103191,58104.0,45734,103838.0,-647.0,-0.63,-0.03,High Risk
U663,2024,4,177888.0,Salary Increases & Fixed Expenses Increase,103191,58104.0,45296,103400.0,-209.0,-0.2,0.02,High Risk
U663,2024,5,177679.0,Salary Increases & Fixed Expenses Increase,111383,58104.0,56184,114288.0,-2905.0,-2.61,0.03,High Risk
U663,2024,6,174774.0,Salary Increases & Fixed Expenses Increase,111383,58104.0,46747,104851.0,6532.0,5.86,0.04,High Risk
U663,2024,7,181306.0,Salary Increases & Fixed Expenses Increase,111383,59075.0,63101,122176.0,-10793.0,-9.69,0.05,High Risk
U663,2024,8,170513.0,Salary Increases & Fixed Expenses Increase,111383,59075.0,52024,111099.0,284.0,0.25,-0.02,High Risk
U663,2024,9,170797.0,Salary Increases & Fixed Expenses Increase,111383,59075.0,50625,109700.0,1683.0,1.51,0.02,High Risk
U663,2024,10,172480.0,Salary Increases & Fixed Expenses Increase,111383,59075.0,61457,120532.0,-9149.0,-8.21,0.03,High Risk
U663,2024,11,163331.0,Salary Increases & Fixed Expenses Increase,111383,59075.0,58295,117370.0,-5987.0,-5.38,-0.03,High Risk
U663,2024,12,157344.0,Salary Increases & Fixed Expenses Increase,111383,59075.0,51304,110379.0,1004.0,0.9,0.05,High Risk
U664,2024,1,249996.0,Salary Increases & Fixed Expenses Remain Stable,175424,43995.0,105083,149078.0,26346.0,15.02,-0.0,Medium Risk
U664,2024,2,276342.0,Salary Increases & Fixed Expenses Remain Stable,175424,43995.0,96474,140469.0,34955.0,19.93,0.01,Medium Risk
U664,2024,3,311297.0,Salary Increases & Fixed Expenses Remain Stable,175424,43995.0,112813,156808.0,18616.0,10.61,-0.04,High Risk
U664,2024,4,329913.0,Salary Increases & Fixed Expenses Remain Stable,198109,43995.0,116146,160141.0,37968.0,19.17,-0.0,Medium Risk
U664,2024,5,367881.0,Salary Increases & Fixed Expenses Remain Stable,198109,43995.0,112226,156221.0,41888.0,21.14,-0.02,Medium Risk
U664,2024,6,409769.0,Salary Increases & Fixed Expenses Remain Stable,198109,43995.0,94677,138672.0,59437.0,30.0,-0.04,Low Risk
U664,2024,7,469206.0,Salary Increases & Fixed Expenses Remain Stable,198109,43995.0,102000,145995.0,52114.0,26.31,0.04,Low Risk
U664,2024,8,521320.0,Salary Increases & Fixed Expenses Remain Stable,198109,43995.0,96004,139999.0,58110.0,29.33,0.03,Low Risk
U664,2024,9,579430.0,Salary Increases & Fixed Expenses Remain Stable,198109,43995.0,126811,170806.0,27303.0,13.78,-0.05,High Risk
U664,2024,10,606733.0,Salary Increases & Fixed Expenses Remain Stable,198109,43995.0,97570,141565.0,56544.0,28.54,-0.04,Low Risk
U664,2024,11,663277.0,Salary Increases & Fixed Expenses Remain Stable,198109,43995.0,98427,142422.0,55687.0,28.11,-0.05,Low Risk
U664,2024,12,718964.0,Salary Increases & Fixed Expenses Remain Stable,198109,43995.0,135167,179162.0,18947.0,9.56,0.01,High Risk
U665,2024,1,208916.0,Salary Increases & Fixed Expenses Increase,148304,47079.0,49068,96147.0,52157.0,35.17,-0.02,Low Risk
U665,2024,2,261073.0,Salary Increases & Fixed Expenses Increase,148304,47079.0,47836,94915.0,53389.0,36.0,-0.02,Low Risk
U665,2024,3,314462.0,Salary Increases & Fixed Expenses Increase,148304,47079.0,68049,115128.0,33176.0,22.37,-0.01,Medium Risk
U665,2024,4,347638.0,Salary Increases & Fixed Expenses Increase,148304,47079.0,54502,101581.0,46723.0,31.5,-0.01,Low Risk
U665,2024,5,394361.0,Salary Increases & Fixed Expenses Increase,148304,47079.0,58658,105737.0,42567.0,28.7,-0.01,Low Risk
U665,2024,6,436928.0,Salary Increases & Fixed Expenses Increase,163293,47079.0,63430,110509.0,52784.0,32.32,0.03,Low Risk
U665,2024,7,489712.0,Salary Increases & Fixed Expenses Increase,163293,47079.0,50473,97552.0,65741.0,40.26,0.0,Low Risk
U665,2024,8,555453.0,Salary Increases & Fixed Expenses Increase,163293,47079.0,57613,104692.0,58601.0,35.89,0.04,Low Risk
U665,2024,9,614054.0,Salary Increases & Fixed Expenses Increase,163293,47079.0,53842,100921.0,62372.0,38.2,-0.02,Low Risk
U665,2024,10,676426.0,Salary Increases & Fixed Expenses Increase,163293,47079.0,67673,114752.0,48541.0,29.73,0.02,Low Risk
U665,2024,11,724967.0,Salary Increases & Fixed Expenses Increase,163293,47704.0,63289,110993.0,52300.0,32.03,0.04,Low Risk
U665,2024,12,777267.0,Salary Increases & Fixed Expenses Increase,163293,49318.0,58820,108138.0,55155.0,33.78,-0.01,Low Risk
U666,2024,1,228787.0,Salary Increases & Fixed Expenses Remain Stable,229190,65669.0,169320,234989.0,-5799.0,-2.53,0.05,High Risk
U666,2024,2,222988.0,Salary Increases & Fixed Expenses Remain Stable,229190,65669.0,182257,247926.0,-18736.0,-8.17,-0.02,High Risk
U666,2024,3,204252.0,Salary Increases & Fixed Expenses Remain Stable,241503,65669.0,206243,271912.0,-30409.0,-12.59,-0.0,High Risk
U666,2024,4,173843.0,Salary Increases & Fixed Expenses Remain Stable,241503,65669.0,145672,211341.0,30162.0,12.49,0.04,High Risk
U666,2024,5,204005.0,Salary Increases & Fixed Expenses Remain Stable,241503,65669.0,165015,230684.0,10819.0,4.48,0.04,High Risk
U666,2024,6,214824.0,Salary Increases & Fixed Expenses Remain Stable,241503,65669.0,148503,214172.0,27331.0,11.32,-0.01,High Risk
U666,2024,7,242155.0,Salary Increases & Fixed Expenses Remain Stable,241503,65669.0,160975,226644.0,14859.0,6.15,-0.01,High Risk
U666,2024,8,257014.0,Salary Increases & Fixed Expenses Remain Stable,241503,65669.0,158526,224195.0,17308.0,7.17,-0.02,High Risk
U666,2024,9,274322.0,Salary Increases & Fixed Expenses Remain Stable,241503,65669.0,217936,283605.0,-42102.0,-17.43,-0.01,High Risk
U666,2024,10,232220.0,Salary Increases & Fixed Expenses Remain Stable,241503,65669.0,225899,291568.0,-50065.0,-20.73,0.04,High Risk
U666,2024,11,182155.0,Salary Increases & Fixed Expenses Remain Stable,241503,65669.0,164561,230230.0,11273.0,4.67,-0.04,High Risk
U666,2024,12,193428.0,Salary Increases & Fixed Expenses Remain Stable,241503,65669.0,218991,284660.0,-43157.0,-17.87,-0.0,High Risk
U667,2024,1,224870.0,Salary Increases & Fixed Expenses Remain Stable,73777,30246.0,27257,57503.0,16274.0,22.06,0.01,Medium Risk
U667,2024,2,241144.0,Salary Increases & Fixed Expenses Remain Stable,73777,30246.0,22150,52396.0,21381.0,28.98,0.04,Low Risk
U667,2024,3,262525.0,Salary Increases & Fixed Expenses Remain Stable,73777,30246.0,25805,56051.0,17726.0,24.03,-0.03,Medium Risk
U667,2024,4,280251.0,Salary Increases & Fixed Expenses Remain Stable,73777,30246.0,28243,58489.0,15288.0,20.72,0.01,Medium Risk
U667,2024,5,295539.0,Salary Increases & Fixed Expenses Remain Stable,89318,30246.0,32167,62413.0,26905.0,30.12,-0.02,Low Risk
U667,2024,6,322444.0,Salary Increases & Fixed Expenses Remain Stable,89318,30246.0,33863,64109.0,25209.0,28.22,0.05,Low Risk
U667,2024,7,347653.0,Salary Increases & Fixed Expenses Remain Stable,89318,30246.0,35448,65694.0,23624.0,26.45,-0.01,Low Risk
U667,2024,8,371277.0,Salary Increases & Fixed Expenses Remain Stable,89318,30246.0,27662,57908.0,31410.0,35.17,0.02,Low Risk
U667,2024,9,402687.0,Salary Increases & Fixed Expenses Remain Stable,89318,30246.0,27874,58120.0,31198.0,34.93,0.04,Low Risk
U667,2024,10,433885.0,Salary Increases & Fixed Expenses Remain Stable,89318,30246.0,31035,61281.0,28037.0,31.39,0.01,Low Risk
U667,2024,11,461922.0,Salary Increases & Fixed Expenses Remain Stable,89318,30246.0,35709,65955.0,23363.0,26.16,0.04,Low Risk
U667,2024,12,485285.0,Salary Increases & Fixed Expenses Remain Stable,89318,30246.0,33737,63983.0,25335.0,28.36,0.02,Low Risk
U668,2024,1,242241.0,Salary Increases & Fixed Expenses Increase,66182,28956.0,21259,50215.0,15967.0,24.13,0.02,Medium Risk
U668,2024,2,258208.0,Salary Increases & Fixed Expenses Increase,66182,28956.0,22767,51723.0,14459.0,21.85,-0.04,Medium Risk
U668,2024,3,272667.0,Salary Increases & Fixed Expenses Increase,66182,28956.0,32607,61563.0,4619.0,6.98,-0.01,High Risk
U668,2024,4,277286.0,Salary Increases & Fixed Expenses Increase,66182,28956.0,22274,51230.0,14952.0,22.59,0.0,Medium Risk
U668,2024,5,292238.0,Salary Increases & Fixed Expenses Increase,66182,28956.0,24261,53217.0,12965.0,19.59,-0.04,Medium Risk
U668,2024,6,305203.0,Salary Increases & Fixed Expenses Increase,71535,28956.0,25642,54598.0,16937.0,23.68,-0.03,Medium Risk
U668,2024,7,322140.0,Salary Increases & Fixed Expenses Increase,71535,30549.0,26840,57389.0,14146.0,19.77,-0.04,Medium Risk
U668,2024,8,336286.0,Salary Increases & Fixed Expenses Increase,71535,30549.0,26801,57350.0,14185.0,19.83,-0.0,Medium Risk
U668,2024,9,350471.0,Salary Increases & Fixed Expenses Increase,71535,30549.0,28513,59062.0,12473.0,17.44,-0.03,Medium Risk
U668,2024,10,362944.0,Salary Increases & Fixed Expenses Increase,71535,30549.0,30635,61184.0,10351.0,14.47,0.0,High Risk
U668,2024,11,373295.0,Salary Increases & Fixed Expenses Increase,71535,30549.0,27424,57973.0,13562.0,18.96,0.0,Medium Risk
U668,2024,12,386857.0,Salary Increases & Fixed Expenses Increase,71535,30549.0,24937,55486.0,16049.0,22.44,-0.01,Medium Risk
U669,2024,1,207666.0,Salary Increases & Fixed Expenses Remain Stable,194784,66686.0,99546,166232.0,28552.0,14.66,0.04,High Risk
U669,2024,2,236218.0,Salary Increases & Fixed Expenses Remain Stable,194784,66686.0,88978,155664.0,39120.0,20.08,-0.01,Medium Risk
U669,2024,3,275338.0,Salary Increases & Fixed Expenses Remain Stable,221982,66686.0,143323,210009.0,11973.0,5.39,0.01,High Risk
U669,2024,4,287311.0,Salary Increases & Fixed Expenses Remain Stable,221982,66686.0,110630,177316.0,44666.0,20.12,0.01,Medium Risk
U669,2024,5,331977.0,Salary Increases & Fixed Expenses Remain Stable,221982,66686.0,107227,173913.0,48069.0,21.65,-0.03,Medium Risk
U669,2024,6,380046.0,Salary Increases & Fixed Expenses Remain Stable,221982,66686.0,89720,156406.0,65576.0,29.54,-0.05,Low Risk
U669,2024,7,445622.0,Salary Increases & Fixed Expenses Remain Stable,221982,66686.0,106696,173382.0,48600.0,21.89,0.01,Medium Risk
U669,2024,8,494222.0,Salary Increases & Fixed Expenses Remain Stable,221982,66686.0,124266,190952.0,31030.0,13.98,-0.02,High Risk
U669,2024,9,525252.0,Salary Increases & Fixed Expenses Remain Stable,221982,66686.0,147263,213949.0,8033.0,3.62,-0.02,High Risk
U669,2024,10,533285.0,Salary Increases & Fixed Expenses Remain Stable,221982,66686.0,115586,182272.0,39710.0,17.89,-0.04,Medium Risk
U669,2024,11,572995.0,Salary Increases & Fixed Expenses Remain Stable,221982,66686.0,131061,197747.0,24235.0,10.92,0.01,High Risk
U669,2024,12,597230.0,Salary Increases & Fixed Expenses Remain Stable,221982,66686.0,125436,192122.0,29860.0,13.45,-0.05,High Risk
U670,2024,1,213276.0,Salary Increases & Fixed Expenses Remain Stable,23788,17405.0,9071,26476.0,-2688.0,-11.3,-0.03,High Risk
U670,2024,2,210588.0,Salary Increases & Fixed Expenses Remain Stable,23788,17405.0,7496,24901.0,-1113.0,-4.68,-0.02,High Risk
U670,2024,3,209475.0,Salary Increases & Fixed Expenses Remain Stable,23788,17405.0,8596,26001.0,-2213.0,-9.3,-0.02,High Risk
U670,2024,4,207262.0,Salary Increases & Fixed Expenses Remain Stable,45902,17405.0,17739,35144.0,10758.0,23.44,-0.02,Medium Risk
U670,2024,5,218020.0,Salary Increases & Fixed Expenses Remain Stable,45902,17405.0,17926,35331.0,10571.0,23.03,0.01,Medium Risk
U670,2024,6,228591.0,Salary Increases & Fixed Expenses Remain Stable,45902,17405.0,17794,35199.0,10703.0,23.32,-0.0,Medium Risk
U670,2024,7,239294.0,Salary Increases & Fixed Expenses Remain Stable,45902,17405.0,14894,32299.0,13603.0,29.63,-0.02,Low Risk
U670,2024,8,252897.0,Salary Increases & Fixed Expenses Remain Stable,45902,17405.0,15543,32948.0,12954.0,28.22,0.01,Low Risk
U670,2024,9,265851.0,Salary Increases & Fixed Expenses Remain Stable,45902,17405.0,20121,37526.0,8376.0,18.25,0.03,Medium Risk
U670,2024,10,274227.0,Salary Increases & Fixed Expenses Remain Stable,45902,17405.0,21399,38804.0,7098.0,15.46,-0.0,Medium Risk
U670,2024,11,281325.0,Salary Increases & Fixed Expenses Remain Stable,45902,17405.0,17525,34930.0,10972.0,23.9,0.03,Medium Risk
U670,2024,12,292297.0,Salary Increases & Fixed Expenses Remain Stable,45902,17405.0,18949,36354.0,9548.0,20.8,-0.04,Medium Risk
U671,2024,1,202138.0,Salary Increases & Fixed Expenses Remain Stable,271114,81799.0,88405,170204.0,100910.0,37.22,-0.04,Low Risk
U671,2024,2,303048.0,Salary Increases & Fixed Expenses Remain Stable,271114,81799.0,97999,179798.0,91316.0,33.68,0.0,Low Risk
U671,2024,3,394364.0,Salary Increases & Fixed Expenses Remain Stable,271114,81799.0,125316,207115.0,63999.0,23.61,0.02,Medium Risk
U671,2024,4,458363.0,Salary Increases & Fixed Expenses Remain Stable,271114,81799.0,98065,179864.0,91250.0,33.66,0.01,Low Risk
U671,2024,5,549613.0,Salary Increases & Fixed Expenses Remain Stable,298250,81799.0,108040,189839.0,108411.0,36.35,0.0,Low Risk
U671,2024,6,658024.0,Salary Increases & Fixed Expenses Remain Stable,298250,81799.0,101242,183041.0,115209.0,38.63,0.0,Low Risk
U671,2024,7,773233.0,Salary Increases & Fixed Expenses Remain Stable,298250,81799.0,111096,192895.0,105355.0,35.32,-0.03,Low Risk
U671,2024,8,878588.0,Salary Increases & Fixed Expenses Remain Stable,298250,81799.0,111586,193385.0,104865.0,35.16,-0.02,Low Risk
U671,2024,9,983453.0,Salary Increases & Fixed Expenses Remain Stable,298250,81799.0,112356,194155.0,104095.0,34.9,0.03,Low Risk
U671,2024,10,1087548.0,Salary Increases & Fixed Expenses Remain Stable,298250,81799.0,125183,206982.0,91268.0,30.6,0.01,Low Risk
U671,2024,11,1178816.0,Salary Increases & Fixed Expenses Remain Stable,298250,81799.0,124873,206672.0,91578.0,30.71,-0.04,Low Risk
U671,2024,12,1270394.0,Salary Increases & Fixed Expenses Remain Stable,298250,81799.0,110621,192420.0,105830.0,35.48,-0.02,Low Risk
U672,2024,1,213663.0,Salary Increases & Fixed Expenses Increase,91532,32724.0,35290,68014.0,23518.0,25.69,-0.05,Low Risk
U672,2024,2,237181.0,Salary Increases & Fixed Expenses Increase,91532,32724.0,34098,66822.0,24710.0,27.0,0.02,Low Risk
U672,2024,3,261891.0,Salary Increases & Fixed Expenses Increase,91532,32724.0,32954,65678.0,25854.0,28.25,0.03,Low Risk
U672,2024,4,287745.0,Salary Increases & Fixed Expenses Increase,91532,32724.0,29333,62057.0,29475.0,32.2,-0.04,Low Risk
U672,2024,5,317220.0,Salary Increases & Fixed Expenses Increase,116355,32724.0,40090,72814.0,43541.0,37.42,-0.03,Low Risk
U672,2024,6,360761.0,Salary Increases & Fixed Expenses Increase,116355,34400.0,39330,73730.0,42625.0,36.63,0.01,Low Risk
U672,2024,7,403386.0,Salary Increases & Fixed Expenses Increase,116355,34400.0,42910,77310.0,39045.0,33.56,-0.03,Low Risk
U672,2024,8,442431.0,Salary Increases & Fixed Expenses Increase,116355,34400.0,46153,80553.0,35802.0,30.77,-0.02,Low Risk
U672,2024,9,478233.0,Salary Increases & Fixed Expenses Increase,116355,34400.0,38633,73033.0,43322.0,37.23,0.05,Low Risk
U672,2024,10,521555.0,Salary Increases & Fixed Expenses Increase,116355,34400.0,51950,86350.0,30005.0,25.79,0.0,Low Risk
U672,2024,11,551560.0,Salary Increases & Fixed Expenses Increase,116355,35115.0,36542,71657.0,44698.0,38.42,-0.03,Low Risk
U672,2024,12,596258.0,Salary Increases & Fixed Expenses Increase,116355,35115.0,42444,77559.0,38796.0,33.34,0.02,Low Risk
U673,2024,1,201968.0,Salary Increases & Fixed Expenses Increase,266149,94414.0,157243,251657.0,14492.0,5.45,-0.02,High Risk
U673,2024,2,216460.0,Salary Increases & Fixed Expenses Increase,266149,94414.0,158014,252428.0,13721.0,5.16,-0.02,High Risk
U673,2024,3,230181.0,Salary Increases & Fixed Expenses Increase,266149,94414.0,133413,227827.0,38322.0,14.4,-0.03,High Risk
U673,2024,4,268503.0,Salary Increases & Fixed Expenses Increase,266149,94414.0,136683,231097.0,35052.0,13.17,-0.03,High Risk
U673,2024,5,303555.0,Salary Increases & Fixed Expenses Increase,266149,94414.0,133917,228331.0,37818.0,14.21,0.04,High Risk
U673,2024,6,341373.0,Salary Increases & Fixed Expenses Increase,276860,96345.0,123774,220119.0,56741.0,20.49,0.03,Medium Risk
U673,2024,7,398114.0,Salary Increases & Fixed Expenses Increase,276860,96345.0,122028,218373.0,58487.0,21.13,-0.0,Medium Risk
U673,2024,8,456601.0,Salary Increases & Fixed Expenses Increase,276860,96345.0,127833,224178.0,52682.0,19.03,0.04,Medium Risk
U673,2024,9,509283.0,Salary Increases & Fixed Expenses Increase,276860,96345.0,166779,263124.0,13736.0,4.96,-0.03,High Risk
U673,2024,10,523019.0,Salary Increases & Fixed Expenses Increase,276860,96345.0,170528,266873.0,9987.0,3.61,-0.02,High Risk
U673,2024,11,533006.0,Salary Increases & Fixed Expenses Increase,276860,96345.0,140928,237273.0,39587.0,14.3,0.01,High Risk
U673,2024,12,572593.0,Salary Increases & Fixed Expenses Increase,276860,98212.0,152784,250996.0,25864.0,9.34,0.02,High Risk
U674,2024,1,212758.0,Stable Salary & Stable Fixed Expenses,224444,96912.0,157194,254106.0,-29662.0,-13.22,-0.03,High Risk
U674,2024,2,183096.0,Stable Salary & Stable Fixed Expenses,224444,96912.0,146272,243184.0,-18740.0,-8.35,-0.04,High Risk
U674,2024,3,164356.0,Stable Salary & Stable Fixed Expenses,224444,96912.0,186592,283504.0,-59060.0,-26.31,0.01,High Risk
U674,2024,4,105296.0,Stable Salary & Stable Fixed Expenses,224444,96912.0,166640,263552.0,-39108.0,-17.42,-0.05,High Risk
U674,2024,5,66188.0,Stable Salary & Stable Fixed Expenses,224444,96912.0,175228,272140.0,-47696.0,-21.25,0.03,High Risk
U674,2024,6,18492.0,Stable Salary & Stable Fixed Expenses,224444,96912.0,165808,262720.0,-38276.0,-17.05,-0.03,High Risk
U674,2024,7,-19784.0,Stable Salary & Stable Fixed Expenses,224444,96912.0,159249,256161.0,-31717.0,-14.13,-0.05,High Risk
U674,2024,8,-51501.0,Stable Salary & Stable Fixed Expenses,224444,96912.0,141259,238171.0,-13727.0,-6.12,-0.01,High Risk
U674,2024,9,-65228.0,Stable Salary & Stable Fixed Expenses,224444,96912.0,179875,276787.0,-52343.0,-23.32,-0.04,High Risk
U674,2024,10,-117571.0,Stable Salary & Stable Fixed Expenses,224444,96912.0,205966,302878.0,-78434.0,-34.95,0.03,High Risk
U674,2024,11,-196005.0,Stable Salary & Stable Fixed Expenses,224444,96912.0,170444,267356.0,-42912.0,-19.12,-0.04,High Risk
U674,2024,12,-238917.0,Stable Salary & Stable Fixed Expenses,224444,96912.0,217285,314197.0,-89753.0,-39.99,0.0,High Risk
U675,2024,1,246856.0,Stable Salary & Decreasing Fixed Expenses,255890,101728.0,146143,247871.0,8019.0,3.13,0.02,High Risk
U675,2024,2,254875.0,Stable Salary & Decreasing Fixed Expenses,255890,101728.0,125391,227119.0,28771.0,11.24,0.02,High Risk
U675,2024,3,283646.0,Stable Salary & Decreasing Fixed Expenses,255890,101728.0,176844,278572.0,-22682.0,-8.86,-0.03,High Risk
U675,2024,4,260964.0,Stable Salary & Decreasing Fixed Expenses,255890,101728.0,143112,244840.0,11050.0,4.32,0.0,High Risk
U675,2024,5,272014.0,Stable Salary & Decreasing Fixed Expenses,255890,101728.0,142843,244571.0,11319.0,4.42,0.05,High Risk
U675,2024,6,283333.0,Stable Salary & Decreasing Fixed Expenses,255890,101728.0,109489,211217.0,44673.0,17.46,0.01,Medium Risk
U675,2024,7,328006.0,Stable Salary & Decreasing Fixed Expenses,255890,101728.0,107305,209033.0,46857.0,18.31,0.02,Medium Risk
U675,2024,8,374863.0,Stable Salary & Decreasing Fixed Expenses,255890,101728.0,141131,242859.0,13031.0,5.09,-0.04,High Risk
U675,2024,9,387894.0,Stable Salary & Decreasing Fixed Expenses,255890,101728.0,130106,231834.0,24056.0,9.4,0.04,High Risk
U675,2024,10,411950.0,Stable Salary & Decreasing Fixed Expenses,255890,101728.0,134177,235905.0,19985.0,7.81,-0.01,High Risk
U675,2024,11,431935.0,Stable Salary & Decreasing Fixed Expenses,255890,101728.0,124527,226255.0,29635.0,11.58,-0.04,High Risk
U675,2024,12,461570.0,Stable Salary & Decreasing Fixed Expenses,255890,101728.0,171327,273055.0,-17165.0,-6.71,0.05,High Risk
U676,2024,1,248341.0,Stable Salary & Stable Fixed Expenses,166684,48728.0,78034,126762.0,39922.0,23.95,-0.04,Medium Risk
U676,2024,2,288263.0,Stable Salary & Stable Fixed Expenses,166684,48728.0,95219,143947.0,22737.0,13.64,0.0,High Risk
U676,2024,3,311000.0,Stable Salary & Stable Fixed Expenses,166684,48728.0,107139,155867.0,10817.0,6.49,-0.02,High Risk
U676,2024,4,321817.0,Stable Salary & Stable Fixed Expenses,166684,48728.0,75901,124629.0,42055.0,25.23,0.03,Low Risk
U676,2024,5,363872.0,Stable Salary & Stable Fixed Expenses,166684,48728.0,82635,131363.0,35321.0,21.19,-0.05,Medium Risk
U676,2024,6,399193.0,Stable Salary & Stable Fixed Expenses,166684,48728.0,86445,135173.0,31511.0,18.9,-0.03,Medium Risk
U676,2024,7,430704.0,Stable Salary & Stable Fixed Expenses,166684,48728.0,78663,127391.0,39293.0,23.57,0.0,Medium Risk
U676,2024,8,469997.0,Stable Salary & Stable Fixed Expenses,166684,48728.0,91124,139852.0,26832.0,16.1,0.04,Medium Risk
U676,2024,9,496829.0,Stable Salary & Stable Fixed Expenses,166684,48728.0,106484,155212.0,11472.0,6.88,0.01,High Risk
U676,2024,10,508301.0,Stable Salary & Stable Fixed Expenses,166684,48728.0,109591,158319.0,8365.0,5.02,0.02,High Risk
U676,2024,11,516666.0,Stable Salary & Stable Fixed Expenses,166684,48728.0,97184,145912.0,20772.0,12.46,0.02,High Risk
U676,2024,12,537438.0,Stable Salary & Stable Fixed Expenses,166684,48728.0,94536,143264.0,23420.0,14.05,-0.02,High Risk
U677,2024,1,212878.0,Salary Increases & Fixed Expenses Increase,276156,106797.0,153380,260177.0,15979.0,5.79,-0.04,High Risk
U677,2024,2,228857.0,Salary Increases & Fixed Expenses Increase,276156,106797.0,138080,244877.0,31279.0,11.33,-0.03,High Risk
U677,2024,3,260136.0,Salary Increases & Fixed Expenses Increase,276156,106797.0,131300,238097.0,38059.0,13.78,0.04,High Risk
U677,2024,4,298195.0,Salary Increases & Fixed Expenses Increase,276156,107420.0,114299,221719.0,54437.0,19.71,-0.01,Medium Risk
U677,2024,5,352632.0,Salary Increases & Fixed Expenses Increase,276156,107420.0,138584,246004.0,30152.0,10.92,-0.05,High Risk
U677,2024,6,382784.0,Salary Increases & Fixed Expenses Increase,276156,107420.0,137823,245243.0,30913.0,11.19,-0.04,High Risk
U677,2024,7,413697.0,Salary Increases & Fixed Expenses Increase,282363,109032.0,156455,265487.0,16876.0,5.98,0.03,High Risk
U677,2024,8,430573.0,Salary Increases & Fixed Expenses Increase,282363,109032.0,152218,261250.0,21113.0,7.48,-0.02,High Risk
U677,2024,9,451686.0,Salary Increases & Fixed Expenses Increase,282363,109032.0,158325,267357.0,15006.0,5.31,0.03,High Risk
U677,2024,10,466692.0,Salary Increases & Fixed Expenses Increase,282363,109032.0,132952,241984.0,40379.0,14.3,-0.0,High Risk
U677,2024,11,507071.0,Salary Increases & Fixed Expenses Increase,282363,110843.0,146347,257190.0,25173.0,8.92,0.03,High Risk
U677,2024,12,532244.0,Salary Increases & Fixed Expenses Increase,282363,110843.0,145421,256264.0,26099.0,9.24,-0.05,High Risk
U678,2024,1,216068.0,Salary Increases & Fixed Expenses Remain Stable,122529,40983.0,70083,111066.0,11463.0,9.36,-0.01,High Risk
U678,2024,2,227531.0,Salary Increases & Fixed Expenses Remain Stable,122529,40983.0,62152,103135.0,19394.0,15.83,0.02,Medium Risk
U678,2024,3,246925.0,Salary Increases & Fixed Expenses Remain Stable,122529,40983.0,83768,124751.0,-2222.0,-1.81,-0.05,High Risk
U678,2024,4,244703.0,Salary Increases & Fixed Expenses Remain Stable,122529,40983.0,63396,104379.0,18150.0,14.81,0.03,High Risk
U678,2024,5,262853.0,Salary Increases & Fixed Expenses Remain Stable,122529,40983.0,58359,99342.0,23187.0,18.92,0.02,Medium Risk
U678,2024,6,286040.0,Salary Increases & Fixed Expenses Remain Stable,122529,40983.0,55185,96168.0,26361.0,21.51,-0.04,Medium Risk
U678,2024,7,312401.0,Salary Increases & Fixed Expenses Remain Stable,122529,40983.0,57030,98013.0,24516.0,20.01,-0.01,Medium Risk
U678,2024,8,336917.0,Salary Increases & Fixed Expenses Remain Stable,147484,40983.0,70000,110983.0,36501.0,24.75,0.02,Medium Risk
U678,2024,9,373418.0,Salary Increases & Fixed Expenses Remain Stable,147484,40983.0,80323,121306.0,26178.0,17.75,-0.0,Medium Risk
U678,2024,10,399596.0,Salary Increases & Fixed Expenses Remain Stable,147484,40983.0,75407,116390.0,31094.0,21.08,0.04,Medium Risk
U678,2024,11,430690.0,Salary Increases & Fixed Expenses Remain Stable,147484,40983.0,71828,112811.0,34673.0,23.51,0.04,Medium Risk
U678,2024,12,465363.0,Salary Increases & Fixed Expenses Remain Stable,147484,40983.0,80557,121540.0,25944.0,17.59,-0.01,Medium Risk
U679,2024,1,216298.0,Salary Increases & Fixed Expenses Increase,52623,39774.0,31354,71128.0,-18505.0,-35.17,-0.02,High Risk
U679,2024,2,197793.0,Salary Increases & Fixed Expenses Increase,52623,39774.0,27788,67562.0,-14939.0,-28.39,0.02,High Risk
U679,2024,3,182854.0,Salary Increases & Fixed Expenses Increase,52623,39774.0,22025,61799.0,-9176.0,-17.44,-0.03,High Risk
U679,2024,4,173678.0,Salary Increases & Fixed Expenses Increase,52623,41040.0,30540,71580.0,-18957.0,-36.02,-0.01,High Risk
U679,2024,5,154721.0,Salary Increases & Fixed Expenses Increase,76698,42331.0,37790,80121.0,-3423.0,-4.46,-0.05,High Risk
U679,2024,6,151298.0,Salary Increases & Fixed Expenses Increase,76698,43059.0,37039,80098.0,-3400.0,-4.43,0.0,High Risk
U679,2024,7,147898.0,Salary Increases & Fixed Expenses Increase,76698,43059.0,41931,84990.0,-8292.0,-10.81,-0.03,High Risk
U679,2024,8,139606.0,Salary Increases & Fixed Expenses Increase,76698,43059.0,37762,80821.0,-4123.0,-5.38,-0.04,High Risk
U679,2024,9,135483.0,Salary Increases & Fixed Expenses Increase,76698,43059.0,33136,76195.0,503.0,0.66,-0.02,High Risk
U679,2024,10,135986.0,Salary Increases & Fixed Expenses Increase,76698,43059.0,43014,86073.0,-9375.0,-12.22,-0.01,High Risk
U679,2024,11,126611.0,Salary Increases & Fixed Expenses Increase,76698,44730.0,33694,78424.0,-1726.0,-2.25,0.02,High Risk
U679,2024,12,124885.0,Salary Increases & Fixed Expenses Increase,76698,44730.0,34440,79170.0,-2472.0,-3.22,-0.0,High Risk
U680,2024,1,215043.0,Stable Salary & Stable Fixed Expenses,129840,57616.0,52560,110176.0,19664.0,15.14,0.02,Medium Risk
U680,2024,2,234707.0,Stable Salary & Stable Fixed Expenses,129840,57616.0,66629,124245.0,5595.0,4.31,0.02,High Risk
U680,2024,3,240302.0,Stable Salary & Stable Fixed Expenses,129840,57616.0,69656,127272.0,2568.0,1.98,0.03,High Risk
U680,2024,4,242870.0,Stable Salary & Stable Fixed Expenses,129840,57616.0,59950,117566.0,12274.0,9.45,-0.05,High Risk
U680,2024,5,255144.0,Stable Salary & Stable Fixed Expenses,129840,57616.0,69407,127023.0,2817.0,2.17,0.01,High Risk
U680,2024,6,257961.0,Stable Salary & Stable Fixed Expenses,129840,57616.0,61272,118888.0,10952.0,8.43,-0.01,High Risk
U680,2024,7,268913.0,Stable Salary & Stable Fixed Expenses,129840,57616.0,65116,122732.0,7108.0,5.47,0.04,High Risk
U680,2024,8,276021.0,Stable Salary & Stable Fixed Expenses,129840,57616.0,56715,114331.0,15509.0,11.94,0.03,High Risk
U680,2024,9,291530.0,Stable Salary & Stable Fixed Expenses,129840,57616.0,58526,116142.0,13698.0,10.55,-0.04,High Risk
U680,2024,10,305228.0,Stable Salary & Stable Fixed Expenses,129840,57616.0,64099,121715.0,8125.0,6.26,-0.04,High Risk
U680,2024,11,313353.0,Stable Salary & Stable Fixed Expenses,129840,57616.0,56229,113845.0,15995.0,12.32,0.0,High Risk
U680,2024,12,329348.0,Stable Salary & Stable Fixed Expenses,129840,57616.0,69352,126968.0,2872.0,2.21,-0.02,High Risk
U681,2024,1,209499.0,Stable Salary & Decreasing Fixed Expenses,156666,59005.0,69101,128106.0,28560.0,18.23,-0.03,Medium Risk
U681,2024,2,238059.0,Stable Salary & Decreasing Fixed Expenses,156666,59005.0,68987,127992.0,28674.0,18.3,-0.04,Medium Risk
U681,2024,3,266733.0,Stable Salary & Decreasing Fixed Expenses,156666,59005.0,102436,161441.0,-4775.0,-3.05,0.03,High Risk
U681,2024,4,261958.0,Stable Salary & Decreasing Fixed Expenses,156666,59005.0,81344,140349.0,16317.0,10.42,0.04,High Risk
U681,2024,5,278275.0,Stable Salary & Decreasing Fixed Expenses,156666,59005.0,76190,135195.0,21471.0,13.7,0.02,High Risk
U681,2024,6,299746.0,Stable Salary & Decreasing Fixed Expenses,156666,59005.0,76828,135833.0,20833.0,13.3,0.0,High Risk
U681,2024,7,320579.0,Stable Salary & Decreasing Fixed Expenses,156666,59005.0,65023,124028.0,32638.0,20.83,0.05,Medium Risk
U681,2024,8,353217.0,Stable Salary & Decreasing Fixed Expenses,156666,59005.0,75943,134948.0,21718.0,13.86,-0.03,High Risk
U681,2024,9,374935.0,Stable Salary & Decreasing Fixed Expenses,156666,59005.0,89311,148316.0,8350.0,5.33,0.03,High Risk
U681,2024,10,383285.0,Stable Salary & Decreasing Fixed Expenses,156666,59005.0,85634,144639.0,12027.0,7.68,-0.01,High Risk
U681,2024,11,395312.0,Stable Salary & Decreasing Fixed Expenses,156666,59005.0,74841,133846.0,22820.0,14.57,-0.03,High Risk
U681,2024,12,418132.0,Stable Salary & Decreasing Fixed Expenses,156666,59005.0,85002,144007.0,12659.0,8.08,-0.01,High Risk
U682,2024,1,222224.0,Stable Salary & Stable Fixed Expenses,23999,10620.0,13005,23625.0,374.0,1.56,-0.01,High Risk
U682,2024,2,222598.0,Stable Salary & Stable Fixed Expenses,23999,10620.0,14204,24824.0,-825.0,-3.44,-0.04,High Risk
U682,2024,3,221773.0,Stable Salary & Stable Fixed Expenses,23999,10620.0,11262,21882.0,2117.0,8.82,0.03,High Risk
U682,2024,4,223890.0,Stable Salary & Stable Fixed Expenses,23999,10620.0,11172,21792.0,2207.0,9.2,-0.05,High Risk
U682,2024,5,226097.0,Stable Salary & Stable Fixed Expenses,23999,10620.0,10546,21166.0,2833.0,11.8,-0.03,High Risk
U682,2024,6,228930.0,Stable Salary & Stable Fixed Expenses,23999,10620.0,13717,24337.0,-338.0,-1.41,-0.04,High Risk
U682,2024,7,228592.0,Stable Salary & Stable Fixed Expenses,23999,10620.0,12336,22956.0,1043.0,4.35,-0.01,High Risk
U682,2024,8,229635.0,Stable Salary & Stable Fixed Expenses,23999,10620.0,10186,20806.0,3193.0,13.3,0.03,High Risk
U682,2024,9,232828.0,Stable Salary & Stable Fixed Expenses,23999,10620.0,12752,23372.0,627.0,2.61,0.01,High Risk
U682,2024,10,233455.0,Stable Salary & Stable Fixed Expenses,23999,10620.0,11813,22433.0,1566.0,6.53,0.03,High Risk
U682,2024,11,235021.0,Stable Salary & Stable Fixed Expenses,23999,10620.0,13286,23906.0,93.0,0.39,0.04,High Risk
U682,2024,12,235114.0,Stable Salary & Stable Fixed Expenses,23999,10620.0,12199,22819.0,1180.0,4.92,0.03,High Risk
U683,2024,1,205897.0,Stable Salary & Decreasing Fixed Expenses,160507,45252.0,85215,130467.0,30040.0,18.72,0.0,Medium Risk
U683,2024,2,235937.0,Stable Salary & Decreasing Fixed Expenses,160507,45252.0,70813,116065.0,44442.0,27.69,-0.02,Low Risk
U683,2024,3,280379.0,Stable Salary & Decreasing Fixed Expenses,160507,45252.0,103944,149196.0,11311.0,7.05,0.05,High Risk
U683,2024,4,291690.0,Stable Salary & Decreasing Fixed Expenses,160507,45252.0,70637,115889.0,44618.0,27.8,-0.02,Low Risk
U683,2024,5,336308.0,Stable Salary & Decreasing Fixed Expenses,160507,45252.0,82872,128124.0,32383.0,20.18,-0.03,Medium Risk
U683,2024,6,368691.0,Stable Salary & Decreasing Fixed Expenses,160507,45252.0,78077,123329.0,37178.0,23.16,0.04,Medium Risk
U683,2024,7,405869.0,Stable Salary & Decreasing Fixed Expenses,160507,45252.0,80977,126229.0,34278.0,21.36,-0.02,Medium Risk
U683,2024,8,440147.0,Stable Salary & Decreasing Fixed Expenses,160507,45252.0,80426,125678.0,34829.0,21.7,-0.01,Medium Risk
U683,2024,9,474976.0,Stable Salary & Decreasing Fixed Expenses,160507,45252.0,85295,130547.0,29960.0,18.67,-0.03,Medium Risk
U683,2024,10,504936.0,Stable Salary & Decreasing Fixed Expenses,160507,45252.0,105530,150782.0,9725.0,6.06,-0.04,High Risk
U683,2024,11,514661.0,Stable Salary & Decreasing Fixed Expenses,160507,45252.0,78323,123575.0,36932.0,23.01,0.01,Medium Risk
U683,2024,12,551593.0,Stable Salary & Decreasing Fixed Expenses,160507,45252.0,99719,144971.0,15536.0,9.68,0.01,High Risk
U684,2024,1,221418.0,Salary Increases & Fixed Expenses Remain Stable,261799,93237.0,189605,282842.0,-21043.0,-8.04,0.02,High Risk
U684,2024,2,200375.0,Salary Increases & Fixed Expenses Remain Stable,261799,93237.0,201666,294903.0,-33104.0,-12.64,-0.0,High Risk
U684,2024,3,167271.0,Salary Increases & Fixed Expenses Remain Stable,261799,93237.0,176241,269478.0,-7679.0,-2.93,0.04,High Risk
U684,2024,4,159592.0,Salary Increases & Fixed Expenses Remain Stable,261799,93237.0,161095,254332.0,7467.0,2.85,0.01,High Risk
U684,2024,5,167059.0,Salary Increases & Fixed Expenses Remain Stable,261799,93237.0,196864,290101.0,-28302.0,-10.81,0.0,High Risk
U684,2024,6,138757.0,Salary Increases & Fixed Expenses Remain Stable,261799,93237.0,208612,301849.0,-40050.0,-15.3,0.05,High Risk
U684,2024,7,98707.0,Salary Increases & Fixed Expenses Remain Stable,261799,93237.0,190751,283988.0,-22189.0,-8.48,-0.01,High Risk
U684,2024,8,76518.0,Salary Increases & Fixed Expenses Remain Stable,280260,93237.0,177641,270878.0,9382.0,3.35,-0.01,High Risk
U684,2024,9,85900.0,Salary Increases & Fixed Expenses Remain Stable,280260,93237.0,202953,296190.0,-15930.0,-5.68,0.03,High Risk
U684,2024,10,69970.0,Salary Increases & Fixed Expenses Remain Stable,280260,93237.0,197674,290911.0,-10651.0,-3.8,0.02,High Risk
U684,2024,11,59319.0,Salary Increases & Fixed Expenses Remain Stable,280260,93237.0,219793,313030.0,-32770.0,-11.69,0.04,High Risk
U684,2024,12,26549.0,Salary Increases & Fixed Expenses Remain Stable,280260,93237.0,186978,280215.0,45.0,0.02,-0.03,High Risk
U685,2024,1,249582.0,Stable Salary & Stable Fixed Expenses,47004,11755.0,20834,32589.0,14415.0,30.67,-0.03,Low Risk
U685,2024,2,263997.0,Stable Salary & Stable Fixed Expenses,47004,11755.0,27918,39673.0,7331.0,15.6,-0.02,Medium Risk
U685,2024,3,271328.0,Stable Salary & Stable Fixed Expenses,47004,11755.0,30887,42642.0,4362.0,9.28,-0.03,High Risk
U685,2024,4,275690.0,Stable Salary & Stable Fixed Expenses,47004,11755.0,25247,37002.0,10002.0,21.28,-0.04,Medium Risk
U685,2024,5,285692.0,Stable Salary & Stable Fixed Expenses,47004,11755.0,26833,38588.0,8416.0,17.9,0.04,Medium Risk
U685,2024,6,294108.0,Stable Salary & Stable Fixed Expenses,47004,11755.0,23378,35133.0,11871.0,25.26,0.01,Low Risk
U685,2024,7,305979.0,Stable Salary & Stable Fixed Expenses,47004,11755.0,21228,32983.0,14021.0,29.83,0.01,Low Risk
U685,2024,8,320000.0,Stable Salary & Stable Fixed Expenses,47004,11755.0,26291,38046.0,8958.0,19.06,0.02,Medium Risk
U685,2024,9,328958.0,Stable Salary & Stable Fixed Expenses,47004,11755.0,26597,38352.0,8652.0,18.41,-0.02,Medium Risk
U685,2024,10,337610.0,Stable Salary & Stable Fixed Expenses,47004,11755.0,31714,43469.0,3535.0,7.52,0.03,High Risk
U685,2024,11,341145.0,Stable Salary & Stable Fixed Expenses,47004,11755.0,20623,32378.0,14626.0,31.12,0.02,Low Risk
U685,2024,12,355771.0,Stable Salary & Stable Fixed Expenses,47004,11755.0,20040,31795.0,15209.0,32.36,0.02,Low Risk
U686,2024,1,200498.0,Stable Salary & Stable Fixed Expenses,233019,68104.0,127345,195449.0,37570.0,16.12,-0.03,Medium Risk
U686,2024,2,238068.0,Stable Salary & Stable Fixed Expenses,233019,68104.0,95271,163375.0,69644.0,29.89,0.02,Low Risk
U686,2024,3,307712.0,Stable Salary & Stable Fixed Expenses,233019,68104.0,149691,217795.0,15224.0,6.53,-0.01,High Risk
U686,2024,4,322936.0,Stable Salary & Stable Fixed Expenses,233019,68104.0,103040,171144.0,61875.0,26.55,-0.02,Low Risk
U686,2024,5,384811.0,Stable Salary & Stable Fixed Expenses,233019,68104.0,115044,183148.0,49871.0,21.4,0.03,Medium Risk
U686,2024,6,434682.0,Stable Salary & Stable Fixed Expenses,233019,68104.0,109675,177779.0,55240.0,23.71,0.02,Medium Risk
U686,2024,7,489922.0,Stable Salary & Stable Fixed Expenses,233019,68104.0,116290,184394.0,48625.0,20.87,-0.0,Medium Risk
U686,2024,8,538547.0,Stable Salary & Stable Fixed Expenses,233019,68104.0,113662,181766.0,51253.0,22.0,0.04,Medium Risk
U686,2024,9,589800.0,Stable Salary & Stable Fixed Expenses,233019,68104.0,136689,204793.0,28226.0,12.11,0.04,High Risk
U686,2024,10,618026.0,Stable Salary & Stable Fixed Expenses,233019,68104.0,123077,191181.0,41838.0,17.95,-0.02,Medium Risk
U686,2024,11,659864.0,Stable Salary & Stable Fixed Expenses,233019,68104.0,145316,213420.0,19599.0,8.41,-0.04,High Risk
U686,2024,12,679463.0,Stable Salary & Stable Fixed Expenses,233019,68104.0,163834,231938.0,1081.0,0.46,0.05,High Risk
U687,2024,1,225792.0,Salary Increases & Fixed Expenses Remain Stable,23194,16213.0,7817,24030.0,-836.0,-3.6,0.04,High Risk
U687,2024,2,224956.0,Salary Increases & Fixed Expenses Remain Stable,23194,16213.0,8971,25184.0,-1990.0,-8.58,0.01,High Risk
U687,2024,3,222966.0,Salary Increases & Fixed Expenses Remain Stable,23194,16213.0,7437,23650.0,-456.0,-1.97,-0.04,High Risk
U687,2024,4,222510.0,Salary Increases & Fixed Expenses Remain Stable,34786,16213.0,12385,28598.0,6188.0,17.79,-0.02,Medium Risk
U687,2024,5,228698.0,Salary Increases & Fixed Expenses Remain Stable,34786,16213.0,13889,30102.0,4684.0,13.47,0.01,High Risk
U687,2024,6,233382.0,Salary Increases & Fixed Expenses Remain Stable,34786,16213.0,12741,28954.0,5832.0,16.77,-0.04,Medium Risk
U687,2024,7,239214.0,Salary Increases & Fixed Expenses Remain Stable,34786,16213.0,12221,28434.0,6352.0,18.26,0.05,Medium Risk
U687,2024,8,245566.0,Salary Increases & Fixed Expenses Remain Stable,34786,16213.0,12236,28449.0,6337.0,18.22,0.02,Medium Risk
U687,2024,9,251903.0,Salary Increases & Fixed Expenses Remain Stable,34786,16213.0,11121,27334.0,7452.0,21.42,0.01,Medium Risk
U687,2024,10,259355.0,Salary Increases & Fixed Expenses Remain Stable,34786,16213.0,12028,28241.0,6545.0,18.82,0.0,Medium Risk
U687,2024,11,265900.0,Salary Increases & Fixed Expenses Remain Stable,34786,16213.0,11194,27407.0,7379.0,21.21,-0.01,Medium Risk
U687,2024,12,273279.0,Salary Increases & Fixed Expenses Remain Stable,34786,16213.0,12311,28524.0,6262.0,18.0,0.01,Medium Risk
U688,2024,1,217877.0,Stable Salary & Decreasing Fixed Expenses,155130,79189.0,57921,137110.0,18020.0,11.62,-0.03,High Risk
U688,2024,2,235897.0,Stable Salary & Decreasing Fixed Expenses,155130,79189.0,51655,130844.0,24286.0,15.66,0.02,Medium Risk
U688,2024,3,260183.0,Stable Salary & Decreasing Fixed Expenses,155130,79189.0,65261,144450.0,10680.0,6.88,0.04,High Risk
U688,2024,4,270863.0,Stable Salary & Decreasing Fixed Expenses,155130,79189.0,48711,127900.0,27230.0,17.55,0.05,Medium Risk
U688,2024,5,298093.0,Stable Salary & Decreasing Fixed Expenses,155130,79189.0,56585,135774.0,19356.0,12.48,-0.01,High Risk
U688,2024,6,317449.0,Stable Salary & Decreasing Fixed Expenses,155130,79189.0,59599,138788.0,16342.0,10.53,0.04,High Risk
U688,2024,7,333791.0,Stable Salary & Decreasing Fixed Expenses,155130,79189.0,59939,139128.0,16002.0,10.32,-0.0,High Risk
U688,2024,8,349793.0,Stable Salary & Decreasing Fixed Expenses,155130,79189.0,60195,139384.0,15746.0,10.15,-0.01,High Risk
U688,2024,9,365539.0,Stable Salary & Decreasing Fixed Expenses,155130,79189.0,59276,138465.0,16665.0,10.74,0.01,High Risk
U688,2024,10,382204.0,Stable Salary & Decreasing Fixed Expenses,155130,79189.0,64075,143264.0,11866.0,7.65,0.02,High Risk
U688,2024,11,394070.0,Stable Salary & Decreasing Fixed Expenses,155130,79189.0,65979,145168.0,9962.0,6.42,-0.04,High Risk
U688,2024,12,404032.0,Stable Salary & Decreasing Fixed Expenses,155130,79189.0,52820,132009.0,23121.0,14.9,0.02,High Risk
U689,2024,1,241240.0,Stable Salary & Stable Fixed Expenses,60623,39105.0,23398,62503.0,-1880.0,-3.1,0.03,High Risk
U689,2024,2,239360.0,Stable Salary & Stable Fixed Expenses,60623,39105.0,21504,60609.0,14.0,0.02,0.03,High Risk
U689,2024,3,239374.0,Stable Salary & Stable Fixed Expenses,60623,39105.0,25062,64167.0,-3544.0,-5.85,-0.0,High Risk
U689,2024,4,235830.0,Stable Salary & Stable Fixed Expenses,60623,39105.0,20611,59716.0,907.0,1.5,-0.03,High Risk
U689,2024,5,236737.0,Stable Salary & Stable Fixed Expenses,60623,39105.0,21716,60821.0,-198.0,-0.33,0.04,High Risk
U689,2024,6,236539.0,Stable Salary & Stable Fixed Expenses,60623,39105.0,18600,57705.0,2918.0,4.81,-0.0,High Risk
U689,2024,7,239457.0,Stable Salary & Stable Fixed Expenses,60623,39105.0,20986,60091.0,532.0,0.88,0.05,High Risk
U689,2024,8,239989.0,Stable Salary & Stable Fixed Expenses,60623,39105.0,22286,61391.0,-768.0,-1.27,0.05,High Risk
U689,2024,9,239221.0,Stable Salary & Stable Fixed Expenses,60623,39105.0,21992,61097.0,-474.0,-0.78,0.0,High Risk
U689,2024,10,238747.0,Stable Salary & Stable Fixed Expenses,60623,39105.0,23392,62497.0,-1874.0,-3.09,0.03,High Risk
U689,2024,11,236873.0,Stable Salary & Stable Fixed Expenses,60623,39105.0,21921,61026.0,-403.0,-0.66,-0.01,High Risk
U689,2024,12,236470.0,Stable Salary & Stable Fixed Expenses,60623,39105.0,19740,58845.0,1778.0,2.93,0.02,High Risk
U690,2024,1,221963.0,Salary Increases & Fixed Expenses Remain Stable,129167,55477.0,85878,141355.0,-12188.0,-9.44,-0.01,High Risk
U690,2024,2,209775.0,Salary Increases & Fixed Expenses Remain Stable,129167,55477.0,89221,144698.0,-15531.0,-12.02,-0.03,High Risk
U690,2024,3,194244.0,Salary Increases & Fixed Expenses Remain Stable,129167,55477.0,78157,133634.0,-4467.0,-3.46,-0.02,High Risk
U690,2024,4,189777.0,Salary Increases & Fixed Expenses Remain Stable,129167,55477.0,82709,138186.0,-9019.0,-6.98,0.03,High Risk
U690,2024,5,180758.0,Salary Increases & Fixed Expenses Remain Stable,129167,55477.0,97232,152709.0,-23542.0,-18.23,0.02,High Risk
U690,2024,6,157216.0,Salary Increases & Fixed Expenses Remain Stable,129167,55477.0,91491,146968.0,-17801.0,-13.78,0.03,High Risk
U690,2024,7,139415.0,Salary Increases & Fixed Expenses Remain Stable,129167,55477.0,86054,141531.0,-12364.0,-9.57,0.0,High Risk
U690,2024,8,127051.0,Salary Increases & Fixed Expenses Remain Stable,141448,55477.0,105660,161137.0,-19689.0,-13.92,0.02,High Risk
U690,2024,9,107362.0,Salary Increases & Fixed Expenses Remain Stable,141448,55477.0,110593,166070.0,-24622.0,-17.41,-0.03,High Risk
U690,2024,10,82740.0,Salary Increases & Fixed Expenses Remain Stable,141448,55477.0,108265,163742.0,-22294.0,-15.76,0.02,High Risk
U690,2024,11,60446.0,Salary Increases & Fixed Expenses Remain Stable,141448,55477.0,113106,168583.0,-27135.0,-19.18,-0.04,High Risk
U690,2024,12,33311.0,Salary Increases & Fixed Expenses Remain Stable,141448,55477.0,112782,168259.0,-26811.0,-18.95,-0.02,High Risk
U691,2024,1,243792.0,Stable Salary & Increasing Fixed Expenses,181647,75828.0,71337,147165.0,34482.0,18.98,-0.04,Medium Risk
U691,2024,2,278274.0,Stable Salary & Increasing Fixed Expenses,181647,75828.0,68365,144193.0,37454.0,20.62,0.05,Medium Risk
U691,2024,3,315728.0,Stable Salary & Increasing Fixed Expenses,181647,75828.0,76082,151910.0,29737.0,16.37,0.01,Medium Risk
U691,2024,4,345465.0,Stable Salary & Increasing Fixed Expenses,181647,75828.0,66533,142361.0,39286.0,21.63,0.02,Medium Risk
U691,2024,5,384751.0,Stable Salary & Increasing Fixed Expenses,181647,77698.0,64160,141858.0,39789.0,21.9,0.01,Medium Risk
U691,2024,6,424540.0,Stable Salary & Increasing Fixed Expenses,181647,77698.0,60765,138463.0,43184.0,23.77,-0.01,Medium Risk
U691,2024,7,467724.0,Stable Salary & Increasing Fixed Expenses,181647,77698.0,58645,136343.0,45304.0,24.94,0.01,Medium Risk
U691,2024,8,513028.0,Stable Salary & Increasing Fixed Expenses,181647,77698.0,64974,142672.0,38975.0,21.46,-0.05,Medium Risk
U691,2024,9,552003.0,Stable Salary & Increasing Fixed Expenses,181647,77698.0,72363,150061.0,31586.0,17.39,-0.04,Medium Risk
U691,2024,10,583589.0,Stable Salary & Increasing Fixed Expenses,181647,77698.0,75982,153680.0,27967.0,15.4,-0.05,Medium Risk
U691,2024,11,611556.0,Stable Salary & Increasing Fixed Expenses,181647,77698.0,76388,154086.0,27561.0,15.17,0.05,Medium Risk
U691,2024,12,639117.0,Stable Salary & Increasing Fixed Expenses,181647,77698.0,67569,145267.0,36380.0,20.03,0.0,Medium Risk
U692,2024,1,242184.0,Stable Salary & Stable Fixed Expenses,119053,79138.0,88213,167351.0,-48298.0,-40.57,0.02,High Risk
U692,2024,2,193886.0,Stable Salary & Stable Fixed Expenses,119053,79138.0,76486,155624.0,-36571.0,-30.72,-0.03,High Risk
U692,2024,3,157315.0,Stable Salary & Stable Fixed Expenses,119053,79138.0,110859,189997.0,-70944.0,-59.59,-0.03,High Risk
U692,2024,4,86371.0,Stable Salary & Stable Fixed Expenses,119053,79138.0,74001,153139.0,-34086.0,-28.63,0.04,High Risk
U692,2024,5,52285.0,Stable Salary & Stable Fixed Expenses,119053,79138.0,73517,152655.0,-33602.0,-28.22,-0.01,High Risk
U692,2024,6,18683.0,Stable Salary & Stable Fixed Expenses,119053,79138.0,85898,165036.0,-45983.0,-38.62,0.01,High Risk
U692,2024,7,-27300.0,Stable Salary & Stable Fixed Expenses,119053,79138.0,92112,171250.0,-52197.0,-43.84,-0.01,High Risk
U692,2024,8,-79497.0,Stable Salary & Stable Fixed Expenses,119053,79138.0,89453,168591.0,-49538.0,-41.61,-0.04,High Risk
U692,2024,9,-129035.0,Stable Salary & Stable Fixed Expenses,119053,79138.0,95847,174985.0,-55932.0,-46.98,-0.03,High Risk
U692,2024,10,-184967.0,Stable Salary & Stable Fixed Expenses,119053,79138.0,110584,189722.0,-70669.0,-59.36,-0.0,High Risk
U692,2024,11,-255636.0,Stable Salary & Stable Fixed Expenses,119053,79138.0,84776,163914.0,-44861.0,-37.68,-0.05,High Risk
U692,2024,12,-300497.0,Stable Salary & Stable Fixed Expenses,119053,79138.0,114002,193140.0,-74087.0,-62.23,0.04,High Risk
U693,2024,1,245827.0,Stable Salary & Increasing Fixed Expenses,281180,102581.0,214195,316776.0,-35596.0,-12.66,-0.01,High Risk
U693,2024,2,210231.0,Stable Salary & Increasing Fixed Expenses,281180,102581.0,220471,323052.0,-41872.0,-14.89,0.03,High Risk
U693,2024,3,168359.0,Stable Salary & Increasing Fixed Expenses,281180,102581.0,214158,316739.0,-35559.0,-12.65,-0.03,High Risk
U693,2024,4,132800.0,Stable Salary & Increasing Fixed Expenses,281180,102581.0,184762,287343.0,-6163.0,-2.19,0.04,High Risk
U693,2024,5,126637.0,Stable Salary & Increasing Fixed Expenses,281180,103827.0,197590,301417.0,-20237.0,-7.2,0.04,High Risk
U693,2024,6,106400.0,Stable Salary & Increasing Fixed Expenses,281180,103827.0,222009,325836.0,-44656.0,-15.88,-0.04,High Risk
U693,2024,7,61744.0,Stable Salary & Increasing Fixed Expenses,281180,103827.0,169384,273211.0,7969.0,2.83,0.01,High Risk
U693,2024,8,69713.0,Stable Salary & Increasing Fixed Expenses,281180,103827.0,190764,294591.0,-13411.0,-4.77,-0.02,High Risk
U693,2024,9,56302.0,Stable Salary & Increasing Fixed Expenses,281180,105214.0,190625,295839.0,-14659.0,-5.21,0.05,High Risk
U693,2024,10,41643.0,Stable Salary & Increasing Fixed Expenses,281180,105214.0,199417,304631.0,-23451.0,-8.34,-0.0,High Risk
U693,2024,11,18192.0,Stable Salary & Increasing Fixed Expenses,281180,105214.0,193078,298292.0,-17112.0,-6.09,-0.04,High Risk
U693,2024,12,1080.0,Stable Salary & Increasing Fixed Expenses,281180,105214.0,186207,291421.0,-10241.0,-3.64,0.05,High Risk
U694,2024,1,245725.0,Stable Salary & Stable Fixed Expenses,50222,27872.0,24573,52445.0,-2223.0,-4.43,-0.05,High Risk
U694,2024,2,243502.0,Stable Salary & Stable Fixed Expenses,50222,27872.0,29608,57480.0,-7258.0,-14.45,0.05,High Risk
U694,2024,3,236244.0,Stable Salary & Stable Fixed Expenses,50222,27872.0,27812,55684.0,-5462.0,-10.88,-0.04,High Risk
U694,2024,4,230782.0,Stable Salary & Stable Fixed Expenses,50222,27872.0,28278,56150.0,-5928.0,-11.8,-0.03,High Risk
U694,2024,5,224854.0,Stable Salary & Stable Fixed Expenses,50222,27872.0,26345,54217.0,-3995.0,-7.95,-0.01,High Risk
U694,2024,6,220859.0,Stable Salary & Stable Fixed Expenses,50222,27872.0,21586,49458.0,764.0,1.52,-0.04,High Risk
U694,2024,7,221623.0,Stable Salary & Stable Fixed Expenses,50222,27872.0,23274,51146.0,-924.0,-1.84,0.02,High Risk
U694,2024,8,220699.0,Stable Salary & Stable Fixed Expenses,50222,27872.0,21329,49201.0,1021.0,2.03,-0.04,High Risk
U694,2024,9,221720.0,Stable Salary & Stable Fixed Expenses,50222,27872.0,21666,49538.0,684.0,1.36,0.02,High Risk
U694,2024,10,222404.0,Stable Salary & Stable Fixed Expenses,50222,27872.0,29552,57424.0,-7202.0,-14.34,0.03,High Risk
U694,2024,11,215202.0,Stable Salary & Stable Fixed Expenses,50222,27872.0,25881,53753.0,-3531.0,-7.03,0.04,High Risk
U694,2024,12,211671.0,Stable Salary & Stable Fixed Expenses,50222,27872.0,24805,52677.0,-2455.0,-4.89,0.03,High Risk
U695,2024,1,212270.0,Salary Increases & Fixed Expenses Remain Stable,82687,37787.0,40068,77855.0,4832.0,5.84,0.03,High Risk
U695,2024,2,217102.0,Salary Increases & Fixed Expenses Remain Stable,82687,37787.0,40273,78060.0,4627.0,5.6,-0.02,High Risk
U695,2024,3,221729.0,Salary Increases & Fixed Expenses Remain Stable,82687,37787.0,47398,85185.0,-2498.0,-3.02,-0.03,High Risk
U695,2024,4,219231.0,Salary Increases & Fixed Expenses Remain Stable,82687,37787.0,36271,74058.0,8629.0,10.44,0.04,High Risk
U695,2024,5,227860.0,Salary Increases & Fixed Expenses Remain Stable,82687,37787.0,41683,79470.0,3217.0,3.89,0.0,High Risk
U695,2024,6,231077.0,Salary Increases & Fixed Expenses Remain Stable,82687,37787.0,37218,75005.0,7682.0,9.29,-0.03,High Risk
U695,2024,7,238759.0,Salary Increases & Fixed Expenses Remain Stable,82687,37787.0,39640,77427.0,5260.0,6.36,-0.05,High Risk
U695,2024,8,244019.0,Salary Increases & Fixed Expenses Remain Stable,96353,37787.0,45932,83719.0,12634.0,13.11,-0.03,High Risk
U695,2024,9,256653.0,Salary Increases & Fixed Expenses Remain Stable,96353,37787.0,51267,89054.0,7299.0,7.58,0.03,High Risk
U695,2024,10,263952.0,Salary Increases & Fixed Expenses Remain Stable,96353,37787.0,40332,78119.0,18234.0,18.92,0.05,Medium Risk
U695,2024,11,282186.0,Salary Increases & Fixed Expenses Remain Stable,96353,37787.0,42669,80456.0,15897.0,16.5,-0.04,Medium Risk
U695,2024,12,298083.0,Salary Increases & Fixed Expenses Remain Stable,96353,37787.0,44926,82713.0,13640.0,14.16,0.01,High Risk
U696,2024,1,223923.0,Stable Salary & Stable Fixed Expenses,221725,114201.0,151880,266081.0,-44356.0,-20.0,0.01,High Risk
U696,2024,2,179567.0,Stable Salary & Stable Fixed Expenses,221725,114201.0,170617,284818.0,-63093.0,-28.46,0.0,High Risk
U696,2024,3,116474.0,Stable Salary & Stable Fixed Expenses,221725,114201.0,156167,270368.0,-48643.0,-21.94,-0.02,High Risk
U696,2024,4,67831.0,Stable Salary & Stable Fixed Expenses,221725,114201.0,135519,249720.0,-27995.0,-12.63,0.05,High Risk
U696,2024,5,39836.0,Stable Salary & Stable Fixed Expenses,221725,114201.0,170291,284492.0,-62767.0,-28.31,-0.03,High Risk
U696,2024,6,-22931.0,Stable Salary & Stable Fixed Expenses,221725,114201.0,151009,265210.0,-43485.0,-19.61,0.03,High Risk
U696,2024,7,-66416.0,Stable Salary & Stable Fixed Expenses,221725,114201.0,148090,262291.0,-40566.0,-18.3,-0.03,High Risk
U696,2024,8,-106982.0,Stable Salary & Stable Fixed Expenses,221725,114201.0,144737,258938.0,-37213.0,-16.78,-0.02,High Risk
U696,2024,9,-144195.0,Stable Salary & Stable Fixed Expenses,221725,114201.0,154659,268860.0,-47135.0,-21.26,0.05,High Risk
U696,2024,10,-191330.0,Stable Salary & Stable Fixed Expenses,221725,114201.0,172269,286470.0,-64745.0,-29.2,0.01,High Risk
U696,2024,11,-256075.0,Stable Salary & Stable Fixed Expenses,221725,114201.0,150959,265160.0,-43435.0,-19.59,0.05,High Risk
U696,2024,12,-299510.0,Stable Salary & Stable Fixed Expenses,221725,114201.0,166123,280324.0,-58599.0,-26.43,-0.01,High Risk
U697,2024,1,207778.0,Stable Salary & Stable Fixed Expenses,67678,27090.0,33862,60952.0,6726.0,9.94,-0.01,High Risk
U697,2024,2,214504.0,Stable Salary & Stable Fixed Expenses,67678,27090.0,38127,65217.0,2461.0,3.64,-0.01,High Risk
U697,2024,3,216965.0,Stable Salary & Stable Fixed Expenses,67678,27090.0,35146,62236.0,5442.0,8.04,-0.03,High Risk
U697,2024,4,222407.0,Stable Salary & Stable Fixed Expenses,67678,27090.0,28036,55126.0,12552.0,18.55,0.04,Medium Risk
U697,2024,5,234959.0,Stable Salary & Stable Fixed Expenses,67678,27090.0,35431,62521.0,5157.0,7.62,-0.02,High Risk
U697,2024,6,240116.0,Stable Salary & Stable Fixed Expenses,67678,27090.0,35973,63063.0,4615.0,6.82,0.01,High Risk
U697,2024,7,244731.0,Stable Salary & Stable Fixed Expenses,67678,27090.0,29647,56737.0,10941.0,16.17,-0.01,Medium Risk
U697,2024,8,255672.0,Stable Salary & Stable Fixed Expenses,67678,27090.0,28714,55804.0,11874.0,17.54,-0.05,Medium Risk
U697,2024,9,267546.0,Stable Salary & Stable Fixed Expenses,67678,27090.0,36473,63563.0,4115.0,6.08,-0.03,High Risk
U697,2024,10,271661.0,Stable Salary & Stable Fixed Expenses,67678,27090.0,34081,61171.0,6507.0,9.61,-0.03,High Risk
U697,2024,11,278168.0,Stable Salary & Stable Fixed Expenses,67678,27090.0,32453,59543.0,8135.0,12.02,-0.01,High Risk
U697,2024,12,286303.0,Stable Salary & Stable Fixed Expenses,67678,27090.0,28167,55257.0,12421.0,18.35,0.05,Medium Risk
U698,2024,1,219907.0,Salary Increases & Fixed Expenses Remain Stable,64847,33705.0,40251,73956.0,-9109.0,-14.05,0.05,High Risk
U698,2024,2,210798.0,Salary Increases & Fixed Expenses Remain Stable,64847,33705.0,49086,82791.0,-17944.0,-27.67,0.05,High Risk
U698,2024,3,192854.0,Salary Increases & Fixed Expenses Remain Stable,64847,33705.0,47420,81125.0,-16278.0,-25.1,0.03,High Risk
U698,2024,4,176576.0,Salary Increases & Fixed Expenses Remain Stable,64847,33705.0,40145,73850.0,-9003.0,-13.88,-0.03,High Risk
U698,2024,5,167573.0,Salary Increases & Fixed Expenses Remain Stable,78779,33705.0,48141,81846.0,-3067.0,-3.89,0.04,High Risk
U698,2024,6,164506.0,Salary Increases & Fixed Expenses Remain Stable,78779,33705.0,52567,86272.0,-7493.0,-9.51,0.03,High Risk
U698,2024,7,157013.0,Salary Increases & Fixed Expenses Remain Stable,78779,33705.0,47705,81410.0,-2631.0,-3.34,-0.03,High Risk
U698,2024,8,154382.0,Salary Increases & Fixed Expenses Remain Stable,78779,33705.0,47316,81021.0,-2242.0,-2.85,-0.01,High Risk
U698,2024,9,152140.0,Salary Increases & Fixed Expenses Remain Stable,78779,33705.0,54372,88077.0,-9298.0,-11.8,-0.03,High Risk
U698,2024,10,142842.0,Salary Increases & Fixed Expenses Remain Stable,78779,33705.0,48674,82379.0,-3600.0,-4.57,0.04,High Risk
U698,2024,11,139242.0,Salary Increases & Fixed Expenses Remain Stable,78779,33705.0,58915,92620.0,-13841.0,-17.57,0.03,High Risk
U698,2024,12,125401.0,Salary Increases & Fixed Expenses Remain Stable,78779,33705.0,48748,82453.0,-3674.0,-4.66,0.05,High Risk
U699,2024,1,230547.0,Salary Increases & Fixed Expenses Remain Stable,51303,38988.0,17332,56320.0,-5017.0,-9.78,-0.01,High Risk
U699,2024,2,225530.0,Salary Increases & Fixed Expenses Remain Stable,51303,38988.0,15834,54822.0,-3519.0,-6.86,-0.01,High Risk
U699,2024,3,222011.0,Salary Increases & Fixed Expenses Remain Stable,51303,38988.0,24999,63987.0,-12684.0,-24.72,-0.03,High Risk
U699,2024,4,209327.0,Salary Increases & Fixed Expenses Remain Stable,71377,38988.0,24183,63171.0,8206.0,11.5,0.02,High Risk
U699,2024,5,217533.0,Salary Increases & Fixed Expenses Remain Stable,71377,38988.0,23229,62217.0,9160.0,12.83,0.03,High Risk
U699,2024,6,226693.0,Salary Increases & Fixed Expenses Remain Stable,71377,38988.0,24920,63908.0,7469.0,10.46,0.01,High Risk
U699,2024,7,234162.0,Salary Increases & Fixed Expenses Remain Stable,71377,38988.0,24244,63232.0,8145.0,11.41,-0.02,High Risk
U699,2024,8,242307.0,Salary Increases & Fixed Expenses Remain Stable,71377,38988.0,22116,61104.0,10273.0,14.39,-0.04,High Risk
U699,2024,9,252580.0,Salary Increases & Fixed Expenses Remain Stable,71377,38988.0,30646,69634.0,1743.0,2.44,-0.05,High Risk
U699,2024,10,254323.0,Salary Increases & Fixed Expenses Remain Stable,71377,38988.0,24959,63947.0,7430.0,10.41,0.04,High Risk
U699,2024,11,261753.0,Salary Increases & Fixed Expenses Remain Stable,71377,38988.0,25749,64737.0,6640.0,9.3,0.02,High Risk
U699,2024,12,268393.0,Salary Increases & Fixed Expenses Remain Stable,71377,38988.0,29306,68294.0,3083.0,4.32,0.02,High Risk
U700,2024,1,216755.0,Salary Increases & Fixed Expenses Remain Stable,287418,111072.0,151267,262339.0,25079.0,8.73,-0.05,High Risk
U700,2024,2,241834.0,Salary Increases & Fixed Expenses Remain Stable,287418,111072.0,148784,259856.0,27562.0,9.59,-0.03,High Risk
U700,2024,3,269396.0,Salary Increases & Fixed Expenses Remain Stable,296022,111072.0,157389,268461.0,27561.0,9.31,-0.02,High Risk
U700,2024,4,296957.0,Salary Increases & Fixed Expenses Remain Stable,296022,111072.0,159184,270256.0,25766.0,8.7,0.04,High Risk
U700,2024,5,322723.0,Salary Increases & Fixed Expenses Remain Stable,296022,111072.0,166791,277863.0,18159.0,6.13,-0.03,High Risk
U700,2024,6,340882.0,Salary Increases & Fixed Expenses Remain Stable,296022,111072.0,172581,283653.0,12369.0,4.18,-0.02,High Risk
U700,2024,7,353251.0,Salary Increases & Fixed Expenses Remain Stable,296022,111072.0,168939,280011.0,16011.0,5.41,-0.03,High Risk
U700,2024,8,369262.0,Salary Increases & Fixed Expenses Remain Stable,296022,111072.0,164292,275364.0,20658.0,6.98,0.01,High Risk
U700,2024,9,389920.0,Salary Increases & Fixed Expenses Remain Stable,296022,111072.0,137499,248571.0,47451.0,16.03,-0.01,Medium Risk
U700,2024,10,437371.0,Salary Increases & Fixed Expenses Remain Stable,296022,111072.0,156999,268071.0,27951.0,9.44,-0.02,High Risk
U700,2024,11,465322.0,Salary Increases & Fixed Expenses Remain Stable,296022,111072.0,133242,244314.0,51708.0,17.47,0.0,Medium Risk
U700,2024,12,517030.0,Salary Increases & Fixed Expenses Remain Stable,296022,111072.0,133396,244468.0,51554.0,17.42,-0.03,Medium Risk
U701,2024,1,240514.0,Stable Salary & Increasing Fixed Expenses,279028,116005.0,146179,262184.0,16844.0,6.04,-0.03,High Risk
U701,2024,2,257358.0,Stable Salary & Increasing Fixed Expenses,279028,117363.0,126611,243974.0,35054.0,12.56,-0.01,High Risk
U701,2024,3,292412.0,Stable Salary & Increasing Fixed Expenses,279028,117363.0,145053,262416.0,16612.0,5.95,0.05,High Risk
U701,2024,4,309024.0,Stable Salary & Increasing Fixed Expenses,279028,117363.0,166379,283742.0,-4714.0,-1.69,-0.04,High Risk
U701,2024,5,304310.0,Stable Salary & Increasing Fixed Expenses,279028,117363.0,124973,242336.0,36692.0,13.15,0.04,High Risk
U701,2024,6,341002.0,Stable Salary & Increasing Fixed Expenses,279028,117363.0,128487,245850.0,33178.0,11.89,0.0,High Risk
U701,2024,7,374180.0,Stable Salary & Increasing Fixed Expenses,279028,117363.0,157437,274800.0,4228.0,1.52,0.02,High Risk
U701,2024,8,378408.0,Stable Salary & Increasing Fixed Expenses,279028,117363.0,116250,233613.0,45415.0,16.28,-0.03,Medium Risk
U701,2024,9,423823.0,Stable Salary & Increasing Fixed Expenses,279028,117363.0,157149,274512.0,4516.0,1.62,0.04,High Risk
U701,2024,10,428339.0,Stable Salary & Increasing Fixed Expenses,279028,117363.0,143022,260385.0,18643.0,6.68,-0.02,High Risk
U701,2024,11,446982.0,Stable Salary & Increasing Fixed Expenses,279028,117363.0,163230,280593.0,-1565.0,-0.56,0.01,High Risk
U701,2024,12,445417.0,Stable Salary & Increasing Fixed Expenses,279028,117363.0,143482,260845.0,18183.0,6.52,-0.04,High Risk
U702,2024,1,248734.0,Stable Salary & Stable Fixed Expenses,242493,85531.0,97195,182726.0,59767.0,24.65,0.0,Medium Risk
U702,2024,2,308501.0,Stable Salary & Stable Fixed Expenses,242493,85531.0,105569,191100.0,51393.0,21.19,-0.03,Medium Risk
U702,2024,3,359894.0,Stable Salary & Stable Fixed Expenses,242493,85531.0,128192,213723.0,28770.0,11.86,-0.03,High Risk
U702,2024,4,388664.0,Stable Salary & Stable Fixed Expenses,242493,85531.0,138773,224304.0,18189.0,7.5,-0.04,High Risk
U702,2024,5,406853.0,Stable Salary & Stable Fixed Expenses,242493,85531.0,144379,229910.0,12583.0,5.19,-0.01,High Risk
U702,2024,6,419436.0,Stable Salary & Stable Fixed Expenses,242493,85531.0,142337,227868.0,14625.0,6.03,-0.01,High Risk
U702,2024,7,434061.0,Stable Salary & Stable Fixed Expenses,242493,85531.0,141509,227040.0,15453.0,6.37,0.03,High Risk
U702,2024,8,449514.0,Stable Salary & Stable Fixed Expenses,242493,85531.0,104891,190422.0,52071.0,21.47,0.0,Medium Risk
U702,2024,9,501585.0,Stable Salary & Stable Fixed Expenses,242493,85531.0,129398,214929.0,27564.0,11.37,0.04,High Risk
U702,2024,10,529149.0,Stable Salary & Stable Fixed Expenses,242493,85531.0,113302,198833.0,43660.0,18.0,-0.04,Medium Risk
U702,2024,11,572809.0,Stable Salary & Stable Fixed Expenses,242493,85531.0,109465,194996.0,47497.0,19.59,0.02,Medium Risk
U702,2024,12,620306.0,Stable Salary & Stable Fixed Expenses,242493,85531.0,130380,215911.0,26582.0,10.96,0.01,High Risk
U703,2024,1,240849.0,Salary Increases & Fixed Expenses Remain Stable,180396,79292.0,64419,143711.0,36685.0,20.34,0.04,Medium Risk
U703,2024,2,277534.0,Salary Increases & Fixed Expenses Remain Stable,180396,79292.0,61877,141169.0,39227.0,21.74,-0.02,Medium Risk
U703,2024,3,316761.0,Salary Increases & Fixed Expenses Remain Stable,180396,79292.0,71893,151185.0,29211.0,16.19,0.05,Medium Risk
U703,2024,4,345972.0,Salary Increases & Fixed Expenses Remain Stable,180396,79292.0,57580,136872.0,43524.0,24.13,0.05,Medium Risk
U703,2024,5,389496.0,Salary Increases & Fixed Expenses Remain Stable,207707,79292.0,81269,160561.0,47146.0,22.7,-0.02,Medium Risk
U703,2024,6,436642.0,Salary Increases & Fixed Expenses Remain Stable,207707,79292.0,82681,161973.0,45734.0,22.02,0.01,Medium Risk
U703,2024,7,482376.0,Salary Increases & Fixed Expenses Remain Stable,207707,79292.0,70410,149702.0,58005.0,27.93,0.04,Low Risk
U703,2024,8,540381.0,Salary Increases & Fixed Expenses Remain Stable,207707,79292.0,75032,154324.0,53383.0,25.7,0.03,Low Risk
U703,2024,9,593764.0,Salary Increases & Fixed Expenses Remain Stable,207707,79292.0,65403,144695.0,63012.0,30.34,0.01,Low Risk
U703,2024,10,656776.0,Salary Increases & Fixed Expenses Remain Stable,207707,79292.0,80256,159548.0,48159.0,23.19,0.0,Medium Risk
U703,2024,11,704935.0,Salary Increases & Fixed Expenses Remain Stable,207707,79292.0,69497,148789.0,58918.0,28.37,0.03,Low Risk
U703,2024,12,763853.0,Salary Increases & Fixed Expenses Remain Stable,207707,79292.0,80529,159821.0,47886.0,23.05,0.04,Medium Risk
U704,2024,1,241726.0,Stable Salary & Increasing Fixed Expenses,58778,23849.0,33241,57090.0,1688.0,2.87,0.03,High Risk
U704,2024,2,243414.0,Stable Salary & Increasing Fixed Expenses,58778,25398.0,26961,52359.0,6419.0,10.92,-0.03,High Risk
U704,2024,3,249833.0,Stable Salary & Increasing Fixed Expenses,58778,25398.0,28399,53797.0,4981.0,8.47,-0.03,High Risk
U704,2024,4,254814.0,Stable Salary & Increasing Fixed Expenses,58778,25398.0,28551,53949.0,4829.0,8.22,0.02,High Risk
U704,2024,5,259643.0,Stable Salary & Increasing Fixed Expenses,58778,25398.0,33207,58605.0,173.0,0.29,0.02,High Risk
U704,2024,6,259816.0,Stable Salary & Increasing Fixed Expenses,58778,25398.0,35185,60583.0,-1805.0,-3.07,-0.04,High Risk
U704,2024,7,258011.0,Stable Salary & Increasing Fixed Expenses,58778,25398.0,32244,57642.0,1136.0,1.93,-0.03,High Risk
U704,2024,8,259147.0,Stable Salary & Increasing Fixed Expenses,58778,25398.0,27014,52412.0,6366.0,10.83,-0.02,High Risk
U704,2024,9,265513.0,Stable Salary & Increasing Fixed Expenses,58778,25398.0,23644,49042.0,9736.0,16.56,-0.03,Medium Risk
U704,2024,10,275249.0,Stable Salary & Increasing Fixed Expenses,58778,25398.0,26349,51747.0,7031.0,11.96,0.01,High Risk
U704,2024,11,282280.0,Stable Salary & Increasing Fixed Expenses,58778,27186.0,29770,56956.0,1822.0,3.1,0.03,High Risk
U704,2024,12,284102.0,Stable Salary & Increasing Fixed Expenses,58778,27186.0,25398,52584.0,6194.0,10.54,-0.03,High Risk
U705,2024,1,208035.0,Salary Increases & Fixed Expenses Remain Stable,286416,74967.0,149211,224178.0,62238.0,21.73,-0.02,Medium Risk
U705,2024,2,270273.0,Salary Increases & Fixed Expenses Remain Stable,286416,74967.0,167517,242484.0,43932.0,15.34,-0.01,Medium Risk
U705,2024,3,314205.0,Salary Increases & Fixed Expenses Remain Stable,286416,74967.0,145721,220688.0,65728.0,22.95,0.02,Medium Risk
U705,2024,4,379933.0,Salary Increases & Fixed Expenses Remain Stable,286416,74967.0,123936,198903.0,87513.0,30.55,-0.04,Low Risk
U705,2024,5,467446.0,Salary Increases & Fixed Expenses Remain Stable,303619,74967.0,181338,256305.0,47314.0,15.58,0.0,Medium Risk
U705,2024,6,514760.0,Salary Increases & Fixed Expenses Remain Stable,303619,74967.0,172508,247475.0,56144.0,18.49,0.0,Medium Risk
U705,2024,7,570904.0,Salary Increases & Fixed Expenses Remain Stable,303619,74967.0,136200,211167.0,92452.0,30.45,0.03,Low Risk
U705,2024,8,663356.0,Salary Increases & Fixed Expenses Remain Stable,303619,74967.0,174345,249312.0,54307.0,17.89,0.01,Medium Risk
U705,2024,9,717663.0,Salary Increases & Fixed Expenses Remain Stable,303619,74967.0,135741,210708.0,92911.0,30.6,-0.05,Low Risk
U705,2024,10,810574.0,Salary Increases & Fixed Expenses Remain Stable,303619,74967.0,163671,238638.0,64981.0,21.4,-0.05,Medium Risk
U705,2024,11,875555.0,Salary Increases & Fixed Expenses Remain Stable,303619,74967.0,160698,235665.0,67954.0,22.38,0.03,Medium Risk
U705,2024,12,943509.0,Salary Increases & Fixed Expenses Remain Stable,303619,74967.0,128407,203374.0,100245.0,33.02,-0.03,Low Risk
U706,2024,1,243736.0,Salary Increases & Fixed Expenses Increase,224653,85211.0,112231,197442.0,27211.0,12.11,0.02,High Risk
U706,2024,2,270947.0,Salary Increases & Fixed Expenses Increase,224653,85211.0,124310,209521.0,15132.0,6.74,-0.04,High Risk
U706,2024,3,286079.0,Salary Increases & Fixed Expenses Increase,224653,85211.0,158086,243297.0,-18644.0,-8.3,0.01,High Risk
U706,2024,4,267435.0,Salary Increases & Fixed Expenses Increase,224653,86772.0,107274,194046.0,30607.0,13.62,0.01,High Risk
U706,2024,5,298042.0,Salary Increases & Fixed Expenses Increase,224653,86772.0,120129,206901.0,17752.0,7.9,-0.01,High Risk
U706,2024,6,315794.0,Salary Increases & Fixed Expenses Increase,224653,86772.0,100360,187132.0,37521.0,16.7,0.03,Medium Risk
U706,2024,7,353315.0,Salary Increases & Fixed Expenses Increase,252568,86772.0,134453,221225.0,31343.0,12.41,-0.04,High Risk
U706,2024,8,384658.0,Salary Increases & Fixed Expenses Increase,252568,86772.0,120790,207562.0,45006.0,17.82,-0.02,Medium Risk
U706,2024,9,429664.0,Salary Increases & Fixed Expenses Increase,252568,86772.0,146210,232982.0,19586.0,7.75,0.02,High Risk
U706,2024,10,449250.0,Salary Increases & Fixed Expenses Increase,252568,86772.0,176981,263753.0,-11185.0,-4.43,0.03,High Risk
U706,2024,11,438065.0,Salary Increases & Fixed Expenses Increase,252568,86772.0,133579,220351.0,32217.0,12.76,-0.04,High Risk
U706,2024,12,470282.0,Salary Increases & Fixed Expenses Increase,252568,86772.0,186433,273205.0,-20637.0,-8.17,-0.0,High Risk
U707,2024,1,221281.0,Stable Salary & Stable Fixed Expenses,77988,31055.0,27185,58240.0,19748.0,25.32,-0.04,Low Risk
U707,2024,2,241029.0,Stable Salary & Stable Fixed Expenses,77988,31055.0,29028,60083.0,17905.0,22.96,-0.03,Medium Risk
U707,2024,3,258934.0,Stable Salary & Stable Fixed Expenses,77988,31055.0,30496,61551.0,16437.0,21.08,-0.05,Medium Risk
U707,2024,4,275371.0,Stable Salary & Stable Fixed Expenses,77988,31055.0,29860,60915.0,17073.0,21.89,0.04,Medium Risk
U707,2024,5,292444.0,Stable Salary & Stable Fixed Expenses,77988,31055.0,27327,58382.0,19606.0,25.14,0.0,Low Risk
U707,2024,6,312050.0,Stable Salary & Stable Fixed Expenses,77988,31055.0,25960,57015.0,20973.0,26.89,-0.04,Low Risk
U707,2024,7,333023.0,Stable Salary & Stable Fixed Expenses,77988,31055.0,29921,60976.0,17012.0,21.81,-0.02,Medium Risk
U707,2024,8,350035.0,Stable Salary & Stable Fixed Expenses,77988,31055.0,30283,61338.0,16650.0,21.35,-0.03,Medium Risk
U707,2024,9,366685.0,Stable Salary & Stable Fixed Expenses,77988,31055.0,25913,56968.0,21020.0,26.95,-0.01,Low Risk
U707,2024,10,387705.0,Stable Salary & Stable Fixed Expenses,77988,31055.0,28714,59769.0,18219.0,23.36,-0.04,Medium Risk
U707,2024,11,405924.0,Stable Salary & Stable Fixed Expenses,77988,31055.0,25663,56718.0,21270.0,27.27,-0.01,Low Risk
U707,2024,12,427194.0,Stable Salary & Stable Fixed Expenses,77988,31055.0,26932,57987.0,20001.0,25.65,-0.01,Low Risk
U708,2024,1,200443.0,Stable Salary & Stable Fixed Expenses,292593,103041.0,127380,230421.0,62172.0,21.25,-0.03,Medium Risk
U708,2024,2,262615.0,Stable Salary & Stable Fixed Expenses,292593,103041.0,138823,241864.0,50729.0,17.34,-0.02,Medium Risk
U708,2024,3,313344.0,Stable Salary & Stable Fixed Expenses,292593,103041.0,172292,275333.0,17260.0,5.9,0.04,High Risk
U708,2024,4,330604.0,Stable Salary & Stable Fixed Expenses,292593,103041.0,149585,252626.0,39967.0,13.66,0.02,High Risk
U708,2024,5,370571.0,Stable Salary & Stable Fixed Expenses,292593,103041.0,155984,259025.0,33568.0,11.47,-0.05,High Risk
U708,2024,6,404139.0,Stable Salary & Stable Fixed Expenses,292593,103041.0,152449,255490.0,37103.0,12.68,0.03,High Risk
U708,2024,7,441242.0,Stable Salary & Stable Fixed Expenses,292593,103041.0,159368,262409.0,30184.0,10.32,0.03,High Risk
U708,2024,8,471426.0,Stable Salary & Stable Fixed Expenses,292593,103041.0,175073,278114.0,14479.0,4.95,-0.02,High Risk
U708,2024,9,485905.0,Stable Salary & Stable Fixed Expenses,292593,103041.0,157087,260128.0,32465.0,11.1,0.03,High Risk
U708,2024,10,518370.0,Stable Salary & Stable Fixed Expenses,292593,103041.0,188738,291779.0,814.0,0.28,-0.01,High Risk
U708,2024,11,519184.0,Stable Salary & Stable Fixed Expenses,292593,103041.0,159925,262966.0,29627.0,10.13,0.04,High Risk
U708,2024,12,548811.0,Stable Salary & Stable Fixed Expenses,292593,103041.0,171012,274053.0,18540.0,6.34,0.02,High Risk
U709,2024,1,214389.0,Stable Salary & Decreasing Fixed Expenses,130956,48511.0,67835,116346.0,14610.0,11.16,-0.03,High Risk
U709,2024,2,228999.0,Stable Salary & Decreasing Fixed Expenses,130956,48511.0,53567,102078.0,28878.0,22.05,-0.01,Medium Risk
U709,2024,3,257877.0,Stable Salary & Decreasing Fixed Expenses,130956,48511.0,68211,116722.0,14234.0,10.87,-0.02,High Risk
U709,2024,4,272111.0,Stable Salary & Decreasing Fixed Expenses,130956,48511.0,57574,106085.0,24871.0,18.99,-0.05,Medium Risk
U709,2024,5,296982.0,Stable Salary & Decreasing Fixed Expenses,130956,48511.0,56910,105421.0,25535.0,19.5,-0.03,Medium Risk
U709,2024,6,322517.0,Stable Salary & Decreasing Fixed Expenses,130956,48511.0,75484,123995.0,6961.0,5.32,0.05,High Risk
U709,2024,7,329478.0,Stable Salary & Decreasing Fixed Expenses,130956,48511.0,57182,105693.0,25263.0,19.29,0.05,Medium Risk
U709,2024,8,354741.0,Stable Salary & Decreasing Fixed Expenses,130956,48511.0,61611,110122.0,20834.0,15.91,0.02,Medium Risk
U709,2024,9,375575.0,Stable Salary & Decreasing Fixed Expenses,130956,48511.0,64913,113424.0,17532.0,13.39,0.03,High Risk
U709,2024,10,393107.0,Stable Salary & Decreasing Fixed Expenses,130956,48511.0,71504,120015.0,10941.0,8.35,0.04,High Risk
U709,2024,11,404048.0,Stable Salary & Decreasing Fixed Expenses,130956,48511.0,71680,120191.0,10765.0,8.22,-0.02,High Risk
U709,2024,12,414813.0,Stable Salary & Decreasing Fixed Expenses,130956,48511.0,70430,118941.0,12015.0,9.17,0.03,High Risk
U710,2024,1,236981.0,Stable Salary & Stable Fixed Expenses,287979,69054.0,101491,170545.0,117434.0,40.78,-0.01,Low Risk
U710,2024,2,354415.0,Stable Salary & Stable Fixed Expenses,287979,69054.0,96328,165382.0,122597.0,42.57,-0.04,Low Risk
U710,2024,3,477012.0,Stable Salary & Stable Fixed Expenses,287979,69054.0,103969,173023.0,114956.0,39.92,-0.01,Low Risk
U710,2024,4,591968.0,Stable Salary & Stable Fixed Expenses,287979,69054.0,108514,177568.0,110411.0,38.34,0.01,Low Risk
U710,2024,5,702379.0,Stable Salary & Stable Fixed Expenses,287979,69054.0,106518,175572.0,112407.0,39.03,-0.0,Low Risk
U710,2024,6,814786.0,Stable Salary & Stable Fixed Expenses,287979,69054.0,98062,167116.0,120863.0,41.97,-0.03,Low Risk
U710,2024,7,935649.0,Stable Salary & Stable Fixed Expenses,287979,69054.0,113581,182635.0,105344.0,36.58,0.02,Low Risk
U710,2024,8,1040993.0,Stable Salary & Stable Fixed Expenses,287979,69054.0,94399,163453.0,124526.0,43.24,-0.04,Low Risk
U710,2024,9,1165519.0,Stable Salary & Stable Fixed Expenses,287979,69054.0,112619,181673.0,106306.0,36.91,-0.03,Low Risk
U710,2024,10,1271825.0,Stable Salary & Stable Fixed Expenses,287979,69054.0,133911,202965.0,85014.0,29.52,0.05,Low Risk
U710,2024,11,1356839.0,Stable Salary & Stable Fixed Expenses,287979,69054.0,109220,178274.0,109705.0,38.09,-0.04,Low Risk
U710,2024,12,1466544.0,Stable Salary & Stable Fixed Expenses,287979,69054.0,100090,169144.0,118835.0,41.27,0.05,Low Risk
U711,2024,1,219342.0,Salary Increases & Fixed Expenses Remain Stable,158481,61504.0,65112,126616.0,31865.0,20.11,0.01,Medium Risk
U711,2024,2,251207.0,Salary Increases & Fixed Expenses Remain Stable,158481,61504.0,69861,131365.0,27116.0,17.11,-0.01,Medium Risk
U711,2024,3,278323.0,Salary Increases & Fixed Expenses Remain Stable,165995,61504.0,73765,135269.0,30726.0,18.51,0.0,Medium Risk
U711,2024,4,309049.0,Salary Increases & Fixed Expenses Remain Stable,165995,61504.0,69132,130636.0,35359.0,21.3,0.0,Medium Risk
U711,2024,5,344408.0,Salary Increases & Fixed Expenses Remain Stable,165995,61504.0,84355,145859.0,20136.0,12.13,-0.03,High Risk
U711,2024,6,364544.0,Salary Increases & Fixed Expenses Remain Stable,165995,61504.0,77809,139313.0,26682.0,16.07,-0.03,Medium Risk
U711,2024,7,391226.0,Salary Increases & Fixed Expenses Remain Stable,165995,61504.0,83181,144685.0,21310.0,12.84,0.01,High Risk
U711,2024,8,412536.0,Salary Increases & Fixed Expenses Remain Stable,165995,61504.0,87555,149059.0,16936.0,10.2,-0.0,High Risk
U711,2024,9,429472.0,Salary Increases & Fixed Expenses Remain Stable,165995,61504.0,71085,132589.0,33406.0,20.12,0.05,Medium Risk
U711,2024,10,462878.0,Salary Increases & Fixed Expenses Remain Stable,165995,61504.0,75116,136620.0,29375.0,17.7,0.01,Medium Risk
U711,2024,11,492253.0,Salary Increases & Fixed Expenses Remain Stable,165995,61504.0,70994,132498.0,33497.0,20.18,-0.02,Medium Risk
U711,2024,12,525750.0,Salary Increases & Fixed Expenses Remain Stable,165995,61504.0,67012,128516.0,37479.0,22.58,-0.02,Medium Risk
U712,2024,1,218107.0,Salary Increases & Fixed Expenses Remain Stable,191265,61041.0,77234,138275.0,52990.0,27.71,0.03,Low Risk
U712,2024,2,271097.0,Salary Increases & Fixed Expenses Remain Stable,191265,61041.0,80083,141124.0,50141.0,26.22,0.0,Low Risk
U712,2024,3,321238.0,Salary Increases & Fixed Expenses Remain Stable,191265,61041.0,119973,181014.0,10251.0,5.36,0.01,High Risk
U712,2024,4,331489.0,Salary Increases & Fixed Expenses Remain Stable,191265,61041.0,112621,173662.0,17603.0,9.2,-0.03,High Risk
U712,2024,5,349092.0,Salary Increases & Fixed Expenses Remain Stable,191265,61041.0,108702,169743.0,21522.0,11.25,-0.01,High Risk
U712,2024,6,370614.0,Salary Increases & Fixed Expenses Remain Stable,191265,61041.0,96792,157833.0,33432.0,17.48,-0.03,Medium Risk
U712,2024,7,404046.0,Salary Increases & Fixed Expenses Remain Stable,191265,61041.0,94570,155611.0,35654.0,18.64,-0.03,Medium Risk
U712,2024,8,439700.0,Salary Increases & Fixed Expenses Remain Stable,204990,61041.0,97650,158691.0,46299.0,22.59,-0.0,Medium Risk
U712,2024,9,485999.0,Salary Increases & Fixed Expenses Remain Stable,204990,61041.0,139492,200533.0,4457.0,2.17,0.05,High Risk
U712,2024,10,490456.0,Salary Increases & Fixed Expenses Remain Stable,204990,61041.0,127821,188862.0,16128.0,7.87,-0.0,High Risk
U712,2024,11,506584.0,Salary Increases & Fixed Expenses Remain Stable,204990,61041.0,113352,174393.0,30597.0,14.93,-0.01,High Risk
U712,2024,12,537181.0,Salary Increases & Fixed Expenses Remain Stable,204990,61041.0,128798,189839.0,15151.0,7.39,0.03,High Risk
U713,2024,1,247686.0,Salary Increases & Fixed Expenses Remain Stable,178428,59715.0,65727,125442.0,52986.0,29.7,0.02,Low Risk
U713,2024,2,300672.0,Salary Increases & Fixed Expenses Remain Stable,178428,59715.0,65164,124879.0,53549.0,30.01,0.02,Low Risk
U713,2024,3,354221.0,Salary Increases & Fixed Expenses Remain Stable,178428,59715.0,70664,130379.0,48049.0,26.93,-0.02,Low Risk
U713,2024,4,402270.0,Salary Increases & Fixed Expenses Remain Stable,178428,59715.0,59448,119163.0,59265.0,33.22,0.04,Low Risk
U713,2024,5,461535.0,Salary Increases & Fixed Expenses Remain Stable,178428,59715.0,55329,115044.0,63384.0,35.52,-0.02,Low Risk
U713,2024,6,524919.0,Salary Increases & Fixed Expenses Remain Stable,178428,59715.0,57943,117658.0,60770.0,34.06,-0.01,Low Risk
U713,2024,7,585689.0,Salary Increases & Fixed Expenses Remain Stable,178428,59715.0,55406,115121.0,63307.0,35.48,0.0,Low Risk
U713,2024,8,648996.0,Salary Increases & Fixed Expenses Remain Stable,190707,59715.0,74503,134218.0,56489.0,29.62,0.02,Low Risk
U713,2024,9,705485.0,Salary Increases & Fixed Expenses Remain Stable,190707,59715.0,62358,122073.0,68634.0,35.99,0.01,Low Risk
U713,2024,10,774119.0,Salary Increases & Fixed Expenses Remain Stable,190707,59715.0,77355,137070.0,53637.0,28.13,-0.02,Low Risk
U713,2024,11,827756.0,Salary Increases & Fixed Expenses Remain Stable,190707,59715.0,68057,127772.0,62935.0,33.0,0.04,Low Risk
U713,2024,12,890691.0,Salary Increases & Fixed Expenses Remain Stable,190707,59715.0,76829,136544.0,54163.0,28.4,0.02,Low Risk
U714,2024,1,227840.0,Salary Increases & Fixed Expenses Increase,21478,14732.0,14037,28769.0,-7291.0,-33.95,0.0,High Risk
U714,2024,2,220549.0,Salary Increases & Fixed Expenses Increase,21478,16475.0,16731,33206.0,-11728.0,-54.6,0.03,High Risk
U714,2024,3,208821.0,Salary Increases & Fixed Expenses Increase,28730,16475.0,19379,35854.0,-7124.0,-24.8,-0.01,High Risk
U714,2024,4,201697.0,Salary Increases & Fixed Expenses Increase,28730,17447.0,17324,34771.0,-6041.0,-21.03,0.01,High Risk
U714,2024,5,195656.0,Salary Increases & Fixed Expenses Increase,28730,17447.0,17500,34947.0,-6217.0,-21.64,0.03,High Risk
U714,2024,6,189439.0,Salary Increases & Fixed Expenses Increase,28730,17447.0,21892,39339.0,-10609.0,-36.93,-0.0,High Risk
U714,2024,7,178830.0,Salary Increases & Fixed Expenses Increase,28730,19084.0,20451,39535.0,-10805.0,-37.61,-0.05,High Risk
U714,2024,8,168025.0,Salary Increases & Fixed Expenses Increase,28730,19084.0,17323,36407.0,-7677.0,-26.72,0.02,High Risk
U714,2024,9,160348.0,Salary Increases & Fixed Expenses Increase,28730,19084.0,21827,40911.0,-12181.0,-42.4,0.04,High Risk
U714,2024,10,148167.0,Salary Increases & Fixed Expenses Increase,28730,20257.0,20328,40585.0,-11855.0,-41.26,-0.05,High Risk
U714,2024,11,136312.0,Salary Increases & Fixed Expenses Increase,28730,20257.0,21962,42219.0,-13489.0,-46.95,0.01,High Risk
U714,2024,12,122823.0,Salary Increases & Fixed Expenses Increase,28730,20257.0,19098,39355.0,-10625.0,-36.98,0.02,High Risk
U715,2024,1,210169.0,Stable Salary & Stable Fixed Expenses,112450,68042.0,37797,105839.0,6611.0,5.88,-0.04,High Risk
U715,2024,2,216780.0,Stable Salary & Stable Fixed Expenses,112450,68042.0,41206,109248.0,3202.0,2.85,0.03,High Risk
U715,2024,3,219982.0,Stable Salary & Stable Fixed Expenses,112450,68042.0,43613,111655.0,795.0,0.71,0.0,High Risk
U715,2024,4,220777.0,Stable Salary & Stable Fixed Expenses,112450,68042.0,36065,104107.0,8343.0,7.42,-0.0,High Risk
U715,2024,5,229120.0,Stable Salary & Stable Fixed Expenses,112450,68042.0,43209,111251.0,1199.0,1.07,0.02,High Risk
U715,2024,6,230319.0,Stable Salary & Stable Fixed Expenses,112450,68042.0,39644,107686.0,4764.0,4.24,-0.02,High Risk
U715,2024,7,235083.0,Stable Salary & Stable Fixed Expenses,112450,68042.0,35169,103211.0,9239.0,8.22,-0.04,High Risk
U715,2024,8,244322.0,Stable Salary & Stable Fixed Expenses,112450,68042.0,40233,108275.0,4175.0,3.71,0.05,High Risk
U715,2024,9,248497.0,Stable Salary & Stable Fixed Expenses,112450,68042.0,39595,107637.0,4813.0,4.28,0.04,High Risk
U715,2024,10,253310.0,Stable Salary & Stable Fixed Expenses,112450,68042.0,47589,115631.0,-3181.0,-2.83,-0.04,High Risk
U715,2024,11,250129.0,Stable Salary & Stable Fixed Expenses,112450,68042.0,34782,102824.0,9626.0,8.56,-0.04,High Risk
U715,2024,12,259755.0,Stable Salary & Stable Fixed Expenses,112450,68042.0,39581,107623.0,4827.0,4.29,-0.03,High Risk
U716,2024,1,244311.0,Salary Increases & Fixed Expenses Increase,75455,32005.0,44872,76877.0,-1422.0,-1.88,0.02,High Risk
U716,2024,2,242889.0,Salary Increases & Fixed Expenses Increase,75455,32005.0,45094,77099.0,-1644.0,-2.18,-0.01,High Risk
U716,2024,3,241245.0,Salary Increases & Fixed Expenses Increase,75455,32005.0,37390,69395.0,6060.0,8.03,-0.0,High Risk
U716,2024,4,247305.0,Salary Increases & Fixed Expenses Increase,104841,32005.0,50043,82048.0,22793.0,21.74,-0.04,Medium Risk
U716,2024,5,270098.0,Salary Increases & Fixed Expenses Increase,104841,32005.0,46434,78439.0,26402.0,25.18,0.04,Low Risk
U716,2024,6,296500.0,Salary Increases & Fixed Expenses Increase,104841,33864.0,59275,93139.0,11702.0,11.16,0.02,High Risk
U716,2024,7,308202.0,Salary Increases & Fixed Expenses Increase,104841,33864.0,55107,88971.0,15870.0,15.14,0.05,Medium Risk
U716,2024,8,324072.0,Salary Increases & Fixed Expenses Increase,104841,33864.0,51684,85548.0,19293.0,18.4,-0.0,Medium Risk
U716,2024,9,343365.0,Salary Increases & Fixed Expenses Increase,104841,33864.0,54630,88494.0,16347.0,15.59,-0.0,Medium Risk
U716,2024,10,359712.0,Salary Increases & Fixed Expenses Increase,104841,33864.0,47224,81088.0,23753.0,22.66,-0.0,Medium Risk
U716,2024,11,383465.0,Salary Increases & Fixed Expenses Increase,104841,34407.0,49377,83784.0,21057.0,20.08,0.02,Medium Risk
U716,2024,12,404522.0,Salary Increases & Fixed Expenses Increase,104841,34407.0,54304,88711.0,16130.0,15.39,0.03,Medium Risk
U717,2024,1,219654.0,Salary Increases & Fixed Expenses Increase,106975,68753.0,32324,101077.0,5898.0,5.51,-0.01,High Risk
U717,2024,2,225552.0,Salary Increases & Fixed Expenses Increase,106975,68753.0,35719,104472.0,2503.0,2.34,-0.04,High Risk
U717,2024,3,228055.0,Salary Increases & Fixed Expenses Increase,106975,68753.0,41915,110668.0,-3693.0,-3.45,-0.01,High Risk
U717,2024,4,224362.0,Salary Increases & Fixed Expenses Increase,106975,68753.0,34148,102901.0,4074.0,3.81,-0.05,High Risk
U717,2024,5,228436.0,Salary Increases & Fixed Expenses Increase,106975,68753.0,33662,102415.0,4560.0,4.26,0.02,High Risk
U717,2024,6,232996.0,Salary Increases & Fixed Expenses Increase,106975,68753.0,41715,110468.0,-3493.0,-3.27,0.03,High Risk
U717,2024,7,229503.0,Salary Increases & Fixed Expenses Increase,106975,68753.0,39806,108559.0,-1584.0,-1.48,-0.02,High Risk
U717,2024,8,227919.0,Salary Increases & Fixed Expenses Increase,135130,70297.0,53963,124260.0,10870.0,8.04,-0.04,High Risk
U717,2024,9,238789.0,Salary Increases & Fixed Expenses Increase,135130,70297.0,48315,118612.0,16518.0,12.22,0.03,High Risk
U717,2024,10,255307.0,Salary Increases & Fixed Expenses Increase,135130,70297.0,64795,135092.0,38.0,0.03,-0.01,High Risk
U717,2024,11,255345.0,Salary Increases & Fixed Expenses Increase,135130,71738.0,54135,125873.0,9257.0,6.85,-0.03,High Risk
U717,2024,12,264602.0,Salary Increases & Fixed Expenses Increase,135130,71738.0,59005,130743.0,4387.0,3.25,0.04,High Risk
U718,2024,1,205387.0,Salary Increases & Fixed Expenses Increase,129305,59335.0,39647,98982.0,30323.0,23.45,-0.01,Medium Risk
U718,2024,2,235710.0,Salary Increases & Fixed Expenses Increase,129305,59335.0,41317,100652.0,28653.0,22.16,-0.0,Medium Risk
U718,2024,3,264363.0,Salary Increases & Fixed Expenses Increase,129305,59335.0,38794,98129.0,31176.0,24.11,-0.04,Medium Risk
U718,2024,4,295539.0,Salary Increases & Fixed Expenses Increase,129305,59335.0,43103,102438.0,26867.0,20.78,0.02,Medium Risk
U718,2024,5,322406.0,Salary Increases & Fixed Expenses Increase,129305,59335.0,39033,98368.0,30937.0,23.93,-0.04,Medium Risk
U718,2024,6,353343.0,Salary Increases & Fixed Expenses Increase,129305,59335.0,48618,107953.0,21352.0,16.51,0.01,Medium Risk
U718,2024,7,374695.0,Salary Increases & Fixed Expenses Increase,129305,59335.0,44739,104074.0,25231.0,19.51,-0.0,Medium Risk
U718,2024,8,399926.0,Salary Increases & Fixed Expenses Increase,134465,60441.0,41823,102264.0,32201.0,23.95,-0.0,Medium Risk
U718,2024,9,432127.0,Salary Increases & Fixed Expenses Increase,134465,60441.0,47334,107775.0,26690.0,19.85,-0.0,Medium Risk
U718,2024,10,458817.0,Salary Increases & Fixed Expenses Increase,134465,62393.0,41468,103861.0,30604.0,22.76,0.01,Medium Risk
U718,2024,11,489421.0,Salary Increases & Fixed Expenses Increase,134465,62393.0,52851,115244.0,19221.0,14.29,-0.04,High Risk
U718,2024,12,508642.0,Salary Increases & Fixed Expenses Increase,134465,62393.0,42457,104850.0,29615.0,22.02,0.03,Medium Risk
U719,2024,1,247153.0,Salary Increases & Fixed Expenses Remain Stable,84896,38944.0,29159,68103.0,16793.0,19.78,0.03,Medium Risk
U719,2024,2,263946.0,Salary Increases & Fixed Expenses Remain Stable,84896,38944.0,33480,72424.0,12472.0,14.69,-0.03,High Risk
U719,2024,3,276418.0,Salary Increases & Fixed Expenses Remain Stable,84896,38944.0,39028,77972.0,6924.0,8.16,-0.0,High Risk
U719,2024,4,283342.0,Salary Increases & Fixed Expenses Remain Stable,84896,38944.0,26252,65196.0,19700.0,23.2,-0.04,Medium Risk
U719,2024,5,303042.0,Salary Increases & Fixed Expenses Remain Stable,84896,38944.0,27637,66581.0,18315.0,21.57,0.0,Medium Risk
U719,2024,6,321357.0,Salary Increases & Fixed Expenses Remain Stable,100400,38944.0,38953,77897.0,22503.0,22.41,-0.04,Medium Risk
U719,2024,7,343860.0,Salary Increases & Fixed Expenses Remain Stable,100400,38944.0,34161,73105.0,27295.0,27.19,-0.0,Low Risk
U719,2024,8,371155.0,Salary Increases & Fixed Expenses Remain Stable,100400,38944.0,31231,70175.0,30225.0,30.1,-0.04,Low Risk
U719,2024,9,401380.0,Salary Increases & Fixed Expenses Remain Stable,100400,38944.0,39569,78513.0,21887.0,21.8,0.03,Medium Risk
U719,2024,10,423267.0,Salary Increases & Fixed Expenses Remain Stable,100400,38944.0,48501,87445.0,12955.0,12.9,0.05,High Risk
U719,2024,11,436222.0,Salary Increases & Fixed Expenses Remain Stable,100400,38944.0,36303,75247.0,25153.0,25.05,-0.02,Low Risk
U719,2024,12,461375.0,Salary Increases & Fixed Expenses Remain Stable,100400,38944.0,38935,77879.0,22521.0,22.43,0.03,Medium Risk
U720,2024,1,237213.0,Stable Salary & Stable Fixed Expenses,193143,74436.0,81925,156361.0,36782.0,19.04,-0.03,Medium Risk
U720,2024,2,273995.0,Stable Salary & Stable Fixed Expenses,193143,74436.0,94437,168873.0,24270.0,12.57,-0.01,High Risk
U720,2024,3,298265.0,Stable Salary & Stable Fixed Expenses,193143,74436.0,86779,161215.0,31928.0,16.53,0.01,Medium Risk
U720,2024,4,330193.0,Stable Salary & Stable Fixed Expenses,193143,74436.0,90654,165090.0,28053.0,14.52,-0.05,High Risk
U720,2024,5,358246.0,Stable Salary & Stable Fixed Expenses,193143,74436.0,103922,178358.0,14785.0,7.65,-0.05,High Risk
U720,2024,6,373031.0,Stable Salary & Stable Fixed Expenses,193143,74436.0,100751,175187.0,17956.0,9.3,-0.04,High Risk
U720,2024,7,390987.0,Stable Salary & Stable Fixed Expenses,193143,74436.0,106224,180660.0,12483.0,6.46,-0.05,High Risk
U720,2024,8,403470.0,Stable Salary & Stable Fixed Expenses,193143,74436.0,114494,188930.0,4213.0,2.18,0.04,High Risk
U720,2024,9,407683.0,Stable Salary & Stable Fixed Expenses,193143,74436.0,89468,163904.0,29239.0,15.14,0.03,Medium Risk
U720,2024,10,436922.0,Stable Salary & Stable Fixed Expenses,193143,74436.0,98489,172925.0,20218.0,10.47,0.01,High Risk
U720,2024,11,457140.0,Stable Salary & Stable Fixed Expenses,193143,74436.0,77839,152275.0,40868.0,21.16,-0.04,Medium Risk
U720,2024,12,498008.0,Stable Salary & Stable Fixed Expenses,193143,74436.0,109790,184226.0,8917.0,4.62,0.04,High Risk
U721,2024,1,246142.0,Salary Increases & Fixed Expenses Increase,198571,58428.0,80284,138712.0,59859.0,30.14,-0.0,Low Risk
U721,2024,2,306001.0,Salary Increases & Fixed Expenses Increase,198571,58428.0,119063,177491.0,21080.0,10.62,-0.01,High Risk
U721,2024,3,327081.0,Salary Increases & Fixed Expenses Increase,198571,59054.0,142086,201140.0,-2569.0,-1.29,0.04,High Risk
U721,2024,4,324512.0,Salary Increases & Fixed Expenses Increase,198571,59054.0,105811,164865.0,33706.0,16.97,-0.03,Medium Risk
U721,2024,5,358218.0,Salary Increases & Fixed Expenses Increase,198571,59054.0,111027,170081.0,28490.0,14.35,0.03,High Risk
U721,2024,6,386708.0,Salary Increases & Fixed Expenses Increase,198571,59054.0,92075,151129.0,47442.0,23.89,-0.01,Medium Risk
U721,2024,7,434150.0,Salary Increases & Fixed Expenses Increase,198571,59054.0,95744,154798.0,43773.0,22.04,0.01,Medium Risk
U721,2024,8,477923.0,Salary Increases & Fixed Expenses Increase,221513,59054.0,126153,185207.0,36306.0,16.39,0.0,Medium Risk
U721,2024,9,514229.0,Salary Increases & Fixed Expenses Increase,221513,59054.0,113184,172238.0,49275.0,22.24,-0.0,Medium Risk
U721,2024,10,563504.0,Salary Increases & Fixed Expenses Increase,221513,59580.0,143605,203185.0,18328.0,8.27,-0.04,High Risk
U721,2024,11,581832.0,Salary Increases & Fixed Expenses Increase,221513,59580.0,98349,157929.0,63584.0,28.7,0.01,Low Risk
U721,2024,12,645416.0,Salary Increases & Fixed Expenses Increase,221513,59580.0,140793,200373.0,21140.0,9.54,-0.01,High Risk
U722,2024,1,242079.0,Salary Increases & Fixed Expenses Remain Stable,286589,103651.0,139679,243330.0,43259.0,15.09,0.02,Medium Risk
U722,2024,2,285338.0,Salary Increases & Fixed Expenses Remain Stable,286589,103651.0,156673,260324.0,26265.0,9.16,0.01,High Risk
U722,2024,3,311603.0,Salary Increases & Fixed Expenses Remain Stable,293232,103651.0,117825,221476.0,71756.0,24.47,-0.05,Medium Risk
U722,2024,4,383359.0,Salary Increases & Fixed Expenses Remain Stable,293232,103651.0,148011,251662.0,41570.0,14.18,0.01,High Risk
U722,2024,5,424929.0,Salary Increases & Fixed Expenses Remain Stable,293232,103651.0,160536,264187.0,29045.0,9.91,0.03,High Risk
U722,2024,6,453974.0,Salary Increases & Fixed Expenses Remain Stable,293232,103651.0,120647,224298.0,68934.0,23.51,-0.03,Medium Risk
U722,2024,7,522908.0,Salary Increases & Fixed Expenses Remain Stable,293232,103651.0,175507,279158.0,14074.0,4.8,-0.04,High Risk
U722,2024,8,536982.0,Salary Increases & Fixed Expenses Remain Stable,293232,103651.0,128753,232404.0,60828.0,20.74,-0.01,Medium Risk
U722,2024,9,597810.0,Salary Increases & Fixed Expenses Remain Stable,293232,103651.0,135858,239509.0,53723.0,18.32,0.03,Medium Risk
U722,2024,10,651533.0,Salary Increases & Fixed Expenses Remain Stable,293232,103651.0,158689,262340.0,30892.0,10.54,0.03,High Risk
U722,2024,11,682425.0,Salary Increases & Fixed Expenses Remain Stable,293232,103651.0,175576,279227.0,14005.0,4.78,-0.04,High Risk
U722,2024,12,696430.0,Salary Increases & Fixed Expenses Remain Stable,293232,103651.0,153178,256829.0,36403.0,12.41,-0.02,High Risk
U723,2024,1,221646.0,Salary Increases & Fixed Expenses Remain Stable,190157,42579.0,142979,185558.0,4599.0,2.42,-0.0,High Risk
U723,2024,2,226245.0,Salary Increases & Fixed Expenses Remain Stable,190157,42579.0,130892,173471.0,16686.0,8.77,-0.02,High Risk
U723,2024,3,242931.0,Salary Increases & Fixed Expenses Remain Stable,190157,42579.0,140634,183213.0,6944.0,3.65,-0.01,High Risk
U723,2024,4,249875.0,Salary Increases & Fixed Expenses Remain Stable,190157,42579.0,149584,192163.0,-2006.0,-1.05,0.05,High Risk
U723,2024,5,247869.0,Salary Increases & Fixed Expenses Remain Stable,197694,42579.0,129112,171691.0,26003.0,13.15,-0.03,High Risk
U723,2024,6,273872.0,Salary Increases & Fixed Expenses Remain Stable,197694,42579.0,135250,177829.0,19865.0,10.05,-0.01,High Risk
U723,2024,7,293737.0,Salary Increases & Fixed Expenses Remain Stable,197694,42579.0,124112,166691.0,31003.0,15.68,0.04,Medium Risk
U723,2024,8,324740.0,Salary Increases & Fixed Expenses Remain Stable,197694,42579.0,127539,170118.0,27576.0,13.95,-0.03,High Risk
U723,2024,9,352316.0,Salary Increases & Fixed Expenses Remain Stable,197694,42579.0,149377,191956.0,5738.0,2.9,0.03,High Risk
U723,2024,10,358054.0,Salary Increases & Fixed Expenses Remain Stable,197694,42579.0,171240,213819.0,-16125.0,-8.16,0.03,High Risk
U723,2024,11,341929.0,Salary Increases & Fixed Expenses Remain Stable,197694,42579.0,119774,162353.0,35341.0,17.88,0.02,Medium Risk
U723,2024,12,377270.0,Salary Increases & Fixed Expenses Remain Stable,197694,42579.0,153522,196101.0,1593.0,0.81,-0.03,High Risk
U724,2024,1,214936.0,Salary Increases & Fixed Expenses Remain Stable,59350,39288.0,19175,58463.0,887.0,1.49,-0.03,High Risk
U724,2024,2,215823.0,Salary Increases & Fixed Expenses Remain Stable,59350,39288.0,23039,62327.0,-2977.0,-5.02,-0.01,High Risk
U724,2024,3,212846.0,Salary Increases & Fixed Expenses Remain Stable,59350,39288.0,25289,64577.0,-5227.0,-8.81,0.01,High Risk
U724,2024,4,207619.0,Salary Increases & Fixed Expenses Remain Stable,59350,39288.0,20787,60075.0,-725.0,-1.22,-0.05,High Risk
U724,2024,5,206894.0,Salary Increases & Fixed Expenses Remain Stable,87129,39288.0,27873,67161.0,19968.0,22.92,0.05,Medium Risk
U724,2024,6,226862.0,Salary Increases & Fixed Expenses Remain Stable,87129,39288.0,26793,66081.0,21048.0,24.16,-0.04,Medium Risk
U724,2024,7,247910.0,Salary Increases & Fixed Expenses Remain Stable,87129,39288.0,28529,67817.0,19312.0,22.16,-0.02,Medium Risk
U724,2024,8,267222.0,Salary Increases & Fixed Expenses Remain Stable,87129,39288.0,27799,67087.0,20042.0,23.0,0.04,Medium Risk
U724,2024,9,287264.0,Salary Increases & Fixed Expenses Remain Stable,87129,39288.0,29438,68726.0,18403.0,21.12,0.04,Medium Risk
U724,2024,10,305667.0,Salary Increases & Fixed Expenses Remain Stable,87129,39288.0,38197,77485.0,9644.0,11.07,-0.03,High Risk
U724,2024,11,315311.0,Salary Increases & Fixed Expenses Remain Stable,87129,39288.0,36924,76212.0,10917.0,12.53,0.03,High Risk
U724,2024,12,326228.0,Salary Increases & Fixed Expenses Remain Stable,87129,39288.0,37125,76413.0,10716.0,12.3,-0.01,High Risk
U725,2024,1,208395.0,Salary Increases & Fixed Expenses Decrease,177957,41686.0,64446,106132.0,71825.0,40.36,-0.0,Low Risk
U725,2024,2,280220.0,Salary Increases & Fixed Expenses Decrease,177957,41686.0,65594,107280.0,70677.0,39.72,-0.01,Low Risk
U725,2024,3,350897.0,Salary Increases & Fixed Expenses Decrease,177957,41686.0,78659,120345.0,57612.0,32.37,0.01,Low Risk
U725,2024,4,408509.0,Salary Increases & Fixed Expenses Decrease,177957,41686.0,55833,97519.0,80438.0,45.2,-0.04,Low Risk
U725,2024,5,488947.0,Salary Increases & Fixed Expenses Decrease,177957,41686.0,60343,102029.0,75928.0,42.67,0.05,Low Risk
U725,2024,6,564875.0,Salary Increases & Fixed Expenses Decrease,196329,41686.0,60972,102658.0,93671.0,47.71,0.05,Low Risk
U725,2024,7,658546.0,Salary Increases & Fixed Expenses Decrease,196329,41686.0,67424,109110.0,87219.0,44.42,-0.04,Low Risk
U725,2024,8,745765.0,Salary Increases & Fixed Expenses Decrease,196329,41686.0,73621,115307.0,81022.0,41.27,0.03,Low Risk
U725,2024,9,826787.0,Salary Increases & Fixed Expenses Decrease,196329,41686.0,76128,117814.0,78515.0,39.99,0.03,Low Risk
U725,2024,10,905302.0,Salary Increases & Fixed Expenses Decrease,196329,41686.0,87626,129312.0,67017.0,34.14,0.01,Low Risk
U725,2024,11,972319.0,Salary Increases & Fixed Expenses Decrease,196329,41686.0,68825,110511.0,85818.0,43.71,0.04,Low Risk
U725,2024,12,1058137.0,Salary Increases & Fixed Expenses Decrease,196329,41686.0,64159,105845.0,90484.0,46.09,-0.0,Low Risk
U726,2024,1,235143.0,Salary Increases & Fixed Expenses Remain Stable,101720,53627.0,44826,98453.0,3267.0,3.21,-0.02,High Risk
U726,2024,2,238410.0,Salary Increases & Fixed Expenses Remain Stable,101720,53627.0,49658,103285.0,-1565.0,-1.54,0.03,High Risk
U726,2024,3,236845.0,Salary Increases & Fixed Expenses Remain Stable,120113,53627.0,63066,116693.0,3420.0,2.85,-0.01,High Risk
U726,2024,4,240265.0,Salary Increases & Fixed Expenses Remain Stable,120113,53627.0,65989,119616.0,497.0,0.41,0.02,High Risk
U726,2024,5,240762.0,Salary Increases & Fixed Expenses Remain Stable,120113,53627.0,56434,110061.0,10052.0,8.37,0.01,High Risk
U726,2024,6,250814.0,Salary Increases & Fixed Expenses Remain Stable,120113,53627.0,63358,116985.0,3128.0,2.6,-0.04,High Risk
U726,2024,7,253942.0,Salary Increases & Fixed Expenses Remain Stable,120113,53627.0,69590,123217.0,-3104.0,-2.58,0.0,High Risk
U726,2024,8,250838.0,Salary Increases & Fixed Expenses Remain Stable,120113,53627.0,70551,124178.0,-4065.0,-3.38,0.04,High Risk
U726,2024,9,246773.0,Salary Increases & Fixed Expenses Remain Stable,120113,53627.0,63378,117005.0,3108.0,2.59,0.03,High Risk
U726,2024,10,249881.0,Salary Increases & Fixed Expenses Remain Stable,120113,53627.0,71314,124941.0,-4828.0,-4.02,-0.03,High Risk
U726,2024,11,245053.0,Salary Increases & Fixed Expenses Remain Stable,120113,53627.0,67023,120650.0,-537.0,-0.45,0.03,High Risk
U726,2024,12,244516.0,Salary Increases & Fixed Expenses Remain Stable,120113,53627.0,61101,114728.0,5385.0,4.48,-0.02,High Risk
U727,2024,1,247704.0,Stable Salary & Increasing Fixed Expenses,122576,77533.0,73582,151115.0,-28539.0,-23.28,-0.04,High Risk
U727,2024,2,219165.0,Stable Salary & Increasing Fixed Expenses,122576,77533.0,95526,173059.0,-50483.0,-41.19,-0.02,High Risk
U727,2024,3,168682.0,Stable Salary & Increasing Fixed Expenses,122576,77533.0,112999,190532.0,-67956.0,-55.44,0.03,High Risk
U727,2024,4,100726.0,Stable Salary & Increasing Fixed Expenses,122576,77533.0,76296,153829.0,-31253.0,-25.5,-0.04,High Risk
U727,2024,5,69473.0,Stable Salary & Increasing Fixed Expenses,122576,77533.0,80149,157682.0,-35106.0,-28.64,0.05,High Risk
U727,2024,6,34367.0,Stable Salary & Increasing Fixed Expenses,122576,77533.0,76049,153582.0,-31006.0,-25.3,-0.03,High Risk
U727,2024,7,3361.0,Stable Salary & Increasing Fixed Expenses,122576,79459.0,77072,156531.0,-33955.0,-27.7,0.01,High Risk
U727,2024,8,-30594.0,Stable Salary & Increasing Fixed Expenses,122576,79459.0,92026,171485.0,-48909.0,-39.9,-0.0,High Risk
U727,2024,9,-79503.0,Stable Salary & Increasing Fixed Expenses,122576,79459.0,96717,176176.0,-53600.0,-43.73,0.01,High Risk
U727,2024,10,-133103.0,Stable Salary & Increasing Fixed Expenses,122576,81060.0,110260,191320.0,-68744.0,-56.08,-0.03,High Risk
U727,2024,11,-201847.0,Stable Salary & Increasing Fixed Expenses,122576,81060.0,86551,167611.0,-45035.0,-36.74,-0.03,High Risk
U727,2024,12,-246882.0,Stable Salary & Increasing Fixed Expenses,122576,81060.0,93313,174373.0,-51797.0,-42.26,0.02,High Risk
U728,2024,1,211779.0,Stable Salary & Stable Fixed Expenses,211868,77049.0,118387,195436.0,16432.0,7.76,0.02,High Risk
U728,2024,2,228211.0,Stable Salary & Stable Fixed Expenses,211868,77049.0,88643,165692.0,46176.0,21.79,0.01,Medium Risk
U728,2024,3,274387.0,Stable Salary & Stable Fixed Expenses,211868,77049.0,122006,199055.0,12813.0,6.05,-0.0,High Risk
U728,2024,4,287200.0,Stable Salary & Stable Fixed Expenses,211868,77049.0,88054,165103.0,46765.0,22.07,0.04,Medium Risk
U728,2024,5,333965.0,Stable Salary & Stable Fixed Expenses,211868,77049.0,97214,174263.0,37605.0,17.75,0.03,Medium Risk
U728,2024,6,371570.0,Stable Salary & Stable Fixed Expenses,211868,77049.0,117286,194335.0,17533.0,8.28,0.02,High Risk
U728,2024,7,389103.0,Stable Salary & Stable Fixed Expenses,211868,77049.0,91553,168602.0,43266.0,20.42,-0.03,Medium Risk
U728,2024,8,432369.0,Stable Salary & Stable Fixed Expenses,211868,77049.0,101512,178561.0,33307.0,15.72,-0.04,Medium Risk
U728,2024,9,465676.0,Stable Salary & Stable Fixed Expenses,211868,77049.0,116567,193616.0,18252.0,8.61,-0.03,High Risk
U728,2024,10,483928.0,Stable Salary & Stable Fixed Expenses,211868,77049.0,108648,185697.0,26171.0,12.35,0.01,High Risk
U728,2024,11,510099.0,Stable Salary & Stable Fixed Expenses,211868,77049.0,110067,187116.0,24752.0,11.68,0.01,High Risk
U728,2024,12,534851.0,Stable Salary & Stable Fixed Expenses,211868,77049.0,129399,206448.0,5420.0,2.56,-0.02,High Risk
U729,2024,1,248282.0,Stable Salary & Increasing Fixed Expenses,57932,31809.0,31315,63124.0,-5192.0,-8.96,0.01,High Risk
U729,2024,2,243090.0,Stable Salary & Increasing Fixed Expenses,57932,32889.0,34576,67465.0,-9533.0,-16.46,-0.03,High Risk
U729,2024,3,233557.0,Stable Salary & Increasing Fixed Expenses,57932,32889.0,31608,64497.0,-6565.0,-11.33,0.04,High Risk
U729,2024,4,226992.0,Stable Salary & Increasing Fixed Expenses,57932,32889.0,26914,59803.0,-1871.0,-3.23,-0.03,High Risk
U729,2024,5,225121.0,Stable Salary & Increasing Fixed Expenses,57932,32889.0,29740,62629.0,-4697.0,-8.11,-0.05,High Risk
U729,2024,6,220424.0,Stable Salary & Increasing Fixed Expenses,57932,32889.0,32039,64928.0,-6996.0,-12.08,-0.04,High Risk
U729,2024,7,213428.0,Stable Salary & Increasing Fixed Expenses,57932,32889.0,31285,64174.0,-6242.0,-10.77,0.02,High Risk
U729,2024,8,207186.0,Stable Salary & Increasing Fixed Expenses,57932,32889.0,27382,60271.0,-2339.0,-4.04,0.04,High Risk
U729,2024,9,204847.0,Stable Salary & Increasing Fixed Expenses,57932,32889.0,30040,62929.0,-4997.0,-8.63,-0.04,High Risk
U729,2024,10,199850.0,Stable Salary & Increasing Fixed Expenses,57932,32889.0,39150,72039.0,-14107.0,-24.35,-0.05,High Risk
U729,2024,11,185743.0,Stable Salary & Increasing Fixed Expenses,57932,32889.0,33543,66432.0,-8500.0,-14.67,-0.05,High Risk
U729,2024,12,177243.0,Stable Salary & Increasing Fixed Expenses,57932,32889.0,31789,64678.0,-6746.0,-11.64,-0.04,High Risk
U730,2024,1,217006.0,Salary Increases & Fixed Expenses Remain Stable,20614,22787.0,11377,34164.0,-13550.0,-65.73,0.01,High Risk
U730,2024,2,203456.0,Salary Increases & Fixed Expenses Remain Stable,20614,22787.0,11914,34701.0,-14087.0,-68.34,0.0,High Risk
U730,2024,3,189369.0,Salary Increases & Fixed Expenses Remain Stable,20614,22787.0,9613,32400.0,-11786.0,-57.17,-0.02,High Risk
U730,2024,4,177583.0,Salary Increases & Fixed Expenses Remain Stable,20614,22787.0,9817,32604.0,-11990.0,-58.16,0.03,High Risk
U730,2024,5,165593.0,Salary Increases & Fixed Expenses Remain Stable,20614,22787.0,12255,35042.0,-14428.0,-69.99,-0.03,High Risk
U730,2024,6,151165.0,Salary Increases & Fixed Expenses Remain Stable,20614,22787.0,9429,32216.0,-11602.0,-56.28,-0.04,High Risk
U730,2024,7,139563.0,Salary Increases & Fixed Expenses Remain Stable,20614,22787.0,12357,35144.0,-14530.0,-70.49,0.04,High Risk
U730,2024,8,125033.0,Salary Increases & Fixed Expenses Remain Stable,47463,22787.0,27917,50704.0,-3241.0,-6.83,0.02,High Risk
U730,2024,9,121792.0,Salary Increases & Fixed Expenses Remain Stable,47463,22787.0,22007,44794.0,2669.0,5.62,-0.01,High Risk
U730,2024,10,124461.0,Salary Increases & Fixed Expenses Remain Stable,47463,22787.0,20048,42835.0,4628.0,9.75,0.02,High Risk
U730,2024,11,129089.0,Salary Increases & Fixed Expenses Remain Stable,47463,22787.0,22023,44810.0,2653.0,5.59,-0.02,High Risk
U730,2024,12,131742.0,Salary Increases & Fixed Expenses Remain Stable,47463,22787.0,26839,49626.0,-2163.0,-4.56,-0.05,High Risk
U731,2024,1,225665.0,Salary Increases & Fixed Expenses Decrease,87804,24540.0,52288,76828.0,10976.0,12.5,0.02,High Risk
U731,2024,2,236641.0,Salary Increases & Fixed Expenses Decrease,87804,24540.0,49752,74292.0,13512.0,15.39,0.02,Medium Risk
U731,2024,3,250153.0,Salary Increases & Fixed Expenses Decrease,87804,24540.0,44906,69446.0,18358.0,20.91,0.02,Medium Risk
U731,2024,4,268511.0,Salary Increases & Fixed Expenses Decrease,87804,23501.0,37172,60673.0,27131.0,30.9,-0.02,Low Risk
U731,2024,5,295642.0,Salary Increases & Fixed Expenses Decrease,87804,23501.0,38621,62122.0,25682.0,29.25,-0.04,Low Risk
U731,2024,6,321324.0,Salary Increases & Fixed Expenses Decrease,97624,22664.0,39676,62340.0,35284.0,36.14,0.01,Low Risk
U731,2024,7,356608.0,Salary Increases & Fixed Expenses Decrease,97624,21392.0,45528,66920.0,30704.0,31.45,0.02,Low Risk
U731,2024,8,387312.0,Salary Increases & Fixed Expenses Decrease,97624,21392.0,45414,66806.0,30818.0,31.57,0.03,Low Risk
U731,2024,9,418130.0,Salary Increases & Fixed Expenses Decrease,97624,21392.0,57417,78809.0,18815.0,19.27,0.03,Medium Risk
U731,2024,10,436945.0,Salary Increases & Fixed Expenses Decrease,97624,21392.0,51626,73018.0,24606.0,25.2,0.04,Low Risk
U731,2024,11,461551.0,Salary Increases & Fixed Expenses Decrease,97624,21392.0,55830,77222.0,20402.0,20.9,-0.03,Medium Risk
U731,2024,12,481953.0,Salary Increases & Fixed Expenses Decrease,97624,21392.0,42833,64225.0,33399.0,34.21,0.01,Low Risk
U732,2024,1,212736.0,Stable Salary & Increasing Fixed Expenses,40652,16989.0,26658,43647.0,-2995.0,-7.37,0.0,High Risk
U732,2024,2,209741.0,Stable Salary & Increasing Fixed Expenses,40652,16989.0,29404,46393.0,-5741.0,-14.12,-0.02,High Risk
U732,2024,3,204000.0,Stable Salary & Increasing Fixed Expenses,40652,16989.0,29470,46459.0,-5807.0,-14.28,0.01,High Risk
U732,2024,4,198193.0,Stable Salary & Increasing Fixed Expenses,40652,16989.0,24822,41811.0,-1159.0,-2.85,-0.03,High Risk
U732,2024,5,197034.0,Stable Salary & Increasing Fixed Expenses,40652,16989.0,26437,43426.0,-2774.0,-6.82,-0.03,High Risk
U732,2024,6,194260.0,Stable Salary & Increasing Fixed Expenses,40652,16989.0,26603,43592.0,-2940.0,-7.23,0.04,High Risk
U732,2024,7,191320.0,Stable Salary & Increasing Fixed Expenses,40652,16989.0,27410,44399.0,-3747.0,-9.22,0.05,High Risk
U732,2024,8,187573.0,Stable Salary & Increasing Fixed Expenses,40652,16989.0,28666,45655.0,-5003.0,-12.31,0.03,High Risk
U732,2024,9,182570.0,Stable Salary & Increasing Fixed Expenses,40652,16989.0,24723,41712.0,-1060.0,-2.61,-0.03,High Risk
U732,2024,10,181510.0,Stable Salary & Increasing Fixed Expenses,40652,16989.0,29196,46185.0,-5533.0,-13.61,0.02,High Risk
U732,2024,11,175977.0,Stable Salary & Increasing Fixed Expenses,40652,18820.0,26258,45078.0,-4426.0,-10.89,-0.05,High Risk
U732,2024,12,171551.0,Stable Salary & Increasing Fixed Expenses,40652,18820.0,29416,48236.0,-7584.0,-18.66,-0.02,High Risk
U733,2024,1,210615.0,Salary Increases & Fixed Expenses Remain Stable,64776,23499.0,25018,48517.0,16259.0,25.1,0.04,Low Risk
U733,2024,2,226874.0,Salary Increases & Fixed Expenses Remain Stable,64776,23499.0,21197,44696.0,20080.0,31.0,-0.0,Low Risk
U733,2024,3,246954.0,Salary Increases & Fixed Expenses Remain Stable,64776,23499.0,25290,48789.0,15987.0,24.68,0.02,Medium Risk
U733,2024,4,262941.0,Salary Increases & Fixed Expenses Remain Stable,64776,23499.0,25728,49227.0,15549.0,24.0,-0.02,Medium Risk
U733,2024,5,278490.0,Salary Increases & Fixed Expenses Remain Stable,64776,23499.0,21011,44510.0,20266.0,31.29,0.03,Low Risk
U733,2024,6,298756.0,Salary Increases & Fixed Expenses Remain Stable,64776,23499.0,20505,44004.0,20772.0,32.07,-0.03,Low Risk
U733,2024,7,319528.0,Salary Increases & Fixed Expenses Remain Stable,64776,23499.0,22387,45886.0,18890.0,29.16,0.03,Low Risk
U733,2024,8,338418.0,Salary Increases & Fixed Expenses Remain Stable,94355,23499.0,33066,56565.0,37790.0,40.05,0.05,Low Risk
U733,2024,9,376208.0,Salary Increases & Fixed Expenses Remain Stable,94355,23499.0,34249,57748.0,36607.0,38.8,-0.01,Low Risk
U733,2024,10,412815.0,Salary Increases & Fixed Expenses Remain Stable,94355,23499.0,42090,65589.0,28766.0,30.49,0.01,Low Risk
U733,2024,11,441581.0,Salary Increases & Fixed Expenses Remain Stable,94355,23499.0,32065,55564.0,38791.0,41.11,0.04,Low Risk
U733,2024,12,480372.0,Salary Increases & Fixed Expenses Remain Stable,94355,23499.0,37602,61101.0,33254.0,35.24,0.03,Low Risk
U734,2024,1,213728.0,Salary Increases & Fixed Expenses Remain Stable,147096,64870.0,76924,141794.0,5302.0,3.6,0.01,High Risk
U734,2024,2,219030.0,Salary Increases & Fixed Expenses Remain Stable,147096,64870.0,82530,147400.0,-304.0,-0.21,-0.01,High Risk
U734,2024,3,218726.0,Salary Increases & Fixed Expenses Remain Stable,147096,64870.0,69768,134638.0,12458.0,8.47,-0.04,High Risk
U734,2024,4,231184.0,Salary Increases & Fixed Expenses Remain Stable,147096,64870.0,60594,125464.0,21632.0,14.71,0.0,High Risk
U734,2024,5,252816.0,Salary Increases & Fixed Expenses Remain Stable,147096,64870.0,59050,123920.0,23176.0,15.76,-0.05,Medium Risk
U734,2024,6,275992.0,Salary Increases & Fixed Expenses Remain Stable,147096,64870.0,75873,140743.0,6353.0,4.32,0.04,High Risk
U734,2024,7,282345.0,Salary Increases & Fixed Expenses Remain Stable,162818,64870.0,92204,157074.0,5744.0,3.53,0.0,High Risk
U734,2024,8,288089.0,Salary Increases & Fixed Expenses Remain Stable,162818,64870.0,85508,150378.0,12440.0,7.64,0.01,High Risk
U734,2024,9,300529.0,Salary Increases & Fixed Expenses Remain Stable,162818,64870.0,79183,144053.0,18765.0,11.53,-0.02,High Risk
U734,2024,10,319294.0,Salary Increases & Fixed Expenses Remain Stable,162818,64870.0,75741,140611.0,22207.0,13.64,-0.01,High Risk
U734,2024,11,341501.0,Salary Increases & Fixed Expenses Remain Stable,162818,64870.0,84387,149257.0,13561.0,8.33,-0.02,High Risk
U734,2024,12,355062.0,Salary Increases & Fixed Expenses Remain Stable,162818,64870.0,77576,142446.0,20372.0,12.51,0.03,High Risk
U735,2024,1,236487.0,Stable Salary & Decreasing Fixed Expenses,124003,59624.0,65928,125552.0,-1549.0,-1.25,0.02,High Risk
U735,2024,2,234938.0,Stable Salary & Decreasing Fixed Expenses,124003,59624.0,63600,123224.0,779.0,0.63,0.0,High Risk
U735,2024,3,235717.0,Stable Salary & Decreasing Fixed Expenses,124003,59624.0,93038,152662.0,-28659.0,-23.11,0.0,High Risk
U735,2024,4,207058.0,Stable Salary & Decreasing Fixed Expenses,124003,59624.0,57172,116796.0,7207.0,5.81,0.0,High Risk
U735,2024,5,214265.0,Stable Salary & Decreasing Fixed Expenses,124003,59624.0,69608,129232.0,-5229.0,-4.22,0.01,High Risk
U735,2024,6,209036.0,Stable Salary & Decreasing Fixed Expenses,124003,59624.0,62704,122328.0,1675.0,1.35,-0.04,High Risk
U735,2024,7,210711.0,Stable Salary & Decreasing Fixed Expenses,124003,59624.0,65341,124965.0,-962.0,-0.78,-0.02,High Risk
U735,2024,8,209749.0,Stable Salary & Decreasing Fixed Expenses,124003,59624.0,54825,114449.0,9554.0,7.7,-0.01,High Risk
U735,2024,9,219303.0,Stable Salary & Decreasing Fixed Expenses,124003,59624.0,55227,114851.0,9152.0,7.38,-0.0,High Risk
U735,2024,10,228455.0,Stable Salary & Decreasing Fixed Expenses,124003,59624.0,72347,131971.0,-7968.0,-6.43,-0.05,High Risk
U735,2024,11,220487.0,Stable Salary & Decreasing Fixed Expenses,124003,59624.0,54407,114031.0,9972.0,8.04,-0.04,High Risk
U735,2024,12,230459.0,Stable Salary & Decreasing Fixed Expenses,124003,59624.0,53288,112912.0,11091.0,8.94,-0.03,High Risk
U736,2024,1,223322.0,Salary Increases & Fixed Expenses Remain Stable,166643,69390.0,127170,196560.0,-29917.0,-17.95,-0.04,High Risk
U736,2024,2,193405.0,Salary Increases & Fixed Expenses Remain Stable,166643,69390.0,122408,191798.0,-25155.0,-15.1,-0.01,High Risk
U736,2024,3,168250.0,Salary Increases & Fixed Expenses Remain Stable,166643,69390.0,140582,209972.0,-43329.0,-26.0,0.03,High Risk
U736,2024,4,124921.0,Salary Increases & Fixed Expenses Remain Stable,166643,69390.0,104227,173617.0,-6974.0,-4.18,0.02,High Risk
U736,2024,5,117947.0,Salary Increases & Fixed Expenses Remain Stable,176312,69390.0,108497,177887.0,-1575.0,-0.89,-0.04,High Risk
U736,2024,6,116372.0,Salary Increases & Fixed Expenses Remain Stable,176312,69390.0,106488,175878.0,434.0,0.25,0.04,High Risk
U736,2024,7,116806.0,Salary Increases & Fixed Expenses Remain Stable,176312,69390.0,109234,178624.0,-2312.0,-1.31,0.04,High Risk
U736,2024,8,114494.0,Salary Increases & Fixed Expenses Remain Stable,176312,69390.0,140275,209665.0,-33353.0,-18.92,0.04,High Risk
U736,2024,9,81141.0,Salary Increases & Fixed Expenses Remain Stable,176312,69390.0,137042,206432.0,-30120.0,-17.08,0.01,High Risk
U736,2024,10,51021.0,Salary Increases & Fixed Expenses Remain Stable,176312,69390.0,174564,243954.0,-67642.0,-38.36,-0.02,High Risk
U736,2024,11,-16621.0,Salary Increases & Fixed Expenses Remain Stable,176312,69390.0,134464,203854.0,-27542.0,-15.62,0.01,High Risk
U736,2024,12,-44163.0,Salary Increases & Fixed Expenses Remain Stable,176312,69390.0,147953,217343.0,-41031.0,-23.27,-0.02,High Risk
U737,2024,1,210490.0,Stable Salary & Increasing Fixed Expenses,85376,30268.0,65090,95358.0,-9982.0,-11.69,0.02,High Risk
U737,2024,2,200508.0,Stable Salary & Increasing Fixed Expenses,85376,30268.0,51958,82226.0,3150.0,3.69,-0.04,High Risk
U737,2024,3,203658.0,Stable Salary & Increasing Fixed Expenses,85376,30268.0,79811,110079.0,-24703.0,-28.93,-0.04,High Risk
U737,2024,4,178955.0,Stable Salary & Increasing Fixed Expenses,85376,30268.0,56665,86933.0,-1557.0,-1.82,0.03,High Risk
U737,2024,5,177398.0,Stable Salary & Increasing Fixed Expenses,85376,30268.0,53880,84148.0,1228.0,1.44,-0.02,High Risk
U737,2024,6,178626.0,Stable Salary & Increasing Fixed Expenses,85376,30914.0,64025,94939.0,-9563.0,-11.2,0.02,High Risk
U737,2024,7,169063.0,Stable Salary & Increasing Fixed Expenses,85376,30914.0,63227,94141.0,-8765.0,-10.27,-0.03,High Risk
U737,2024,8,160298.0,Stable Salary & Increasing Fixed Expenses,85376,31554.0,54282,85836.0,-460.0,-0.54,0.04,High Risk
U737,2024,9,159838.0,Stable Salary & Increasing Fixed Expenses,85376,31554.0,65854,97408.0,-12032.0,-14.09,0.02,High Risk
U737,2024,10,147806.0,Stable Salary & Increasing Fixed Expenses,85376,33003.0,65720,98723.0,-13347.0,-15.63,-0.0,High Risk
U737,2024,11,134459.0,Stable Salary & Increasing Fixed Expenses,85376,33003.0,65699,98702.0,-13326.0,-15.61,0.02,High Risk
U737,2024,12,121133.0,Stable Salary & Increasing Fixed Expenses,85376,33003.0,62827,95830.0,-10454.0,-12.24,-0.02,High Risk
U738,2024,1,224841.0,Salary Increases & Fixed Expenses Remain Stable,93628,27077.0,28311,55388.0,38240.0,40.84,-0.04,Low Risk
U738,2024,2,263081.0,Salary Increases & Fixed Expenses Remain Stable,93628,27077.0,29957,57034.0,36594.0,39.08,0.01,Low Risk
U738,2024,3,299675.0,Salary Increases & Fixed Expenses Remain Stable,93628,27077.0,34140,61217.0,32411.0,34.62,-0.03,Low Risk
U738,2024,4,332086.0,Salary Increases & Fixed Expenses Remain Stable,93628,27077.0,33656,60733.0,32895.0,35.13,0.01,Low Risk
U738,2024,5,364981.0,Salary Increases & Fixed Expenses Remain Stable,114798,27077.0,35021,62098.0,52700.0,45.91,-0.0,Low Risk
U738,2024,6,417681.0,Salary Increases & Fixed Expenses Remain Stable,114798,27077.0,36109,63186.0,51612.0,44.96,-0.02,Low Risk
U738,2024,7,469293.0,Salary Increases & Fixed Expenses Remain Stable,114798,27077.0,44556,71633.0,43165.0,37.6,-0.05,Low Risk
U738,2024,8,512458.0,Salary Increases & Fixed Expenses Remain Stable,114798,27077.0,42160,69237.0,45561.0,39.69,0.04,Low Risk
U738,2024,9,558019.0,Salary Increases & Fixed Expenses Remain Stable,114798,27077.0,35546,62623.0,52175.0,45.45,0.04,Low Risk
U738,2024,10,610194.0,Salary Increases & Fixed Expenses Remain Stable,114798,27077.0,51875,78952.0,35846.0,31.23,-0.05,Low Risk
U738,2024,11,646040.0,Salary Increases & Fixed Expenses Remain Stable,114798,27077.0,35346,62423.0,52375.0,45.62,0.02,Low Risk
U738,2024,12,698415.0,Salary Increases & Fixed Expenses Remain Stable,114798,27077.0,36722,63799.0,50999.0,44.42,-0.02,Low Risk
U739,2024,1,231402.0,Salary Increases & Fixed Expenses Remain Stable,37071,21498.0,12257,33755.0,3316.0,8.94,0.04,High Risk
U739,2024,2,234718.0,Salary Increases & Fixed Expenses Remain Stable,37071,21498.0,12805,34303.0,2768.0,7.47,0.03,High Risk
U739,2024,3,237486.0,Salary Increases & Fixed Expenses Remain Stable,37071,21498.0,15328,36826.0,245.0,0.66,-0.03,High Risk
U739,2024,4,237731.0,Salary Increases & Fixed Expenses Remain Stable,37071,21498.0,14285,35783.0,1288.0,3.47,0.05,High Risk
U739,2024,5,239019.0,Salary Increases & Fixed Expenses Remain Stable,37071,21498.0,13835,35333.0,1738.0,4.69,-0.03,High Risk
U739,2024,6,240757.0,Salary Increases & Fixed Expenses Remain Stable,44299,21498.0,15623,37121.0,7178.0,16.2,0.02,Medium Risk
U739,2024,7,247935.0,Salary Increases & Fixed Expenses Remain Stable,44299,21498.0,15390,36888.0,7411.0,16.73,0.01,Medium Risk
U739,2024,8,255346.0,Salary Increases & Fixed Expenses Remain Stable,44299,21498.0,15973,37471.0,6828.0,15.41,0.01,Medium Risk
U739,2024,9,262174.0,Salary Increases & Fixed Expenses Remain Stable,44299,21498.0,16678,38176.0,6123.0,13.82,0.01,High Risk
U739,2024,10,268297.0,Salary Increases & Fixed Expenses Remain Stable,44299,21498.0,15979,37477.0,6822.0,15.4,-0.01,Medium Risk
U739,2024,11,275119.0,Salary Increases & Fixed Expenses Remain Stable,44299,21498.0,13660,35158.0,9141.0,20.63,0.02,Medium Risk
U739,2024,12,284260.0,Salary Increases & Fixed Expenses Remain Stable,44299,21498.0,13448,34946.0,9353.0,21.11,-0.02,Medium Risk
U740,2024,1,225937.0,Salary Increases & Fixed Expenses Remain Stable,34979,17512.0,12630,30142.0,4837.0,13.83,-0.0,High Risk
U740,2024,2,230774.0,Salary Increases & Fixed Expenses Remain Stable,34979,17512.0,10511,28023.0,6956.0,19.89,-0.0,Medium Risk
U740,2024,3,237730.0,Salary Increases & Fixed Expenses Remain Stable,34979,17512.0,14709,32221.0,2758.0,7.88,-0.01,High Risk
U740,2024,4,240488.0,Salary Increases & Fixed Expenses Remain Stable,34979,17512.0,13554,31066.0,3913.0,11.19,0.01,High Risk
U740,2024,5,244401.0,Salary Increases & Fixed Expenses Remain Stable,43440,17512.0,13664,31176.0,12264.0,28.23,-0.02,Low Risk
U740,2024,6,256665.0,Salary Increases & Fixed Expenses Remain Stable,43440,17512.0,16499,34011.0,9429.0,21.71,-0.02,Medium Risk
U740,2024,7,266094.0,Salary Increases & Fixed Expenses Remain Stable,43440,17512.0,17269,34781.0,8659.0,19.93,0.03,Medium Risk
U740,2024,8,274753.0,Salary Increases & Fixed Expenses Remain Stable,43440,17512.0,16612,34124.0,9316.0,21.45,-0.0,Medium Risk
U740,2024,9,284069.0,Salary Increases & Fixed Expenses Remain Stable,43440,17512.0,14431,31943.0,11497.0,26.47,0.05,Low Risk
U740,2024,10,295566.0,Salary Increases & Fixed Expenses Remain Stable,43440,17512.0,19121,36633.0,6807.0,15.67,-0.02,Medium Risk
U740,2024,11,302373.0,Salary Increases & Fixed Expenses Remain Stable,43440,17512.0,13839,31351.0,12089.0,27.83,0.03,Low Risk
U740,2024,12,314462.0,Salary Increases & Fixed Expenses Remain Stable,43440,17512.0,17065,34577.0,8863.0,20.4,0.04,Medium Risk
U741,2024,1,209475.0,Salary Increases & Fixed Expenses Decrease,40805,16559.0,16717,33276.0,7529.0,18.45,-0.02,Medium Risk
U741,2024,2,217004.0,Salary Increases & Fixed Expenses Decrease,40805,16559.0,22775,39334.0,1471.0,3.6,0.0,High Risk
U741,2024,3,218475.0,Salary Increases & Fixed Expenses Decrease,40805,16559.0,24238,40797.0,8.0,0.02,0.02,High Risk
U741,2024,4,218483.0,Salary Increases & Fixed Expenses Decrease,40805,16559.0,21027,37586.0,3219.0,7.89,0.05,High Risk
U741,2024,5,221702.0,Salary Increases & Fixed Expenses Decrease,40805,16559.0,17658,34217.0,6588.0,16.15,-0.0,Medium Risk
U741,2024,6,228290.0,Salary Increases & Fixed Expenses Decrease,40805,16559.0,24192,40751.0,54.0,0.13,-0.02,High Risk
U741,2024,7,228344.0,Salary Increases & Fixed Expenses Decrease,62096,16559.0,29817,46376.0,15720.0,25.32,-0.04,Low Risk
U741,2024,8,244064.0,Salary Increases & Fixed Expenses Decrease,62096,16559.0,29964,46523.0,15573.0,25.08,-0.02,Low Risk
U741,2024,9,259637.0,Salary Increases & Fixed Expenses Decrease,62096,16559.0,27932,44491.0,17605.0,28.35,0.03,Low Risk
U741,2024,10,277242.0,Salary Increases & Fixed Expenses Decrease,62096,16559.0,34494,51053.0,11043.0,17.78,0.03,Medium Risk
U741,2024,11,288285.0,Salary Increases & Fixed Expenses Decrease,62096,16559.0,35441,52000.0,10096.0,16.26,0.04,Medium Risk
U741,2024,12,298381.0,Salary Increases & Fixed Expenses Decrease,62096,16559.0,28566,45125.0,16971.0,27.33,0.04,Low Risk
U742,2024,1,219546.0,Stable Salary & Stable Fixed Expenses,125149,74039.0,48529,122568.0,2581.0,2.06,-0.04,High Risk
U742,2024,2,222127.0,Stable Salary & Stable Fixed Expenses,125149,74039.0,38857,112896.0,12253.0,9.79,0.01,High Risk
U742,2024,3,234380.0,Stable Salary & Stable Fixed Expenses,125149,74039.0,51806,125845.0,-696.0,-0.56,-0.04,High Risk
U742,2024,4,233684.0,Stable Salary & Stable Fixed Expenses,125149,74039.0,43967,118006.0,7143.0,5.71,0.02,High Risk
U742,2024,5,240827.0,Stable Salary & Stable Fixed Expenses,125149,74039.0,45031,119070.0,6079.0,4.86,0.02,High Risk
U742,2024,6,246906.0,Stable Salary & Stable Fixed Expenses,125149,74039.0,49158,123197.0,1952.0,1.56,-0.0,High Risk
U742,2024,7,248858.0,Stable Salary & Stable Fixed Expenses,125149,74039.0,47563,121602.0,3547.0,2.83,0.01,High Risk
U742,2024,8,252405.0,Stable Salary & Stable Fixed Expenses,125149,74039.0,44953,118992.0,6157.0,4.92,-0.01,High Risk
U742,2024,9,258562.0,Stable Salary & Stable Fixed Expenses,125149,74039.0,50189,124228.0,921.0,0.74,0.04,High Risk
U742,2024,10,259483.0,Stable Salary & Stable Fixed Expenses,125149,74039.0,46472,120511.0,4638.0,3.71,-0.02,High Risk
U742,2024,11,264121.0,Stable Salary & Stable Fixed Expenses,125149,74039.0,43727,117766.0,7383.0,5.9,0.02,High Risk
U742,2024,12,271504.0,Stable Salary & Stable Fixed Expenses,125149,74039.0,52057,126096.0,-947.0,-0.76,-0.04,High Risk
U743,2024,1,224188.0,Salary Increases & Fixed Expenses Increase,110905,76832.0,61172,138004.0,-27099.0,-24.43,-0.01,High Risk
U743,2024,2,197089.0,Salary Increases & Fixed Expenses Increase,110905,76832.0,53905,130737.0,-19832.0,-17.88,0.04,High Risk
U743,2024,3,177257.0,Salary Increases & Fixed Expenses Increase,139701,76832.0,80436,157268.0,-17567.0,-12.57,0.03,High Risk
U743,2024,4,159690.0,Salary Increases & Fixed Expenses Increase,139701,76832.0,69031,145863.0,-6162.0,-4.41,0.03,High Risk
U743,2024,5,153528.0,Salary Increases & Fixed Expenses Increase,139701,76832.0,64520,141352.0,-1651.0,-1.18,-0.03,High Risk
U743,2024,6,151877.0,Salary Increases & Fixed Expenses Increase,139701,78140.0,82584,160724.0,-21023.0,-15.05,0.01,High Risk
U743,2024,7,130854.0,Salary Increases & Fixed Expenses Increase,139701,78140.0,72114,150254.0,-10553.0,-7.55,-0.05,High Risk
U743,2024,8,120301.0,Salary Increases & Fixed Expenses Increase,139701,78140.0,78824,156964.0,-17263.0,-12.36,-0.02,High Risk
U743,2024,9,103038.0,Salary Increases & Fixed Expenses Increase,139701,78140.0,81513,159653.0,-19952.0,-14.28,-0.01,High Risk
U743,2024,10,83086.0,Salary Increases & Fixed Expenses Increase,139701,78643.0,75178,153821.0,-14120.0,-10.11,-0.02,High Risk
U743,2024,11,68966.0,Salary Increases & Fixed Expenses Increase,139701,78643.0,61066,139709.0,-8.0,-0.01,-0.03,High Risk
U743,2024,12,68958.0,Salary Increases & Fixed Expenses Increase,139701,79808.0,70309,150117.0,-10416.0,-7.46,-0.02,High Risk
U744,2024,1,230963.0,Stable Salary & Decreasing Fixed Expenses,211007,72637.0,90215,162852.0,48155.0,22.82,0.02,Medium Risk
U744,2024,2,279118.0,Stable Salary & Decreasing Fixed Expenses,211007,72637.0,109624,182261.0,28746.0,13.62,-0.03,High Risk
U744,2024,3,307864.0,Stable Salary & Decreasing Fixed Expenses,211007,72637.0,124849,197486.0,13521.0,6.41,-0.04,High Risk
U744,2024,4,321385.0,Stable Salary & Decreasing Fixed Expenses,211007,72637.0,99690,172327.0,38680.0,18.33,0.02,Medium Risk
U744,2024,5,360065.0,Stable Salary & Decreasing Fixed Expenses,211007,72637.0,124372,197009.0,13998.0,6.63,-0.03,High Risk
U744,2024,6,374063.0,Stable Salary & Decreasing Fixed Expenses,211007,72637.0,91981,164618.0,46389.0,21.98,-0.0,Medium Risk
U744,2024,7,420452.0,Stable Salary & Decreasing Fixed Expenses,211007,72637.0,116657,189294.0,21713.0,10.29,0.04,High Risk
U744,2024,8,442165.0,Stable Salary & Decreasing Fixed Expenses,211007,72637.0,117138,189775.0,21232.0,10.06,-0.02,High Risk
U744,2024,9,463397.0,Stable Salary & Decreasing Fixed Expenses,211007,72637.0,130666,203303.0,7704.0,3.65,-0.03,High Risk
U744,2024,10,471101.0,Stable Salary & Decreasing Fixed Expenses,211007,72637.0,140454,213091.0,-2084.0,-0.99,0.02,High Risk
U744,2024,11,469017.0,Stable Salary & Decreasing Fixed Expenses,211007,72637.0,120534,193171.0,17836.0,8.45,-0.03,High Risk
U744,2024,12,486853.0,Stable Salary & Decreasing Fixed Expenses,211007,72637.0,145485,218122.0,-7115.0,-3.37,-0.01,High Risk
U745,2024,1,235539.0,Salary Increases & Fixed Expenses Remain Stable,210008,94923.0,115658,210581.0,-573.0,-0.27,-0.03,High Risk
U745,2024,2,234966.0,Salary Increases & Fixed Expenses Remain Stable,210008,94923.0,121204,216127.0,-6119.0,-2.91,0.04,High Risk
U745,2024,3,228847.0,Salary Increases & Fixed Expenses Remain Stable,216990,94923.0,108954,203877.0,13113.0,6.04,-0.05,High Risk
U745,2024,4,241960.0,Salary Increases & Fixed Expenses Remain Stable,216990,94923.0,106910,201833.0,15157.0,6.99,0.01,High Risk
U745,2024,5,257117.0,Salary Increases & Fixed Expenses Remain Stable,216990,94923.0,90049,184972.0,32018.0,14.76,-0.01,High Risk
U745,2024,6,289135.0,Salary Increases & Fixed Expenses Remain Stable,216990,94923.0,95655,190578.0,26412.0,12.17,0.02,High Risk
U745,2024,7,315547.0,Salary Increases & Fixed Expenses Remain Stable,216990,94923.0,100672,195595.0,21395.0,9.86,0.0,High Risk
U745,2024,8,336942.0,Salary Increases & Fixed Expenses Remain Stable,216990,94923.0,103504,198427.0,18563.0,8.55,-0.0,High Risk
U745,2024,9,355505.0,Salary Increases & Fixed Expenses Remain Stable,216990,94923.0,125475,220398.0,-3408.0,-1.57,-0.0,High Risk
U745,2024,10,352097.0,Salary Increases & Fixed Expenses Remain Stable,216990,94923.0,125373,220296.0,-3306.0,-1.52,-0.02,High Risk
U745,2024,11,348791.0,Salary Increases & Fixed Expenses Remain Stable,216990,94923.0,111768,206691.0,10299.0,4.75,-0.04,High Risk
U745,2024,12,359090.0,Salary Increases & Fixed Expenses Remain Stable,216990,94923.0,102140,197063.0,19927.0,9.18,-0.05,High Risk
U746,2024,1,232236.0,Salary Increases & Fixed Expenses Remain Stable,53595,25188.0,35534,60722.0,-7127.0,-13.3,0.01,High Risk
U746,2024,2,225109.0,Salary Increases & Fixed Expenses Remain Stable,53595,25188.0,40365,65553.0,-11958.0,-22.31,-0.04,High Risk
U746,2024,3,213151.0,Salary Increases & Fixed Expenses Remain Stable,53595,25188.0,37043,62231.0,-8636.0,-16.11,-0.02,High Risk
U746,2024,4,204515.0,Salary Increases & Fixed Expenses Remain Stable,53595,25188.0,34421,59609.0,-6014.0,-11.22,-0.03,High Risk
U746,2024,5,198501.0,Salary Increases & Fixed Expenses Remain Stable,53595,25188.0,35163,60351.0,-6756.0,-12.61,-0.05,High Risk
U746,2024,6,191745.0,Salary Increases & Fixed Expenses Remain Stable,53595,25188.0,34078,59266.0,-5671.0,-10.58,-0.02,High Risk
U746,2024,7,186074.0,Salary Increases & Fixed Expenses Remain Stable,53595,25188.0,34039,59227.0,-5632.0,-10.51,-0.03,High Risk
U746,2024,8,180442.0,Salary Increases & Fixed Expenses Remain Stable,74852,25188.0,57085,82273.0,-7421.0,-9.91,0.02,High Risk
U746,2024,9,173021.0,Salary Increases & Fixed Expenses Remain Stable,74852,25188.0,53432,78620.0,-3768.0,-5.03,-0.04,High Risk
U746,2024,10,169253.0,Salary Increases & Fixed Expenses Remain Stable,74852,25188.0,58155,83343.0,-8491.0,-11.34,-0.04,High Risk
U746,2024,11,160762.0,Salary Increases & Fixed Expenses Remain Stable,74852,25188.0,59784,84972.0,-10120.0,-13.52,0.02,High Risk
U746,2024,12,150642.0,Salary Increases & Fixed Expenses Remain Stable,74852,25188.0,49626,74814.0,38.0,0.05,0.0,High Risk
U747,2024,1,209685.0,Salary Increases & Fixed Expenses Remain Stable,78036,28013.0,40852,68865.0,9171.0,11.75,0.04,High Risk
U747,2024,2,218856.0,Salary Increases & Fixed Expenses Remain Stable,78036,28013.0,45984,73997.0,4039.0,5.18,-0.03,High Risk
U747,2024,3,222895.0,Salary Increases & Fixed Expenses Remain Stable,78036,28013.0,43932,71945.0,6091.0,7.81,0.05,High Risk
U747,2024,4,228986.0,Salary Increases & Fixed Expenses Remain Stable,78036,28013.0,33648,61661.0,16375.0,20.98,0.0,Medium Risk
U747,2024,5,245361.0,Salary Increases & Fixed Expenses Remain Stable,78036,28013.0,40654,68667.0,9369.0,12.01,-0.01,High Risk
U747,2024,6,254730.0,Salary Increases & Fixed Expenses Remain Stable,78036,28013.0,46313,74326.0,3710.0,4.75,0.03,High Risk
U747,2024,7,258440.0,Salary Increases & Fixed Expenses Remain Stable,78036,28013.0,35966,63979.0,14057.0,18.01,-0.01,Medium Risk
U747,2024,8,272497.0,Salary Increases & Fixed Expenses Remain Stable,102933,28013.0,44037,72050.0,30883.0,30.0,0.05,Low Risk
U747,2024,9,303380.0,Salary Increases & Fixed Expenses Remain Stable,102933,28013.0,67337,95350.0,7583.0,7.37,0.03,High Risk
U747,2024,10,310963.0,Salary Increases & Fixed Expenses Remain Stable,102933,28013.0,53450,81463.0,21470.0,20.86,-0.04,Medium Risk
U747,2024,11,332433.0,Salary Increases & Fixed Expenses Remain Stable,102933,28013.0,56648,84661.0,18272.0,17.75,-0.02,Medium Risk
U747,2024,12,350705.0,Salary Increases & Fixed Expenses Remain Stable,102933,28013.0,59885,87898.0,15035.0,14.61,0.04,High Risk
U748,2024,1,225840.0,Stable Salary & Increasing Fixed Expenses,91707,34387.0,67024,101411.0,-9704.0,-10.58,0.01,High Risk
U748,2024,2,216136.0,Stable Salary & Increasing Fixed Expenses,91707,34387.0,61308,95695.0,-3988.0,-4.35,-0.03,High Risk
U748,2024,3,212148.0,Stable Salary & Increasing Fixed Expenses,91707,34387.0,61800,96187.0,-4480.0,-4.89,0.01,High Risk
U748,2024,4,207668.0,Stable Salary & Increasing Fixed Expenses,91707,34387.0,70205,104592.0,-12885.0,-14.05,-0.01,High Risk
U748,2024,5,194783.0,Stable Salary & Increasing Fixed Expenses,91707,34387.0,62227,96614.0,-4907.0,-5.35,-0.03,High Risk
U748,2024,6,189876.0,Stable Salary & Increasing Fixed Expenses,91707,35821.0,59514,95335.0,-3628.0,-3.96,-0.02,High Risk
U748,2024,7,186248.0,Stable Salary & Increasing Fixed Expenses,91707,35821.0,60934,96755.0,-5048.0,-5.5,0.02,High Risk
U748,2024,8,181200.0,Stable Salary & Increasing Fixed Expenses,91707,37389.0,60559,97948.0,-6241.0,-6.81,-0.02,High Risk
U748,2024,9,174959.0,Stable Salary & Increasing Fixed Expenses,91707,37389.0,69963,107352.0,-15645.0,-17.06,-0.03,High Risk
U748,2024,10,159314.0,Stable Salary & Increasing Fixed Expenses,91707,37389.0,55239,92628.0,-921.0,-1.0,0.04,High Risk
U748,2024,11,158393.0,Stable Salary & Increasing Fixed Expenses,91707,37389.0,65259,102648.0,-10941.0,-11.93,0.03,High Risk
U748,2024,12,147452.0,Stable Salary & Increasing Fixed Expenses,91707,37389.0,63304,100693.0,-8986.0,-9.8,0.02,High Risk
U749,2024,1,222281.0,Stable Salary & Stable Fixed Expenses,164512,79204.0,68727,147931.0,16581.0,10.08,0.04,High Risk
U749,2024,2,238862.0,Stable Salary & Stable Fixed Expenses,164512,79204.0,96495,175699.0,-11187.0,-6.8,-0.03,High Risk
U749,2024,3,227675.0,Stable Salary & Stable Fixed Expenses,164512,79204.0,88405,167609.0,-3097.0,-1.88,0.04,High Risk
U749,2024,4,224578.0,Stable Salary & Stable Fixed Expenses,164512,79204.0,66884,146088.0,18424.0,11.2,0.02,High Risk
U749,2024,5,243002.0,Stable Salary & Stable Fixed Expenses,164512,79204.0,70126,149330.0,15182.0,9.23,0.02,High Risk
U749,2024,6,258184.0,Stable Salary & Stable Fixed Expenses,164512,79204.0,90579,169783.0,-5271.0,-3.2,0.05,High Risk
U749,2024,7,252913.0,Stable Salary & Stable Fixed Expenses,164512,79204.0,85632,164836.0,-324.0,-0.2,0.03,High Risk
U749,2024,8,252589.0,Stable Salary & Stable Fixed Expenses,164512,79204.0,66622,145826.0,18686.0,11.36,-0.01,High Risk
U749,2024,9,271275.0,Stable Salary & Stable Fixed Expenses,164512,79204.0,81143,160347.0,4165.0,2.53,-0.01,High Risk
U749,2024,10,275440.0,Stable Salary & Stable Fixed Expenses,164512,79204.0,79335,158539.0,5973.0,3.63,0.0,High Risk
U749,2024,11,281413.0,Stable Salary & Stable Fixed Expenses,164512,79204.0,79934,159138.0,5374.0,3.27,0.01,High Risk
U749,2024,12,286787.0,Stable Salary & Stable Fixed Expenses,164512,79204.0,81549,160753.0,3759.0,2.28,0.03,High Risk
U750,2024,1,213286.0,Salary Increases & Fixed Expenses Increase,207692,109446.0,112413,221859.0,-14167.0,-6.82,-0.03,High Risk
U750,2024,2,199119.0,Salary Increases & Fixed Expenses Increase,207692,109446.0,83352,192798.0,14894.0,7.17,0.02,High Risk
U750,2024,3,214013.0,Salary Increases & Fixed Expenses Increase,232915,109446.0,136446,245892.0,-12977.0,-5.57,0.01,High Risk
U750,2024,4,201036.0,Salary Increases & Fixed Expenses Increase,232915,109446.0,94091,203537.0,29378.0,12.61,-0.02,High Risk
U750,2024,5,230414.0,Salary Increases & Fixed Expenses Increase,232915,109446.0,110248,219694.0,13221.0,5.68,-0.0,High Risk
U750,2024,6,243635.0,Salary Increases & Fixed Expenses Increase,232915,109446.0,107821,217267.0,15648.0,6.72,-0.02,High Risk
U750,2024,7,259283.0,Salary Increases & Fixed Expenses Increase,232915,109446.0,132086,241532.0,-8617.0,-3.7,0.0,High Risk
U750,2024,8,250666.0,Salary Increases & Fixed Expenses Increase,232915,109446.0,97946,207392.0,25523.0,10.96,-0.01,High Risk
U750,2024,9,276189.0,Salary Increases & Fixed Expenses Increase,232915,109446.0,132103,241549.0,-8634.0,-3.71,0.04,High Risk
U750,2024,10,267555.0,Salary Increases & Fixed Expenses Increase,232915,110358.0,168370,278728.0,-45813.0,-19.67,-0.05,High Risk
U750,2024,11,221742.0,Salary Increases & Fixed Expenses Increase,232915,110358.0,109308,219666.0,13249.0,5.69,0.01,High Risk
U750,2024,12,234991.0,Salary Increases & Fixed Expenses Increase,232915,110358.0,103410,213768.0,19147.0,8.22,-0.02,High Risk
U751,2024,1,216516.0,Salary Increases & Fixed Expenses Remain Stable,204298,66748.0,82632,149380.0,54918.0,26.88,-0.04,Low Risk
U751,2024,2,271434.0,Salary Increases & Fixed Expenses Remain Stable,204298,66748.0,102877,169625.0,34673.0,16.97,0.04,Medium Risk
U751,2024,3,306107.0,Salary Increases & Fixed Expenses Remain Stable,204298,66748.0,126721,193469.0,10829.0,5.3,0.01,High Risk
U751,2024,4,316936.0,Salary Increases & Fixed Expenses Remain Stable,204298,66748.0,93540,160288.0,44010.0,21.54,-0.03,Medium Risk
U751,2024,5,360946.0,Salary Increases & Fixed Expenses Remain Stable,210181,66748.0,116480,183228.0,26953.0,12.82,0.04,High Risk
U751,2024,6,387899.0,Salary Increases & Fixed Expenses Remain Stable,210181,66748.0,101253,168001.0,42180.0,20.07,0.05,Medium Risk
U751,2024,7,430079.0,Salary Increases & Fixed Expenses Remain Stable,210181,66748.0,87607,154355.0,55826.0,26.56,-0.01,Low Risk
U751,2024,8,485905.0,Salary Increases & Fixed Expenses Remain Stable,210181,66748.0,118226,184974.0,25207.0,11.99,0.03,High Risk
U751,2024,9,511112.0,Salary Increases & Fixed Expenses Remain Stable,210181,66748.0,115430,182178.0,28003.0,13.32,-0.01,High Risk
U751,2024,10,539115.0,Salary Increases & Fixed Expenses Remain Stable,210181,66748.0,135145,201893.0,8288.0,3.94,-0.03,High Risk
U751,2024,11,547403.0,Salary Increases & Fixed Expenses Remain Stable,210181,66748.0,110018,176766.0,33415.0,15.9,0.0,Medium Risk
U751,2024,12,580818.0,Salary Increases & Fixed Expenses Remain Stable,210181,66748.0,85189,151937.0,58244.0,27.71,-0.03,Low Risk
U752,2024,1,236809.0,Salary Increases & Fixed Expenses Decrease,27727,12402.0,17492,29894.0,-2167.0,-7.82,-0.0,High Risk
U752,2024,2,234642.0,Salary Increases & Fixed Expenses Decrease,27727,12402.0,17082,29484.0,-1757.0,-6.34,-0.05,High Risk
U752,2024,3,232885.0,Salary Increases & Fixed Expenses Decrease,27727,12402.0,20367,32769.0,-5042.0,-18.18,-0.04,High Risk
U752,2024,4,227843.0,Salary Increases & Fixed Expenses Decrease,27727,12402.0,19974,32376.0,-4649.0,-16.77,-0.01,High Risk
U752,2024,5,223194.0,Salary Increases & Fixed Expenses Decrease,39210,12402.0,29390,41792.0,-2582.0,-6.59,-0.03,High Risk
U752,2024,6,220612.0,Salary Increases & Fixed Expenses Decrease,39210,12402.0,23791,36193.0,3017.0,7.69,0.02,High Risk
U752,2024,7,223629.0,Salary Increases & Fixed Expenses Decrease,39210,12402.0,25108,37510.0,1700.0,4.34,-0.03,High Risk
U752,2024,8,225329.0,Salary Increases & Fixed Expenses Decrease,39210,12402.0,27007,39409.0,-199.0,-0.51,-0.04,High Risk
U752,2024,9,225130.0,Salary Increases & Fixed Expenses Decrease,39210,12402.0,28765,41167.0,-1957.0,-4.99,0.0,High Risk
U752,2024,10,223173.0,Salary Increases & Fixed Expenses Decrease,39210,12402.0,38991,51393.0,-12183.0,-31.07,-0.04,High Risk
U752,2024,11,210990.0,Salary Increases & Fixed Expenses Decrease,39210,12402.0,32349,44751.0,-5541.0,-14.13,-0.04,High Risk
U752,2024,12,205449.0,Salary Increases & Fixed Expenses Decrease,39210,12402.0,31602,44004.0,-4794.0,-12.23,0.01,High Risk
U753,2024,1,231466.0,Salary Increases & Fixed Expenses Remain Stable,209947,109186.0,116271,225457.0,-15510.0,-7.39,0.02,High Risk
U753,2024,2,215956.0,Salary Increases & Fixed Expenses Remain Stable,209947,109186.0,85583,194769.0,15178.0,7.23,-0.0,High Risk
U753,2024,3,231134.0,Salary Increases & Fixed Expenses Remain Stable,209947,109186.0,98928,208114.0,1833.0,0.87,0.0,High Risk
U753,2024,4,232967.0,Salary Increases & Fixed Expenses Remain Stable,209947,109186.0,97167,206353.0,3594.0,1.71,0.03,High Risk
U753,2024,5,236561.0,Salary Increases & Fixed Expenses Remain Stable,226461,109186.0,92438,201624.0,24837.0,10.97,-0.04,High Risk
U753,2024,6,261398.0,Salary Increases & Fixed Expenses Remain Stable,226461,109186.0,119841,229027.0,-2566.0,-1.13,-0.02,High Risk
U753,2024,7,258832.0,Salary Increases & Fixed Expenses Remain Stable,226461,109186.0,95833,205019.0,21442.0,9.47,-0.04,High Risk
U753,2024,8,280274.0,Salary Increases & Fixed Expenses Remain Stable,226461,109186.0,133452,242638.0,-16177.0,-7.14,0.03,High Risk
U753,2024,9,264097.0,Salary Increases & Fixed Expenses Remain Stable,226461,109186.0,134577,243763.0,-17302.0,-7.64,0.02,High Risk
U753,2024,10,246795.0,Salary Increases & Fixed Expenses Remain Stable,226461,109186.0,111322,220508.0,5953.0,2.63,0.04,High Risk
U753,2024,11,252748.0,Salary Increases & Fixed Expenses Remain Stable,226461,109186.0,104059,213245.0,13216.0,5.84,-0.0,High Risk
U753,2024,12,265964.0,Salary Increases & Fixed Expenses Remain Stable,226461,109186.0,122127,231313.0,-4852.0,-2.14,-0.01,High Risk
U754,2024,1,214142.0,Salary Increases & Fixed Expenses Decrease,147974,73897.0,74849,148746.0,-772.0,-0.52,-0.02,High Risk
U754,2024,2,213370.0,Salary Increases & Fixed Expenses Decrease,147974,73897.0,86996,160893.0,-12919.0,-8.73,0.02,High Risk
U754,2024,3,200451.0,Salary Increases & Fixed Expenses Decrease,147974,73897.0,87603,161500.0,-13526.0,-9.14,0.02,High Risk
U754,2024,4,186925.0,Salary Increases & Fixed Expenses Decrease,165833,73897.0,81755,155652.0,10181.0,6.14,-0.03,High Risk
U754,2024,5,197106.0,Salary Increases & Fixed Expenses Decrease,165833,73897.0,67510,141407.0,24426.0,14.73,-0.04,High Risk
U754,2024,6,221532.0,Salary Increases & Fixed Expenses Decrease,165833,73897.0,98634,172531.0,-6698.0,-4.04,0.0,High Risk
U754,2024,7,214834.0,Salary Increases & Fixed Expenses Decrease,165833,73897.0,80075,153972.0,11861.0,7.15,-0.03,High Risk
U754,2024,8,226695.0,Salary Increases & Fixed Expenses Decrease,165833,73897.0,83389,157286.0,8547.0,5.15,0.02,High Risk
U754,2024,9,235242.0,Salary Increases & Fixed Expenses Decrease,165833,73897.0,81022,154919.0,10914.0,6.58,0.02,High Risk
U754,2024,10,246156.0,Salary Increases & Fixed Expenses Decrease,165833,73897.0,101315,175212.0,-9379.0,-5.66,0.01,High Risk
U754,2024,11,236777.0,Salary Increases & Fixed Expenses Decrease,165833,73897.0,108000,181897.0,-16064.0,-9.69,0.03,High Risk
U754,2024,12,220713.0,Salary Increases & Fixed Expenses Decrease,165833,73897.0,114786,188683.0,-22850.0,-13.78,0.02,High Risk
U755,2024,1,215680.0,Salary Increases & Fixed Expenses Remain Stable,120599,64176.0,49354,113530.0,7069.0,5.86,-0.03,High Risk
U755,2024,2,222749.0,Salary Increases & Fixed Expenses Remain Stable,120599,64176.0,62887,127063.0,-6464.0,-5.36,-0.01,High Risk
U755,2024,3,216285.0,Salary Increases & Fixed Expenses Remain Stable,134378,64176.0,74196,138372.0,-3994.0,-2.97,0.01,High Risk
U755,2024,4,212291.0,Salary Increases & Fixed Expenses Remain Stable,134378,64176.0,53884,118060.0,16318.0,12.14,-0.0,High Risk
U755,2024,5,228609.0,Salary Increases & Fixed Expenses Remain Stable,134378,64176.0,57932,122108.0,12270.0,9.13,-0.0,High Risk
U755,2024,6,240879.0,Salary Increases & Fixed Expenses Remain Stable,134378,64176.0,67534,131710.0,2668.0,1.99,-0.02,High Risk
U755,2024,7,243547.0,Salary Increases & Fixed Expenses Remain Stable,134378,64176.0,78926,143102.0,-8724.0,-6.49,-0.03,High Risk
U755,2024,8,234823.0,Salary Increases & Fixed Expenses Remain Stable,134378,64176.0,54652,118828.0,15550.0,11.57,-0.01,High Risk
U755,2024,9,250373.0,Salary Increases & Fixed Expenses Remain Stable,134378,64176.0,59501,123677.0,10701.0,7.96,0.04,High Risk
U755,2024,10,261074.0,Salary Increases & Fixed Expenses Remain Stable,134378,64176.0,77342,141518.0,-7140.0,-5.31,0.04,High Risk
U755,2024,11,253934.0,Salary Increases & Fixed Expenses Remain Stable,134378,64176.0,74809,138985.0,-4607.0,-3.43,-0.01,High Risk
U755,2024,12,249327.0,Salary Increases & Fixed Expenses Remain Stable,134378,64176.0,62854,127030.0,7348.0,5.47,-0.03,High Risk
U756,2024,1,249943.0,Stable Salary & Increasing Fixed Expenses,283669,102228.0,97190,199418.0,84251.0,29.7,0.01,Low Risk
U756,2024,2,334194.0,Stable Salary & Increasing Fixed Expenses,283669,102228.0,107449,209677.0,73992.0,26.08,-0.0,Low Risk
U756,2024,3,408186.0,Stable Salary & Increasing Fixed Expenses,283669,102228.0,106117,208345.0,75324.0,26.55,-0.03,Low Risk
U756,2024,4,483510.0,Stable Salary & Increasing Fixed Expenses,283669,102228.0,94576,196804.0,86865.0,30.62,-0.04,Low Risk
U756,2024,5,570375.0,Stable Salary & Increasing Fixed Expenses,283669,102228.0,101210,203438.0,80231.0,28.28,-0.01,Low Risk
U756,2024,6,650606.0,Stable Salary & Increasing Fixed Expenses,283669,102228.0,110739,212967.0,70702.0,24.92,0.03,Medium Risk
U756,2024,7,721308.0,Stable Salary & Increasing Fixed Expenses,283669,102228.0,93563,195791.0,87878.0,30.98,-0.04,Low Risk
U756,2024,8,809186.0,Stable Salary & Increasing Fixed Expenses,283669,102228.0,109368,211596.0,72073.0,25.41,0.03,Low Risk
U756,2024,9,881259.0,Stable Salary & Increasing Fixed Expenses,283669,102228.0,96604,198832.0,84837.0,29.91,-0.04,Low Risk
U756,2024,10,966096.0,Stable Salary & Increasing Fixed Expenses,283669,102228.0,102100,204328.0,79341.0,27.97,-0.03,Low Risk
U756,2024,11,1045437.0,Stable Salary & Increasing Fixed Expenses,283669,102228.0,112980,215208.0,68461.0,24.13,-0.03,Medium Risk
U756,2024,12,1113898.0,Stable Salary & Increasing Fixed Expenses,283669,102228.0,108221,210449.0,73220.0,25.81,0.02,Low Risk
U757,2024,1,204259.0,Salary Increases & Fixed Expenses Increase,257561,87898.0,116825,204723.0,52838.0,20.51,-0.0,Medium Risk
U757,2024,2,257097.0,Salary Increases & Fixed Expenses Increase,257561,89861.0,133704,223565.0,33996.0,13.2,0.04,High Risk
U757,2024,3,291093.0,Salary Increases & Fixed Expenses Increase,257561,89861.0,117654,207515.0,50046.0,19.43,0.0,Medium Risk
U757,2024,4,341139.0,Salary Increases & Fixed Expenses Increase,257561,89861.0,124787,214648.0,42913.0,16.66,-0.01,Medium Risk
U757,2024,5,384052.0,Salary Increases & Fixed Expenses Increase,257561,89861.0,114355,204216.0,53345.0,20.71,0.02,Medium Risk
U757,2024,6,437397.0,Salary Increases & Fixed Expenses Increase,274927,89861.0,141852,231713.0,43214.0,15.72,0.02,Medium Risk
U757,2024,7,480611.0,Salary Increases & Fixed Expenses Increase,274927,89861.0,113479,203340.0,71587.0,26.04,-0.03,Low Risk
U757,2024,8,552198.0,Salary Increases & Fixed Expenses Increase,274927,89861.0,164194,254055.0,20872.0,7.59,0.02,High Risk
U757,2024,9,573070.0,Salary Increases & Fixed Expenses Increase,274927,89861.0,122055,211916.0,63011.0,22.92,-0.04,Medium Risk
U757,2024,10,636081.0,Salary Increases & Fixed Expenses Increase,274927,89861.0,133306,223167.0,51760.0,18.83,-0.02,Medium Risk
U757,2024,11,687841.0,Salary Increases & Fixed Expenses Increase,274927,89861.0,121506,211367.0,63560.0,23.12,0.03,Medium Risk
U757,2024,12,751401.0,Salary Increases & Fixed Expenses Increase,274927,89861.0,156710,246571.0,28356.0,10.31,-0.01,High Risk
U758,2024,1,231278.0,Salary Increases & Fixed Expenses Remain Stable,112475,48182.0,41556,89738.0,22737.0,20.22,0.02,Medium Risk
U758,2024,2,254015.0,Salary Increases & Fixed Expenses Remain Stable,112475,48182.0,43853,92035.0,20440.0,18.17,-0.03,Medium Risk
U758,2024,3,274455.0,Salary Increases & Fixed Expenses Remain Stable,118714,48182.0,42112,90294.0,28420.0,23.94,0.05,Medium Risk
U758,2024,4,302875.0,Salary Increases & Fixed Expenses Remain Stable,118714,48182.0,35950,84132.0,34582.0,29.13,0.02,Low Risk
U758,2024,5,337457.0,Salary Increases & Fixed Expenses Remain Stable,118714,48182.0,46570,94752.0,23962.0,20.18,-0.02,Medium Risk
U758,2024,6,361419.0,Salary Increases & Fixed Expenses Remain Stable,118714,48182.0,42888,91070.0,27644.0,23.29,0.01,Medium Risk
U758,2024,7,389063.0,Salary Increases & Fixed Expenses Remain Stable,118714,48182.0,37963,86145.0,32569.0,27.43,-0.02,Low Risk
U758,2024,8,421632.0,Salary Increases & Fixed Expenses Remain Stable,118714,48182.0,37100,85282.0,33432.0,28.16,0.0,Low Risk
U758,2024,9,455064.0,Salary Increases & Fixed Expenses Remain Stable,118714,48182.0,40572,88754.0,29960.0,25.24,-0.01,Low Risk
U758,2024,10,485024.0,Salary Increases & Fixed Expenses Remain Stable,118714,48182.0,47361,95543.0,23171.0,19.52,0.0,Medium Risk
U758,2024,11,508195.0,Salary Increases & Fixed Expenses Remain Stable,118714,48182.0,47145,95327.0,23387.0,19.7,0.01,Medium Risk
U758,2024,12,531582.0,Salary Increases & Fixed Expenses Remain Stable,118714,48182.0,38776,86958.0,31756.0,26.75,0.04,Low Risk
U759,2024,1,228440.0,Salary Increases & Fixed Expenses Increase,241139,68397.0,153069,221466.0,19673.0,8.16,0.02,High Risk
U759,2024,2,248113.0,Salary Increases & Fixed Expenses Increase,241139,68397.0,151468,219865.0,21274.0,8.82,-0.04,High Risk
U759,2024,3,269387.0,Salary Increases & Fixed Expenses Increase,241139,68397.0,209737,278134.0,-36995.0,-15.34,0.02,High Risk
U759,2024,4,232392.0,Salary Increases & Fixed Expenses Increase,248105,69094.0,153122,222216.0,25889.0,10.43,-0.03,High Risk
U759,2024,5,258281.0,Salary Increases & Fixed Expenses Increase,248105,69094.0,173098,242192.0,5913.0,2.38,0.01,High Risk
U759,2024,6,264194.0,Salary Increases & Fixed Expenses Increase,248105,69094.0,176199,245293.0,2812.0,1.13,-0.04,High Risk
U759,2024,7,267006.0,Salary Increases & Fixed Expenses Increase,248105,70236.0,161281,231517.0,16588.0,6.69,0.01,High Risk
U759,2024,8,283594.0,Salary Increases & Fixed Expenses Increase,248105,70236.0,173849,244085.0,4020.0,1.62,-0.0,High Risk
U759,2024,9,287614.0,Salary Increases & Fixed Expenses Increase,248105,70236.0,174607,244843.0,3262.0,1.31,0.01,High Risk
U759,2024,10,290876.0,Salary Increases & Fixed Expenses Increase,248105,70236.0,187719,257955.0,-9850.0,-3.97,0.03,High Risk
U759,2024,11,281026.0,Salary Increases & Fixed Expenses Increase,248105,70236.0,162022,232258.0,15847.0,6.39,-0.03,High Risk
U759,2024,12,296873.0,Salary Increases & Fixed Expenses Increase,248105,70236.0,171632,241868.0,6237.0,2.51,-0.05,High Risk
U760,2024,1,239835.0,Salary Increases & Fixed Expenses Remain Stable,95739,24861.0,51221,76082.0,19657.0,20.53,0.01,Medium Risk
U760,2024,2,259492.0,Salary Increases & Fixed Expenses Remain Stable,95739,24861.0,51686,76547.0,19192.0,20.05,-0.02,Medium Risk
U760,2024,3,278684.0,Salary Increases & Fixed Expenses Remain Stable,95739,24861.0,55451,80312.0,15427.0,16.11,0.01,Medium Risk
U760,2024,4,294111.0,Salary Increases & Fixed Expenses Remain Stable,95739,24861.0,41540,66401.0,29338.0,30.64,-0.03,Low Risk
U760,2024,5,323449.0,Salary Increases & Fixed Expenses Remain Stable,95739,24861.0,56305,81166.0,14573.0,15.22,0.05,Medium Risk
U760,2024,6,338022.0,Salary Increases & Fixed Expenses Remain Stable,95739,24861.0,46803,71664.0,24075.0,25.15,0.03,Low Risk
U760,2024,7,362097.0,Salary Increases & Fixed Expenses Remain Stable,95739,24861.0,42573,67434.0,28305.0,29.56,-0.04,Low Risk
U760,2024,8,390402.0,Salary Increases & Fixed Expenses Remain Stable,107553,24861.0,59072,83933.0,23620.0,21.96,-0.01,Medium Risk
U760,2024,9,414022.0,Salary Increases & Fixed Expenses Remain Stable,107553,24861.0,49789,74650.0,32903.0,30.59,0.04,Low Risk
U760,2024,10,446925.0,Salary Increases & Fixed Expenses Remain Stable,107553,24861.0,54993,79854.0,27699.0,25.75,0.04,Low Risk
U760,2024,11,474624.0,Salary Increases & Fixed Expenses Remain Stable,107553,24861.0,52390,77251.0,30302.0,28.17,0.05,Low Risk
U760,2024,12,504926.0,Salary Increases & Fixed Expenses Remain Stable,107553,24861.0,50886,75747.0,31806.0,29.57,-0.02,Low Risk
U761,2024,1,240186.0,Salary Increases & Fixed Expenses Increase,252698,72529.0,112313,184842.0,67856.0,26.85,-0.03,Low Risk
U761,2024,2,308042.0,Salary Increases & Fixed Expenses Increase,252698,72529.0,139581,212110.0,40588.0,16.06,-0.0,Medium Risk
U761,2024,3,348630.0,Salary Increases & Fixed Expenses Increase,252698,73345.0,122451,195796.0,56902.0,22.52,-0.03,Medium Risk
U761,2024,4,405532.0,Salary Increases & Fixed Expenses Increase,252698,73345.0,102266,175611.0,77087.0,30.51,-0.02,Low Risk
U761,2024,5,482619.0,Salary Increases & Fixed Expenses Increase,252698,73345.0,112962,186307.0,66391.0,26.27,-0.03,Low Risk
U761,2024,6,549010.0,Salary Increases & Fixed Expenses Increase,259833,73345.0,116033,189378.0,70455.0,27.12,-0.01,Low Risk
U761,2024,7,619465.0,Salary Increases & Fixed Expenses Increase,259833,73345.0,146712,220057.0,39776.0,15.31,-0.02,Medium Risk
U761,2024,8,659241.0,Salary Increases & Fixed Expenses Increase,259833,75004.0,110575,185579.0,74254.0,28.58,-0.04,Low Risk
U761,2024,9,733495.0,Salary Increases & Fixed Expenses Increase,259833,75936.0,121995,197931.0,61902.0,23.82,0.0,Medium Risk
U761,2024,10,795397.0,Salary Increases & Fixed Expenses Increase,259833,75936.0,163590,239526.0,20307.0,7.82,0.02,High Risk
U761,2024,11,815704.0,Salary Increases & Fixed Expenses Increase,259833,76914.0,112261,189175.0,70658.0,27.19,0.03,Low Risk
U761,2024,12,886362.0,Salary Increases & Fixed Expenses Increase,259833,77879.0,125715,203594.0,56239.0,21.64,-0.01,Medium Risk
U762,2024,1,244461.0,Stable Salary & Increasing Fixed Expenses,59842,35863.0,19895,55758.0,4084.0,6.82,0.0,High Risk
U762,2024,2,248545.0,Stable Salary & Increasing Fixed Expenses,59842,35863.0,23310,59173.0,669.0,1.12,-0.01,High Risk
U762,2024,3,249214.0,Stable Salary & Increasing Fixed Expenses,59842,35863.0,24302,60165.0,-323.0,-0.54,-0.01,High Risk
U762,2024,4,248891.0,Stable Salary & Increasing Fixed Expenses,59842,35863.0,18653,54516.0,5326.0,8.9,0.05,High Risk
U762,2024,5,254217.0,Stable Salary & Increasing Fixed Expenses,59842,37640.0,23195,60835.0,-993.0,-1.66,-0.0,High Risk
U762,2024,6,253224.0,Stable Salary & Increasing Fixed Expenses,59842,37640.0,23128,60768.0,-926.0,-1.55,0.0,High Risk
U762,2024,7,252298.0,Stable Salary & Increasing Fixed Expenses,59842,37640.0,23514,61154.0,-1312.0,-2.19,-0.0,High Risk
U762,2024,8,250986.0,Stable Salary & Increasing Fixed Expenses,59842,37640.0,23594,61234.0,-1392.0,-2.33,-0.05,High Risk
U762,2024,9,249594.0,Stable Salary & Increasing Fixed Expenses,59842,37640.0,25743,63383.0,-3541.0,-5.92,0.03,High Risk
U762,2024,10,246053.0,Stable Salary & Increasing Fixed Expenses,59842,37640.0,23498,61138.0,-1296.0,-2.17,-0.02,High Risk
U762,2024,11,244757.0,Stable Salary & Increasing Fixed Expenses,59842,37640.0,19633,57273.0,2569.0,4.29,0.01,High Risk
U762,2024,12,247326.0,Stable Salary & Increasing Fixed Expenses,59842,37640.0,23706,61346.0,-1504.0,-2.51,-0.04,High Risk
U763,2024,1,231868.0,Stable Salary & Decreasing Fixed Expenses,276495,118093.0,194264,312357.0,-35862.0,-12.97,-0.05,High Risk
U763,2024,2,196006.0,Stable Salary & Decreasing Fixed Expenses,276495,118093.0,206001,324094.0,-47599.0,-17.22,0.02,High Risk
U763,2024,3,148407.0,Stable Salary & Decreasing Fixed Expenses,276495,118093.0,266653,384746.0,-108251.0,-39.15,0.04,High Risk
U763,2024,4,40156.0,Stable Salary & Decreasing Fixed Expenses,276495,118093.0,168605,286698.0,-10203.0,-3.69,-0.01,High Risk
U763,2024,5,29953.0,Stable Salary & Decreasing Fixed Expenses,276495,118093.0,205157,323250.0,-46755.0,-16.91,-0.03,High Risk
U763,2024,6,-16802.0,Stable Salary & Decreasing Fixed Expenses,276495,118093.0,192472,310565.0,-34070.0,-12.32,0.04,High Risk
U763,2024,7,-50872.0,Stable Salary & Decreasing Fixed Expenses,276495,118093.0,215134,333227.0,-56732.0,-20.52,-0.03,High Risk
U763,2024,8,-107604.0,Stable Salary & Decreasing Fixed Expenses,276495,118093.0,213785,331878.0,-55383.0,-20.03,0.0,High Risk
U763,2024,9,-162987.0,Stable Salary & Decreasing Fixed Expenses,276495,118093.0,245685,363778.0,-87283.0,-31.57,0.0,High Risk
U763,2024,10,-250270.0,Stable Salary & Decreasing Fixed Expenses,276495,118093.0,268913,387006.0,-110511.0,-39.97,0.04,High Risk
U763,2024,11,-360781.0,Stable Salary & Decreasing Fixed Expenses,276495,118093.0,208879,326972.0,-50477.0,-18.26,-0.05,High Risk
U763,2024,12,-411258.0,Stable Salary & Decreasing Fixed Expenses,276495,118093.0,210478,328571.0,-52076.0,-18.83,0.04,High Risk
U764,2024,1,207318.0,Stable Salary & Stable Fixed Expenses,77296,24799.0,27390,52189.0,25107.0,32.48,0.02,Low Risk
U764,2024,2,232425.0,Stable Salary & Stable Fixed Expenses,77296,24799.0,30864,55663.0,21633.0,27.99,-0.01,Low Risk
U764,2024,3,254058.0,Stable Salary & Stable Fixed Expenses,77296,24799.0,33356,58155.0,19141.0,24.76,-0.04,Medium Risk
U764,2024,4,273199.0,Stable Salary & Stable Fixed Expenses,77296,24799.0,25786,50585.0,26711.0,34.56,0.05,Low Risk
U764,2024,5,299910.0,Stable Salary & Stable Fixed Expenses,77296,24799.0,30894,55693.0,21603.0,27.95,0.02,Low Risk
U764,2024,6,321513.0,Stable Salary & Stable Fixed Expenses,77296,24799.0,28457,53256.0,24040.0,31.1,0.04,Low Risk
U764,2024,7,345553.0,Stable Salary & Stable Fixed Expenses,77296,24799.0,27156,51955.0,25341.0,32.78,0.0,Low Risk
U764,2024,8,370894.0,Stable Salary & Stable Fixed Expenses,77296,24799.0,26790,51589.0,25707.0,33.26,-0.01,Low Risk
U764,2024,9,396601.0,Stable Salary & Stable Fixed Expenses,77296,24799.0,28441,53240.0,24056.0,31.12,0.01,Low Risk
U764,2024,10,420657.0,Stable Salary & Stable Fixed Expenses,77296,24799.0,31709,56508.0,20788.0,26.89,-0.04,Low Risk
U764,2024,11,441445.0,Stable Salary & Stable Fixed Expenses,77296,24799.0,26526,51325.0,25971.0,33.6,-0.0,Low Risk
U764,2024,12,467416.0,Stable Salary & Stable Fixed Expenses,77296,24799.0,23513,48312.0,28984.0,37.5,-0.02,Low Risk
U765,2024,1,211869.0,Salary Increases & Fixed Expenses Remain Stable,242961,110084.0,138756,248840.0,-5879.0,-2.42,0.01,High Risk
U765,2024,2,205990.0,Salary Increases & Fixed Expenses Remain Stable,242961,110084.0,109334,219418.0,23543.0,9.69,0.04,High Risk
U765,2024,3,229533.0,Salary Increases & Fixed Expenses Remain Stable,242961,110084.0,124901,234985.0,7976.0,3.28,-0.05,High Risk
U765,2024,4,237509.0,Salary Increases & Fixed Expenses Remain Stable,265753,110084.0,113003,223087.0,42666.0,16.05,-0.02,Medium Risk
U765,2024,5,280175.0,Salary Increases & Fixed Expenses Remain Stable,265753,110084.0,146571,256655.0,9098.0,3.42,0.01,High Risk
U765,2024,6,289273.0,Salary Increases & Fixed Expenses Remain Stable,265753,110084.0,140499,250583.0,15170.0,5.71,0.02,High Risk
U765,2024,7,304443.0,Salary Increases & Fixed Expenses Remain Stable,265753,110084.0,133084,243168.0,22585.0,8.5,0.04,High Risk
U765,2024,8,327028.0,Salary Increases & Fixed Expenses Remain Stable,265753,110084.0,111654,221738.0,44015.0,16.56,0.01,Medium Risk
U765,2024,9,371043.0,Salary Increases & Fixed Expenses Remain Stable,265753,110084.0,109794,219878.0,45875.0,17.26,-0.0,Medium Risk
U765,2024,10,416918.0,Salary Increases & Fixed Expenses Remain Stable,265753,110084.0,137732,247816.0,17937.0,6.75,-0.02,High Risk
U765,2024,11,434855.0,Salary Increases & Fixed Expenses Remain Stable,265753,110084.0,125861,235945.0,29808.0,11.22,0.02,High Risk
U765,2024,12,464663.0,Salary Increases & Fixed Expenses Remain Stable,265753,110084.0,155746,265830.0,-77.0,-0.03,0.05,High Risk
U766,2024,1,223657.0,Stable Salary & Stable Fixed Expenses,185050,48100.0,78585,126685.0,58365.0,31.54,-0.02,Low Risk
U766,2024,2,282022.0,Stable Salary & Stable Fixed Expenses,185050,48100.0,90299,138399.0,46651.0,25.21,-0.04,Low Risk
U766,2024,3,328673.0,Stable Salary & Stable Fixed Expenses,185050,48100.0,108799,156899.0,28151.0,15.21,0.03,Medium Risk
U766,2024,4,356824.0,Stable Salary & Stable Fixed Expenses,185050,48100.0,79742,127842.0,57208.0,30.91,0.01,Low Risk
U766,2024,5,414032.0,Stable Salary & Stable Fixed Expenses,185050,48100.0,98917,147017.0,38033.0,20.55,-0.05,Medium Risk
U766,2024,6,452065.0,Stable Salary & Stable Fixed Expenses,185050,48100.0,102848,150948.0,34102.0,18.43,0.01,Medium Risk
U766,2024,7,486167.0,Stable Salary & Stable Fixed Expenses,185050,48100.0,105359,153459.0,31591.0,17.07,0.02,Medium Risk
U766,2024,8,517758.0,Stable Salary & Stable Fixed Expenses,185050,48100.0,81348,129448.0,55602.0,30.05,0.03,Low Risk
U766,2024,9,573360.0,Stable Salary & Stable Fixed Expenses,185050,48100.0,101452,149552.0,35498.0,19.18,-0.0,Medium Risk
U766,2024,10,608858.0,Stable Salary & Stable Fixed Expenses,185050,48100.0,85887,133987.0,51063.0,27.59,-0.02,Low Risk
U766,2024,11,659921.0,Stable Salary & Stable Fixed Expenses,185050,48100.0,77446,125546.0,59504.0,32.16,-0.03,Low Risk
U766,2024,12,719425.0,Stable Salary & Stable Fixed Expenses,185050,48100.0,81283,129383.0,55667.0,30.08,0.02,Low Risk
U767,2024,1,225458.0,Salary Increases & Fixed Expenses Increase,81596,31946.0,42436,74382.0,7214.0,8.84,-0.0,High Risk
U767,2024,2,232672.0,Salary Increases & Fixed Expenses Increase,81596,31946.0,41604,73550.0,8046.0,9.86,-0.01,High Risk
U767,2024,3,240718.0,Salary Increases & Fixed Expenses Increase,81596,31946.0,36596,68542.0,13054.0,16.0,0.03,Medium Risk
U767,2024,4,253772.0,Salary Increases & Fixed Expenses Increase,87789,31946.0,48106,80052.0,7737.0,8.81,0.04,High Risk
U767,2024,5,261509.0,Salary Increases & Fixed Expenses Increase,87789,31946.0,47213,79159.0,8630.0,9.83,0.03,High Risk
U767,2024,6,270139.0,Salary Increases & Fixed Expenses Increase,87789,31946.0,38580,70526.0,17263.0,19.66,0.01,Medium Risk
U767,2024,7,287402.0,Salary Increases & Fixed Expenses Increase,87789,31946.0,46390,78336.0,9453.0,10.77,0.0,High Risk
U767,2024,8,296855.0,Salary Increases & Fixed Expenses Increase,87789,31946.0,43002,74948.0,12841.0,14.63,0.02,High Risk
U767,2024,9,309696.0,Salary Increases & Fixed Expenses Increase,87789,33749.0,38158,71907.0,15882.0,18.09,-0.01,Medium Risk
U767,2024,10,325578.0,Salary Increases & Fixed Expenses Increase,87789,33749.0,36586,70335.0,17454.0,19.88,0.0,Medium Risk
U767,2024,11,343032.0,Salary Increases & Fixed Expenses Increase,87789,33749.0,50477,84226.0,3563.0,4.06,-0.02,High Risk
U767,2024,12,346595.0,Salary Increases & Fixed Expenses Increase,87789,33749.0,51012,84761.0,3028.0,3.45,0.02,High Risk
U768,2024,1,225720.0,Salary Increases & Fixed Expenses Remain Stable,114532,67628.0,58252,125880.0,-11348.0,-9.91,0.01,High Risk
U768,2024,2,214372.0,Salary Increases & Fixed Expenses Remain Stable,114532,67628.0,50324,117952.0,-3420.0,-2.99,-0.03,High Risk
U768,2024,3,210952.0,Salary Increases & Fixed Expenses Remain Stable,114532,67628.0,62936,130564.0,-16032.0,-14.0,-0.05,High Risk
U768,2024,4,194920.0,Salary Increases & Fixed Expenses Remain Stable,114532,67628.0,57437,125065.0,-10533.0,-9.2,0.04,High Risk
U768,2024,5,184387.0,Salary Increases & Fixed Expenses Remain Stable,114532,67628.0,46287,113915.0,617.0,0.54,0.03,High Risk
U768,2024,6,185004.0,Salary Increases & Fixed Expenses Remain Stable,129996,67628.0,74528,142156.0,-12160.0,-9.35,-0.04,High Risk
U768,2024,7,172844.0,Salary Increases & Fixed Expenses Remain Stable,129996,67628.0,68752,136380.0,-6384.0,-4.91,-0.04,High Risk
U768,2024,8,166460.0,Salary Increases & Fixed Expenses Remain Stable,129996,67628.0,66441,134069.0,-4073.0,-3.13,0.02,High Risk
U768,2024,9,162387.0,Salary Increases & Fixed Expenses Remain Stable,129996,67628.0,67958,135586.0,-5590.0,-4.3,0.02,High Risk
U768,2024,10,156797.0,Salary Increases & Fixed Expenses Remain Stable,129996,67628.0,68977,136605.0,-6609.0,-5.08,0.03,High Risk
U768,2024,11,150188.0,Salary Increases & Fixed Expenses Remain Stable,129996,67628.0,55674,123302.0,6694.0,5.15,0.04,High Risk
U768,2024,12,156882.0,Salary Increases & Fixed Expenses Remain Stable,129996,67628.0,73212,140840.0,-10844.0,-8.34,-0.0,High Risk
U769,2024,1,203266.0,Stable Salary & Stable Fixed Expenses,44270,19689.0,31299,50988.0,-6718.0,-15.18,0.05,High Risk
U769,2024,2,196548.0,Stable Salary & Stable Fixed Expenses,44270,19689.0,33487,53176.0,-8906.0,-20.12,-0.03,High Risk
U769,2024,3,187642.0,Stable Salary & Stable Fixed Expenses,44270,19689.0,26821,46510.0,-2240.0,-5.06,-0.02,High Risk
U769,2024,4,185402.0,Stable Salary & Stable Fixed Expenses,44270,19689.0,30316,50005.0,-5735.0,-12.95,-0.02,High Risk
U769,2024,5,179667.0,Stable Salary & Stable Fixed Expenses,44270,19689.0,28055,47744.0,-3474.0,-7.85,-0.02,High Risk
U769,2024,6,176193.0,Stable Salary & Stable Fixed Expenses,44270,19689.0,28825,48514.0,-4244.0,-9.59,-0.01,High Risk
U769,2024,7,171949.0,Stable Salary & Stable Fixed Expenses,44270,19689.0,30620,50309.0,-6039.0,-13.64,-0.04,High Risk
U769,2024,8,165910.0,Stable Salary & Stable Fixed Expenses,44270,19689.0,27505,47194.0,-2924.0,-6.6,0.04,High Risk
U769,2024,9,162986.0,Stable Salary & Stable Fixed Expenses,44270,19689.0,34992,54681.0,-10411.0,-23.52,0.03,High Risk
U769,2024,10,152575.0,Stable Salary & Stable Fixed Expenses,44270,19689.0,29129,48818.0,-4548.0,-10.27,-0.05,High Risk
U769,2024,11,148027.0,Stable Salary & Stable Fixed Expenses,44270,19689.0,29319,49008.0,-4738.0,-10.7,0.04,High Risk
U769,2024,12,143289.0,Stable Salary & Stable Fixed Expenses,44270,19689.0,33215,52904.0,-8634.0,-19.5,-0.04,High Risk
U770,2024,1,227372.0,Salary Increases & Fixed Expenses Remain Stable,226861,88196.0,127779,215975.0,10886.0,4.8,0.02,High Risk
U770,2024,2,238258.0,Salary Increases & Fixed Expenses Remain Stable,226861,88196.0,93750,181946.0,44915.0,19.8,-0.05,Medium Risk
U770,2024,3,283173.0,Salary Increases & Fixed Expenses Remain Stable,226861,88196.0,153996,242192.0,-15331.0,-6.76,-0.04,High Risk
U770,2024,4,267842.0,Salary Increases & Fixed Expenses Remain Stable,239588,88196.0,118920,207116.0,32472.0,13.55,0.01,High Risk
U770,2024,5,300314.0,Salary Increases & Fixed Expenses Remain Stable,239588,88196.0,112655,200851.0,38737.0,16.17,0.01,Medium Risk
U770,2024,6,339051.0,Salary Increases & Fixed Expenses Remain Stable,239588,88196.0,99309,187505.0,52083.0,21.74,-0.05,Medium Risk
U770,2024,7,391134.0,Salary Increases & Fixed Expenses Remain Stable,239588,88196.0,126751,214947.0,24641.0,10.28,-0.03,High Risk
U770,2024,8,415775.0,Salary Increases & Fixed Expenses Remain Stable,239588,88196.0,125416,213612.0,25976.0,10.84,-0.04,High Risk
U770,2024,9,441751.0,Salary Increases & Fixed Expenses Remain Stable,239588,88196.0,104360,192556.0,47032.0,19.63,0.01,Medium Risk
U770,2024,10,488783.0,Salary Increases & Fixed Expenses Remain Stable,239588,88196.0,136494,224690.0,14898.0,6.22,0.04,High Risk
U770,2024,11,503681.0,Salary Increases & Fixed Expenses Remain Stable,239588,88196.0,101697,189893.0,49695.0,20.74,0.02,Medium Risk
U770,2024,12,553376.0,Salary Increases & Fixed Expenses Remain Stable,239588,88196.0,120686,208882.0,30706.0,12.82,0.05,High Risk
U771,2024,1,245555.0,Salary Increases & Fixed Expenses Remain Stable,290562,98524.0,143552,242076.0,48486.0,16.69,0.05,Medium Risk
U771,2024,2,294041.0,Salary Increases & Fixed Expenses Remain Stable,290562,98524.0,118943,217467.0,73095.0,25.16,0.04,Low Risk
U771,2024,3,367136.0,Salary Increases & Fixed Expenses Remain Stable,290562,98524.0,132589,231113.0,59449.0,20.46,-0.0,Medium Risk
U771,2024,4,426585.0,Salary Increases & Fixed Expenses Remain Stable,308589,98524.0,170922,269446.0,39143.0,12.68,-0.0,High Risk
U771,2024,5,465728.0,Salary Increases & Fixed Expenses Remain Stable,308589,98524.0,178077,276601.0,31988.0,10.37,0.0,High Risk
U771,2024,6,497716.0,Salary Increases & Fixed Expenses Remain Stable,308589,98524.0,158335,256859.0,51730.0,16.76,0.02,Medium Risk
U771,2024,7,549446.0,Salary Increases & Fixed Expenses Remain Stable,308589,98524.0,128606,227130.0,81459.0,26.4,-0.01,Low Risk
U771,2024,8,630905.0,Salary Increases & Fixed Expenses Remain Stable,308589,98524.0,149501,248025.0,60564.0,19.63,-0.01,Medium Risk
U771,2024,9,691469.0,Salary Increases & Fixed Expenses Remain Stable,308589,98524.0,166258,264782.0,43807.0,14.2,0.03,High Risk
U771,2024,10,735276.0,Salary Increases & Fixed Expenses Remain Stable,308589,98524.0,180840,279364.0,29225.0,9.47,-0.04,High Risk
U771,2024,11,764501.0,Salary Increases & Fixed Expenses Remain Stable,308589,98524.0,137966,236490.0,72099.0,23.36,-0.01,Medium Risk
U771,2024,12,836600.0,Salary Increases & Fixed Expenses Remain Stable,308589,98524.0,161269,259793.0,48796.0,15.81,0.03,Medium Risk
U772,2024,1,228448.0,Stable Salary & Increasing Fixed Expenses,207220,99848.0,155237,255085.0,-47865.0,-23.1,0.0,High Risk
U772,2024,2,180583.0,Stable Salary & Increasing Fixed Expenses,207220,99848.0,151849,251697.0,-44477.0,-21.46,0.01,High Risk
U772,2024,3,136106.0,Stable Salary & Increasing Fixed Expenses,207220,101299.0,191314,292613.0,-85393.0,-41.21,0.03,High Risk
U772,2024,4,50713.0,Stable Salary & Increasing Fixed Expenses,207220,102787.0,163045,265832.0,-58612.0,-28.28,0.0,High Risk
U772,2024,5,-7899.0,Stable Salary & Increasing Fixed Expenses,207220,102787.0,141636,244423.0,-37203.0,-17.95,-0.04,High Risk
U772,2024,6,-45102.0,Stable Salary & Increasing Fixed Expenses,207220,102787.0,139889,242676.0,-35456.0,-17.11,0.0,High Risk
U772,2024,7,-80558.0,Stable Salary & Increasing Fixed Expenses,207220,102787.0,150939,253726.0,-46506.0,-22.44,0.05,High Risk
U772,2024,8,-127064.0,Stable Salary & Increasing Fixed Expenses,207220,102787.0,129277,232064.0,-24844.0,-11.99,0.04,High Risk
U772,2024,9,-151908.0,Stable Salary & Increasing Fixed Expenses,207220,103296.0,178546,281842.0,-74622.0,-36.01,0.01,High Risk
U772,2024,10,-226530.0,Stable Salary & Increasing Fixed Expenses,207220,103296.0,143541,246837.0,-39617.0,-19.12,-0.05,High Risk
U772,2024,11,-266147.0,Stable Salary & Increasing Fixed Expenses,207220,103296.0,150184,253480.0,-46260.0,-22.32,0.03,High Risk
U772,2024,12,-312407.0,Stable Salary & Increasing Fixed Expenses,207220,103296.0,163072,266368.0,-59148.0,-28.54,0.04,High Risk
U773,2024,1,245169.0,Salary Increases & Fixed Expenses Remain Stable,167285,51582.0,94034,145616.0,21669.0,12.95,-0.02,High Risk
U773,2024,2,266838.0,Salary Increases & Fixed Expenses Remain Stable,167285,51582.0,77131,128713.0,38572.0,23.06,-0.02,Medium Risk
U773,2024,3,305410.0,Salary Increases & Fixed Expenses Remain Stable,167285,51582.0,116938,168520.0,-1235.0,-0.74,0.04,High Risk
U773,2024,4,304175.0,Salary Increases & Fixed Expenses Remain Stable,173331,51582.0,70978,122560.0,50771.0,29.29,-0.02,Low Risk
U773,2024,5,354946.0,Salary Increases & Fixed Expenses Remain Stable,173331,51582.0,83814,135396.0,37935.0,21.89,0.04,Medium Risk
U773,2024,6,392881.0,Salary Increases & Fixed Expenses Remain Stable,173331,51582.0,73346,124928.0,48403.0,27.93,-0.01,Low Risk
U773,2024,7,441284.0,Salary Increases & Fixed Expenses Remain Stable,173331,51582.0,101041,152623.0,20708.0,11.95,0.01,High Risk
U773,2024,8,461992.0,Salary Increases & Fixed Expenses Remain Stable,173331,51582.0,82979,134561.0,38770.0,22.37,-0.03,Medium Risk
U773,2024,9,500762.0,Salary Increases & Fixed Expenses Remain Stable,173331,51582.0,106718,158300.0,15031.0,8.67,-0.04,High Risk
U773,2024,10,515793.0,Salary Increases & Fixed Expenses Remain Stable,173331,51582.0,101454,153036.0,20295.0,11.71,0.05,High Risk
U773,2024,11,536088.0,Salary Increases & Fixed Expenses Remain Stable,173331,51582.0,88970,140552.0,32779.0,18.91,0.05,Medium Risk
U773,2024,12,568867.0,Salary Increases & Fixed Expenses Remain Stable,173331,51582.0,91159,142741.0,30590.0,17.65,0.01,Medium Risk
U774,2024,1,244054.0,Salary Increases & Fixed Expenses Remain Stable,81968,29018.0,45669,74687.0,7281.0,8.88,0.02,High Risk
U774,2024,2,251335.0,Salary Increases & Fixed Expenses Remain Stable,81968,29018.0,48165,77183.0,4785.0,5.84,0.0,High Risk
U774,2024,3,256120.0,Salary Increases & Fixed Expenses Remain Stable,81968,29018.0,45981,74999.0,6969.0,8.5,-0.04,High Risk
U774,2024,4,263089.0,Salary Increases & Fixed Expenses Remain Stable,81968,29018.0,36917,65935.0,16033.0,19.56,0.02,Medium Risk
U774,2024,5,279122.0,Salary Increases & Fixed Expenses Remain Stable,109180,29018.0,59972,88990.0,20190.0,18.49,-0.01,Medium Risk
U774,2024,6,299312.0,Salary Increases & Fixed Expenses Remain Stable,109180,29018.0,63055,92073.0,17107.0,15.67,0.03,Medium Risk
U774,2024,7,316419.0,Salary Increases & Fixed Expenses Remain Stable,109180,29018.0,48432,77450.0,31730.0,29.06,0.02,Low Risk
U774,2024,8,348149.0,Salary Increases & Fixed Expenses Remain Stable,109180,29018.0,60164,89182.0,19998.0,18.32,0.03,Medium Risk
U774,2024,9,368147.0,Salary Increases & Fixed Expenses Remain Stable,109180,29018.0,56492,85510.0,23670.0,21.68,-0.04,Medium Risk
U774,2024,10,391817.0,Salary Increases & Fixed Expenses Remain Stable,109180,29018.0,53461,82479.0,26701.0,24.46,0.03,Medium Risk
U774,2024,11,418518.0,Salary Increases & Fixed Expenses Remain Stable,109180,29018.0,64558,93576.0,15604.0,14.29,-0.01,High Risk
U774,2024,12,434122.0,Salary Increases & Fixed Expenses Remain Stable,109180,29018.0,54860,83878.0,25302.0,23.17,0.02,Medium Risk
U775,2024,1,244909.0,Salary Increases & Fixed Expenses Decrease,116720,68856.0,61490,130346.0,-13626.0,-11.67,0.01,High Risk
U775,2024,2,231283.0,Salary Increases & Fixed Expenses Decrease,116720,68856.0,59990,128846.0,-12126.0,-10.39,0.04,High Risk
U775,2024,3,219157.0,Salary Increases & Fixed Expenses Decrease,116720,68856.0,74064,142920.0,-26200.0,-22.45,0.04,High Risk
U775,2024,4,192957.0,Salary Increases & Fixed Expenses Decrease,116720,68856.0,48405,117261.0,-541.0,-0.46,-0.0,High Risk
U775,2024,5,192416.0,Salary Increases & Fixed Expenses Decrease,136003,68856.0,62924,131780.0,4223.0,3.11,-0.05,High Risk
U775,2024,6,196639.0,Salary Increases & Fixed Expenses Decrease,136003,68856.0,75159,144015.0,-8012.0,-5.89,0.01,High Risk
U775,2024,7,188627.0,Salary Increases & Fixed Expenses Decrease,136003,68856.0,65092,133948.0,2055.0,1.51,0.0,High Risk
U775,2024,8,190682.0,Salary Increases & Fixed Expenses Decrease,136003,68856.0,77920,146776.0,-10773.0,-7.92,0.0,High Risk
U775,2024,9,179909.0,Salary Increases & Fixed Expenses Decrease,136003,68856.0,59143,127999.0,8004.0,5.89,0.04,High Risk
U775,2024,10,187913.0,Salary Increases & Fixed Expenses Decrease,136003,68856.0,90790,159646.0,-23643.0,-17.38,0.0,High Risk
U775,2024,11,164270.0,Salary Increases & Fixed Expenses Decrease,136003,68856.0,64681,133537.0,2466.0,1.81,-0.02,High Risk
U775,2024,12,166736.0,Salary Increases & Fixed Expenses Decrease,136003,68856.0,87152,156008.0,-20005.0,-14.71,-0.05,High Risk
U776,2024,1,239432.0,Salary Increases & Fixed Expenses Remain Stable,158753,50380.0,81940,132320.0,26433.0,16.65,-0.0,Medium Risk
U776,2024,2,265865.0,Salary Increases & Fixed Expenses Remain Stable,158753,50380.0,78757,129137.0,29616.0,18.66,0.04,Medium Risk
U776,2024,3,295481.0,Salary Increases & Fixed Expenses Remain Stable,158753,50380.0,114624,165004.0,-6251.0,-3.94,-0.0,High Risk
U776,2024,4,289230.0,Salary Increases & Fixed Expenses Remain Stable,172633,50380.0,73175,123555.0,49078.0,28.43,0.01,Low Risk
U776,2024,5,338308.0,Salary Increases & Fixed Expenses Remain Stable,172633,50380.0,69420,119800.0,52833.0,30.6,-0.02,Low Risk
U776,2024,6,391141.0,Salary Increases & Fixed Expenses Remain Stable,172633,50380.0,85735,136115.0,36518.0,21.15,0.01,Medium Risk
U776,2024,7,427659.0,Salary Increases & Fixed Expenses Remain Stable,172633,50380.0,94183,144563.0,28070.0,16.26,0.04,Medium Risk
U776,2024,8,455729.0,Salary Increases & Fixed Expenses Remain Stable,172633,50380.0,93620,144000.0,28633.0,16.59,0.02,Medium Risk
U776,2024,9,484362.0,Salary Increases & Fixed Expenses Remain Stable,172633,50380.0,104862,155242.0,17391.0,10.07,0.01,High Risk
U776,2024,10,501753.0,Salary Increases & Fixed Expenses Remain Stable,172633,50380.0,84380,134760.0,37873.0,21.94,-0.04,Medium Risk
U776,2024,11,539626.0,Salary Increases & Fixed Expenses Remain Stable,172633,50380.0,96827,147207.0,25426.0,14.73,-0.01,High Risk
U776,2024,12,565052.0,Salary Increases & Fixed Expenses Remain Stable,172633,50380.0,100624,151004.0,21629.0,12.53,-0.01,High Risk
U777,2024,1,207552.0,Stable Salary & Stable Fixed Expenses,33219,13116.0,22297,35413.0,-2194.0,-6.6,-0.01,High Risk
U777,2024,2,205358.0,Stable Salary & Stable Fixed Expenses,33219,13116.0,24215,37331.0,-4112.0,-12.38,0.03,High Risk
U777,2024,3,201246.0,Stable Salary & Stable Fixed Expenses,33219,13116.0,20699,33815.0,-596.0,-1.79,0.02,High Risk
U777,2024,4,200650.0,Stable Salary & Stable Fixed Expenses,33219,13116.0,25577,38693.0,-5474.0,-16.48,0.04,High Risk
U777,2024,5,195176.0,Stable Salary & Stable Fixed Expenses,33219,13116.0,25699,38815.0,-5596.0,-16.85,-0.02,High Risk
U777,2024,6,189580.0,Stable Salary & Stable Fixed Expenses,33219,13116.0,20015,33131.0,88.0,0.26,0.04,High Risk
U777,2024,7,189668.0,Stable Salary & Stable Fixed Expenses,33219,13116.0,24864,37980.0,-4761.0,-14.33,0.02,High Risk
U777,2024,8,184907.0,Stable Salary & Stable Fixed Expenses,33219,13116.0,25161,38277.0,-5058.0,-15.23,-0.0,High Risk
U777,2024,9,179849.0,Stable Salary & Stable Fixed Expenses,33219,13116.0,23946,37062.0,-3843.0,-11.57,-0.04,High Risk
U777,2024,10,176006.0,Stable Salary & Stable Fixed Expenses,33219,13116.0,23326,36442.0,-3223.0,-9.7,0.01,High Risk
U777,2024,11,172783.0,Stable Salary & Stable Fixed Expenses,33219,13116.0,24478,37594.0,-4375.0,-13.17,-0.03,High Risk
U777,2024,12,168408.0,Stable Salary & Stable Fixed Expenses,33219,13116.0,21151,34267.0,-1048.0,-3.15,-0.04,High Risk
U778,2024,1,236373.0,Stable Salary & Stable Fixed Expenses,161566,64457.0,72638,137095.0,24471.0,15.15,0.03,Medium Risk
U778,2024,2,260844.0,Stable Salary & Stable Fixed Expenses,161566,64457.0,85685,150142.0,11424.0,7.07,-0.0,High Risk
U778,2024,3,272268.0,Stable Salary & Stable Fixed Expenses,161566,64457.0,106806,171263.0,-9697.0,-6.0,0.03,High Risk
U778,2024,4,262571.0,Stable Salary & Stable Fixed Expenses,161566,64457.0,88498,152955.0,8611.0,5.33,-0.01,High Risk
U778,2024,5,271182.0,Stable Salary & Stable Fixed Expenses,161566,64457.0,69180,133637.0,27929.0,17.29,0.0,Medium Risk
U778,2024,6,299111.0,Stable Salary & Stable Fixed Expenses,161566,64457.0,83323,147780.0,13786.0,8.53,0.0,High Risk
U778,2024,7,312897.0,Stable Salary & Stable Fixed Expenses,161566,64457.0,71238,135695.0,25871.0,16.01,-0.0,Medium Risk
U778,2024,8,338768.0,Stable Salary & Stable Fixed Expenses,161566,64457.0,80408,144865.0,16701.0,10.34,-0.03,High Risk
U778,2024,9,355469.0,Stable Salary & Stable Fixed Expenses,161566,64457.0,95584,160041.0,1525.0,0.94,-0.02,High Risk
U778,2024,10,356994.0,Stable Salary & Stable Fixed Expenses,161566,64457.0,91012,155469.0,6097.0,3.77,0.0,High Risk
U778,2024,11,363091.0,Stable Salary & Stable Fixed Expenses,161566,64457.0,64754,129211.0,32355.0,20.03,0.03,Medium Risk
U778,2024,12,395446.0,Stable Salary & Stable Fixed Expenses,161566,64457.0,94102,158559.0,3007.0,1.86,0.01,High Risk
U779,2024,1,218185.0,Stable Salary & Increasing Fixed Expenses,51943,35693.0,19984,55677.0,-3734.0,-7.19,-0.0,High Risk
U779,2024,2,214451.0,Stable Salary & Increasing Fixed Expenses,51943,35693.0,18959,54652.0,-2709.0,-5.22,-0.02,High Risk
U779,2024,3,211742.0,Stable Salary & Increasing Fixed Expenses,51943,35693.0,21655,57348.0,-5405.0,-10.41,0.0,High Risk
U779,2024,4,206337.0,Stable Salary & Increasing Fixed Expenses,51943,35693.0,18305,53998.0,-2055.0,-3.96,0.01,High Risk
U779,2024,5,204282.0,Stable Salary & Increasing Fixed Expenses,51943,35693.0,16159,51852.0,91.0,0.18,0.04,High Risk
U779,2024,6,204373.0,Stable Salary & Increasing Fixed Expenses,51943,35693.0,20501,56194.0,-4251.0,-8.18,0.01,High Risk
U779,2024,7,200122.0,Stable Salary & Increasing Fixed Expenses,51943,36432.0,16939,53371.0,-1428.0,-2.75,-0.02,High Risk
U779,2024,8,198694.0,Stable Salary & Increasing Fixed Expenses,51943,36432.0,16605,53037.0,-1094.0,-2.11,0.01,High Risk
U779,2024,9,197600.0,Stable Salary & Increasing Fixed Expenses,51943,36432.0,18566,54998.0,-3055.0,-5.88,0.0,High Risk
U779,2024,10,194545.0,Stable Salary & Increasing Fixed Expenses,51943,36432.0,24903,61335.0,-9392.0,-18.08,0.02,High Risk
U779,2024,11,185153.0,Stable Salary & Increasing Fixed Expenses,51943,38194.0,21196,59390.0,-7447.0,-14.34,-0.0,High Risk
U779,2024,12,177706.0,Stable Salary & Increasing Fixed Expenses,51943,38194.0,25379,63573.0,-11630.0,-22.39,-0.05,High Risk
U780,2024,1,215539.0,Salary Increases & Fixed Expenses Decrease,238613,101137.0,122872,224009.0,14604.0,6.12,-0.0,High Risk
U780,2024,2,230143.0,Salary Increases & Fixed Expenses Decrease,238613,101137.0,123120,224257.0,14356.0,6.02,0.01,High Risk
U780,2024,3,244499.0,Salary Increases & Fixed Expenses Decrease,238613,101137.0,165567,266704.0,-28091.0,-11.77,0.0,High Risk
U780,2024,4,216408.0,Salary Increases & Fixed Expenses Decrease,238613,101137.0,110886,212023.0,26590.0,11.14,-0.02,High Risk
U780,2024,5,242998.0,Salary Increases & Fixed Expenses Decrease,246784,101137.0,122178,223315.0,23469.0,9.51,0.04,High Risk
U780,2024,6,266467.0,Salary Increases & Fixed Expenses Decrease,246784,101137.0,99369,200506.0,46278.0,18.75,-0.04,Medium Risk
U780,2024,7,312745.0,Salary Increases & Fixed Expenses Decrease,246784,101137.0,123749,224886.0,21898.0,8.87,-0.04,High Risk
U780,2024,8,334643.0,Salary Increases & Fixed Expenses Decrease,246784,101137.0,129730,230867.0,15917.0,6.45,-0.03,High Risk
U780,2024,9,350560.0,Salary Increases & Fixed Expenses Decrease,246784,101137.0,106369,207506.0,39278.0,15.92,-0.02,Medium Risk
U780,2024,10,389838.0,Salary Increases & Fixed Expenses Decrease,246784,101137.0,142861,243998.0,2786.0,1.13,0.01,High Risk
U780,2024,11,392624.0,Salary Increases & Fixed Expenses Decrease,246784,101137.0,120108,221245.0,25539.0,10.35,-0.02,High Risk
U780,2024,12,418163.0,Salary Increases & Fixed Expenses Decrease,246784,101137.0,165647,266784.0,-20000.0,-8.1,0.02,High Risk
U781,2024,1,239062.0,Salary Increases & Fixed Expenses Remain Stable,44078,15230.0,29396,44626.0,-548.0,-1.24,-0.04,High Risk
U781,2024,2,238514.0,Salary Increases & Fixed Expenses Remain Stable,44078,15230.0,31083,46313.0,-2235.0,-5.07,0.04,High Risk
U781,2024,3,236279.0,Salary Increases & Fixed Expenses Remain Stable,44078,15230.0,34995,50225.0,-6147.0,-13.95,-0.03,High Risk
U781,2024,4,230132.0,Salary Increases & Fixed Expenses Remain Stable,44078,15230.0,29197,44427.0,-349.0,-0.79,0.01,High Risk
U781,2024,5,229783.0,Salary Increases & Fixed Expenses Remain Stable,58016,15230.0,45356,60586.0,-2570.0,-4.43,0.03,High Risk
U781,2024,6,227213.0,Salary Increases & Fixed Expenses Remain Stable,58016,15230.0,42265,57495.0,521.0,0.9,-0.03,High Risk
U781,2024,7,227734.0,Salary Increases & Fixed Expenses Remain Stable,58016,15230.0,39955,55185.0,2831.0,4.88,0.04,High Risk
U781,2024,8,230565.0,Salary Increases & Fixed Expenses Remain Stable,58016,15230.0,40077,55307.0,2709.0,4.67,0.05,High Risk
U781,2024,9,233274.0,Salary Increases & Fixed Expenses Remain Stable,58016,15230.0,38902,54132.0,3884.0,6.69,-0.01,High Risk
U781,2024,10,237158.0,Salary Increases & Fixed Expenses Remain Stable,58016,15230.0,44167,59397.0,-1381.0,-2.38,0.01,High Risk
U781,2024,11,235777.0,Salary Increases & Fixed Expenses Remain Stable,58016,15230.0,37884,53114.0,4902.0,8.45,0.04,High Risk
U781,2024,12,240679.0,Salary Increases & Fixed Expenses Remain Stable,58016,15230.0,36801,52031.0,5985.0,10.32,-0.03,High Risk
U782,2024,1,218270.0,Salary Increases & Fixed Expenses Remain Stable,64482,26683.0,35574,62257.0,2225.0,3.45,-0.02,High Risk
U782,2024,2,220495.0,Salary Increases & Fixed Expenses Remain Stable,64482,26683.0,37990,64673.0,-191.0,-0.3,0.02,High Risk
U782,2024,3,220304.0,Salary Increases & Fixed Expenses Remain Stable,64482,26683.0,25865,52548.0,11934.0,18.51,-0.01,Medium Risk
U782,2024,4,232238.0,Salary Increases & Fixed Expenses Remain Stable,64482,26683.0,28765,55448.0,9034.0,14.01,0.0,High Risk
U782,2024,5,241272.0,Salary Increases & Fixed Expenses Remain Stable,64482,26683.0,35069,61752.0,2730.0,4.23,-0.01,High Risk
U782,2024,6,244002.0,Salary Increases & Fixed Expenses Remain Stable,84711,26683.0,49634,76317.0,8394.0,9.91,0.04,High Risk
U782,2024,7,252396.0,Salary Increases & Fixed Expenses Remain Stable,84711,26683.0,48688,75371.0,9340.0,11.03,-0.02,High Risk
U782,2024,8,261736.0,Salary Increases & Fixed Expenses Remain Stable,84711,26683.0,39978,66661.0,18050.0,21.31,-0.04,Medium Risk
U782,2024,9,279786.0,Salary Increases & Fixed Expenses Remain Stable,84711,26683.0,41958,68641.0,16070.0,18.97,0.02,Medium Risk
U782,2024,10,295856.0,Salary Increases & Fixed Expenses Remain Stable,84711,26683.0,48891,75574.0,9137.0,10.79,-0.05,High Risk
U782,2024,11,304993.0,Salary Increases & Fixed Expenses Remain Stable,84711,26683.0,39299,65982.0,18729.0,22.11,0.05,Medium Risk
U782,2024,12,323722.0,Salary Increases & Fixed Expenses Remain Stable,84711,26683.0,42310,68993.0,15718.0,18.55,0.03,Medium Risk
U783,2024,1,212990.0,Salary Increases & Fixed Expenses Remain Stable,98848,27329.0,36475,63804.0,35044.0,35.45,0.04,Low Risk
U783,2024,2,248034.0,Salary Increases & Fixed Expenses Remain Stable,98848,27329.0,32749,60078.0,38770.0,39.22,0.04,Low Risk
U783,2024,3,286804.0,Salary Increases & Fixed Expenses Remain Stable,98848,27329.0,37457,64786.0,34062.0,34.46,-0.03,Low Risk
U783,2024,4,320866.0,Salary Increases & Fixed Expenses Remain Stable,98848,27329.0,34566,61895.0,36953.0,37.38,-0.05,Low Risk
U783,2024,5,357819.0,Salary Increases & Fixed Expenses Remain Stable,98848,27329.0,37244,64573.0,34275.0,34.67,-0.02,Low Risk
U783,2024,6,392094.0,Salary Increases & Fixed Expenses Remain Stable,98848,27329.0,38809,66138.0,32710.0,33.09,-0.04,Low Risk
U783,2024,7,424804.0,Salary Increases & Fixed Expenses Remain Stable,98848,27329.0,37448,64777.0,34071.0,34.47,0.01,Low Risk
U783,2024,8,458875.0,Salary Increases & Fixed Expenses Remain Stable,123127,27329.0,37671,65000.0,58127.0,47.21,0.05,Low Risk
U783,2024,9,517002.0,Salary Increases & Fixed Expenses Remain Stable,123127,27329.0,47025,74354.0,48773.0,39.61,-0.04,Low Risk
U783,2024,10,565775.0,Salary Increases & Fixed Expenses Remain Stable,123127,27329.0,41448,68777.0,54350.0,44.14,-0.03,Low Risk
U783,2024,11,620125.0,Salary Increases & Fixed Expenses Remain Stable,123127,27329.0,48392,75721.0,47406.0,38.5,-0.05,Low Risk
U783,2024,12,667531.0,Salary Increases & Fixed Expenses Remain Stable,123127,27329.0,38217,65546.0,57581.0,46.77,0.0,Low Risk
U784,2024,1,246223.0,Salary Increases & Fixed Expenses Remain Stable,106869,73728.0,48080,121808.0,-14939.0,-13.98,0.0,High Risk
U784,2024,2,231284.0,Salary Increases & Fixed Expenses Remain Stable,106869,73728.0,58623,132351.0,-25482.0,-23.84,0.01,High Risk
U784,2024,3,205802.0,Salary Increases & Fixed Expenses Remain Stable,106869,73728.0,68506,142234.0,-35365.0,-33.09,-0.01,High Risk
U784,2024,4,170437.0,Salary Increases & Fixed Expenses Remain Stable,106869,73728.0,46089,119817.0,-12948.0,-12.12,-0.01,High Risk
U784,2024,5,157489.0,Salary Increases & Fixed Expenses Remain Stable,106869,73728.0,60157,133885.0,-27016.0,-25.28,0.04,High Risk
U784,2024,6,130473.0,Salary Increases & Fixed Expenses Remain Stable,106869,73728.0,44241,117969.0,-11100.0,-10.39,0.04,High Risk
U784,2024,7,119373.0,Salary Increases & Fixed Expenses Remain Stable,106869,73728.0,47527,121255.0,-14386.0,-13.46,-0.02,High Risk
U784,2024,8,104987.0,Salary Increases & Fixed Expenses Remain Stable,125572,73728.0,59072,132800.0,-7228.0,-5.76,0.02,High Risk
U784,2024,9,97759.0,Salary Increases & Fixed Expenses Remain Stable,125572,73728.0,77814,151542.0,-25970.0,-20.68,-0.04,High Risk
U784,2024,10,71789.0,Salary Increases & Fixed Expenses Remain Stable,125572,73728.0,69221,142949.0,-17377.0,-13.84,-0.0,High Risk
U784,2024,11,54412.0,Salary Increases & Fixed Expenses Remain Stable,125572,73728.0,63450,137178.0,-11606.0,-9.24,0.03,High Risk
U784,2024,12,42806.0,Salary Increases & Fixed Expenses Remain Stable,125572,73728.0,86757,160485.0,-34913.0,-27.8,0.0,High Risk
U785,2024,1,248924.0,Salary Increases & Fixed Expenses Increase,211421,118016.0,121275,239291.0,-27870.0,-13.18,-0.03,High Risk
U785,2024,2,221054.0,Salary Increases & Fixed Expenses Increase,211421,119564.0,118846,238410.0,-26989.0,-12.77,0.0,High Risk
U785,2024,3,194065.0,Salary Increases & Fixed Expenses Increase,211421,119564.0,111215,230779.0,-19358.0,-9.16,0.01,High Risk
U785,2024,4,174707.0,Salary Increases & Fixed Expenses Increase,229051,119564.0,117661,237225.0,-8174.0,-3.57,-0.01,High Risk
U785,2024,5,166533.0,Salary Increases & Fixed Expenses Increase,229051,120250.0,125738,245988.0,-16937.0,-7.39,0.03,High Risk
U785,2024,6,149596.0,Salary Increases & Fixed Expenses Increase,229051,120250.0,121859,242109.0,-13058.0,-5.7,0.04,High Risk
U785,2024,7,136538.0,Salary Increases & Fixed Expenses Increase,229051,120250.0,91862,212112.0,16939.0,7.4,0.05,High Risk
U785,2024,8,153477.0,Salary Increases & Fixed Expenses Increase,229051,120250.0,116675,236925.0,-7874.0,-3.44,-0.03,High Risk
U785,2024,9,145603.0,Salary Increases & Fixed Expenses Increase,229051,120998.0,122262,243260.0,-14209.0,-6.2,-0.02,High Risk
U785,2024,10,131394.0,Salary Increases & Fixed Expenses Increase,229051,122894.0,133471,256365.0,-27314.0,-11.92,0.04,High Risk
U785,2024,11,104080.0,Salary Increases & Fixed Expenses Increase,229051,122894.0,94699,217593.0,11458.0,5.0,-0.02,High Risk
U785,2024,12,115538.0,Salary Increases & Fixed Expenses Increase,229051,122894.0,103533,226427.0,2624.0,1.15,-0.02,High Risk
U786,2024,1,204197.0,Stable Salary & Increasing Fixed Expenses,86373,26435.0,56545,82980.0,3393.0,3.93,-0.05,High Risk
U786,2024,2,207590.0,Stable Salary & Increasing Fixed Expenses,86373,26435.0,54002,80437.0,5936.0,6.87,0.03,High Risk
U786,2024,3,213526.0,Stable Salary & Increasing Fixed Expenses,86373,26435.0,63953,90388.0,-4015.0,-4.65,0.01,High Risk
U786,2024,4,209511.0,Stable Salary & Increasing Fixed Expenses,86373,26435.0,65671,92106.0,-5733.0,-6.64,0.05,High Risk
U786,2024,5,203778.0,Stable Salary & Increasing Fixed Expenses,86373,26435.0,64857,91292.0,-4919.0,-5.7,-0.02,High Risk
U786,2024,6,198859.0,Stable Salary & Increasing Fixed Expenses,86373,26435.0,64182,90617.0,-4244.0,-4.91,-0.01,High Risk
U786,2024,7,194615.0,Stable Salary & Increasing Fixed Expenses,86373,26435.0,56656,83091.0,3282.0,3.8,-0.0,High Risk
U786,2024,8,197897.0,Stable Salary & Increasing Fixed Expenses,86373,28413.0,64782,93195.0,-6822.0,-7.9,0.04,High Risk
U786,2024,9,191075.0,Stable Salary & Increasing Fixed Expenses,86373,28413.0,56828,85241.0,1132.0,1.31,-0.04,High Risk
U786,2024,10,192207.0,Stable Salary & Increasing Fixed Expenses,86373,28413.0,52389,80802.0,5571.0,6.45,0.01,High Risk
U786,2024,11,197778.0,Stable Salary & Increasing Fixed Expenses,86373,28413.0,59932,88345.0,-1972.0,-2.28,-0.01,High Risk
U786,2024,12,195806.0,Stable Salary & Increasing Fixed Expenses,86373,28413.0,63607,92020.0,-5647.0,-6.54,0.0,High Risk
U787,2024,1,203528.0,Salary Increases & Fixed Expenses Increase,150331,75893.0,58152,134045.0,16286.0,10.83,0.01,High Risk
U787,2024,2,219814.0,Salary Increases & Fixed Expenses Increase,150331,75893.0,49726,125619.0,24712.0,16.44,0.0,Medium Risk
U787,2024,3,244526.0,Salary Increases & Fixed Expenses Increase,150331,75893.0,67789,143682.0,6649.0,4.42,0.04,High Risk
U787,2024,4,251175.0,Salary Increases & Fixed Expenses Increase,158787,75893.0,60699,136592.0,22195.0,13.98,-0.03,High Risk
U787,2024,5,273370.0,Salary Increases & Fixed Expenses Increase,158787,75893.0,54093,129986.0,28801.0,18.14,0.02,Medium Risk
U787,2024,6,302171.0,Salary Increases & Fixed Expenses Increase,158787,75893.0,57837,133730.0,25057.0,15.78,-0.05,Medium Risk
U787,2024,7,327228.0,Salary Increases & Fixed Expenses Increase,158787,75893.0,48753,124646.0,34141.0,21.5,-0.01,Medium Risk
U787,2024,8,361369.0,Salary Increases & Fixed Expenses Increase,158787,75893.0,49117,125010.0,33777.0,21.27,-0.01,Medium Risk
U787,2024,9,395146.0,Salary Increases & Fixed Expenses Increase,158787,77740.0,60356,138096.0,20691.0,13.03,0.01,High Risk
U787,2024,10,415837.0,Salary Increases & Fixed Expenses Increase,158787,77740.0,69450,147190.0,11597.0,7.3,0.05,High Risk
U787,2024,11,427434.0,Salary Increases & Fixed Expenses Increase,158787,77740.0,55682,133422.0,25365.0,15.97,0.04,Medium Risk
U787,2024,12,452799.0,Salary Increases & Fixed Expenses Increase,158787,77740.0,48803,126543.0,32244.0,20.31,-0.02,Medium Risk
U788,2024,1,217031.0,Salary Increases & Fixed Expenses Remain Stable,164870,67731.0,60297,128028.0,36842.0,22.35,0.01,Medium Risk
U788,2024,2,253873.0,Salary Increases & Fixed Expenses Remain Stable,164870,67731.0,56175,123906.0,40964.0,24.85,0.01,Medium Risk
U788,2024,3,294837.0,Salary Increases & Fixed Expenses Remain Stable,164870,67731.0,66956,134687.0,30183.0,18.31,0.04,Medium Risk
U788,2024,4,325020.0,Salary Increases & Fixed Expenses Remain Stable,164870,67731.0,64726,132457.0,32413.0,19.66,0.04,Medium Risk
U788,2024,5,357433.0,Salary Increases & Fixed Expenses Remain Stable,180013,67731.0,55908,123639.0,56374.0,31.32,0.03,Low Risk
U788,2024,6,413807.0,Salary Increases & Fixed Expenses Remain Stable,180013,67731.0,59320,127051.0,52962.0,29.42,-0.02,Low Risk
U788,2024,7,466769.0,Salary Increases & Fixed Expenses Remain Stable,180013,67731.0,66796,134527.0,45486.0,25.27,0.0,Low Risk
U788,2024,8,512255.0,Salary Increases & Fixed Expenses Remain Stable,180013,67731.0,70551,138282.0,41731.0,23.18,-0.02,Medium Risk
U788,2024,9,553986.0,Salary Increases & Fixed Expenses Remain Stable,180013,67731.0,57042,124773.0,55240.0,30.69,-0.02,Low Risk
U788,2024,10,609226.0,Salary Increases & Fixed Expenses Remain Stable,180013,67731.0,62495,130226.0,49787.0,27.66,0.02,Low Risk
U788,2024,11,659013.0,Salary Increases & Fixed Expenses Remain Stable,180013,67731.0,67834,135565.0,44448.0,24.69,0.0,Medium Risk
U788,2024,12,703461.0,Salary Increases & Fixed Expenses Remain Stable,180013,67731.0,60956,128687.0,51326.0,28.51,0.05,Low Risk
U789,2024,1,221741.0,Salary Increases & Fixed Expenses Decrease,96940,35145.0,42693,77838.0,19102.0,19.7,0.03,Medium Risk
U789,2024,2,240843.0,Salary Increases & Fixed Expenses Decrease,96940,35145.0,50256,85401.0,11539.0,11.9,0.03,High Risk
U789,2024,3,252382.0,Salary Increases & Fixed Expenses Decrease,96940,35145.0,65034,100179.0,-3239.0,-3.34,-0.03,High Risk
U789,2024,4,249143.0,Salary Increases & Fixed Expenses Decrease,96940,35145.0,49571,84716.0,12224.0,12.61,-0.0,High Risk
U789,2024,5,261367.0,Salary Increases & Fixed Expenses Decrease,96940,35145.0,38806,73951.0,22989.0,23.71,0.05,Medium Risk
U789,2024,6,284356.0,Salary Increases & Fixed Expenses Decrease,96940,35145.0,50390,85535.0,11405.0,11.77,0.03,High Risk
U789,2024,7,295761.0,Salary Increases & Fixed Expenses Decrease,116211,35145.0,63203,98348.0,17863.0,15.37,-0.05,Medium Risk
U789,2024,8,313624.0,Salary Increases & Fixed Expenses Decrease,116211,33207.0,60407,93614.0,22597.0,19.44,0.03,Medium Risk
U789,2024,9,336221.0,Salary Increases & Fixed Expenses Decrease,116211,33207.0,54299,87506.0,28705.0,24.7,-0.01,Medium Risk
U789,2024,10,364926.0,Salary Increases & Fixed Expenses Decrease,116211,33207.0,69589,102796.0,13415.0,11.54,0.02,High Risk
U789,2024,11,378341.0,Salary Increases & Fixed Expenses Decrease,116211,33207.0,68661,101868.0,14343.0,12.34,0.0,High Risk
U789,2024,12,392684.0,Salary Increases & Fixed Expenses Decrease,116211,33207.0,84639,117846.0,-1635.0,-1.41,-0.04,High Risk
U790,2024,1,241947.0,Stable Salary & Increasing Fixed Expenses,145380,49553.0,50432,99985.0,45395.0,31.23,0.0,Low Risk
U790,2024,2,287342.0,Stable Salary & Increasing Fixed Expenses,145380,49553.0,44572,94125.0,51255.0,35.26,0.0,Low Risk
U790,2024,3,338597.0,Stable Salary & Increasing Fixed Expenses,145380,49553.0,60275,109828.0,35552.0,24.45,-0.04,Medium Risk
U790,2024,4,374149.0,Stable Salary & Increasing Fixed Expenses,145380,49553.0,44187,93740.0,51640.0,35.52,0.03,Low Risk
U790,2024,5,425789.0,Stable Salary & Increasing Fixed Expenses,145380,51106.0,44067,95173.0,50207.0,34.54,0.04,Low Risk
U790,2024,6,475996.0,Stable Salary & Increasing Fixed Expenses,145380,51106.0,49146,100252.0,45128.0,31.04,-0.04,Low Risk
U790,2024,7,521124.0,Stable Salary & Increasing Fixed Expenses,145380,52285.0,44476,96761.0,48619.0,33.44,0.01,Low Risk
U790,2024,8,569743.0,Stable Salary & Increasing Fixed Expenses,145380,52285.0,49832,102117.0,43263.0,29.76,-0.02,Low Risk
U790,2024,9,613006.0,Stable Salary & Increasing Fixed Expenses,145380,52285.0,46140,98425.0,46955.0,32.3,0.02,Low Risk
U790,2024,10,659961.0,Stable Salary & Increasing Fixed Expenses,145380,53899.0,60550,114449.0,30931.0,21.28,0.04,Medium Risk
U790,2024,11,690892.0,Stable Salary & Increasing Fixed Expenses,145380,53899.0,46246,100145.0,45235.0,31.12,-0.01,Low Risk
U790,2024,12,736127.0,Stable Salary & Increasing Fixed Expenses,145380,54756.0,55054,109810.0,35570.0,24.47,0.04,Medium Risk
U791,2024,1,243984.0,Stable Salary & Increasing Fixed Expenses,288232,103330.0,175587,278917.0,9315.0,3.23,-0.03,High Risk
U791,2024,2,253299.0,Stable Salary & Increasing Fixed Expenses,288232,103330.0,229926,333256.0,-45024.0,-15.62,-0.02,High Risk
U791,2024,3,208275.0,Stable Salary & Increasing Fixed Expenses,288232,103330.0,206599,309929.0,-21697.0,-7.53,-0.02,High Risk
U791,2024,4,186578.0,Stable Salary & Increasing Fixed Expenses,288232,103330.0,192274,295604.0,-7372.0,-2.56,0.05,High Risk
U791,2024,5,179206.0,Stable Salary & Increasing Fixed Expenses,288232,103330.0,195735,299065.0,-10833.0,-3.76,-0.04,High Risk
U791,2024,6,168373.0,Stable Salary & Increasing Fixed Expenses,288232,103330.0,210961,314291.0,-26059.0,-9.04,0.05,High Risk
U791,2024,7,142314.0,Stable Salary & Increasing Fixed Expenses,288232,103330.0,208877,312207.0,-23975.0,-8.32,0.02,High Risk
U791,2024,8,118339.0,Stable Salary & Increasing Fixed Expenses,288232,103330.0,187640,290970.0,-2738.0,-0.95,0.03,High Risk
U791,2024,9,115601.0,Stable Salary & Increasing Fixed Expenses,288232,103330.0,213035,316365.0,-28133.0,-9.76,-0.02,High Risk
U791,2024,10,87468.0,Stable Salary & Increasing Fixed Expenses,288232,104803.0,175253,280056.0,8176.0,2.84,-0.01,High Risk
U791,2024,11,95644.0,Stable Salary & Increasing Fixed Expenses,288232,104803.0,189722,294525.0,-6293.0,-2.18,0.04,High Risk
U791,2024,12,89351.0,Stable Salary & Increasing Fixed Expenses,288232,106294.0,221657,327951.0,-39719.0,-13.78,-0.01,High Risk
U792,2024,1,248930.0,Stable Salary & Decreasing Fixed Expenses,178409,50680.0,56044,106724.0,71685.0,40.18,0.0,Low Risk
U792,2024,2,320615.0,Stable Salary & Decreasing Fixed Expenses,178409,50680.0,67850,118530.0,59879.0,33.56,0.05,Low Risk
U792,2024,3,380494.0,Stable Salary & Decreasing Fixed Expenses,178409,49492.0,82382,131874.0,46535.0,26.08,0.03,Low Risk
U792,2024,4,427029.0,Stable Salary & Decreasing Fixed Expenses,178409,49492.0,58246,107738.0,70671.0,39.61,0.0,Low Risk
U792,2024,5,497700.0,Stable Salary & Decreasing Fixed Expenses,178409,49492.0,66203,115695.0,62714.0,35.15,0.04,Low Risk
U792,2024,6,560414.0,Stable Salary & Decreasing Fixed Expenses,178409,49492.0,66714,116206.0,62203.0,34.87,0.03,Low Risk
U792,2024,7,622617.0,Stable Salary & Decreasing Fixed Expenses,178409,49492.0,59621,109113.0,69296.0,38.84,0.03,Low Risk
U792,2024,8,691913.0,Stable Salary & Decreasing Fixed Expenses,178409,49492.0,59959,109451.0,68958.0,38.65,0.02,Low Risk
U792,2024,9,760871.0,Stable Salary & Decreasing Fixed Expenses,178409,49492.0,69820,119312.0,59097.0,33.12,-0.01,Low Risk
U792,2024,10,819968.0,Stable Salary & Decreasing Fixed Expenses,178409,49492.0,80876,130368.0,48041.0,26.93,-0.01,Low Risk
U792,2024,11,868009.0,Stable Salary & Decreasing Fixed Expenses,178409,49492.0,60006,109498.0,68911.0,38.63,-0.0,Low Risk
U792,2024,12,936920.0,Stable Salary & Decreasing Fixed Expenses,178409,49492.0,65360,114852.0,63557.0,35.62,0.03,Low Risk
U793,2024,1,208710.0,Salary Increases & Fixed Expenses Decrease,100591,57382.0,32964,90346.0,10245.0,10.18,0.02,High Risk
U793,2024,2,218955.0,Salary Increases & Fixed Expenses Decrease,100591,57382.0,37499,94881.0,5710.0,5.68,0.04,High Risk
U793,2024,3,224665.0,Salary Increases & Fixed Expenses Decrease,100591,57382.0,42959,100341.0,250.0,0.25,0.03,High Risk
U793,2024,4,224915.0,Salary Increases & Fixed Expenses Decrease,100591,57382.0,32026,89408.0,11183.0,11.12,-0.03,High Risk
U793,2024,5,236098.0,Salary Increases & Fixed Expenses Decrease,100591,57382.0,31300,88682.0,11909.0,11.84,-0.04,High Risk
U793,2024,6,248007.0,Salary Increases & Fixed Expenses Decrease,107295,57382.0,34362,91744.0,15551.0,14.49,0.02,High Risk
U793,2024,7,263558.0,Salary Increases & Fixed Expenses Decrease,107295,57382.0,32865,90247.0,17048.0,15.89,-0.04,Medium Risk
U793,2024,8,280606.0,Salary Increases & Fixed Expenses Decrease,107295,57382.0,42248,99630.0,7665.0,7.14,0.02,High Risk
U793,2024,9,288271.0,Salary Increases & Fixed Expenses Decrease,107295,57382.0,34926,92308.0,14987.0,13.97,-0.0,High Risk
U793,2024,10,303258.0,Salary Increases & Fixed Expenses Decrease,107295,57382.0,43811,101193.0,6102.0,5.69,-0.01,High Risk
U793,2024,11,309360.0,Salary Increases & Fixed Expenses Decrease,107295,57382.0,42070,99452.0,7843.0,7.31,-0.01,High Risk
U793,2024,12,317203.0,Salary Increases & Fixed Expenses Decrease,107295,57382.0,36417,93799.0,13496.0,12.58,-0.03,High Risk
U794,2024,1,231364.0,Salary Increases & Fixed Expenses Remain Stable,168000,71767.0,110159,181926.0,-13926.0,-8.29,-0.01,High Risk
U794,2024,2,217438.0,Salary Increases & Fixed Expenses Remain Stable,168000,71767.0,126944,198711.0,-30711.0,-18.28,0.02,High Risk
U794,2024,3,186727.0,Salary Increases & Fixed Expenses Remain Stable,168000,71767.0,135357,207124.0,-39124.0,-23.29,0.01,High Risk
U794,2024,4,147603.0,Salary Increases & Fixed Expenses Remain Stable,168000,71767.0,111363,183130.0,-15130.0,-9.01,-0.04,High Risk
U794,2024,5,132473.0,Salary Increases & Fixed Expenses Remain Stable,168000,71767.0,114574,186341.0,-18341.0,-10.92,-0.04,High Risk
U794,2024,6,114132.0,Salary Increases & Fixed Expenses Remain Stable,168000,71767.0,103683,175450.0,-7450.0,-4.43,0.01,High Risk
U794,2024,7,106682.0,Salary Increases & Fixed Expenses Remain Stable,168000,71767.0,109020,180787.0,-12787.0,-7.61,-0.01,High Risk
U794,2024,8,93895.0,Salary Increases & Fixed Expenses Remain Stable,182602,71767.0,129233,201000.0,-18398.0,-10.08,-0.04,High Risk
U794,2024,9,75497.0,Salary Increases & Fixed Expenses Remain Stable,182602,71767.0,128859,200626.0,-18024.0,-9.87,-0.03,High Risk
U794,2024,10,57473.0,Salary Increases & Fixed Expenses Remain Stable,182602,71767.0,171089,242856.0,-60254.0,-33.0,0.05,High Risk
U794,2024,11,-2781.0,Salary Increases & Fixed Expenses Remain Stable,182602,71767.0,126674,198441.0,-15839.0,-8.67,-0.02,High Risk
U794,2024,12,-18620.0,Salary Increases & Fixed Expenses Remain Stable,182602,71767.0,141923,213690.0,-31088.0,-17.03,0.01,High Risk
U795,2024,1,239132.0,Stable Salary & Increasing Fixed Expenses,238189,79848.0,113537,193385.0,44804.0,18.81,0.01,Medium Risk
U795,2024,2,283936.0,Stable Salary & Increasing Fixed Expenses,238189,79848.0,120403,200251.0,37938.0,15.93,-0.04,Medium Risk
U795,2024,3,321874.0,Stable Salary & Increasing Fixed Expenses,238189,79848.0,134535,214383.0,23806.0,9.99,-0.03,High Risk
U795,2024,4,345680.0,Stable Salary & Increasing Fixed Expenses,238189,79848.0,104580,184428.0,53761.0,22.57,0.01,Medium Risk
U795,2024,5,399441.0,Stable Salary & Increasing Fixed Expenses,238189,79848.0,110583,190431.0,47758.0,20.05,-0.03,Medium Risk
U795,2024,6,447199.0,Stable Salary & Increasing Fixed Expenses,238189,79848.0,141814,221662.0,16527.0,6.94,0.0,High Risk
U795,2024,7,463726.0,Stable Salary & Increasing Fixed Expenses,238189,79848.0,128865,208713.0,29476.0,12.38,0.04,High Risk
U795,2024,8,493202.0,Stable Salary & Increasing Fixed Expenses,238189,79848.0,136012,215860.0,22329.0,9.37,0.04,High Risk
U795,2024,9,515531.0,Stable Salary & Increasing Fixed Expenses,238189,79848.0,101579,181427.0,56762.0,23.83,0.04,Medium Risk
U795,2024,10,572293.0,Stable Salary & Increasing Fixed Expenses,238189,79848.0,97433,177281.0,60908.0,25.57,0.04,Low Risk
U795,2024,11,633201.0,Stable Salary & Increasing Fixed Expenses,238189,81166.0,121243,202409.0,35780.0,15.02,-0.0,Medium Risk
U795,2024,12,668981.0,Stable Salary & Increasing Fixed Expenses,238189,81166.0,96806,177972.0,60217.0,25.28,-0.02,Low Risk
U796,2024,1,211113.0,Stable Salary & Stable Fixed Expenses,141068,54952.0,80122,135074.0,5994.0,4.25,0.02,High Risk
U796,2024,2,217107.0,Stable Salary & Stable Fixed Expenses,141068,54952.0,73886,128838.0,12230.0,8.67,-0.0,High Risk
U796,2024,3,229337.0,Stable Salary & Stable Fixed Expenses,141068,54952.0,64696,119648.0,21420.0,15.18,0.0,Medium Risk
U796,2024,4,250757.0,Stable Salary & Stable Fixed Expenses,141068,54952.0,68259,123211.0,17857.0,12.66,0.04,High Risk
U796,2024,5,268614.0,Stable Salary & Stable Fixed Expenses,141068,54952.0,63364,118316.0,22752.0,16.13,0.04,Medium Risk
U796,2024,6,291366.0,Stable Salary & Stable Fixed Expenses,141068,54952.0,78695,133647.0,7421.0,5.26,0.01,High Risk
U796,2024,7,298787.0,Stable Salary & Stable Fixed Expenses,141068,54952.0,63885,118837.0,22231.0,15.76,-0.04,Medium Risk
U796,2024,8,321018.0,Stable Salary & Stable Fixed Expenses,141068,54952.0,58308,113260.0,27808.0,19.71,0.03,Medium Risk
U796,2024,9,348826.0,Stable Salary & Stable Fixed Expenses,141068,54952.0,62028,116980.0,24088.0,17.08,-0.01,Medium Risk
U796,2024,10,372914.0,Stable Salary & Stable Fixed Expenses,141068,54952.0,80231,135183.0,5885.0,4.17,-0.02,High Risk
U796,2024,11,378799.0,Stable Salary & Stable Fixed Expenses,141068,54952.0,68418,123370.0,17698.0,12.55,0.02,High Risk
U796,2024,12,396497.0,Stable Salary & Stable Fixed Expenses,141068,54952.0,72883,127835.0,13233.0,9.38,0.03,High Risk
U797,2024,1,237174.0,Stable Salary & Stable Fixed Expenses,54228,29500.0,28935,58435.0,-4207.0,-7.76,0.04,High Risk
U797,2024,2,232967.0,Stable Salary & Stable Fixed Expenses,54228,29500.0,26447,55947.0,-1719.0,-3.17,0.03,High Risk
U797,2024,3,231248.0,Stable Salary & Stable Fixed Expenses,54228,29500.0,31009,60509.0,-6281.0,-11.58,-0.04,High Risk
U797,2024,4,224967.0,Stable Salary & Stable Fixed Expenses,54228,29500.0,24515,54015.0,213.0,0.39,-0.01,High Risk
U797,2024,5,225180.0,Stable Salary & Stable Fixed Expenses,54228,29500.0,23502,53002.0,1226.0,2.26,-0.04,High Risk
U797,2024,6,226406.0,Stable Salary & Stable Fixed Expenses,54228,29500.0,27149,56649.0,-2421.0,-4.46,0.03,High Risk
U797,2024,7,223985.0,Stable Salary & Stable Fixed Expenses,54228,29500.0,31960,61460.0,-7232.0,-13.34,0.05,High Risk
U797,2024,8,216753.0,Stable Salary & Stable Fixed Expenses,54228,29500.0,28334,57834.0,-3606.0,-6.65,-0.02,High Risk
U797,2024,9,213147.0,Stable Salary & Stable Fixed Expenses,54228,29500.0,28919,58419.0,-4191.0,-7.73,-0.05,High Risk
U797,2024,10,208956.0,Stable Salary & Stable Fixed Expenses,54228,29500.0,33908,63408.0,-9180.0,-16.93,-0.02,High Risk
U797,2024,11,199776.0,Stable Salary & Stable Fixed Expenses,54228,29500.0,34705,64205.0,-9977.0,-18.4,0.0,High Risk
U797,2024,12,189799.0,Stable Salary & Stable Fixed Expenses,54228,29500.0,27737,57237.0,-3009.0,-5.55,0.04,High Risk
U798,2024,1,227532.0,Salary Increases & Fixed Expenses Remain Stable,265514,111600.0,99291,210891.0,54623.0,20.57,0.03,Medium Risk
U798,2024,2,282155.0,Salary Increases & Fixed Expenses Remain Stable,265514,111600.0,91255,202855.0,62659.0,23.6,-0.02,Medium Risk
U798,2024,3,344814.0,Salary Increases & Fixed Expenses Remain Stable,265514,111600.0,128718,240318.0,25196.0,9.49,-0.03,High Risk
U798,2024,4,370010.0,Salary Increases & Fixed Expenses Remain Stable,281446,111600.0,84631,196231.0,85215.0,30.28,0.03,Low Risk
U798,2024,5,455225.0,Salary Increases & Fixed Expenses Remain Stable,281446,111600.0,92415,204015.0,77431.0,27.51,-0.04,Low Risk
U798,2024,6,532656.0,Salary Increases & Fixed Expenses Remain Stable,281446,111600.0,110138,221738.0,59708.0,21.21,-0.03,Medium Risk
U798,2024,7,592364.0,Salary Increases & Fixed Expenses Remain Stable,281446,111600.0,105807,217407.0,64039.0,22.75,0.02,Medium Risk
U798,2024,8,656403.0,Salary Increases & Fixed Expenses Remain Stable,281446,111600.0,90004,201604.0,79842.0,28.37,0.05,Low Risk
U798,2024,9,736245.0,Salary Increases & Fixed Expenses Remain Stable,281446,111600.0,119237,230837.0,50609.0,17.98,-0.04,Medium Risk
U798,2024,10,786854.0,Salary Increases & Fixed Expenses Remain Stable,281446,111600.0,121637,233237.0,48209.0,17.13,-0.05,Medium Risk
U798,2024,11,835063.0,Salary Increases & Fixed Expenses Remain Stable,281446,111600.0,97813,209413.0,72033.0,25.59,-0.03,Low Risk
U798,2024,12,907096.0,Salary Increases & Fixed Expenses Remain Stable,281446,111600.0,136983,248583.0,32863.0,11.68,-0.03,High Risk
U799,2024,1,207224.0,Salary Increases & Fixed Expenses Increase,210417,70823.0,112168,182991.0,27426.0,13.03,0.02,High Risk
U799,2024,2,234650.0,Salary Increases & Fixed Expenses Increase,210417,72180.0,118106,190286.0,20131.0,9.57,-0.02,High Risk
U799,2024,3,254781.0,Salary Increases & Fixed Expenses Increase,210417,72180.0,114367,186547.0,23870.0,11.34,0.04,High Risk
U799,2024,4,278651.0,Salary Increases & Fixed Expenses Increase,210417,72180.0,98880,171060.0,39357.0,18.7,0.04,Medium Risk
U799,2024,5,318008.0,Salary Increases & Fixed Expenses Increase,210417,73775.0,98205,171980.0,38437.0,18.27,-0.03,Medium Risk
U799,2024,6,356445.0,Salary Increases & Fixed Expenses Increase,210417,73775.0,120037,193812.0,16605.0,7.89,-0.04,High Risk
U799,2024,7,373050.0,Salary Increases & Fixed Expenses Increase,228958,74540.0,134919,209459.0,19499.0,8.52,-0.03,High Risk
U799,2024,8,392549.0,Salary Increases & Fixed Expenses Increase,228958,74540.0,114158,188698.0,40260.0,17.58,0.04,Medium Risk
U799,2024,9,432809.0,Salary Increases & Fixed Expenses Increase,228958,74540.0,98953,173493.0,55465.0,24.22,-0.02,Medium Risk
U799,2024,10,488274.0,Salary Increases & Fixed Expenses Increase,228958,75040.0,157749,232789.0,-3831.0,-1.67,-0.02,High Risk
U799,2024,11,484443.0,Salary Increases & Fixed Expenses Increase,228958,75040.0,112956,187996.0,40962.0,17.89,0.01,Medium Risk
U799,2024,12,525405.0,Salary Increases & Fixed Expenses Increase,228958,75040.0,121401,196441.0,32517.0,14.2,-0.05,High Risk
U800,2024,1,205752.0,Salary Increases & Fixed Expenses Increase,79933,39097.0,44388,83485.0,-3552.0,-4.44,-0.01,High Risk
U800,2024,2,202200.0,Salary Increases & Fixed Expenses Increase,79933,39097.0,42200,81297.0,-1364.0,-1.71,-0.02,High Risk
U800,2024,3,200836.0,Salary Increases & Fixed Expenses Increase,79933,39097.0,57839,96936.0,-17003.0,-21.27,-0.01,High Risk
U800,2024,4,183833.0,Salary Increases & Fixed Expenses Increase,79933,39097.0,38351,77448.0,2485.0,3.11,0.02,High Risk
U800,2024,5,186318.0,Salary Increases & Fixed Expenses Increase,89303,39097.0,52628,91725.0,-2422.0,-2.71,0.03,High Risk
U800,2024,6,183896.0,Salary Increases & Fixed Expenses Increase,89303,40835.0,45035,85870.0,3433.0,3.84,-0.0,High Risk
U800,2024,7,187329.0,Salary Increases & Fixed Expenses Increase,89303,40835.0,45099,85934.0,3369.0,3.77,-0.01,High Risk
U800,2024,8,190698.0,Salary Increases & Fixed Expenses Increase,89303,40835.0,37644,78479.0,10824.0,12.12,0.02,High Risk
U800,2024,9,201522.0,Salary Increases & Fixed Expenses Increase,89303,41555.0,52132,93687.0,-4384.0,-4.91,-0.0,High Risk
U800,2024,10,197138.0,Salary Increases & Fixed Expenses Increase,89303,41555.0,50323,91878.0,-2575.0,-2.88,-0.01,High Risk
U800,2024,11,194563.0,Salary Increases & Fixed Expenses Increase,89303,43124.0,37251,80375.0,8928.0,10.0,-0.05,High Risk
U800,2024,12,203491.0,Salary Increases & Fixed Expenses Increase,89303,43124.0,38634,81758.0,7545.0,8.45,0.04,High Risk
U801,2024,1,217004.0,Salary Increases & Fixed Expenses Remain Stable,107270,40919.0,53563,94482.0,12788.0,11.92,0.03,High Risk
U801,2024,2,229792.0,Salary Increases & Fixed Expenses Remain Stable,107270,40919.0,52583,93502.0,13768.0,12.83,-0.01,High Risk
U801,2024,3,243560.0,Salary Increases & Fixed Expenses Remain Stable,107270,40919.0,56541,97460.0,9810.0,9.15,-0.04,High Risk
U801,2024,4,253370.0,Salary Increases & Fixed Expenses Remain Stable,107270,40919.0,43437,84356.0,22914.0,21.36,0.02,Medium Risk
U801,2024,5,276284.0,Salary Increases & Fixed Expenses Remain Stable,121034,40919.0,66028,106947.0,14087.0,11.64,-0.04,High Risk
U801,2024,6,290371.0,Salary Increases & Fixed Expenses Remain Stable,121034,40919.0,63912,104831.0,16203.0,13.39,0.05,High Risk
U801,2024,7,306574.0,Salary Increases & Fixed Expenses Remain Stable,121034,40919.0,64616,105535.0,15499.0,12.81,0.04,High Risk
U801,2024,8,322073.0,Salary Increases & Fixed Expenses Remain Stable,121034,40919.0,62819,103738.0,17296.0,14.29,-0.03,High Risk
U801,2024,9,339369.0,Salary Increases & Fixed Expenses Remain Stable,121034,40919.0,70534,111453.0,9581.0,7.92,0.02,High Risk
U801,2024,10,348950.0,Salary Increases & Fixed Expenses Remain Stable,121034,40919.0,58571,99490.0,21544.0,17.8,-0.05,Medium Risk
U801,2024,11,370494.0,Salary Increases & Fixed Expenses Remain Stable,121034,40919.0,56232,97151.0,23883.0,19.73,-0.03,Medium Risk
U801,2024,12,394377.0,Salary Increases & Fixed Expenses Remain Stable,121034,40919.0,52020,92939.0,28095.0,23.21,-0.05,Medium Risk
U802,2024,1,248503.0,Stable Salary & Stable Fixed Expenses,215926,91781.0,108605,200386.0,15540.0,7.2,-0.0,High Risk
U802,2024,2,264043.0,Stable Salary & Stable Fixed Expenses,215926,91781.0,111265,203046.0,12880.0,5.97,-0.01,High Risk
U802,2024,3,276923.0,Stable Salary & Stable Fixed Expenses,215926,91781.0,109850,201631.0,14295.0,6.62,0.04,High Risk
U802,2024,4,291218.0,Stable Salary & Stable Fixed Expenses,215926,91781.0,86428,178209.0,37717.0,17.47,0.02,Medium Risk
U802,2024,5,328935.0,Stable Salary & Stable Fixed Expenses,215926,91781.0,102297,194078.0,21848.0,10.12,0.03,High Risk
U802,2024,6,350783.0,Stable Salary & Stable Fixed Expenses,215926,91781.0,94392,186173.0,29753.0,13.78,0.03,High Risk
U802,2024,7,380536.0,Stable Salary & Stable Fixed Expenses,215926,91781.0,113809,205590.0,10336.0,4.79,-0.02,High Risk
U802,2024,8,390872.0,Stable Salary & Stable Fixed Expenses,215926,91781.0,115788,207569.0,8357.0,3.87,0.03,High Risk
U802,2024,9,399229.0,Stable Salary & Stable Fixed Expenses,215926,91781.0,116383,208164.0,7762.0,3.59,-0.02,High Risk
U802,2024,10,406991.0,Stable Salary & Stable Fixed Expenses,215926,91781.0,112998,204779.0,11147.0,5.16,-0.03,High Risk
U802,2024,11,418138.0,Stable Salary & Stable Fixed Expenses,215926,91781.0,110138,201919.0,14007.0,6.49,0.04,High Risk
U802,2024,12,432145.0,Stable Salary & Stable Fixed Expenses,215926,91781.0,110643,202424.0,13502.0,6.25,0.02,High Risk
U803,2024,1,227043.0,Salary Increases & Fixed Expenses Remain Stable,248257,94901.0,99294,194195.0,54062.0,21.78,0.04,Medium Risk
U803,2024,2,281105.0,Salary Increases & Fixed Expenses Remain Stable,248257,94901.0,79400,174301.0,73956.0,29.79,-0.0,Low Risk
U803,2024,3,355061.0,Salary Increases & Fixed Expenses Remain Stable,248257,94901.0,98543,193444.0,54813.0,22.08,-0.02,Medium Risk
U803,2024,4,409874.0,Salary Increases & Fixed Expenses Remain Stable,248257,94901.0,95748,190649.0,57608.0,23.2,0.01,Medium Risk
U803,2024,5,467482.0,Salary Increases & Fixed Expenses Remain Stable,248257,94901.0,84256,179157.0,69100.0,27.83,-0.03,Low Risk
U803,2024,6,536582.0,Salary Increases & Fixed Expenses Remain Stable,259778,94901.0,93742,188643.0,71135.0,27.38,0.02,Low Risk
U803,2024,7,607717.0,Salary Increases & Fixed Expenses Remain Stable,259778,94901.0,93039,187940.0,71838.0,27.65,0.05,Low Risk
U803,2024,8,679555.0,Salary Increases & Fixed Expenses Remain Stable,259778,94901.0,91974,186875.0,72903.0,28.06,-0.02,Low Risk
U803,2024,9,752458.0,Salary Increases & Fixed Expenses Remain Stable,259778,94901.0,81112,176013.0,83765.0,32.24,-0.02,Low Risk
U803,2024,10,836223.0,Salary Increases & Fixed Expenses Remain Stable,259778,94901.0,86867,181768.0,78010.0,30.03,0.02,Low Risk
U803,2024,11,914233.0,Salary Increases & Fixed Expenses Remain Stable,259778,94901.0,96958,191859.0,67919.0,26.15,-0.01,Low Risk
U803,2024,12,982152.0,Salary Increases & Fixed Expenses Remain Stable,259778,94901.0,82694,177595.0,82183.0,31.64,0.01,Low Risk
U804,2024,1,248589.0,Salary Increases & Fixed Expenses Remain Stable,53965,32569.0,38816,71385.0,-17420.0,-32.28,0.02,High Risk
U804,2024,2,231169.0,Salary Increases & Fixed Expenses Remain Stable,53965,32569.0,35861,68430.0,-14465.0,-26.8,0.05,High Risk
U804,2024,3,216704.0,Salary Increases & Fixed Expenses Remain Stable,74029,32569.0,59866,92435.0,-18406.0,-24.86,-0.01,High Risk
U804,2024,4,198298.0,Salary Increases & Fixed Expenses Remain Stable,74029,32569.0,52980,85549.0,-11520.0,-15.56,-0.01,High Risk
U804,2024,5,186778.0,Salary Increases & Fixed Expenses Remain Stable,74029,32569.0,53680,86249.0,-12220.0,-16.51,-0.02,High Risk
U804,2024,6,174558.0,Salary Increases & Fixed Expenses Remain Stable,74029,32569.0,45824,78393.0,-4364.0,-5.89,-0.03,High Risk
U804,2024,7,170194.0,Salary Increases & Fixed Expenses Remain Stable,74029,32569.0,55056,87625.0,-13596.0,-18.37,-0.02,High Risk
U804,2024,8,156598.0,Salary Increases & Fixed Expenses Remain Stable,74029,32569.0,46239,78808.0,-4779.0,-6.46,0.01,High Risk
U804,2024,9,151819.0,Salary Increases & Fixed Expenses Remain Stable,74029,32569.0,59170,91739.0,-17710.0,-23.92,-0.05,High Risk
U804,2024,10,134109.0,Salary Increases & Fixed Expenses Remain Stable,74029,32569.0,58212,90781.0,-16752.0,-22.63,-0.02,High Risk
U804,2024,11,117357.0,Salary Increases & Fixed Expenses Remain Stable,74029,32569.0,47800,80369.0,-6340.0,-8.56,0.04,High Risk
U804,2024,12,111017.0,Salary Increases & Fixed Expenses Remain Stable,74029,32569.0,54667,87236.0,-13207.0,-17.84,0.02,High Risk
U805,2024,1,202727.0,Salary Increases & Fixed Expenses Increase,53298,28357.0,41064,69421.0,-16123.0,-30.25,-0.04,High Risk
U805,2024,2,186604.0,Salary Increases & Fixed Expenses Increase,53298,28357.0,38401,66758.0,-13460.0,-25.25,-0.02,High Risk
U805,2024,3,173144.0,Salary Increases & Fixed Expenses Increase,53298,28357.0,48755,77112.0,-23814.0,-44.68,0.03,High Risk
U805,2024,4,149330.0,Salary Increases & Fixed Expenses Increase,53298,28357.0,38145,66502.0,-13204.0,-24.77,-0.05,High Risk
U805,2024,5,136126.0,Salary Increases & Fixed Expenses Increase,53298,28357.0,33736,62093.0,-8795.0,-16.5,-0.03,High Risk
U805,2024,6,127331.0,Salary Increases & Fixed Expenses Increase,53298,29242.0,34608,63850.0,-10552.0,-19.8,0.02,High Risk
U805,2024,7,116779.0,Salary Increases & Fixed Expenses Increase,53298,29242.0,38249,67491.0,-14193.0,-26.63,-0.05,High Risk
U805,2024,8,102586.0,Salary Increases & Fixed Expenses Increase,77133,29242.0,49428,78670.0,-1537.0,-1.99,0.02,High Risk
U805,2024,9,101049.0,Salary Increases & Fixed Expenses Increase,77133,29242.0,50108,79350.0,-2217.0,-2.87,0.01,High Risk
U805,2024,10,98832.0,Salary Increases & Fixed Expenses Increase,77133,29753.0,57861,87614.0,-10481.0,-13.59,0.04,High Risk
U805,2024,11,88351.0,Salary Increases & Fixed Expenses Increase,77133,29753.0,57288,87041.0,-9908.0,-12.85,-0.03,High Risk
U805,2024,12,78443.0,Salary Increases & Fixed Expenses Increase,77133,30268.0,51313,81581.0,-4448.0,-5.77,0.01,High Risk
U806,2024,1,206873.0,Salary Increases & Fixed Expenses Increase,248246,97891.0,105923,203814.0,44432.0,17.9,-0.04,Medium Risk
U806,2024,2,251305.0,Salary Increases & Fixed Expenses Increase,248246,97891.0,100326,198217.0,50029.0,20.15,-0.01,Medium Risk
U806,2024,3,301334.0,Salary Increases & Fixed Expenses Increase,248246,97891.0,117960,215851.0,32395.0,13.05,-0.03,High Risk
U806,2024,4,333729.0,Salary Increases & Fixed Expenses Increase,248246,99646.0,129405,229051.0,19195.0,7.73,-0.05,High Risk
U806,2024,5,352924.0,Salary Increases & Fixed Expenses Increase,248246,99646.0,128608,228254.0,19992.0,8.05,-0.02,High Risk
U806,2024,6,372916.0,Salary Increases & Fixed Expenses Increase,248246,99646.0,118777,218423.0,29823.0,12.01,0.03,High Risk
U806,2024,7,402739.0,Salary Increases & Fixed Expenses Increase,276298,99646.0,116926,216572.0,59726.0,21.62,-0.04,Medium Risk
U806,2024,8,462465.0,Salary Increases & Fixed Expenses Increase,276298,99646.0,144642,244288.0,32010.0,11.59,-0.0,High Risk
U806,2024,9,494475.0,Salary Increases & Fixed Expenses Increase,276298,99646.0,131707,231353.0,44945.0,16.27,0.02,Medium Risk
U806,2024,10,539420.0,Salary Increases & Fixed Expenses Increase,276298,99646.0,150035,249681.0,26617.0,9.63,0.01,High Risk
U806,2024,11,566037.0,Salary Increases & Fixed Expenses Increase,276298,100801.0,117074,217875.0,58423.0,21.14,-0.02,Medium Risk
U806,2024,12,624460.0,Salary Increases & Fixed Expenses Increase,276298,100801.0,164802,265603.0,10695.0,3.87,-0.04,High Risk
U807,2024,1,212234.0,Stable Salary & Increasing Fixed Expenses,169630,68401.0,61765,130166.0,39464.0,23.26,-0.04,Medium Risk
U807,2024,2,251698.0,Stable Salary & Increasing Fixed Expenses,169630,68401.0,65123,133524.0,36106.0,21.29,0.02,Medium Risk
U807,2024,3,287804.0,Stable Salary & Increasing Fixed Expenses,169630,68401.0,64229,132630.0,37000.0,21.81,-0.03,Medium Risk
U807,2024,4,324804.0,Stable Salary & Increasing Fixed Expenses,169630,68401.0,65025,133426.0,36204.0,21.34,-0.02,Medium Risk
U807,2024,5,361008.0,Stable Salary & Increasing Fixed Expenses,169630,68401.0,60676,129077.0,40553.0,23.91,-0.03,Medium Risk
U807,2024,6,401561.0,Stable Salary & Increasing Fixed Expenses,169630,68401.0,53665,122066.0,47564.0,28.04,0.04,Low Risk
U807,2024,7,449125.0,Stable Salary & Increasing Fixed Expenses,169630,68401.0,65699,134100.0,35530.0,20.95,-0.02,Medium Risk
U807,2024,8,484655.0,Stable Salary & Increasing Fixed Expenses,169630,68401.0,62978,131379.0,38251.0,22.55,-0.05,Medium Risk
U807,2024,9,522906.0,Stable Salary & Increasing Fixed Expenses,169630,68401.0,61856,130257.0,39373.0,23.21,-0.05,Medium Risk
U807,2024,10,562279.0,Stable Salary & Increasing Fixed Expenses,169630,68401.0,79865,148266.0,21364.0,12.59,0.03,High Risk
U807,2024,11,583643.0,Stable Salary & Increasing Fixed Expenses,169630,68401.0,68628,137029.0,32601.0,19.22,-0.01,Medium Risk
U807,2024,12,616244.0,Stable Salary & Increasing Fixed Expenses,169630,68401.0,66806,135207.0,34423.0,20.29,0.03,Medium Risk
U808,2024,1,211831.0,Stable Salary & Stable Fixed Expenses,96468,31228.0,54001,85229.0,11239.0,11.65,0.05,High Risk
U808,2024,2,223070.0,Stable Salary & Stable Fixed Expenses,96468,31228.0,44097,75325.0,21143.0,21.92,-0.02,Medium Risk
U808,2024,3,244213.0,Stable Salary & Stable Fixed Expenses,96468,31228.0,57262,88490.0,7978.0,8.27,-0.03,High Risk
U808,2024,4,252191.0,Stable Salary & Stable Fixed Expenses,96468,31228.0,49732,80960.0,15508.0,16.08,-0.01,Medium Risk
U808,2024,5,267699.0,Stable Salary & Stable Fixed Expenses,96468,31228.0,39823,71051.0,25417.0,26.35,0.05,Low Risk
U808,2024,6,293116.0,Stable Salary & Stable Fixed Expenses,96468,31228.0,39009,70237.0,26231.0,27.19,0.03,Low Risk
U808,2024,7,319347.0,Stable Salary & Stable Fixed Expenses,96468,31228.0,42360,73588.0,22880.0,23.72,-0.03,Medium Risk
U808,2024,8,342227.0,Stable Salary & Stable Fixed Expenses,96468,31228.0,40554,71782.0,24686.0,25.59,-0.0,Low Risk
U808,2024,9,366913.0,Stable Salary & Stable Fixed Expenses,96468,31228.0,42748,73976.0,22492.0,23.32,-0.01,Medium Risk
U808,2024,10,389405.0,Stable Salary & Stable Fixed Expenses,96468,31228.0,42588,73816.0,22652.0,23.48,-0.02,Medium Risk
U808,2024,11,412057.0,Stable Salary & Stable Fixed Expenses,96468,31228.0,55230,86458.0,10010.0,10.38,0.01,High Risk
U808,2024,12,422067.0,Stable Salary & Stable Fixed Expenses,96468,31228.0,56237,87465.0,9003.0,9.33,-0.04,High Risk
U809,2024,1,204085.0,Salary Increases & Fixed Expenses Remain Stable,89961,39152.0,31755,70907.0,19054.0,21.18,-0.03,Medium Risk
U809,2024,2,223139.0,Salary Increases & Fixed Expenses Remain Stable,89961,39152.0,29169,68321.0,21640.0,24.05,0.05,Medium Risk
U809,2024,3,244779.0,Salary Increases & Fixed Expenses Remain Stable,89961,39152.0,30459,69611.0,20350.0,22.62,-0.01,Medium Risk
U809,2024,4,265129.0,Salary Increases & Fixed Expenses Remain Stable,106844,39152.0,36689,75841.0,31003.0,29.02,-0.04,Low Risk
U809,2024,5,296132.0,Salary Increases & Fixed Expenses Remain Stable,106844,39152.0,33022,72174.0,34670.0,32.45,0.05,Low Risk
U809,2024,6,330802.0,Salary Increases & Fixed Expenses Remain Stable,106844,39152.0,34286,73438.0,33406.0,31.27,-0.04,Low Risk
U809,2024,7,364208.0,Salary Increases & Fixed Expenses Remain Stable,106844,39152.0,32077,71229.0,35615.0,33.33,-0.02,Low Risk
U809,2024,8,399823.0,Salary Increases & Fixed Expenses Remain Stable,106844,39152.0,37140,76292.0,30552.0,28.59,0.03,Low Risk
U809,2024,9,430375.0,Salary Increases & Fixed Expenses Remain Stable,106844,39152.0,39289,78441.0,28403.0,26.58,0.03,Low Risk
U809,2024,10,458778.0,Salary Increases & Fixed Expenses Remain Stable,106844,39152.0,39585,78737.0,28107.0,26.31,0.04,Low Risk
U809,2024,11,486885.0,Salary Increases & Fixed Expenses Remain Stable,106844,39152.0,36057,75209.0,31635.0,29.61,0.04,Low Risk
U809,2024,12,518520.0,Salary Increases & Fixed Expenses Remain Stable,106844,39152.0,38671,77823.0,29021.0,27.16,0.03,Low Risk
U810,2024,1,229665.0,Salary Increases & Fixed Expenses Increase,155933,66334.0,49101,115435.0,40498.0,25.97,0.03,Low Risk
U810,2024,2,270163.0,Salary Increases & Fixed Expenses Increase,155933,66334.0,60755,127089.0,28844.0,18.5,-0.03,Medium Risk
U810,2024,3,299007.0,Salary Increases & Fixed Expenses Increase,155933,66334.0,52445,118779.0,37154.0,23.83,-0.0,Medium Risk
U810,2024,4,336161.0,Salary Increases & Fixed Expenses Increase,155933,68250.0,58742,126992.0,28941.0,18.56,0.04,Medium Risk
U810,2024,5,365102.0,Salary Increases & Fixed Expenses Increase,155933,68250.0,57140,125390.0,30543.0,19.59,0.01,Medium Risk
U810,2024,6,395645.0,Salary Increases & Fixed Expenses Increase,155933,68250.0,60684,128934.0,26999.0,17.31,0.05,Medium Risk
U810,2024,7,422644.0,Salary Increases & Fixed Expenses Increase,155933,68250.0,53804,122054.0,33879.0,21.73,0.01,Medium Risk
U810,2024,8,456523.0,Salary Increases & Fixed Expenses Increase,163187,68250.0,60485,128735.0,34452.0,21.11,-0.0,Medium Risk
U810,2024,9,490975.0,Salary Increases & Fixed Expenses Increase,163187,68250.0,62280,130530.0,32657.0,20.01,0.04,Medium Risk
U810,2024,10,523632.0,Salary Increases & Fixed Expenses Increase,163187,68250.0,54467,122717.0,40470.0,24.8,0.05,Medium Risk
U810,2024,11,564102.0,Salary Increases & Fixed Expenses Increase,163187,68250.0,49216,117466.0,45721.0,28.02,0.01,Low Risk
U810,2024,12,609823.0,Salary Increases & Fixed Expenses Increase,163187,68250.0,54899,123149.0,40038.0,24.54,0.03,Medium Risk
U811,2024,1,231479.0,Stable Salary & Increasing Fixed Expenses,145632,64489.0,52626,117115.0,28517.0,19.58,0.03,Medium Risk
U811,2024,2,259996.0,Stable Salary & Increasing Fixed Expenses,145632,65780.0,49834,115614.0,30018.0,20.61,0.02,Medium Risk
U811,2024,3,290014.0,Stable Salary & Increasing Fixed Expenses,145632,65780.0,53810,119590.0,26042.0,17.88,0.04,Medium Risk
U811,2024,4,316056.0,Stable Salary & Increasing Fixed Expenses,145632,65780.0,55948,121728.0,23904.0,16.41,0.02,Medium Risk
U811,2024,5,339960.0,Stable Salary & Increasing Fixed Expenses,145632,65780.0,52355,118135.0,27497.0,18.88,-0.01,Medium Risk
U811,2024,6,367457.0,Stable Salary & Increasing Fixed Expenses,145632,65780.0,52837,118617.0,27015.0,18.55,0.0,Medium Risk
U811,2024,7,394472.0,Stable Salary & Increasing Fixed Expenses,145632,65780.0,47415,113195.0,32437.0,22.27,-0.02,Medium Risk
U811,2024,8,426909.0,Stable Salary & Increasing Fixed Expenses,145632,65780.0,50090,115870.0,29762.0,20.44,0.04,Medium Risk
U811,2024,9,456671.0,Stable Salary & Increasing Fixed Expenses,145632,65780.0,52508,118288.0,27344.0,18.78,0.0,Medium Risk
U811,2024,10,484015.0,Stable Salary & Increasing Fixed Expenses,145632,65780.0,52168,117948.0,27684.0,19.01,0.01,Medium Risk
U811,2024,11,511699.0,Stable Salary & Increasing Fixed Expenses,145632,65780.0,44500,110280.0,35352.0,24.27,0.01,Medium Risk
U811,2024,12,547051.0,Stable Salary & Increasing Fixed Expenses,145632,65780.0,46420,112200.0,33432.0,22.96,0.04,Medium Risk
U812,2024,1,240172.0,Salary Increases & Fixed Expenses Decrease,76913,26595.0,47315,73910.0,3003.0,3.9,-0.01,High Risk
U812,2024,2,243175.0,Salary Increases & Fixed Expenses Decrease,76913,26595.0,49745,76340.0,573.0,0.74,-0.04,High Risk
U812,2024,3,243748.0,Salary Increases & Fixed Expenses Decrease,76913,26595.0,58660,85255.0,-8342.0,-10.85,-0.04,High Risk
U812,2024,4,235406.0,Salary Increases & Fixed Expenses Decrease,76913,26595.0,58258,84853.0,-7940.0,-10.32,-0.04,High Risk
U812,2024,5,227466.0,Salary Increases & Fixed Expenses Decrease,76913,26595.0,60149,86744.0,-9831.0,-12.78,0.03,High Risk
U812,2024,6,217635.0,Salary Increases & Fixed Expenses Decrease,98184,26595.0,59065,85660.0,12524.0,12.76,-0.02,High Risk
U812,2024,7,230159.0,Salary Increases & Fixed Expenses Decrease,98184,26595.0,72818,99413.0,-1229.0,-1.25,0.04,High Risk
U812,2024,8,228930.0,Salary Increases & Fixed Expenses Decrease,98184,24926.0,59081,84007.0,14177.0,14.44,-0.02,High Risk
U812,2024,9,243107.0,Salary Increases & Fixed Expenses Decrease,98184,24926.0,78135,103061.0,-4877.0,-4.97,0.03,High Risk
U812,2024,10,238230.0,Salary Increases & Fixed Expenses Decrease,98184,24926.0,71854,96780.0,1404.0,1.43,0.02,High Risk
U812,2024,11,239634.0,Salary Increases & Fixed Expenses Decrease,98184,24926.0,70757,95683.0,2501.0,2.55,-0.01,High Risk
U812,2024,12,242135.0,Salary Increases & Fixed Expenses Decrease,98184,24926.0,69430,94356.0,3828.0,3.9,0.0,High Risk
U813,2024,1,231159.0,Salary Increases & Fixed Expenses Remain Stable,118199,71279.0,45370,116649.0,1550.0,1.31,-0.01,High Risk
U813,2024,2,232709.0,Salary Increases & Fixed Expenses Remain Stable,118199,71279.0,39312,110591.0,7608.0,6.44,0.0,High Risk
U813,2024,3,240317.0,Salary Increases & Fixed Expenses Remain Stable,118199,71279.0,56095,127374.0,-9175.0,-7.76,0.02,High Risk
U813,2024,4,231142.0,Salary Increases & Fixed Expenses Remain Stable,118199,71279.0,43263,114542.0,3657.0,3.09,0.05,High Risk
U813,2024,5,234799.0,Salary Increases & Fixed Expenses Remain Stable,118199,71279.0,38056,109335.0,8864.0,7.5,0.04,High Risk
U813,2024,6,243663.0,Salary Increases & Fixed Expenses Remain Stable,118199,71279.0,41612,112891.0,5308.0,4.49,-0.03,High Risk
U813,2024,7,248971.0,Salary Increases & Fixed Expenses Remain Stable,118199,71279.0,44669,115948.0,2251.0,1.9,-0.04,High Risk
U813,2024,8,251222.0,Salary Increases & Fixed Expenses Remain Stable,127453,71279.0,44166,115445.0,12008.0,9.42,-0.02,High Risk
U813,2024,9,263230.0,Salary Increases & Fixed Expenses Remain Stable,127453,71279.0,48224,119503.0,7950.0,6.24,-0.02,High Risk
U813,2024,10,271180.0,Salary Increases & Fixed Expenses Remain Stable,127453,71279.0,46401,117680.0,9773.0,7.67,-0.03,High Risk
U813,2024,11,280953.0,Salary Increases & Fixed Expenses Remain Stable,127453,71279.0,42719,113998.0,13455.0,10.56,0.01,High Risk
U813,2024,12,294408.0,Salary Increases & Fixed Expenses Remain Stable,127453,71279.0,42599,113878.0,13575.0,10.65,0.03,High Risk
U814,2024,1,239708.0,Salary Increases & Fixed Expenses Remain Stable,43438,13432.0,25285,38717.0,4721.0,10.87,0.03,High Risk
U814,2024,2,244429.0,Salary Increases & Fixed Expenses Remain Stable,43438,13432.0,23864,37296.0,6142.0,14.14,0.03,High Risk
U814,2024,3,250571.0,Salary Increases & Fixed Expenses Remain Stable,43438,13432.0,23813,37245.0,6193.0,14.26,-0.05,High Risk
U814,2024,4,256764.0,Salary Increases & Fixed Expenses Remain Stable,43438,13432.0,22232,35664.0,7774.0,17.9,0.02,Medium Risk
U814,2024,5,264538.0,Salary Increases & Fixed Expenses Remain Stable,69363,13432.0,35293,48725.0,20638.0,29.75,-0.05,Low Risk
U814,2024,6,285176.0,Salary Increases & Fixed Expenses Remain Stable,69363,13432.0,37140,50572.0,18791.0,27.09,-0.05,Low Risk
U814,2024,7,303967.0,Salary Increases & Fixed Expenses Remain Stable,69363,13432.0,32671,46103.0,23260.0,33.53,0.02,Low Risk
U814,2024,8,327227.0,Salary Increases & Fixed Expenses Remain Stable,69363,13432.0,36636,50068.0,19295.0,27.82,-0.01,Low Risk
U814,2024,9,346522.0,Salary Increases & Fixed Expenses Remain Stable,69363,13432.0,41037,54469.0,14894.0,21.47,-0.0,Medium Risk
U814,2024,10,361416.0,Salary Increases & Fixed Expenses Remain Stable,69363,13432.0,37186,50618.0,18745.0,27.02,-0.05,Low Risk
U814,2024,11,380161.0,Salary Increases & Fixed Expenses Remain Stable,69363,13432.0,33468,46900.0,22463.0,32.38,0.05,Low Risk
U814,2024,12,402624.0,Salary Increases & Fixed Expenses Remain Stable,69363,13432.0,35713,49145.0,20218.0,29.15,-0.04,Low Risk
U815,2024,1,213593.0,Stable Salary & Increasing Fixed Expenses,266321,91255.0,141197,232452.0,33869.0,12.72,0.04,High Risk
U815,2024,2,247462.0,Stable Salary & Increasing Fixed Expenses,266321,91255.0,151224,242479.0,23842.0,8.95,0.05,High Risk
U815,2024,3,271304.0,Stable Salary & Increasing Fixed Expenses,266321,91255.0,160898,252153.0,14168.0,5.32,0.05,High Risk
U815,2024,4,285472.0,Stable Salary & Increasing Fixed Expenses,266321,92689.0,146595,239284.0,27037.0,10.15,0.05,High Risk
U815,2024,5,312509.0,Stable Salary & Increasing Fixed Expenses,266321,93857.0,131772,225629.0,40692.0,15.28,0.04,Medium Risk
U815,2024,6,353201.0,Stable Salary & Increasing Fixed Expenses,266321,95357.0,136782,232139.0,34182.0,12.83,0.02,High Risk
U815,2024,7,387383.0,Stable Salary & Increasing Fixed Expenses,266321,95357.0,119072,214429.0,51892.0,19.48,0.04,Medium Risk
U815,2024,8,439275.0,Stable Salary & Increasing Fixed Expenses,266321,97047.0,159741,256788.0,9533.0,3.58,0.03,High Risk
U815,2024,9,448808.0,Stable Salary & Increasing Fixed Expenses,266321,97047.0,171086,268133.0,-1812.0,-0.68,0.01,High Risk
U815,2024,10,446996.0,Stable Salary & Increasing Fixed Expenses,266321,97047.0,183371,280418.0,-14097.0,-5.29,-0.05,High Risk
U815,2024,11,432899.0,Stable Salary & Increasing Fixed Expenses,266321,97047.0,173860,270907.0,-4586.0,-1.72,0.0,High Risk
U815,2024,12,428313.0,Stable Salary & Increasing Fixed Expenses,266321,97047.0,169610,266657.0,-336.0,-0.13,-0.03,High Risk
U816,2024,1,233577.0,Stable Salary & Stable Fixed Expenses,296719,87168.0,168661,255829.0,40890.0,13.78,-0.02,High Risk
U816,2024,2,274467.0,Stable Salary & Stable Fixed Expenses,296719,87168.0,159942,247110.0,49609.0,16.72,-0.02,Medium Risk
U816,2024,3,324076.0,Stable Salary & Stable Fixed Expenses,296719,87168.0,131234,218402.0,78317.0,26.39,0.04,Low Risk
U816,2024,4,402393.0,Stable Salary & Stable Fixed Expenses,296719,87168.0,139531,226699.0,70020.0,23.6,0.04,Medium Risk
U816,2024,5,472413.0,Stable Salary & Stable Fixed Expenses,296719,87168.0,143190,230358.0,66361.0,22.36,-0.01,Medium Risk
U816,2024,6,538774.0,Stable Salary & Stable Fixed Expenses,296719,87168.0,176352,263520.0,33199.0,11.19,0.05,High Risk
U816,2024,7,571973.0,Stable Salary & Stable Fixed Expenses,296719,87168.0,121016,208184.0,88535.0,29.84,-0.0,Low Risk
U816,2024,8,660508.0,Stable Salary & Stable Fixed Expenses,296719,87168.0,120028,207196.0,89523.0,30.17,-0.02,Low Risk
U816,2024,9,750031.0,Stable Salary & Stable Fixed Expenses,296719,87168.0,160271,247439.0,49280.0,16.61,0.01,Medium Risk
U816,2024,10,799311.0,Stable Salary & Stable Fixed Expenses,296719,87168.0,154256,241424.0,55295.0,18.64,0.04,Medium Risk
U816,2024,11,854606.0,Stable Salary & Stable Fixed Expenses,296719,87168.0,170168,257336.0,39383.0,13.27,0.02,High Risk
U816,2024,12,893989.0,Stable Salary & Stable Fixed Expenses,296719,87168.0,148610,235778.0,60941.0,20.54,-0.04,Medium Risk
U817,2024,1,218498.0,Salary Increases & Fixed Expenses Decrease,42880,15282.0,16920,32202.0,10678.0,24.9,-0.05,Medium Risk
U817,2024,2,229176.0,Salary Increases & Fixed Expenses Decrease,42880,15282.0,16529,31811.0,11069.0,25.81,-0.04,Low Risk
U817,2024,3,240245.0,Salary Increases & Fixed Expenses Decrease,42880,15282.0,16235,31517.0,11363.0,26.5,0.03,Low Risk
U817,2024,4,251608.0,Salary Increases & Fixed Expenses Decrease,42880,15282.0,16303,31585.0,11295.0,26.34,0.03,Low Risk
U817,2024,5,262903.0,Salary Increases & Fixed Expenses Decrease,42880,15282.0,16506,31788.0,11092.0,25.87,0.05,Low Risk
U817,2024,6,273995.0,Salary Increases & Fixed Expenses Decrease,42880,15282.0,14730,30012.0,12868.0,30.01,-0.0,Low Risk
U817,2024,7,286863.0,Salary Increases & Fixed Expenses Decrease,52837,15282.0,16041,31323.0,21514.0,40.72,0.02,Low Risk
U817,2024,8,308377.0,Salary Increases & Fixed Expenses Decrease,52837,15282.0,19598,34880.0,17957.0,33.99,0.04,Low Risk
U817,2024,9,326334.0,Salary Increases & Fixed Expenses Decrease,52837,15282.0,17305,32587.0,20250.0,38.33,0.05,Low Risk
U817,2024,10,346584.0,Salary Increases & Fixed Expenses Decrease,52837,15282.0,24589,39871.0,12966.0,24.54,0.04,Medium Risk
U817,2024,11,359550.0,Salary Increases & Fixed Expenses Decrease,52837,15282.0,20412,35694.0,17143.0,32.45,-0.05,Low Risk
U817,2024,12,376693.0,Salary Increases & Fixed Expenses Decrease,52837,15282.0,18367,33649.0,19188.0,36.32,-0.02,Low Risk
U818,2024,1,238526.0,Stable Salary & Increasing Fixed Expenses,131795,49129.0,56108,105237.0,26558.0,20.15,0.0,Medium Risk
U818,2024,2,265084.0,Stable Salary & Increasing Fixed Expenses,131795,49129.0,76792,125921.0,5874.0,4.46,-0.03,High Risk
U818,2024,3,270958.0,Stable Salary & Increasing Fixed Expenses,131795,49129.0,73510,122639.0,9156.0,6.95,0.01,High Risk
U818,2024,4,280114.0,Stable Salary & Increasing Fixed Expenses,131795,49129.0,60254,109383.0,22412.0,17.01,-0.05,Medium Risk
U818,2024,5,302526.0,Stable Salary & Increasing Fixed Expenses,131795,49129.0,74701,123830.0,7965.0,6.04,-0.02,High Risk
U818,2024,6,310491.0,Stable Salary & Increasing Fixed Expenses,131795,49129.0,75310,124439.0,7356.0,5.58,-0.02,High Risk
U818,2024,7,317847.0,Stable Salary & Increasing Fixed Expenses,131795,49129.0,65167,114296.0,17499.0,13.28,-0.05,High Risk
U818,2024,8,335346.0,Stable Salary & Increasing Fixed Expenses,131795,49129.0,65234,114363.0,17432.0,13.23,-0.04,High Risk
U818,2024,9,352778.0,Stable Salary & Increasing Fixed Expenses,131795,49129.0,55815,104944.0,26851.0,20.37,0.05,Medium Risk
U818,2024,10,379629.0,Stable Salary & Increasing Fixed Expenses,131795,49129.0,74904,124033.0,7762.0,5.89,-0.03,High Risk
U818,2024,11,387391.0,Stable Salary & Increasing Fixed Expenses,131795,49129.0,73703,122832.0,8963.0,6.8,-0.02,High Risk
U818,2024,12,396354.0,Stable Salary & Increasing Fixed Expenses,131795,49129.0,63852,112981.0,18814.0,14.28,-0.02,High Risk
U819,2024,1,203852.0,Stable Salary & Stable Fixed Expenses,143478,56555.0,54191,110746.0,32732.0,22.81,-0.02,Medium Risk
U819,2024,2,236584.0,Stable Salary & Stable Fixed Expenses,143478,56555.0,54788,111343.0,32135.0,22.4,-0.04,Medium Risk
U819,2024,3,268719.0,Stable Salary & Stable Fixed Expenses,143478,56555.0,53801,110356.0,33122.0,23.09,0.01,Medium Risk
U819,2024,4,301841.0,Stable Salary & Stable Fixed Expenses,143478,56555.0,51649,108204.0,35274.0,24.58,0.03,Medium Risk
U819,2024,5,337115.0,Stable Salary & Stable Fixed Expenses,143478,56555.0,48692,105247.0,38231.0,26.65,0.04,Low Risk
U819,2024,6,375346.0,Stable Salary & Stable Fixed Expenses,143478,56555.0,50458,107013.0,36465.0,25.42,0.02,Low Risk
U819,2024,7,411811.0,Stable Salary & Stable Fixed Expenses,143478,56555.0,44209,100764.0,42714.0,29.77,0.02,Low Risk
U819,2024,8,454525.0,Stable Salary & Stable Fixed Expenses,143478,56555.0,53596,110151.0,33327.0,23.23,0.0,Medium Risk
U819,2024,9,487852.0,Stable Salary & Stable Fixed Expenses,143478,56555.0,43080,99635.0,43843.0,30.56,-0.02,Low Risk
U819,2024,10,531695.0,Stable Salary & Stable Fixed Expenses,143478,56555.0,56161,112716.0,30762.0,21.44,-0.05,Medium Risk
U819,2024,11,562457.0,Stable Salary & Stable Fixed Expenses,143478,56555.0,52326,108881.0,34597.0,24.11,-0.04,Medium Risk
U819,2024,12,597054.0,Stable Salary & Stable Fixed Expenses,143478,56555.0,44379,100934.0,42544.0,29.65,0.01,Low Risk
U820,2024,1,246205.0,Stable Salary & Stable Fixed Expenses,268374,79478.0,193572,273050.0,-4676.0,-1.74,-0.03,High Risk
U820,2024,2,241529.0,Stable Salary & Stable Fixed Expenses,268374,79478.0,195942,275420.0,-7046.0,-2.63,0.0,High Risk
U820,2024,3,234483.0,Stable Salary & Stable Fixed Expenses,268374,79478.0,226774,306252.0,-37878.0,-14.11,-0.05,High Risk
U820,2024,4,196605.0,Stable Salary & Stable Fixed Expenses,268374,79478.0,171343,250821.0,17553.0,6.54,-0.0,High Risk
U820,2024,5,214158.0,Stable Salary & Stable Fixed Expenses,268374,79478.0,181812,261290.0,7084.0,2.64,-0.04,High Risk
U820,2024,6,221242.0,Stable Salary & Stable Fixed Expenses,268374,79478.0,203310,282788.0,-14414.0,-5.37,0.04,High Risk
U820,2024,7,206828.0,Stable Salary & Stable Fixed Expenses,268374,79478.0,172920,252398.0,15976.0,5.95,0.05,High Risk
U820,2024,8,222804.0,Stable Salary & Stable Fixed Expenses,268374,79478.0,193381,272859.0,-4485.0,-1.67,-0.04,High Risk
U820,2024,9,218319.0,Stable Salary & Stable Fixed Expenses,268374,79478.0,194229,273707.0,-5333.0,-1.99,0.02,High Risk
U820,2024,10,212986.0,Stable Salary & Stable Fixed Expenses,268374,79478.0,225881,305359.0,-36985.0,-13.78,0.0,High Risk
U820,2024,11,176001.0,Stable Salary & Stable Fixed Expenses,268374,79478.0,181883,261361.0,7013.0,2.61,0.0,High Risk
U820,2024,12,183014.0,Stable Salary & Stable Fixed Expenses,268374,79478.0,253166,332644.0,-64270.0,-23.95,-0.04,High Risk
U821,2024,1,207283.0,Salary Increases & Fixed Expenses Remain Stable,47066,14262.0,20615,34877.0,12189.0,25.9,-0.03,Low Risk
U821,2024,2,219472.0,Salary Increases & Fixed Expenses Remain Stable,47066,14262.0,19378,33640.0,13426.0,28.53,-0.01,Low Risk
U821,2024,3,232898.0,Salary Increases & Fixed Expenses Remain Stable,47066,14262.0,23400,37662.0,9404.0,19.98,-0.0,Medium Risk
U821,2024,4,242302.0,Salary Increases & Fixed Expenses Remain Stable,47066,14262.0,25552,39814.0,7252.0,15.41,-0.01,Medium Risk
U821,2024,5,249554.0,Salary Increases & Fixed Expenses Remain Stable,47066,14262.0,24708,38970.0,8096.0,17.2,0.01,Medium Risk
U821,2024,6,257650.0,Salary Increases & Fixed Expenses Remain Stable,47066,14262.0,25771,40033.0,7033.0,14.94,0.03,High Risk
U821,2024,7,264683.0,Salary Increases & Fixed Expenses Remain Stable,74309,14262.0,36081,50343.0,23966.0,32.25,0.02,Low Risk
U821,2024,8,288649.0,Salary Increases & Fixed Expenses Remain Stable,74309,14262.0,33351,47613.0,26696.0,35.93,-0.01,Low Risk
U821,2024,9,315345.0,Salary Increases & Fixed Expenses Remain Stable,74309,14262.0,32271,46533.0,27776.0,37.38,-0.01,Low Risk
U821,2024,10,343121.0,Salary Increases & Fixed Expenses Remain Stable,74309,14262.0,36995,51257.0,23052.0,31.02,0.0,Low Risk
U821,2024,11,366173.0,Salary Increases & Fixed Expenses Remain Stable,74309,14262.0,33944,48206.0,26103.0,35.13,-0.03,Low Risk
U821,2024,12,392276.0,Salary Increases & Fixed Expenses Remain Stable,74309,14262.0,39912,54174.0,20135.0,27.1,-0.05,Low Risk
U822,2024,1,222320.0,Salary Increases & Fixed Expenses Remain Stable,118174,54215.0,53182,107397.0,10777.0,9.12,-0.02,High Risk
U822,2024,2,233097.0,Salary Increases & Fixed Expenses Remain Stable,118174,54215.0,66536,120751.0,-2577.0,-2.18,0.0,High Risk
U822,2024,3,230520.0,Salary Increases & Fixed Expenses Remain Stable,118174,54215.0,61138,115353.0,2821.0,2.39,-0.0,High Risk
U822,2024,4,233341.0,Salary Increases & Fixed Expenses Remain Stable,118174,54215.0,54492,108707.0,9467.0,8.01,0.02,High Risk
U822,2024,5,242808.0,Salary Increases & Fixed Expenses Remain Stable,118174,54215.0,49430,103645.0,14529.0,12.29,-0.03,High Risk
U822,2024,6,257337.0,Salary Increases & Fixed Expenses Remain Stable,118174,54215.0,66398,120613.0,-2439.0,-2.06,0.03,High Risk
U822,2024,7,254898.0,Salary Increases & Fixed Expenses Remain Stable,118174,54215.0,65820,120035.0,-1861.0,-1.57,0.02,High Risk
U822,2024,8,253037.0,Salary Increases & Fixed Expenses Remain Stable,124361,54215.0,65849,120064.0,4297.0,3.46,0.01,High Risk
U822,2024,9,257334.0,Salary Increases & Fixed Expenses Remain Stable,124361,54215.0,68207,122422.0,1939.0,1.56,-0.04,High Risk
U822,2024,10,259273.0,Salary Increases & Fixed Expenses Remain Stable,124361,54215.0,52428,106643.0,17718.0,14.25,0.04,High Risk
U822,2024,11,276991.0,Salary Increases & Fixed Expenses Remain Stable,124361,54215.0,58158,112373.0,11988.0,9.64,-0.01,High Risk
U822,2024,12,288979.0,Salary Increases & Fixed Expenses Remain Stable,124361,54215.0,61670,115885.0,8476.0,6.82,0.03,High Risk
U823,2024,1,206847.0,Salary Increases & Fixed Expenses Remain Stable,60603,32434.0,40093,72527.0,-11924.0,-19.68,0.0,High Risk
U823,2024,2,194923.0,Salary Increases & Fixed Expenses Remain Stable,60603,32434.0,45279,77713.0,-17110.0,-28.23,0.02,High Risk
U823,2024,3,177813.0,Salary Increases & Fixed Expenses Remain Stable,60603,32434.0,53757,86191.0,-25588.0,-42.22,0.02,High Risk
U823,2024,4,152225.0,Salary Increases & Fixed Expenses Remain Stable,60603,32434.0,38382,70816.0,-10213.0,-16.85,0.02,High Risk
U823,2024,5,142012.0,Salary Increases & Fixed Expenses Remain Stable,60603,32434.0,46461,78895.0,-18292.0,-30.18,-0.03,High Risk
U823,2024,6,123720.0,Salary Increases & Fixed Expenses Remain Stable,60603,32434.0,39845,72279.0,-11676.0,-19.27,-0.01,High Risk
U823,2024,7,112044.0,Salary Increases & Fixed Expenses Remain Stable,60603,32434.0,36795,69229.0,-8626.0,-14.23,-0.03,High Risk
U823,2024,8,103418.0,Salary Increases & Fixed Expenses Remain Stable,68099,32434.0,42969,75403.0,-7304.0,-10.73,0.04,High Risk
U823,2024,9,96114.0,Salary Increases & Fixed Expenses Remain Stable,68099,32434.0,50337,82771.0,-14672.0,-21.55,0.02,High Risk
U823,2024,10,81442.0,Salary Increases & Fixed Expenses Remain Stable,68099,32434.0,59008,91442.0,-23343.0,-34.28,-0.04,High Risk
U823,2024,11,58099.0,Salary Increases & Fixed Expenses Remain Stable,68099,32434.0,50056,82490.0,-14391.0,-21.13,-0.04,High Risk
U823,2024,12,43708.0,Salary Increases & Fixed Expenses Remain Stable,68099,32434.0,47306,79740.0,-11641.0,-17.09,0.02,High Risk
U824,2024,1,231568.0,Salary Increases & Fixed Expenses Increase,282086,70335.0,153709,224044.0,58042.0,20.58,0.0,Medium Risk
U824,2024,2,289610.0,Salary Increases & Fixed Expenses Increase,282086,71524.0,143891,215415.0,66671.0,23.63,-0.04,Medium Risk
U824,2024,3,356281.0,Salary Increases & Fixed Expenses Increase,282086,71524.0,198480,270004.0,12082.0,4.28,0.01,High Risk
U824,2024,4,368363.0,Salary Increases & Fixed Expenses Increase,290090,71524.0,133289,204813.0,85277.0,29.4,-0.04,Low Risk
U824,2024,5,453640.0,Salary Increases & Fixed Expenses Increase,290090,71524.0,153944,225468.0,64622.0,22.28,-0.03,Medium Risk
U824,2024,6,518262.0,Salary Increases & Fixed Expenses Increase,290090,72971.0,134605,207576.0,82514.0,28.44,0.0,Low Risk
U824,2024,7,600776.0,Salary Increases & Fixed Expenses Increase,290090,74792.0,139552,214344.0,75746.0,26.11,0.01,Low Risk
U824,2024,8,676522.0,Salary Increases & Fixed Expenses Increase,290090,75338.0,142085,217423.0,72667.0,25.05,-0.01,Low Risk
U824,2024,9,749189.0,Salary Increases & Fixed Expenses Increase,290090,75338.0,135511,210849.0,79241.0,27.32,-0.01,Low Risk
U824,2024,10,828430.0,Salary Increases & Fixed Expenses Increase,290090,75338.0,150533,225871.0,64219.0,22.14,-0.0,Medium Risk
U824,2024,11,892649.0,Salary Increases & Fixed Expenses Increase,290090,75338.0,153963,229301.0,60789.0,20.96,-0.0,Medium Risk
U824,2024,12,953438.0,Salary Increases & Fixed Expenses Increase,290090,75338.0,161509,236847.0,53243.0,18.35,0.05,Medium Risk
U825,2024,1,239629.0,Stable Salary & Stable Fixed Expenses,296938,76309.0,90468,166777.0,130161.0,43.83,-0.03,Low Risk
U825,2024,2,369790.0,Stable Salary & Stable Fixed Expenses,296938,76309.0,105791,182100.0,114838.0,38.67,0.03,Low Risk
U825,2024,3,484628.0,Stable Salary & Stable Fixed Expenses,296938,76309.0,102430,178739.0,118199.0,39.81,-0.02,Low Risk
U825,2024,4,602827.0,Stable Salary & Stable Fixed Expenses,296938,76309.0,101537,177846.0,119092.0,40.11,-0.04,Low Risk
U825,2024,5,721919.0,Stable Salary & Stable Fixed Expenses,296938,76309.0,94150,170459.0,126479.0,42.59,-0.01,Low Risk
U825,2024,6,848398.0,Stable Salary & Stable Fixed Expenses,296938,76309.0,115394,191703.0,105235.0,35.44,0.0,Low Risk
U825,2024,7,953633.0,Stable Salary & Stable Fixed Expenses,296938,76309.0,103549,179858.0,117080.0,39.43,-0.04,Low Risk
U825,2024,8,1070713.0,Stable Salary & Stable Fixed Expenses,296938,76309.0,98241,174550.0,122388.0,41.22,-0.02,Low Risk
U825,2024,9,1193101.0,Stable Salary & Stable Fixed Expenses,296938,76309.0,107211,183520.0,113418.0,38.2,-0.02,Low Risk
U825,2024,10,1306519.0,Stable Salary & Stable Fixed Expenses,296938,76309.0,108410,184719.0,112219.0,37.79,-0.02,Low Risk
U825,2024,11,1418738.0,Stable Salary & Stable Fixed Expenses,296938,76309.0,92922,169231.0,127707.0,43.01,-0.02,Low Risk
U825,2024,12,1546445.0,Stable Salary & Stable Fixed Expenses,296938,76309.0,117022,193331.0,103607.0,34.89,-0.04,Low Risk
U826,2024,1,242556.0,Salary Increases & Fixed Expenses Remain Stable,29702,10397.0,13242,23639.0,6063.0,20.41,-0.04,Medium Risk
U826,2024,2,248619.0,Salary Increases & Fixed Expenses Remain Stable,29702,10397.0,14199,24596.0,5106.0,17.19,-0.02,Medium Risk
U826,2024,3,253725.0,Salary Increases & Fixed Expenses Remain Stable,59296,10397.0,40143,50540.0,8756.0,14.77,0.02,High Risk
U826,2024,4,262481.0,Salary Increases & Fixed Expenses Remain Stable,59296,10397.0,23719,34116.0,25180.0,42.46,-0.03,Low Risk
U826,2024,5,287661.0,Salary Increases & Fixed Expenses Remain Stable,59296,10397.0,27722,38119.0,21177.0,35.71,0.01,Low Risk
U826,2024,6,308838.0,Salary Increases & Fixed Expenses Remain Stable,59296,10397.0,33423,43820.0,15476.0,26.1,-0.03,Low Risk
U826,2024,7,324314.0,Salary Increases & Fixed Expenses Remain Stable,59296,10397.0,33792,44189.0,15107.0,25.48,-0.04,Low Risk
U826,2024,8,339421.0,Salary Increases & Fixed Expenses Remain Stable,59296,10397.0,27230,37627.0,21669.0,36.54,0.01,Low Risk
U826,2024,9,361090.0,Salary Increases & Fixed Expenses Remain Stable,59296,10397.0,32703,43100.0,16196.0,27.31,0.05,Low Risk
U826,2024,10,377286.0,Salary Increases & Fixed Expenses Remain Stable,59296,10397.0,33653,44050.0,15246.0,25.71,0.02,Low Risk
U826,2024,11,392532.0,Salary Increases & Fixed Expenses Remain Stable,59296,10397.0,33929,44326.0,14970.0,25.25,-0.02,Low Risk
U826,2024,12,407502.0,Salary Increases & Fixed Expenses Remain Stable,59296,10397.0,42225,52622.0,6674.0,11.26,-0.0,High Risk
U827,2024,1,216274.0,Salary Increases & Fixed Expenses Remain Stable,21782,13833.0,9985,23818.0,-2036.0,-9.35,-0.01,High Risk
U827,2024,2,214238.0,Salary Increases & Fixed Expenses Remain Stable,21782,13833.0,12683,26516.0,-4734.0,-21.73,-0.03,High Risk
U827,2024,3,209504.0,Salary Increases & Fixed Expenses Remain Stable,21782,13833.0,12677,26510.0,-4728.0,-21.71,-0.05,High Risk
U827,2024,4,204776.0,Salary Increases & Fixed Expenses Remain Stable,21782,13833.0,9075,22908.0,-1126.0,-5.17,-0.01,High Risk
U827,2024,5,203650.0,Salary Increases & Fixed Expenses Remain Stable,21782,13833.0,12687,26520.0,-4738.0,-21.75,0.04,High Risk
U827,2024,6,198912.0,Salary Increases & Fixed Expenses Remain Stable,26820,13833.0,13047,26880.0,-60.0,-0.22,0.02,High Risk
U827,2024,7,198852.0,Salary Increases & Fixed Expenses Remain Stable,26820,13833.0,12442,26275.0,545.0,2.03,0.02,High Risk
U827,2024,8,199397.0,Salary Increases & Fixed Expenses Remain Stable,26820,13833.0,15168,29001.0,-2181.0,-8.13,-0.02,High Risk
U827,2024,9,197216.0,Salary Increases & Fixed Expenses Remain Stable,26820,13833.0,11546,25379.0,1441.0,5.37,-0.04,High Risk
U827,2024,10,198657.0,Salary Increases & Fixed Expenses Remain Stable,26820,13833.0,16655,30488.0,-3668.0,-13.68,-0.04,High Risk
U827,2024,11,194989.0,Salary Increases & Fixed Expenses Remain Stable,26820,13833.0,13360,27193.0,-373.0,-1.39,0.0,High Risk
U827,2024,12,194616.0,Salary Increases & Fixed Expenses Remain Stable,26820,13833.0,13924,27757.0,-937.0,-3.49,-0.03,High Risk
U828,2024,1,205783.0,Stable Salary & Stable Fixed Expenses,150398,47732.0,107555,155287.0,-4889.0,-3.25,-0.03,High Risk
U828,2024,2,200894.0,Stable Salary & Stable Fixed Expenses,150398,47732.0,107050,154782.0,-4384.0,-2.91,-0.0,High Risk
U828,2024,3,196510.0,Stable Salary & Stable Fixed Expenses,150398,47732.0,103530,151262.0,-864.0,-0.57,-0.01,High Risk
U828,2024,4,195646.0,Stable Salary & Stable Fixed Expenses,150398,47732.0,103193,150925.0,-527.0,-0.35,0.02,High Risk
U828,2024,5,195119.0,Stable Salary & Stable Fixed Expenses,150398,47732.0,101895,149627.0,771.0,0.51,-0.02,High Risk
U828,2024,6,195890.0,Stable Salary & Stable Fixed Expenses,150398,47732.0,109552,157284.0,-6886.0,-4.58,-0.05,High Risk
U828,2024,7,189004.0,Stable Salary & Stable Fixed Expenses,150398,47732.0,110542,158274.0,-7876.0,-5.24,0.03,High Risk
U828,2024,8,181128.0,Stable Salary & Stable Fixed Expenses,150398,47732.0,108676,156408.0,-6010.0,-4.0,-0.04,High Risk
U828,2024,9,175118.0,Stable Salary & Stable Fixed Expenses,150398,47732.0,103013,150745.0,-347.0,-0.23,-0.03,High Risk
U828,2024,10,174771.0,Stable Salary & Stable Fixed Expenses,150398,47732.0,109278,157010.0,-6612.0,-4.4,0.04,High Risk
U828,2024,11,168159.0,Stable Salary & Stable Fixed Expenses,150398,47732.0,116141,163873.0,-13475.0,-8.96,-0.02,High Risk
U828,2024,12,154684.0,Stable Salary & Stable Fixed Expenses,150398,47732.0,116760,164492.0,-14094.0,-9.37,0.01,High Risk
U829,2024,1,242823.0,Stable Salary & Increasing Fixed Expenses,283126,61432.0,224205,285637.0,-2511.0,-0.89,-0.03,High Risk
U829,2024,2,240312.0,Stable Salary & Increasing Fixed Expenses,283126,61432.0,183070,244502.0,38624.0,13.64,0.01,High Risk
U829,2024,3,278936.0,Stable Salary & Increasing Fixed Expenses,283126,61432.0,215277,276709.0,6417.0,2.27,-0.0,High Risk
U829,2024,4,285353.0,Stable Salary & Increasing Fixed Expenses,283126,61432.0,217433,278865.0,4261.0,1.5,0.0,High Risk
U829,2024,5,289614.0,Stable Salary & Increasing Fixed Expenses,283126,61432.0,201685,263117.0,20009.0,7.07,-0.04,High Risk
U829,2024,6,309623.0,Stable Salary & Increasing Fixed Expenses,283126,61432.0,179670,241102.0,42024.0,14.84,0.0,High Risk
U829,2024,7,351647.0,Stable Salary & Increasing Fixed Expenses,283126,61432.0,211992,273424.0,9702.0,3.43,0.04,High Risk
U829,2024,8,361349.0,Stable Salary & Increasing Fixed Expenses,283126,61432.0,200285,261717.0,21409.0,7.56,0.01,High Risk
U829,2024,9,382758.0,Stable Salary & Increasing Fixed Expenses,283126,61432.0,188197,249629.0,33497.0,11.83,-0.01,High Risk
U829,2024,10,416255.0,Stable Salary & Increasing Fixed Expenses,283126,61432.0,198144,259576.0,23550.0,8.32,-0.02,High Risk
U829,2024,11,439805.0,Stable Salary & Increasing Fixed Expenses,283126,61432.0,198952,260384.0,22742.0,8.03,0.03,High Risk
U829,2024,12,462547.0,Stable Salary & Increasing Fixed Expenses,283126,61432.0,180191,241623.0,41503.0,14.66,-0.03,High Risk
U830,2024,1,227008.0,Salary Increases & Fixed Expenses Remain Stable,85102,32447.0,49394,81841.0,3261.0,3.83,0.03,High Risk
U830,2024,2,230269.0,Salary Increases & Fixed Expenses Remain Stable,85102,32447.0,42719,75166.0,9936.0,11.68,0.01,High Risk
U830,2024,3,240205.0,Salary Increases & Fixed Expenses Remain Stable,101997,32447.0,43521,75968.0,26029.0,25.52,0.02,Low Risk
U830,2024,4,266234.0,Salary Increases & Fixed Expenses Remain Stable,101997,32447.0,56385,88832.0,13165.0,12.91,0.04,High Risk
U830,2024,5,279399.0,Salary Increases & Fixed Expenses Remain Stable,101997,32447.0,53522,85969.0,16028.0,15.71,0.01,Medium Risk
U830,2024,6,295427.0,Salary Increases & Fixed Expenses Remain Stable,101997,32447.0,41238,73685.0,28312.0,27.76,-0.0,Low Risk
U830,2024,7,323739.0,Salary Increases & Fixed Expenses Remain Stable,101997,32447.0,55455,87902.0,14095.0,13.82,0.02,High Risk
U830,2024,8,337834.0,Salary Increases & Fixed Expenses Remain Stable,101997,32447.0,48687,81134.0,20863.0,20.45,-0.01,Medium Risk
U830,2024,9,358697.0,Salary Increases & Fixed Expenses Remain Stable,101997,32447.0,43219,75666.0,26331.0,25.82,0.02,Low Risk
U830,2024,10,385028.0,Salary Increases & Fixed Expenses Remain Stable,101997,32447.0,49039,81486.0,20511.0,20.11,0.0,Medium Risk
U830,2024,11,405539.0,Salary Increases & Fixed Expenses Remain Stable,101997,32447.0,41423,73870.0,28127.0,27.58,0.02,Low Risk
U830,2024,12,433666.0,Salary Increases & Fixed Expenses Remain Stable,101997,32447.0,45251,77698.0,24299.0,23.82,0.03,Medium Risk
U831,2024,1,242770.0,Stable Salary & Stable Fixed Expenses,205653,96847.0,97352,194199.0,11454.0,5.57,-0.02,High Risk
U831,2024,2,254224.0,Stable Salary & Stable Fixed Expenses,205653,96847.0,85736,182583.0,23070.0,11.22,-0.05,High Risk
U831,2024,3,277294.0,Stable Salary & Stable Fixed Expenses,205653,96847.0,134263,231110.0,-25457.0,-12.38,0.05,High Risk
U831,2024,4,251837.0,Stable Salary & Stable Fixed Expenses,205653,96847.0,100128,196975.0,8678.0,4.22,-0.02,High Risk
U831,2024,5,260515.0,Stable Salary & Stable Fixed Expenses,205653,96847.0,93422,190269.0,15384.0,7.48,-0.03,High Risk
U831,2024,6,275899.0,Stable Salary & Stable Fixed Expenses,205653,96847.0,97227,194074.0,11579.0,5.63,0.01,High Risk
U831,2024,7,287478.0,Stable Salary & Stable Fixed Expenses,205653,96847.0,115103,211950.0,-6297.0,-3.06,-0.03,High Risk
U831,2024,8,281181.0,Stable Salary & Stable Fixed Expenses,205653,96847.0,82279,179126.0,26527.0,12.9,0.01,High Risk
U831,2024,9,307708.0,Stable Salary & Stable Fixed Expenses,205653,96847.0,112129,208976.0,-3323.0,-1.62,-0.01,High Risk
U831,2024,10,304385.0,Stable Salary & Stable Fixed Expenses,205653,96847.0,147573,244420.0,-38767.0,-18.85,0.01,High Risk
U831,2024,11,265618.0,Stable Salary & Stable Fixed Expenses,205653,96847.0,106718,203565.0,2088.0,1.02,0.04,High Risk
U831,2024,12,267706.0,Stable Salary & Stable Fixed Expenses,205653,96847.0,145761,242608.0,-36955.0,-17.97,0.01,High Risk
U832,2024,1,216410.0,Stable Salary & Decreasing Fixed Expenses,199002,40130.0,104441,144571.0,54431.0,27.35,0.04,Low Risk
U832,2024,2,270841.0,Stable Salary & Decreasing Fixed Expenses,199002,40130.0,115034,155164.0,43838.0,22.03,-0.01,Medium Risk
U832,2024,3,314679.0,Stable Salary & Decreasing Fixed Expenses,199002,40130.0,107639,147769.0,51233.0,25.74,0.04,Low Risk
U832,2024,4,365912.0,Stable Salary & Decreasing Fixed Expenses,199002,40130.0,83146,123276.0,75726.0,38.05,-0.05,Low Risk
U832,2024,5,441638.0,Stable Salary & Decreasing Fixed Expenses,199002,40130.0,95003,135133.0,63869.0,32.09,0.01,Low Risk
U832,2024,6,505507.0,Stable Salary & Decreasing Fixed Expenses,199002,40130.0,104139,144269.0,54733.0,27.5,0.01,Low Risk
U832,2024,7,560240.0,Stable Salary & Decreasing Fixed Expenses,199002,38229.0,82278,120507.0,78495.0,39.44,0.05,Low Risk
U832,2024,8,638735.0,Stable Salary & Decreasing Fixed Expenses,199002,38229.0,82260,120489.0,78513.0,39.45,-0.04,Low Risk
U832,2024,9,717248.0,Stable Salary & Decreasing Fixed Expenses,199002,38229.0,88837,127066.0,71936.0,36.15,0.0,Low Risk
U832,2024,10,789184.0,Stable Salary & Decreasing Fixed Expenses,199002,38229.0,110471,148700.0,50302.0,25.28,-0.01,Low Risk
U832,2024,11,839486.0,Stable Salary & Decreasing Fixed Expenses,199002,38229.0,99825,138054.0,60948.0,30.63,0.04,Low Risk
U832,2024,12,900434.0,Stable Salary & Decreasing Fixed Expenses,199002,38229.0,118371,156600.0,42402.0,21.31,-0.03,Medium Risk
U833,2024,1,224936.0,Salary Increases & Fixed Expenses Remain Stable,129345,68061.0,42535,110596.0,18749.0,14.5,-0.04,High Risk
U833,2024,2,243685.0,Salary Increases & Fixed Expenses Remain Stable,129345,68061.0,46803,114864.0,14481.0,11.2,-0.04,High Risk
U833,2024,3,258166.0,Salary Increases & Fixed Expenses Remain Stable,129345,68061.0,54745,122806.0,6539.0,5.06,0.02,High Risk
U833,2024,4,264705.0,Salary Increases & Fixed Expenses Remain Stable,129345,68061.0,43685,111746.0,17599.0,13.61,-0.0,High Risk
U833,2024,5,282304.0,Salary Increases & Fixed Expenses Remain Stable,129345,68061.0,39069,107130.0,22215.0,17.17,-0.04,Medium Risk
U833,2024,6,304519.0,Salary Increases & Fixed Expenses Remain Stable,151230,68061.0,46222,114283.0,36947.0,24.43,0.04,Medium Risk
U833,2024,7,341466.0,Salary Increases & Fixed Expenses Remain Stable,151230,68061.0,50488,118549.0,32681.0,21.61,0.02,Medium Risk
U833,2024,8,374147.0,Salary Increases & Fixed Expenses Remain Stable,151230,68061.0,46850,114911.0,36319.0,24.02,-0.03,Medium Risk
U833,2024,9,410466.0,Salary Increases & Fixed Expenses Remain Stable,151230,68061.0,56217,124278.0,26952.0,17.82,-0.05,Medium Risk
U833,2024,10,437418.0,Salary Increases & Fixed Expenses Remain Stable,151230,68061.0,65955,134016.0,17214.0,11.38,-0.0,High Risk
U833,2024,11,454632.0,Salary Increases & Fixed Expenses Remain Stable,151230,68061.0,62596,130657.0,20573.0,13.6,0.04,High Risk
U833,2024,12,475205.0,Salary Increases & Fixed Expenses Remain Stable,151230,68061.0,60986,129047.0,22183.0,14.67,0.0,High Risk
U834,2024,1,230459.0,Salary Increases & Fixed Expenses Remain Stable,45013,10883.0,14516,25399.0,19614.0,43.57,0.05,Low Risk
U834,2024,2,250073.0,Salary Increases & Fixed Expenses Remain Stable,45013,10883.0,17333,28216.0,16797.0,37.32,-0.04,Low Risk
U834,2024,3,266870.0,Salary Increases & Fixed Expenses Remain Stable,45013,10883.0,22141,33024.0,11989.0,26.63,-0.03,Low Risk
U834,2024,4,278859.0,Salary Increases & Fixed Expenses Remain Stable,74729,10883.0,24764,35647.0,39082.0,52.3,-0.01,Low Risk
U834,2024,5,317941.0,Salary Increases & Fixed Expenses Remain Stable,74729,10883.0,29730,40613.0,34116.0,45.65,0.02,Low Risk
U834,2024,6,352057.0,Salary Increases & Fixed Expenses Remain Stable,74729,10883.0,25777,36660.0,38069.0,50.94,-0.05,Low Risk
U834,2024,7,390126.0,Salary Increases & Fixed Expenses Remain Stable,74729,10883.0,22640,33523.0,41206.0,55.14,0.01,Low Risk
U834,2024,8,431332.0,Salary Increases & Fixed Expenses Remain Stable,74729,10883.0,22475,33358.0,41371.0,55.36,-0.05,Low Risk
U834,2024,9,472703.0,Salary Increases & Fixed Expenses Remain Stable,74729,10883.0,25490,36373.0,38356.0,51.33,-0.03,Low Risk
U834,2024,10,511059.0,Salary Increases & Fixed Expenses Remain Stable,74729,10883.0,31077,41960.0,32769.0,43.85,-0.05,Low Risk
U834,2024,11,543828.0,Salary Increases & Fixed Expenses Remain Stable,74729,10883.0,25365,36248.0,38481.0,51.49,0.04,Low Risk
U834,2024,12,582309.0,Salary Increases & Fixed Expenses Remain Stable,74729,10883.0,36002,46885.0,27844.0,37.26,-0.01,Low Risk
U835,2024,1,208586.0,Salary Increases & Fixed Expenses Remain Stable,108113,73611.0,52015,125626.0,-17513.0,-16.2,-0.04,High Risk
U835,2024,2,191073.0,Salary Increases & Fixed Expenses Remain Stable,108113,73611.0,44973,118584.0,-10471.0,-9.69,0.04,High Risk
U835,2024,3,180602.0,Salary Increases & Fixed Expenses Remain Stable,108113,73611.0,43349,116960.0,-8847.0,-8.18,0.04,High Risk
U835,2024,4,171755.0,Salary Increases & Fixed Expenses Remain Stable,108113,73611.0,44769,118380.0,-10267.0,-9.5,0.01,High Risk
U835,2024,5,161488.0,Salary Increases & Fixed Expenses Remain Stable,125536,73611.0,73097,146708.0,-21172.0,-16.87,0.02,High Risk
U835,2024,6,140316.0,Salary Increases & Fixed Expenses Remain Stable,125536,73611.0,54568,128179.0,-2643.0,-2.11,-0.01,High Risk
U835,2024,7,137673.0,Salary Increases & Fixed Expenses Remain Stable,125536,73611.0,71215,144826.0,-19290.0,-15.37,0.01,High Risk
U835,2024,8,118383.0,Salary Increases & Fixed Expenses Remain Stable,125536,73611.0,62079,135690.0,-10154.0,-8.09,-0.02,High Risk
U835,2024,9,108229.0,Salary Increases & Fixed Expenses Remain Stable,125536,73611.0,61693,135304.0,-9768.0,-7.78,-0.01,High Risk
U835,2024,10,98461.0,Salary Increases & Fixed Expenses Remain Stable,125536,73611.0,68650,142261.0,-16725.0,-13.32,0.01,High Risk
U835,2024,11,81736.0,Salary Increases & Fixed Expenses Remain Stable,125536,73611.0,74408,148019.0,-22483.0,-17.91,0.01,High Risk
U835,2024,12,59253.0,Salary Increases & Fixed Expenses Remain Stable,125536,73611.0,59690,133301.0,-7765.0,-6.19,0.01,High Risk
U836,2024,1,207727.0,Stable Salary & Decreasing Fixed Expenses,103214,40999.0,55579,96578.0,6636.0,6.43,0.04,High Risk
U836,2024,2,214363.0,Stable Salary & Decreasing Fixed Expenses,103214,40999.0,60826,101825.0,1389.0,1.35,-0.01,High Risk
U836,2024,3,215752.0,Stable Salary & Decreasing Fixed Expenses,103214,40999.0,59758,100757.0,2457.0,2.38,-0.05,High Risk
U836,2024,4,218209.0,Stable Salary & Decreasing Fixed Expenses,103214,40999.0,48147,89146.0,14068.0,13.63,0.04,High Risk
U836,2024,5,232277.0,Stable Salary & Decreasing Fixed Expenses,103214,40999.0,43265,84264.0,18950.0,18.36,-0.04,Medium Risk
U836,2024,6,251227.0,Stable Salary & Decreasing Fixed Expenses,103214,40999.0,60573,101572.0,1642.0,1.59,-0.03,High Risk
U836,2024,7,252869.0,Stable Salary & Decreasing Fixed Expenses,103214,40999.0,44039,85038.0,18176.0,17.61,0.0,Medium Risk
U836,2024,8,271045.0,Stable Salary & Decreasing Fixed Expenses,103214,40999.0,43334,84333.0,18881.0,18.29,-0.04,Medium Risk
U836,2024,9,289926.0,Stable Salary & Decreasing Fixed Expenses,103214,40999.0,53242,94241.0,8973.0,8.69,-0.03,High Risk
U836,2024,10,298899.0,Stable Salary & Decreasing Fixed Expenses,103214,40999.0,53450,94449.0,8765.0,8.49,-0.02,High Risk
U836,2024,11,307664.0,Stable Salary & Decreasing Fixed Expenses,103214,40999.0,42410,83409.0,19805.0,19.19,-0.03,Medium Risk
U836,2024,12,327469.0,Stable Salary & Decreasing Fixed Expenses,103214,40999.0,46595,87594.0,15620.0,15.13,-0.01,Medium Risk
U837,2024,1,209486.0,Salary Increases & Fixed Expenses Remain Stable,274379,119300.0,158534,277834.0,-3455.0,-1.26,0.01,High Risk
U837,2024,2,206031.0,Salary Increases & Fixed Expenses Remain Stable,274379,119300.0,157241,276541.0,-2162.0,-0.79,-0.03,High Risk
U837,2024,3,203869.0,Salary Increases & Fixed Expenses Remain Stable,274379,119300.0,180556,299856.0,-25477.0,-9.29,-0.0,High Risk
U837,2024,4,178392.0,Salary Increases & Fixed Expenses Remain Stable,274379,119300.0,118670,237970.0,36409.0,13.27,0.03,High Risk
U837,2024,5,214801.0,Salary Increases & Fixed Expenses Remain Stable,274379,119300.0,127222,246522.0,27857.0,10.15,0.04,High Risk
U837,2024,6,242658.0,Salary Increases & Fixed Expenses Remain Stable,290480,119300.0,148711,268011.0,22469.0,7.74,-0.02,High Risk
U837,2024,7,265127.0,Salary Increases & Fixed Expenses Remain Stable,290480,119300.0,139462,258762.0,31718.0,10.92,0.01,High Risk
U837,2024,8,296845.0,Salary Increases & Fixed Expenses Remain Stable,290480,119300.0,157294,276594.0,13886.0,4.78,0.04,High Risk
U837,2024,9,310731.0,Salary Increases & Fixed Expenses Remain Stable,290480,119300.0,150421,269721.0,20759.0,7.15,0.01,High Risk
U837,2024,10,331490.0,Salary Increases & Fixed Expenses Remain Stable,290480,119300.0,182770,302070.0,-11590.0,-3.99,0.02,High Risk
U837,2024,11,319900.0,Salary Increases & Fixed Expenses Remain Stable,290480,119300.0,123986,243286.0,47194.0,16.25,0.02,Medium Risk
U837,2024,12,367094.0,Salary Increases & Fixed Expenses Remain Stable,290480,119300.0,145905,265205.0,25275.0,8.7,0.0,High Risk
U838,2024,1,222658.0,Salary Increases & Fixed Expenses Remain Stable,254188,100423.0,115531,215954.0,38234.0,15.04,-0.0,Medium Risk
U838,2024,2,260892.0,Salary Increases & Fixed Expenses Remain Stable,254188,100423.0,105117,205540.0,48648.0,19.14,0.04,Medium Risk
U838,2024,3,309540.0,Salary Increases & Fixed Expenses Remain Stable,254188,100423.0,149955,250378.0,3810.0,1.5,0.01,High Risk
U838,2024,4,313350.0,Salary Increases & Fixed Expenses Remain Stable,254188,100423.0,123402,223825.0,30363.0,11.95,-0.02,High Risk
U838,2024,5,343713.0,Salary Increases & Fixed Expenses Remain Stable,254188,100423.0,132634,233057.0,21131.0,8.31,-0.04,High Risk
U838,2024,6,364844.0,Salary Increases & Fixed Expenses Remain Stable,282240,100423.0,133014,233437.0,48803.0,17.29,0.0,Medium Risk
U838,2024,7,413647.0,Salary Increases & Fixed Expenses Remain Stable,282240,100423.0,127451,227874.0,54366.0,19.26,0.03,Medium Risk
U838,2024,8,468013.0,Salary Increases & Fixed Expenses Remain Stable,282240,100423.0,144648,245071.0,37169.0,13.17,-0.01,High Risk
U838,2024,9,505182.0,Salary Increases & Fixed Expenses Remain Stable,282240,100423.0,184493,284916.0,-2676.0,-0.95,-0.05,High Risk
U838,2024,10,502506.0,Salary Increases & Fixed Expenses Remain Stable,282240,100423.0,173460,273883.0,8357.0,2.96,0.02,High Risk
U838,2024,11,510863.0,Salary Increases & Fixed Expenses Remain Stable,282240,100423.0,152266,252689.0,29551.0,10.47,-0.04,High Risk
U838,2024,12,540414.0,Salary Increases & Fixed Expenses Remain Stable,282240,100423.0,178658,279081.0,3159.0,1.12,-0.03,High Risk
U839,2024,1,214898.0,Salary Increases & Fixed Expenses Remain Stable,268457,80899.0,83901,164800.0,103657.0,38.61,-0.01,Low Risk
U839,2024,2,318555.0,Salary Increases & Fixed Expenses Remain Stable,268457,80899.0,80842,161741.0,106716.0,39.75,-0.0,Low Risk
U839,2024,3,425271.0,Salary Increases & Fixed Expenses Remain Stable,268457,80899.0,95666,176565.0,91892.0,34.23,-0.02,Low Risk
U839,2024,4,517163.0,Salary Increases & Fixed Expenses Remain Stable,268457,80899.0,82131,163030.0,105427.0,39.27,-0.04,Low Risk
U839,2024,5,622590.0,Salary Increases & Fixed Expenses Remain Stable,294901,80899.0,110161,191060.0,103841.0,35.21,-0.05,Low Risk
U839,2024,6,726431.0,Salary Increases & Fixed Expenses Remain Stable,294901,80899.0,90570,171469.0,123432.0,41.86,0.0,Low Risk
U839,2024,7,849863.0,Salary Increases & Fixed Expenses Remain Stable,294901,80899.0,95712,176611.0,118290.0,40.11,0.03,Low Risk
U839,2024,8,968153.0,Salary Increases & Fixed Expenses Remain Stable,294901,80899.0,92297,173196.0,121705.0,41.27,-0.04,Low Risk
U839,2024,9,1089858.0,Salary Increases & Fixed Expenses Remain Stable,294901,80899.0,106868,187767.0,107134.0,36.33,0.04,Low Risk
U839,2024,10,1196992.0,Salary Increases & Fixed Expenses Remain Stable,294901,80899.0,133263,214162.0,80739.0,27.38,0.01,Low Risk
U839,2024,11,1277731.0,Salary Increases & Fixed Expenses Remain Stable,294901,80899.0,120385,201284.0,93617.0,31.75,-0.05,Low Risk
U839,2024,12,1371348.0,Salary Increases & Fixed Expenses Remain Stable,294901,80899.0,146224,227123.0,67778.0,22.98,0.02,Medium Risk
U840,2024,1,249302.0,Stable Salary & Increasing Fixed Expenses,60516,25619.0,27176,52795.0,7721.0,12.76,0.03,High Risk
U840,2024,2,257023.0,Stable Salary & Increasing Fixed Expenses,60516,25619.0,24348,49967.0,10549.0,17.43,-0.05,Medium Risk
U840,2024,3,267572.0,Stable Salary & Increasing Fixed Expenses,60516,25619.0,26572,52191.0,8325.0,13.76,-0.02,High Risk
U840,2024,4,275897.0,Stable Salary & Increasing Fixed Expenses,60516,25619.0,28030,53649.0,6867.0,11.35,0.03,High Risk
U840,2024,5,282764.0,Stable Salary & Increasing Fixed Expenses,60516,25619.0,34498,60117.0,399.0,0.66,-0.03,High Risk
U840,2024,6,283163.0,Stable Salary & Increasing Fixed Expenses,60516,25619.0,35138,60757.0,-241.0,-0.4,-0.04,High Risk
U840,2024,7,282922.0,Stable Salary & Increasing Fixed Expenses,60516,25619.0,33130,58749.0,1767.0,2.92,-0.01,High Risk
U840,2024,8,284689.0,Stable Salary & Increasing Fixed Expenses,60516,25619.0,26379,51998.0,8518.0,14.08,-0.01,High Risk
U840,2024,9,293207.0,Stable Salary & Increasing Fixed Expenses,60516,25619.0,25274,50893.0,9623.0,15.9,-0.03,Medium Risk
U840,2024,10,302830.0,Stable Salary & Increasing Fixed Expenses,60516,25619.0,29643,55262.0,5254.0,8.68,-0.05,High Risk
U840,2024,11,308084.0,Stable Salary & Increasing Fixed Expenses,60516,25619.0,25568,51187.0,9329.0,15.42,0.02,Medium Risk
U840,2024,12,317413.0,Stable Salary & Increasing Fixed Expenses,60516,25619.0,32304,57923.0,2593.0,4.28,0.01,High Risk
U841,2024,1,210762.0,Salary Increases & Fixed Expenses Remain Stable,181363,58469.0,87615,146084.0,35279.0,19.45,-0.0,Medium Risk
U841,2024,2,246041.0,Salary Increases & Fixed Expenses Remain Stable,181363,58469.0,107390,165859.0,15504.0,8.55,0.03,High Risk
U841,2024,3,261545.0,Salary Increases & Fixed Expenses Remain Stable,181363,58469.0,118205,176674.0,4689.0,2.59,-0.0,High Risk
U841,2024,4,266234.0,Salary Increases & Fixed Expenses Remain Stable,181363,58469.0,87899,146368.0,34995.0,19.3,0.03,Medium Risk
U841,2024,5,301229.0,Salary Increases & Fixed Expenses Remain Stable,181363,58469.0,102692,161161.0,20202.0,11.14,0.03,High Risk
U841,2024,6,321431.0,Salary Increases & Fixed Expenses Remain Stable,181363,58469.0,106154,164623.0,16740.0,9.23,0.04,High Risk
U841,2024,7,338171.0,Salary Increases & Fixed Expenses Remain Stable,181363,58469.0,74344,132813.0,48550.0,26.77,0.05,Low Risk
U841,2024,8,386721.0,Salary Increases & Fixed Expenses Remain Stable,206519,58469.0,97074,155543.0,50976.0,24.68,0.01,Medium Risk
U841,2024,9,437697.0,Salary Increases & Fixed Expenses Remain Stable,206519,58469.0,110895,169364.0,37155.0,17.99,0.01,Medium Risk
U841,2024,10,474852.0,Salary Increases & Fixed Expenses Remain Stable,206519,58469.0,129181,187650.0,18869.0,9.14,-0.05,High Risk
U841,2024,11,493721.0,Salary Increases & Fixed Expenses Remain Stable,206519,58469.0,96040,154509.0,52010.0,25.18,-0.05,Low Risk
U841,2024,12,545731.0,Salary Increases & Fixed Expenses Remain Stable,206519,58469.0,144037,202506.0,4013.0,1.94,-0.01,High Risk
U842,2024,1,246657.0,Salary Increases & Fixed Expenses Remain Stable,256298,90778.0,118658,209436.0,46862.0,18.28,-0.05,Medium Risk
U842,2024,2,293519.0,Salary Increases & Fixed Expenses Remain Stable,256298,90778.0,133986,224764.0,31534.0,12.3,0.03,High Risk
U842,2024,3,325053.0,Salary Increases & Fixed Expenses Remain Stable,256298,90778.0,174642,265420.0,-9122.0,-3.56,-0.03,High Risk
U842,2024,4,315931.0,Salary Increases & Fixed Expenses Remain Stable,256298,90778.0,144056,234834.0,21464.0,8.37,-0.01,High Risk
U842,2024,5,337395.0,Salary Increases & Fixed Expenses Remain Stable,256298,90778.0,122756,213534.0,42764.0,16.69,-0.02,Medium Risk
U842,2024,6,380159.0,Salary Increases & Fixed Expenses Remain Stable,256298,90778.0,140490,231268.0,25030.0,9.77,-0.04,High Risk
U842,2024,7,405189.0,Salary Increases & Fixed Expenses Remain Stable,284879,90778.0,146698,237476.0,47403.0,16.64,-0.03,Medium Risk
U842,2024,8,452592.0,Salary Increases & Fixed Expenses Remain Stable,284879,90778.0,169551,260329.0,24550.0,8.62,0.0,High Risk
U842,2024,9,477142.0,Salary Increases & Fixed Expenses Remain Stable,284879,90778.0,146653,237431.0,47448.0,16.66,-0.01,Medium Risk
U842,2024,10,524590.0,Salary Increases & Fixed Expenses Remain Stable,284879,90778.0,166110,256888.0,27991.0,9.83,0.04,High Risk
U842,2024,11,552581.0,Salary Increases & Fixed Expenses Remain Stable,284879,90778.0,140259,231037.0,53842.0,18.9,0.04,Medium Risk
U842,2024,12,606423.0,Salary Increases & Fixed Expenses Remain Stable,284879,90778.0,134780,225558.0,59321.0,20.82,0.04,Medium Risk
U843,2024,1,233213.0,Stable Salary & Stable Fixed Expenses,225275,66281.0,99559,165840.0,59435.0,26.38,0.02,Low Risk
U843,2024,2,292648.0,Stable Salary & Stable Fixed Expenses,225275,66281.0,112949,179230.0,46045.0,20.44,0.04,Medium Risk
U843,2024,3,338693.0,Stable Salary & Stable Fixed Expenses,225275,66281.0,141044,207325.0,17950.0,7.97,-0.03,High Risk
U843,2024,4,356643.0,Stable Salary & Stable Fixed Expenses,225275,66281.0,116312,182593.0,42682.0,18.95,0.03,Medium Risk
U843,2024,5,399325.0,Stable Salary & Stable Fixed Expenses,225275,66281.0,100858,167139.0,58136.0,25.81,-0.05,Low Risk
U843,2024,6,457461.0,Stable Salary & Stable Fixed Expenses,225275,66281.0,128984,195265.0,30010.0,13.32,-0.03,High Risk
U843,2024,7,487471.0,Stable Salary & Stable Fixed Expenses,225275,66281.0,98810,165091.0,60184.0,26.72,-0.02,Low Risk
U843,2024,8,547655.0,Stable Salary & Stable Fixed Expenses,225275,66281.0,114719,181000.0,44275.0,19.65,0.05,Medium Risk
U843,2024,9,591930.0,Stable Salary & Stable Fixed Expenses,225275,66281.0,114352,180633.0,44642.0,19.82,-0.02,Medium Risk
U843,2024,10,636572.0,Stable Salary & Stable Fixed Expenses,225275,66281.0,112511,178792.0,46483.0,20.63,0.02,Medium Risk
U843,2024,11,683055.0,Stable Salary & Stable Fixed Expenses,225275,66281.0,131987,198268.0,27007.0,11.99,-0.01,High Risk
U843,2024,12,710062.0,Stable Salary & Stable Fixed Expenses,225275,66281.0,92071,158352.0,66923.0,29.71,0.03,Low Risk
U844,2024,1,202183.0,Salary Increases & Fixed Expenses Remain Stable,28245,14726.0,17026,31752.0,-3507.0,-12.42,0.03,High Risk
U844,2024,2,198676.0,Salary Increases & Fixed Expenses Remain Stable,28245,14726.0,20810,35536.0,-7291.0,-25.81,0.0,High Risk
U844,2024,3,191385.0,Salary Increases & Fixed Expenses Remain Stable,28245,14726.0,27101,41827.0,-13582.0,-48.09,0.04,High Risk
U844,2024,4,177803.0,Salary Increases & Fixed Expenses Remain Stable,28245,14726.0,18646,33372.0,-5127.0,-18.15,-0.04,High Risk
U844,2024,5,172676.0,Salary Increases & Fixed Expenses Remain Stable,28245,14726.0,19348,34074.0,-5829.0,-20.64,0.02,High Risk
U844,2024,6,166847.0,Salary Increases & Fixed Expenses Remain Stable,39982,14726.0,26576,41302.0,-1320.0,-3.3,-0.01,High Risk
U844,2024,7,165527.0,Salary Increases & Fixed Expenses Remain Stable,39982,14726.0,25931,40657.0,-675.0,-1.69,0.01,High Risk
U844,2024,8,164852.0,Salary Increases & Fixed Expenses Remain Stable,39982,14726.0,28021,42747.0,-2765.0,-6.92,-0.01,High Risk
U844,2024,9,162087.0,Salary Increases & Fixed Expenses Remain Stable,39982,14726.0,27351,42077.0,-2095.0,-5.24,-0.03,High Risk
U844,2024,10,159992.0,Salary Increases & Fixed Expenses Remain Stable,39982,14726.0,33835,48561.0,-8579.0,-21.46,-0.04,High Risk
U844,2024,11,151413.0,Salary Increases & Fixed Expenses Remain Stable,39982,14726.0,28782,43508.0,-3526.0,-8.82,0.0,High Risk
U844,2024,12,147887.0,Salary Increases & Fixed Expenses Remain Stable,39982,14726.0,29743,44469.0,-4487.0,-11.22,0.01,High Risk
U845,2024,1,220003.0,Stable Salary & Increasing Fixed Expenses,177760,77434.0,87847,165281.0,12479.0,7.02,-0.0,High Risk
U845,2024,2,232482.0,Stable Salary & Increasing Fixed Expenses,177760,78133.0,94785,172918.0,4842.0,2.72,0.04,High Risk
U845,2024,3,237324.0,Stable Salary & Increasing Fixed Expenses,177760,78133.0,96632,174765.0,2995.0,1.68,-0.01,High Risk
U845,2024,4,240319.0,Stable Salary & Increasing Fixed Expenses,177760,79249.0,86093,165342.0,12418.0,6.99,-0.02,High Risk
U845,2024,5,252737.0,Stable Salary & Increasing Fixed Expenses,177760,79249.0,86442,165691.0,12069.0,6.79,0.04,High Risk
U845,2024,6,264806.0,Stable Salary & Increasing Fixed Expenses,177760,79249.0,104547,183796.0,-6036.0,-3.4,0.03,High Risk
U845,2024,7,258770.0,Stable Salary & Increasing Fixed Expenses,177760,79249.0,94835,174084.0,3676.0,2.07,-0.05,High Risk
U845,2024,8,262446.0,Stable Salary & Increasing Fixed Expenses,177760,79249.0,77519,156768.0,20992.0,11.81,0.0,High Risk
U845,2024,9,283438.0,Stable Salary & Increasing Fixed Expenses,177760,80265.0,80581,160846.0,16914.0,9.52,-0.0,High Risk
U845,2024,10,300352.0,Stable Salary & Increasing Fixed Expenses,177760,80265.0,93229,173494.0,4266.0,2.4,-0.01,High Risk
U845,2024,11,304618.0,Stable Salary & Increasing Fixed Expenses,177760,80265.0,107148,187413.0,-9653.0,-5.43,-0.04,High Risk
U845,2024,12,294965.0,Stable Salary & Increasing Fixed Expenses,177760,80265.0,120411,200676.0,-22916.0,-12.89,0.03,High Risk
U846,2024,1,238232.0,Salary Increases & Fixed Expenses Increase,291571,64878.0,155961,220839.0,70732.0,24.26,0.02,Medium Risk
U846,2024,2,308964.0,Salary Increases & Fixed Expenses Increase,291571,64878.0,166057,230935.0,60636.0,20.8,0.0,Medium Risk
U846,2024,3,369600.0,Salary Increases & Fixed Expenses Increase,291571,66737.0,134607,201344.0,90227.0,30.95,0.05,Low Risk
U846,2024,4,459827.0,Salary Increases & Fixed Expenses Increase,291571,66737.0,118128,184865.0,106706.0,36.6,-0.01,Low Risk
U846,2024,5,566533.0,Salary Increases & Fixed Expenses Increase,291571,66737.0,150481,217218.0,74353.0,25.5,-0.04,Low Risk
U846,2024,6,640886.0,Salary Increases & Fixed Expenses Increase,291571,66737.0,173642,240379.0,51192.0,17.56,0.03,Medium Risk
U846,2024,7,692078.0,Salary Increases & Fixed Expenses Increase,312310,66737.0,182609,249346.0,62964.0,20.16,0.04,Medium Risk
U846,2024,8,755042.0,Salary Increases & Fixed Expenses Increase,312310,66737.0,146275,213012.0,99298.0,31.79,-0.02,Low Risk
U846,2024,9,854340.0,Salary Increases & Fixed Expenses Increase,312310,66737.0,163920,230657.0,81653.0,26.14,-0.04,Low Risk
U846,2024,10,935993.0,Salary Increases & Fixed Expenses Increase,312310,66737.0,127938,194675.0,117635.0,37.67,-0.0,Low Risk
U846,2024,11,1053628.0,Salary Increases & Fixed Expenses Increase,312310,66737.0,165315,232052.0,80258.0,25.7,0.04,Low Risk
U846,2024,12,1133886.0,Salary Increases & Fixed Expenses Increase,312310,66737.0,156885,223622.0,88688.0,28.4,0.04,Low Risk
U847,2024,1,232156.0,Stable Salary & Stable Fixed Expenses,249723,73064.0,168786,241850.0,7873.0,3.15,0.01,High Risk
U847,2024,2,240029.0,Stable Salary & Stable Fixed Expenses,249723,73064.0,176731,249795.0,-72.0,-0.03,0.05,High Risk
U847,2024,3,239957.0,Stable Salary & Stable Fixed Expenses,249723,73064.0,223901,296965.0,-47242.0,-18.92,-0.04,High Risk
U847,2024,4,192715.0,Stable Salary & Stable Fixed Expenses,249723,73064.0,179282,252346.0,-2623.0,-1.05,0.04,High Risk
U847,2024,5,190092.0,Stable Salary & Stable Fixed Expenses,249723,73064.0,188009,261073.0,-11350.0,-4.55,-0.02,High Risk
U847,2024,6,178742.0,Stable Salary & Stable Fixed Expenses,249723,73064.0,150499,223563.0,26160.0,10.48,-0.03,High Risk
U847,2024,7,204902.0,Stable Salary & Stable Fixed Expenses,249723,73064.0,198067,271131.0,-21408.0,-8.57,0.04,High Risk
U847,2024,8,183494.0,Stable Salary & Stable Fixed Expenses,249723,73064.0,173456,246520.0,3203.0,1.28,-0.0,High Risk
U847,2024,9,186697.0,Stable Salary & Stable Fixed Expenses,249723,73064.0,159997,233061.0,16662.0,6.67,0.04,High Risk
U847,2024,10,203359.0,Stable Salary & Stable Fixed Expenses,249723,73064.0,218721,291785.0,-42062.0,-16.84,0.03,High Risk
U847,2024,11,161297.0,Stable Salary & Stable Fixed Expenses,249723,73064.0,159876,232940.0,16783.0,6.72,-0.01,High Risk
U847,2024,12,178080.0,Stable Salary & Stable Fixed Expenses,249723,73064.0,180021,253085.0,-3362.0,-1.35,0.03,High Risk
U848,2024,1,234955.0,Salary Increases & Fixed Expenses Increase,34058,15890.0,12648,28538.0,5520.0,16.21,0.02,Medium Risk
U848,2024,2,240475.0,Salary Increases & Fixed Expenses Increase,34058,15890.0,10963,26853.0,7205.0,21.16,0.04,Medium Risk
U848,2024,3,247680.0,Salary Increases & Fixed Expenses Increase,42782,15890.0,18524,34414.0,8368.0,19.56,-0.01,Medium Risk
U848,2024,4,256048.0,Salary Increases & Fixed Expenses Increase,42782,15890.0,14174,30064.0,12718.0,29.73,-0.02,Low Risk
U848,2024,5,268766.0,Salary Increases & Fixed Expenses Increase,42782,15890.0,13693,29583.0,13199.0,30.85,-0.05,Low Risk
U848,2024,6,281965.0,Salary Increases & Fixed Expenses Increase,42782,17756.0,14156,31912.0,10870.0,25.41,-0.04,Low Risk
U848,2024,7,292835.0,Salary Increases & Fixed Expenses Increase,42782,18328.0,13931,32259.0,10523.0,24.6,-0.02,Medium Risk
U848,2024,8,303358.0,Salary Increases & Fixed Expenses Increase,42782,18328.0,13767,32095.0,10687.0,24.98,0.01,Medium Risk
U848,2024,9,314045.0,Salary Increases & Fixed Expenses Increase,42782,18328.0,13433,31761.0,11021.0,25.76,0.02,Low Risk
U848,2024,10,325066.0,Salary Increases & Fixed Expenses Increase,42782,18328.0,17141,35469.0,7313.0,17.09,-0.03,Medium Risk
U848,2024,11,332379.0,Salary Increases & Fixed Expenses Increase,42782,18328.0,13078,31406.0,11376.0,26.59,0.01,Low Risk
U848,2024,12,343755.0,Salary Increases & Fixed Expenses Increase,42782,18328.0,14375,32703.0,10079.0,23.56,0.01,Medium Risk
U849,2024,1,244717.0,Salary Increases & Fixed Expenses Increase,25683,22159.0,18344,40503.0,-14820.0,-57.7,-0.01,High Risk
U849,2024,2,229897.0,Salary Increases & Fixed Expenses Increase,25683,22159.0,17329,39488.0,-13805.0,-53.75,0.02,High Risk
U849,2024,3,216092.0,Salary Increases & Fixed Expenses Increase,25683,22159.0,19872,42031.0,-16348.0,-63.65,0.03,High Risk
U849,2024,4,199744.0,Salary Increases & Fixed Expenses Increase,53780,22159.0,42881,65040.0,-11260.0,-20.94,0.01,High Risk
U849,2024,5,188484.0,Salary Increases & Fixed Expenses Increase,53780,22159.0,42765,64924.0,-11144.0,-20.72,0.01,High Risk
U849,2024,6,177340.0,Salary Increases & Fixed Expenses Increase,53780,22159.0,41292,63451.0,-9671.0,-17.98,0.01,High Risk
U849,2024,7,167669.0,Salary Increases & Fixed Expenses Increase,53780,22159.0,42955,65114.0,-11334.0,-21.07,-0.05,High Risk
U849,2024,8,156335.0,Salary Increases & Fixed Expenses Increase,53780,22159.0,37533,59692.0,-5912.0,-10.99,0.01,High Risk
U849,2024,9,150423.0,Salary Increases & Fixed Expenses Increase,53780,22159.0,35271,57430.0,-3650.0,-6.79,0.05,High Risk
U849,2024,10,146773.0,Salary Increases & Fixed Expenses Increase,53780,22159.0,38669,60828.0,-7048.0,-13.11,-0.03,High Risk
U849,2024,11,139725.0,Salary Increases & Fixed Expenses Increase,53780,22159.0,34627,56786.0,-3006.0,-5.59,-0.01,High Risk
U849,2024,12,136719.0,Salary Increases & Fixed Expenses Increase,53780,22159.0,36564,58723.0,-4943.0,-9.19,-0.03,High Risk
U850,2024,1,207957.0,Stable Salary & Increasing Fixed Expenses,270398,84733.0,138629,223362.0,47036.0,17.4,-0.03,Medium Risk
U850,2024,2,254993.0,Stable Salary & Increasing Fixed Expenses,270398,84733.0,124909,209642.0,60756.0,22.47,0.04,Medium Risk
U850,2024,3,315749.0,Stable Salary & Increasing Fixed Expenses,270398,84733.0,139954,224687.0,45711.0,16.91,-0.05,Medium Risk
U850,2024,4,361460.0,Stable Salary & Increasing Fixed Expenses,270398,84733.0,149039,233772.0,36626.0,13.55,0.01,High Risk
U850,2024,5,398086.0,Stable Salary & Increasing Fixed Expenses,270398,86269.0,118131,204400.0,65998.0,24.41,-0.03,Medium Risk
U850,2024,6,464084.0,Stable Salary & Increasing Fixed Expenses,270398,86269.0,117986,204255.0,66143.0,24.46,-0.04,Medium Risk
U850,2024,7,530227.0,Stable Salary & Increasing Fixed Expenses,270398,86269.0,125928,212197.0,58201.0,21.52,-0.04,Medium Risk
U850,2024,8,588428.0,Stable Salary & Increasing Fixed Expenses,270398,86269.0,143776,230045.0,40353.0,14.92,-0.02,High Risk
U850,2024,9,628781.0,Stable Salary & Increasing Fixed Expenses,270398,86269.0,137235,223504.0,46894.0,17.34,0.05,Medium Risk
U850,2024,10,675675.0,Stable Salary & Increasing Fixed Expenses,270398,87267.0,147212,234479.0,35919.0,13.28,-0.04,High Risk
U850,2024,11,711594.0,Stable Salary & Increasing Fixed Expenses,270398,87267.0,160027,247294.0,23104.0,8.54,-0.02,High Risk
U850,2024,12,734698.0,Stable Salary & Increasing Fixed Expenses,270398,87267.0,154196,241463.0,28935.0,10.7,-0.05,High Risk
U851,2024,1,223837.0,Stable Salary & Stable Fixed Expenses,74291,23221.0,55355,78576.0,-4285.0,-5.77,0.02,High Risk
U851,2024,2,219552.0,Stable Salary & Stable Fixed Expenses,74291,23221.0,47957,71178.0,3113.0,4.19,0.05,High Risk
U851,2024,3,222665.0,Stable Salary & Stable Fixed Expenses,74291,23221.0,52166,75387.0,-1096.0,-1.48,0.04,High Risk
U851,2024,4,221569.0,Stable Salary & Stable Fixed Expenses,74291,23221.0,52970,76191.0,-1900.0,-2.56,0.02,High Risk
U851,2024,5,219669.0,Stable Salary & Stable Fixed Expenses,74291,23221.0,45724,68945.0,5346.0,7.2,0.03,High Risk
U851,2024,6,225015.0,Stable Salary & Stable Fixed Expenses,74291,23221.0,52417,75638.0,-1347.0,-1.81,0.01,High Risk
U851,2024,7,223668.0,Stable Salary & Stable Fixed Expenses,74291,23221.0,58613,81834.0,-7543.0,-10.15,-0.02,High Risk
U851,2024,8,216125.0,Stable Salary & Stable Fixed Expenses,74291,23221.0,48121,71342.0,2949.0,3.97,0.04,High Risk
U851,2024,9,219074.0,Stable Salary & Stable Fixed Expenses,74291,23221.0,58865,82086.0,-7795.0,-10.49,-0.04,High Risk
U851,2024,10,211279.0,Stable Salary & Stable Fixed Expenses,74291,23221.0,51188,74409.0,-118.0,-0.16,-0.04,High Risk
U851,2024,11,211161.0,Stable Salary & Stable Fixed Expenses,74291,23221.0,57574,80795.0,-6504.0,-8.75,0.02,High Risk
U851,2024,12,204657.0,Stable Salary & Stable Fixed Expenses,74291,23221.0,51702,74923.0,-632.0,-0.85,-0.03,High Risk
U852,2024,1,243855.0,Salary Increases & Fixed Expenses Remain Stable,194913,56103.0,68219,124322.0,70591.0,36.22,-0.02,Low Risk
U852,2024,2,314446.0,Salary Increases & Fixed Expenses Remain Stable,194913,56103.0,59860,115963.0,78950.0,40.51,-0.05,Low Risk
U852,2024,3,393396.0,Salary Increases & Fixed Expenses Remain Stable,194913,56103.0,66588,122691.0,72222.0,37.05,-0.04,Low Risk
U852,2024,4,465618.0,Salary Increases & Fixed Expenses Remain Stable,194913,56103.0,77012,133115.0,61798.0,31.71,0.04,Low Risk
U852,2024,5,527416.0,Salary Increases & Fixed Expenses Remain Stable,194913,56103.0,68986,125089.0,69824.0,35.82,-0.04,Low Risk
U852,2024,6,597240.0,Salary Increases & Fixed Expenses Remain Stable,194913,56103.0,74326,130429.0,64484.0,33.08,-0.01,Low Risk
U852,2024,7,661724.0,Salary Increases & Fixed Expenses Remain Stable,194913,56103.0,59745,115848.0,79065.0,40.56,-0.02,Low Risk
U852,2024,8,740789.0,Salary Increases & Fixed Expenses Remain Stable,214005,56103.0,78272,134375.0,79630.0,37.21,0.04,Low Risk
U852,2024,9,820419.0,Salary Increases & Fixed Expenses Remain Stable,214005,56103.0,72117,128220.0,85785.0,40.09,0.05,Low Risk
U852,2024,10,906204.0,Salary Increases & Fixed Expenses Remain Stable,214005,56103.0,75028,131131.0,82874.0,38.73,-0.01,Low Risk
U852,2024,11,989078.0,Salary Increases & Fixed Expenses Remain Stable,214005,56103.0,67290,123393.0,90612.0,42.34,-0.05,Low Risk
U852,2024,12,1079690.0,Salary Increases & Fixed Expenses Remain Stable,214005,56103.0,72630,128733.0,85272.0,39.85,0.0,Low Risk
U853,2024,1,245115.0,Stable Salary & Increasing Fixed Expenses,201607,90352.0,109959,200311.0,1296.0,0.64,-0.04,High Risk
U853,2024,2,246411.0,Stable Salary & Increasing Fixed Expenses,201607,90352.0,115649,206001.0,-4394.0,-2.18,0.03,High Risk
U853,2024,3,242017.0,Stable Salary & Increasing Fixed Expenses,201607,90352.0,109135,199487.0,2120.0,1.05,0.02,High Risk
U853,2024,4,244137.0,Stable Salary & Increasing Fixed Expenses,201607,90352.0,86503,176855.0,24752.0,12.28,-0.04,High Risk
U853,2024,5,268889.0,Stable Salary & Increasing Fixed Expenses,201607,90352.0,88990,179342.0,22265.0,11.04,0.04,High Risk
U853,2024,6,291154.0,Stable Salary & Increasing Fixed Expenses,201607,90352.0,82871,173223.0,28384.0,14.08,-0.05,High Risk
U853,2024,7,319538.0,Stable Salary & Increasing Fixed Expenses,201607,90352.0,92885,183237.0,18370.0,9.11,0.01,High Risk
U853,2024,8,337908.0,Stable Salary & Increasing Fixed Expenses,201607,90352.0,100490,190842.0,10765.0,5.34,0.03,High Risk
U853,2024,9,348673.0,Stable Salary & Increasing Fixed Expenses,201607,90352.0,95321,185673.0,15934.0,7.9,-0.01,High Risk
U853,2024,10,364607.0,Stable Salary & Increasing Fixed Expenses,201607,90352.0,94822,185174.0,16433.0,8.15,-0.02,High Risk
U853,2024,11,381040.0,Stable Salary & Increasing Fixed Expenses,201607,90352.0,86675,177027.0,24580.0,12.19,-0.04,High Risk
U853,2024,12,405620.0,Stable Salary & Increasing Fixed Expenses,201607,91704.0,85834,177538.0,24069.0,11.94,0.05,High Risk
U854,2024,1,237312.0,Salary Increases & Fixed Expenses Remain Stable,294466,96190.0,156815,253005.0,41461.0,14.08,0.03,High Risk
U854,2024,2,278773.0,Salary Increases & Fixed Expenses Remain Stable,294466,96190.0,166961,263151.0,31315.0,10.63,0.02,High Risk
U854,2024,3,310088.0,Salary Increases & Fixed Expenses Remain Stable,294466,96190.0,176961,273151.0,21315.0,7.24,0.01,High Risk
U854,2024,4,331403.0,Salary Increases & Fixed Expenses Remain Stable,316259,96190.0,165809,261999.0,54260.0,17.16,-0.0,Medium Risk
U854,2024,5,385663.0,Salary Increases & Fixed Expenses Remain Stable,316259,96190.0,184887,281077.0,35182.0,11.12,-0.02,High Risk
U854,2024,6,420845.0,Salary Increases & Fixed Expenses Remain Stable,316259,96190.0,181434,277624.0,38635.0,12.22,-0.02,High Risk
U854,2024,7,459480.0,Salary Increases & Fixed Expenses Remain Stable,316259,96190.0,188909,285099.0,31160.0,9.85,-0.05,High Risk
U854,2024,8,490640.0,Salary Increases & Fixed Expenses Remain Stable,316259,96190.0,137567,233757.0,82502.0,26.09,-0.03,Low Risk
U854,2024,9,573142.0,Salary Increases & Fixed Expenses Remain Stable,316259,96190.0,128688,224878.0,91381.0,28.89,-0.01,Low Risk
U854,2024,10,664523.0,Salary Increases & Fixed Expenses Remain Stable,316259,96190.0,186785,282975.0,33284.0,10.52,-0.04,High Risk
U854,2024,11,697807.0,Salary Increases & Fixed Expenses Remain Stable,316259,96190.0,140109,236299.0,79960.0,25.28,0.01,Low Risk
U854,2024,12,777767.0,Salary Increases & Fixed Expenses Remain Stable,316259,96190.0,140734,236924.0,79335.0,25.09,-0.03,Low Risk
U855,2024,1,219727.0,Stable Salary & Stable Fixed Expenses,196737,61106.0,150152,211258.0,-14521.0,-7.38,-0.0,High Risk
U855,2024,2,205206.0,Stable Salary & Stable Fixed Expenses,196737,61106.0,131103,192209.0,4528.0,2.3,-0.0,High Risk
U855,2024,3,209734.0,Stable Salary & Stable Fixed Expenses,196737,61106.0,118723,179829.0,16908.0,8.59,0.04,High Risk
U855,2024,4,226642.0,Stable Salary & Stable Fixed Expenses,196737,61106.0,134877,195983.0,754.0,0.38,0.01,High Risk
U855,2024,5,227396.0,Stable Salary & Stable Fixed Expenses,196737,61106.0,120560,181666.0,15071.0,7.66,0.04,High Risk
U855,2024,6,242467.0,Stable Salary & Stable Fixed Expenses,196737,61106.0,156080,217186.0,-20449.0,-10.39,-0.03,High Risk
U855,2024,7,222018.0,Stable Salary & Stable Fixed Expenses,196737,61106.0,136978,198084.0,-1347.0,-0.68,-0.05,High Risk
U855,2024,8,220671.0,Stable Salary & Stable Fixed Expenses,196737,61106.0,122257,183363.0,13374.0,6.8,-0.04,High Risk
U855,2024,9,234045.0,Stable Salary & Stable Fixed Expenses,196737,61106.0,132495,193601.0,3136.0,1.59,0.01,High Risk
U855,2024,10,237181.0,Stable Salary & Stable Fixed Expenses,196737,61106.0,124607,185713.0,11024.0,5.6,0.04,High Risk
U855,2024,11,248205.0,Stable Salary & Stable Fixed Expenses,196737,61106.0,132177,193283.0,3454.0,1.76,-0.01,High Risk
U855,2024,12,251659.0,Stable Salary & Stable Fixed Expenses,196737,61106.0,134482,195588.0,1149.0,0.58,-0.04,High Risk
U856,2024,1,212757.0,Salary Increases & Fixed Expenses Remain Stable,25180,13459.0,8719,22178.0,3002.0,11.92,0.02,High Risk
U856,2024,2,215759.0,Salary Increases & Fixed Expenses Remain Stable,25180,13459.0,9806,23265.0,1915.0,7.61,0.04,High Risk
U856,2024,3,217674.0,Salary Increases & Fixed Expenses Remain Stable,31503,13459.0,11676,25135.0,6368.0,20.21,-0.03,Medium Risk
U856,2024,4,224042.0,Salary Increases & Fixed Expenses Remain Stable,31503,13459.0,12308,25767.0,5736.0,18.21,0.02,Medium Risk
U856,2024,5,229778.0,Salary Increases & Fixed Expenses Remain Stable,31503,13459.0,10187,23646.0,7857.0,24.94,-0.0,Medium Risk
U856,2024,6,237635.0,Salary Increases & Fixed Expenses Remain Stable,31503,13459.0,11434,24893.0,6610.0,20.98,-0.02,Medium Risk
U856,2024,7,244245.0,Salary Increases & Fixed Expenses Remain Stable,31503,13459.0,11036,24495.0,7008.0,22.25,0.01,Medium Risk
U856,2024,8,251253.0,Salary Increases & Fixed Expenses Remain Stable,31503,13459.0,10830,24289.0,7214.0,22.9,-0.05,Medium Risk
U856,2024,9,258467.0,Salary Increases & Fixed Expenses Remain Stable,31503,13459.0,10744,24203.0,7300.0,23.17,-0.03,Medium Risk
U856,2024,10,265767.0,Salary Increases & Fixed Expenses Remain Stable,31503,13459.0,10142,23601.0,7902.0,25.08,-0.02,Low Risk
U856,2024,11,273669.0,Salary Increases & Fixed Expenses Remain Stable,31503,13459.0,10209,23668.0,7835.0,24.87,-0.0,Medium Risk
U856,2024,12,281504.0,Salary Increases & Fixed Expenses Remain Stable,31503,13459.0,11817,25276.0,6227.0,19.77,-0.0,Medium Risk
U857,2024,1,234343.0,Stable Salary & Increasing Fixed Expenses,221472,82215.0,163741,245956.0,-24484.0,-11.06,0.0,High Risk
U857,2024,2,209859.0,Stable Salary & Increasing Fixed Expenses,221472,83158.0,163195,246353.0,-24881.0,-11.23,0.03,High Risk
U857,2024,3,184978.0,Stable Salary & Increasing Fixed Expenses,221472,83158.0,169620,252778.0,-31306.0,-14.14,0.01,High Risk
U857,2024,4,153672.0,Stable Salary & Increasing Fixed Expenses,221472,83158.0,142458,225616.0,-4144.0,-1.87,-0.04,High Risk
U857,2024,5,149528.0,Stable Salary & Increasing Fixed Expenses,221472,83835.0,140874,224709.0,-3237.0,-1.46,0.01,High Risk
U857,2024,6,146291.0,Stable Salary & Increasing Fixed Expenses,221472,83835.0,167245,251080.0,-29608.0,-13.37,0.01,High Risk
U857,2024,7,116683.0,Stable Salary & Increasing Fixed Expenses,221472,83835.0,174305,258140.0,-36668.0,-16.56,-0.0,High Risk
U857,2024,8,80015.0,Stable Salary & Increasing Fixed Expenses,221472,83835.0,153024,236859.0,-15387.0,-6.95,-0.03,High Risk
U857,2024,9,64628.0,Stable Salary & Increasing Fixed Expenses,221472,83835.0,140598,224433.0,-2961.0,-1.34,-0.02,High Risk
U857,2024,10,61667.0,Stable Salary & Increasing Fixed Expenses,221472,83835.0,191036,274871.0,-53399.0,-24.11,-0.02,High Risk
U857,2024,11,8268.0,Stable Salary & Increasing Fixed Expenses,221472,83835.0,158700,242535.0,-21063.0,-9.51,0.05,High Risk
U857,2024,12,-12795.0,Stable Salary & Increasing Fixed Expenses,221472,83835.0,161105,244940.0,-23468.0,-10.6,-0.02,High Risk
U858,2024,1,210932.0,Salary Increases & Fixed Expenses Increase,219358,115419.0,115351,230770.0,-11412.0,-5.2,0.01,High Risk
U858,2024,2,199520.0,Salary Increases & Fixed Expenses Increase,219358,115419.0,125591,241010.0,-21652.0,-9.87,0.01,High Risk
U858,2024,3,177868.0,Salary Increases & Fixed Expenses Increase,219358,115419.0,147180,262599.0,-43241.0,-19.71,0.02,High Risk
U858,2024,4,134627.0,Salary Increases & Fixed Expenses Increase,219358,116989.0,117459,234448.0,-15090.0,-6.88,-0.01,High Risk
U858,2024,5,119537.0,Salary Increases & Fixed Expenses Increase,219358,116989.0,122056,239045.0,-19687.0,-8.97,0.02,High Risk
U858,2024,6,99850.0,Salary Increases & Fixed Expenses Increase,219358,116989.0,100434,217423.0,1935.0,0.88,0.02,High Risk
U858,2024,7,101785.0,Salary Increases & Fixed Expenses Increase,243035,118053.0,132065,250118.0,-7083.0,-2.91,0.03,High Risk
U858,2024,8,94702.0,Salary Increases & Fixed Expenses Increase,243035,118053.0,143804,261857.0,-18822.0,-7.74,0.02,High Risk
U858,2024,9,75880.0,Salary Increases & Fixed Expenses Increase,243035,118053.0,103922,221975.0,21060.0,8.67,-0.01,High Risk
U858,2024,10,96940.0,Salary Increases & Fixed Expenses Increase,243035,118053.0,144925,262978.0,-19943.0,-8.21,-0.05,High Risk
U858,2024,11,76997.0,Salary Increases & Fixed Expenses Increase,243035,118053.0,113756,231809.0,11226.0,4.62,-0.03,High Risk
U858,2024,12,88223.0,Salary Increases & Fixed Expenses Increase,243035,118053.0,114511,232564.0,10471.0,4.31,-0.01,High Risk
U859,2024,1,211926.0,Salary Increases & Fixed Expenses Remain Stable,166288,75327.0,85279,160606.0,5682.0,3.42,-0.03,High Risk
U859,2024,2,217608.0,Salary Increases & Fixed Expenses Remain Stable,166288,75327.0,69861,145188.0,21100.0,12.69,-0.01,High Risk
U859,2024,3,238708.0,Salary Increases & Fixed Expenses Remain Stable,188417,75327.0,92118,167445.0,20972.0,11.13,-0.02,High Risk
U859,2024,4,259680.0,Salary Increases & Fixed Expenses Remain Stable,188417,75327.0,94400,169727.0,18690.0,9.92,-0.01,High Risk
U859,2024,5,278370.0,Salary Increases & Fixed Expenses Remain Stable,188417,75327.0,90011,165338.0,23079.0,12.25,-0.01,High Risk
U859,2024,6,301449.0,Salary Increases & Fixed Expenses Remain Stable,188417,75327.0,86005,161332.0,27085.0,14.38,-0.02,High Risk
U859,2024,7,328534.0,Salary Increases & Fixed Expenses Remain Stable,188417,75327.0,101280,176607.0,11810.0,6.27,-0.03,High Risk
U859,2024,8,340344.0,Salary Increases & Fixed Expenses Remain Stable,188417,75327.0,89165,164492.0,23925.0,12.7,0.04,High Risk
U859,2024,9,364269.0,Salary Increases & Fixed Expenses Remain Stable,188417,75327.0,101376,176703.0,11714.0,6.22,-0.03,High Risk
U859,2024,10,375983.0,Salary Increases & Fixed Expenses Remain Stable,188417,75327.0,101787,177114.0,11303.0,6.0,0.04,High Risk
U859,2024,11,387286.0,Salary Increases & Fixed Expenses Remain Stable,188417,75327.0,106816,182143.0,6274.0,3.33,-0.02,High Risk
U859,2024,12,393560.0,Salary Increases & Fixed Expenses Remain Stable,188417,75327.0,106643,181970.0,6447.0,3.42,0.04,High Risk
U860,2024,1,210104.0,Salary Increases & Fixed Expenses Remain Stable,254976,106197.0,101364,207561.0,47415.0,18.6,-0.03,Medium Risk
U860,2024,2,257519.0,Salary Increases & Fixed Expenses Remain Stable,254976,106197.0,97342,203539.0,51437.0,20.17,-0.02,Medium Risk
U860,2024,3,308956.0,Salary Increases & Fixed Expenses Remain Stable,254976,106197.0,119069,225266.0,29710.0,11.65,0.01,High Risk
U860,2024,4,338666.0,Salary Increases & Fixed Expenses Remain Stable,254976,106197.0,90199,196396.0,58580.0,22.97,0.0,Medium Risk
U860,2024,5,397246.0,Salary Increases & Fixed Expenses Remain Stable,254976,106197.0,83282,189479.0,65497.0,25.69,-0.03,Low Risk
U860,2024,6,462743.0,Salary Increases & Fixed Expenses Remain Stable,254976,106197.0,90674,196871.0,58105.0,22.79,-0.02,Medium Risk
U860,2024,7,520848.0,Salary Increases & Fixed Expenses Remain Stable,254976,106197.0,83494,189691.0,65285.0,25.6,0.04,Low Risk
U860,2024,8,586133.0,Salary Increases & Fixed Expenses Remain Stable,283984,106197.0,94015,200212.0,83772.0,29.5,-0.01,Low Risk
U860,2024,9,669905.0,Salary Increases & Fixed Expenses Remain Stable,283984,106197.0,125862,232059.0,51925.0,18.28,-0.01,Medium Risk
U860,2024,10,721830.0,Salary Increases & Fixed Expenses Remain Stable,283984,106197.0,121984,228181.0,55803.0,19.65,0.05,Medium Risk
U860,2024,11,777633.0,Salary Increases & Fixed Expenses Remain Stable,283984,106197.0,91027,197224.0,86760.0,30.55,0.01,Low Risk
U860,2024,12,864393.0,Salary Increases & Fixed Expenses Remain Stable,283984,106197.0,127191,233388.0,50596.0,17.82,0.02,Medium Risk
U861,2024,1,232228.0,Stable Salary & Stable Fixed Expenses,222555,76282.0,127815,204097.0,18458.0,8.29,0.01,High Risk
U861,2024,2,250686.0,Stable Salary & Stable Fixed Expenses,222555,76282.0,127279,203561.0,18994.0,8.53,-0.01,High Risk
U861,2024,3,269680.0,Stable Salary & Stable Fixed Expenses,222555,76282.0,108530,184812.0,37743.0,16.96,-0.02,Medium Risk
U861,2024,4,307423.0,Stable Salary & Stable Fixed Expenses,222555,76282.0,132130,208412.0,14143.0,6.35,-0.04,High Risk
U861,2024,5,321566.0,Stable Salary & Stable Fixed Expenses,222555,76282.0,124812,201094.0,21461.0,9.64,-0.05,High Risk
U861,2024,6,343027.0,Stable Salary & Stable Fixed Expenses,222555,76282.0,125412,201694.0,20861.0,9.37,0.02,High Risk
U861,2024,7,363888.0,Stable Salary & Stable Fixed Expenses,222555,76282.0,117677,193959.0,28596.0,12.85,0.01,High Risk
U861,2024,8,392484.0,Stable Salary & Stable Fixed Expenses,222555,76282.0,104682,180964.0,41591.0,18.69,-0.02,Medium Risk
U861,2024,9,434075.0,Stable Salary & Stable Fixed Expenses,222555,76282.0,105197,181479.0,41076.0,18.46,-0.01,Medium Risk
U861,2024,10,475151.0,Stable Salary & Stable Fixed Expenses,222555,76282.0,102276,178558.0,43997.0,19.77,0.02,Medium Risk
U861,2024,11,519148.0,Stable Salary & Stable Fixed Expenses,222555,76282.0,106455,182737.0,39818.0,17.89,-0.01,Medium Risk
U861,2024,12,558966.0,Stable Salary & Stable Fixed Expenses,222555,76282.0,105509,181791.0,40764.0,18.32,0.03,Medium Risk
U862,2024,1,248729.0,Stable Salary & Stable Fixed Expenses,217547,99216.0,109007,208223.0,9324.0,4.29,-0.03,High Risk
U862,2024,2,258053.0,Stable Salary & Stable Fixed Expenses,217547,99216.0,92439,191655.0,25892.0,11.9,-0.02,High Risk
U862,2024,3,283945.0,Stable Salary & Stable Fixed Expenses,217547,99216.0,127808,227024.0,-9477.0,-4.36,0.03,High Risk
U862,2024,4,274468.0,Stable Salary & Stable Fixed Expenses,217547,99216.0,114115,213331.0,4216.0,1.94,0.02,High Risk
U862,2024,5,278684.0,Stable Salary & Stable Fixed Expenses,217547,99216.0,109120,208336.0,9211.0,4.23,0.03,High Risk
U862,2024,6,287895.0,Stable Salary & Stable Fixed Expenses,217547,99216.0,100391,199607.0,17940.0,8.25,0.01,High Risk
U862,2024,7,305835.0,Stable Salary & Stable Fixed Expenses,217547,99216.0,127539,226755.0,-9208.0,-4.23,-0.03,High Risk
U862,2024,8,296627.0,Stable Salary & Stable Fixed Expenses,217547,99216.0,124505,223721.0,-6174.0,-2.84,-0.03,High Risk
U862,2024,9,290453.0,Stable Salary & Stable Fixed Expenses,217547,99216.0,96341,195557.0,21990.0,10.11,0.04,High Risk
U862,2024,10,312443.0,Stable Salary & Stable Fixed Expenses,217547,99216.0,123567,222783.0,-5236.0,-2.41,-0.03,High Risk
U862,2024,11,307207.0,Stable Salary & Stable Fixed Expenses,217547,99216.0,109937,209153.0,8394.0,3.86,-0.03,High Risk
U862,2024,12,315601.0,Stable Salary & Stable Fixed Expenses,217547,99216.0,153823,253039.0,-35492.0,-16.31,-0.0,High Risk
U863,2024,1,235413.0,Stable Salary & Stable Fixed Expenses,284484,84535.0,142495,227030.0,57454.0,20.2,-0.02,Medium Risk
U863,2024,2,292867.0,Stable Salary & Stable Fixed Expenses,284484,84535.0,141581,226116.0,58368.0,20.52,-0.01,Medium Risk
U863,2024,3,351235.0,Stable Salary & Stable Fixed Expenses,284484,84535.0,176440,260975.0,23509.0,8.26,0.01,High Risk
U863,2024,4,374744.0,Stable Salary & Stable Fixed Expenses,284484,84535.0,122474,207009.0,77475.0,27.23,-0.02,Low Risk
U863,2024,5,452219.0,Stable Salary & Stable Fixed Expenses,284484,84535.0,119208,203743.0,80741.0,28.38,0.0,Low Risk
U863,2024,6,532960.0,Stable Salary & Stable Fixed Expenses,284484,84535.0,134003,218538.0,65946.0,23.18,-0.01,Medium Risk
U863,2024,7,598906.0,Stable Salary & Stable Fixed Expenses,284484,84535.0,139535,224070.0,60414.0,21.24,0.04,Medium Risk
U863,2024,8,659320.0,Stable Salary & Stable Fixed Expenses,284484,84535.0,129044,213579.0,70905.0,24.92,-0.02,Medium Risk
U863,2024,9,730225.0,Stable Salary & Stable Fixed Expenses,284484,84535.0,145050,229585.0,54899.0,19.3,-0.03,Medium Risk
U863,2024,10,785124.0,Stable Salary & Stable Fixed Expenses,284484,84535.0,183128,267663.0,16821.0,5.91,-0.0,High Risk
U863,2024,11,801945.0,Stable Salary & Stable Fixed Expenses,284484,84535.0,114707,199242.0,85242.0,29.96,0.04,Low Risk
U863,2024,12,887187.0,Stable Salary & Stable Fixed Expenses,284484,84535.0,162289,246824.0,37660.0,13.24,0.02,High Risk
U864,2024,1,242746.0,Salary Increases & Fixed Expenses Remain Stable,154762,54846.0,80197,135043.0,19719.0,12.74,-0.02,High Risk
U864,2024,2,262465.0,Salary Increases & Fixed Expenses Remain Stable,154762,54846.0,86601,141447.0,13315.0,8.6,0.01,High Risk
U864,2024,3,275780.0,Salary Increases & Fixed Expenses Remain Stable,154762,54846.0,82372,137218.0,17544.0,11.34,0.01,High Risk
U864,2024,4,293324.0,Salary Increases & Fixed Expenses Remain Stable,154762,54846.0,62809,117655.0,37107.0,23.98,0.03,Medium Risk
U864,2024,5,330431.0,Salary Increases & Fixed Expenses Remain Stable,154762,54846.0,84886,139732.0,15030.0,9.71,-0.03,High Risk
U864,2024,6,345461.0,Salary Increases & Fixed Expenses Remain Stable,171025,54846.0,86334,141180.0,29845.0,17.45,-0.0,Medium Risk
U864,2024,7,375306.0,Salary Increases & Fixed Expenses Remain Stable,171025,54846.0,98228,153074.0,17951.0,10.5,0.03,High Risk
U864,2024,8,393257.0,Salary Increases & Fixed Expenses Remain Stable,171025,54846.0,82875,137721.0,33304.0,19.47,-0.04,Medium Risk
U864,2024,9,426561.0,Salary Increases & Fixed Expenses Remain Stable,171025,54846.0,78025,132871.0,38154.0,22.31,0.0,Medium Risk
U864,2024,10,464715.0,Salary Increases & Fixed Expenses Remain Stable,171025,54846.0,97306,152152.0,18873.0,11.04,-0.01,High Risk
U864,2024,11,483588.0,Salary Increases & Fixed Expenses Remain Stable,171025,54846.0,89722,144568.0,26457.0,15.47,-0.02,Medium Risk
U864,2024,12,510045.0,Salary Increases & Fixed Expenses Remain Stable,171025,54846.0,71349,126195.0,44830.0,26.21,0.01,Low Risk
U865,2024,1,218548.0,Stable Salary & Stable Fixed Expenses,123778,58190.0,38950,97140.0,26638.0,21.52,0.03,Medium Risk
U865,2024,2,245186.0,Stable Salary & Stable Fixed Expenses,123778,58190.0,47864,106054.0,17724.0,14.32,-0.02,High Risk
U865,2024,3,262910.0,Stable Salary & Stable Fixed Expenses,123778,58190.0,48682,106872.0,16906.0,13.66,-0.03,High Risk
U865,2024,4,279816.0,Stable Salary & Stable Fixed Expenses,123778,58190.0,39895,98085.0,25693.0,20.76,-0.01,Medium Risk
U865,2024,5,305509.0,Stable Salary & Stable Fixed Expenses,123778,58190.0,41710,99900.0,23878.0,19.29,0.05,Medium Risk
U865,2024,6,329387.0,Stable Salary & Stable Fixed Expenses,123778,58190.0,40797,98987.0,24791.0,20.03,-0.04,Medium Risk
U865,2024,7,354178.0,Stable Salary & Stable Fixed Expenses,123778,58190.0,44019,102209.0,21569.0,17.43,0.03,Medium Risk
U865,2024,8,375747.0,Stable Salary & Stable Fixed Expenses,123778,58190.0,37172,95362.0,28416.0,22.96,0.05,Medium Risk
U865,2024,9,404163.0,Stable Salary & Stable Fixed Expenses,123778,58190.0,46812,105002.0,18776.0,15.17,0.03,Medium Risk
U865,2024,10,422939.0,Stable Salary & Stable Fixed Expenses,123778,58190.0,54488,112678.0,11100.0,8.97,0.02,High Risk
U865,2024,11,434039.0,Stable Salary & Stable Fixed Expenses,123778,58190.0,44108,102298.0,21480.0,17.35,-0.03,Medium Risk
U865,2024,12,455519.0,Stable Salary & Stable Fixed Expenses,123778,58190.0,57261,115451.0,8327.0,6.73,0.03,High Risk
U866,2024,1,228273.0,Salary Increases & Fixed Expenses Increase,143892,46849.0,83029,129878.0,14014.0,9.74,-0.03,High Risk
U866,2024,2,242287.0,Salary Increases & Fixed Expenses Increase,143892,46849.0,65859,112708.0,31184.0,21.67,0.05,Medium Risk
U866,2024,3,273471.0,Salary Increases & Fixed Expenses Increase,153478,46849.0,79871,126720.0,26758.0,17.43,-0.01,Medium Risk
U866,2024,4,300229.0,Salary Increases & Fixed Expenses Increase,153478,46849.0,79750,126599.0,26879.0,17.51,-0.02,Medium Risk
U866,2024,5,327108.0,Salary Increases & Fixed Expenses Increase,153478,46849.0,72575,119424.0,34054.0,22.19,-0.02,Medium Risk
U866,2024,6,361162.0,Salary Increases & Fixed Expenses Increase,153478,46849.0,91211,138060.0,15418.0,10.05,-0.0,High Risk
U866,2024,7,376580.0,Salary Increases & Fixed Expenses Increase,153478,46849.0,89930,136779.0,16699.0,10.88,-0.05,High Risk
U866,2024,8,393279.0,Salary Increases & Fixed Expenses Increase,153478,46849.0,63116,109965.0,43513.0,28.35,-0.02,Low Risk
U866,2024,9,436792.0,Salary Increases & Fixed Expenses Increase,153478,48243.0,91629,139872.0,13606.0,8.87,0.01,High Risk
U866,2024,10,450398.0,Salary Increases & Fixed Expenses Increase,153478,48243.0,80785,129028.0,24450.0,15.93,-0.01,Medium Risk
U866,2024,11,474848.0,Salary Increases & Fixed Expenses Increase,153478,48243.0,76289,124532.0,28946.0,18.86,-0.04,Medium Risk
U866,2024,12,503794.0,Salary Increases & Fixed Expenses Increase,153478,48243.0,102942,151185.0,2293.0,1.49,-0.04,High Risk
U867,2024,1,247495.0,Stable Salary & Stable Fixed Expenses,106250,70736.0,58443,129179.0,-22929.0,-21.58,0.03,High Risk
U867,2024,2,224566.0,Stable Salary & Stable Fixed Expenses,106250,70736.0,51882,122618.0,-16368.0,-15.41,0.04,High Risk
U867,2024,3,208198.0,Stable Salary & Stable Fixed Expenses,106250,70736.0,47683,118419.0,-12169.0,-11.45,0.0,High Risk
U867,2024,4,196029.0,Stable Salary & Stable Fixed Expenses,106250,70736.0,61259,131995.0,-25745.0,-24.23,-0.03,High Risk
U867,2024,5,170284.0,Stable Salary & Stable Fixed Expenses,106250,70736.0,59770,130506.0,-24256.0,-22.83,-0.03,High Risk
U867,2024,6,146028.0,Stable Salary & Stable Fixed Expenses,106250,70736.0,62557,133293.0,-27043.0,-25.45,0.05,High Risk
U867,2024,7,118985.0,Stable Salary & Stable Fixed Expenses,106250,70736.0,45076,115812.0,-9562.0,-9.0,-0.0,High Risk
U867,2024,8,109423.0,Stable Salary & Stable Fixed Expenses,106250,70736.0,51591,122327.0,-16077.0,-15.13,0.01,High Risk
U867,2024,9,93346.0,Stable Salary & Stable Fixed Expenses,106250,70736.0,50198,120934.0,-14684.0,-13.82,0.02,High Risk
U867,2024,10,78662.0,Stable Salary & Stable Fixed Expenses,106250,70736.0,63162,133898.0,-27648.0,-26.02,0.03,High Risk
U867,2024,11,51014.0,Stable Salary & Stable Fixed Expenses,106250,70736.0,56835,127571.0,-21321.0,-20.07,-0.01,High Risk
U867,2024,12,29693.0,Stable Salary & Stable Fixed Expenses,106250,70736.0,44363,115099.0,-8849.0,-8.33,0.02,High Risk
U868,2024,1,208932.0,Stable Salary & Stable Fixed Expenses,112400,47512.0,40028,87540.0,24860.0,22.12,-0.04,Medium Risk
U868,2024,2,233792.0,Stable Salary & Stable Fixed Expenses,112400,47512.0,36234,83746.0,28654.0,25.49,-0.04,Low Risk
U868,2024,3,262446.0,Stable Salary & Stable Fixed Expenses,112400,47512.0,51126,98638.0,13762.0,12.24,0.02,High Risk
U868,2024,4,276208.0,Stable Salary & Stable Fixed Expenses,112400,47512.0,37432,84944.0,27456.0,24.43,0.02,Medium Risk
U868,2024,5,303664.0,Stable Salary & Stable Fixed Expenses,112400,47512.0,43492,91004.0,21396.0,19.04,-0.01,Medium Risk
U868,2024,6,325060.0,Stable Salary & Stable Fixed Expenses,112400,47512.0,38672,86184.0,26216.0,23.32,0.0,Medium Risk
U868,2024,7,351276.0,Stable Salary & Stable Fixed Expenses,112400,47512.0,35788,83300.0,29100.0,25.89,-0.01,Low Risk
U868,2024,8,380376.0,Stable Salary & Stable Fixed Expenses,112400,47512.0,43859,91371.0,21029.0,18.71,-0.05,Medium Risk
U868,2024,9,401405.0,Stable Salary & Stable Fixed Expenses,112400,47512.0,35902,83414.0,28986.0,25.79,0.04,Low Risk
U868,2024,10,430391.0,Stable Salary & Stable Fixed Expenses,112400,47512.0,51758,99270.0,13130.0,11.68,0.04,High Risk
U868,2024,11,443521.0,Stable Salary & Stable Fixed Expenses,112400,47512.0,41286,88798.0,23602.0,21.0,0.05,Medium Risk
U868,2024,12,467123.0,Stable Salary & Stable Fixed Expenses,112400,47512.0,42256,89768.0,22632.0,20.14,0.0,Medium Risk
U869,2024,1,221787.0,Salary Increases & Fixed Expenses Remain Stable,265976,117704.0,135351,253055.0,12921.0,4.86,0.04,High Risk
U869,2024,2,234708.0,Salary Increases & Fixed Expenses Remain Stable,265976,117704.0,106634,224338.0,41638.0,15.65,0.0,Medium Risk
U869,2024,3,276346.0,Salary Increases & Fixed Expenses Remain Stable,265976,117704.0,179928,297632.0,-31656.0,-11.9,-0.0,High Risk
U869,2024,4,244690.0,Salary Increases & Fixed Expenses Remain Stable,265976,117704.0,126269,243973.0,22003.0,8.27,0.02,High Risk
U869,2024,5,266693.0,Salary Increases & Fixed Expenses Remain Stable,265976,117704.0,158154,275858.0,-9882.0,-3.72,0.05,High Risk
U869,2024,6,256811.0,Salary Increases & Fixed Expenses Remain Stable,274516,117704.0,156805,274509.0,7.0,0.0,-0.03,High Risk
U869,2024,7,256818.0,Salary Increases & Fixed Expenses Remain Stable,274516,117704.0,112515,230219.0,44297.0,16.14,0.0,Medium Risk
U869,2024,8,301115.0,Salary Increases & Fixed Expenses Remain Stable,274516,117704.0,115303,233007.0,41509.0,15.12,-0.04,Medium Risk
U869,2024,9,342624.0,Salary Increases & Fixed Expenses Remain Stable,274516,117704.0,148222,265926.0,8590.0,3.13,0.03,High Risk
U869,2024,10,351214.0,Salary Increases & Fixed Expenses Remain Stable,274516,117704.0,182081,299785.0,-25269.0,-9.2,-0.01,High Risk
U869,2024,11,325945.0,Salary Increases & Fixed Expenses Remain Stable,274516,117704.0,159997,277701.0,-3185.0,-1.16,0.04,High Risk
U869,2024,12,322760.0,Salary Increases & Fixed Expenses Remain Stable,274516,117704.0,169491,287195.0,-12679.0,-4.62,-0.02,High Risk
U870,2024,1,248963.0,Stable Salary & Stable Fixed Expenses,251621,89782.0,93480,183262.0,68359.0,27.17,-0.01,Low Risk
U870,2024,2,317322.0,Stable Salary & Stable Fixed Expenses,251621,89782.0,80810,170592.0,81029.0,32.2,0.04,Low Risk
U870,2024,3,398351.0,Stable Salary & Stable Fixed Expenses,251621,89782.0,115302,205084.0,46537.0,18.49,0.05,Medium Risk
U870,2024,4,444888.0,Stable Salary & Stable Fixed Expenses,251621,89782.0,92532,182314.0,69307.0,27.54,0.02,Low Risk
U870,2024,5,514195.0,Stable Salary & Stable Fixed Expenses,251621,89782.0,76293,166075.0,85546.0,34.0,-0.01,Low Risk
U870,2024,6,599741.0,Stable Salary & Stable Fixed Expenses,251621,89782.0,84903,174685.0,76936.0,30.58,-0.01,Low Risk
U870,2024,7,676677.0,Stable Salary & Stable Fixed Expenses,251621,89782.0,80916,170698.0,80923.0,32.16,-0.02,Low Risk
U870,2024,8,757600.0,Stable Salary & Stable Fixed Expenses,251621,89782.0,79937,169719.0,81902.0,32.55,0.01,Low Risk
U870,2024,9,839502.0,Stable Salary & Stable Fixed Expenses,251621,89782.0,87509,177291.0,74330.0,29.54,0.02,Low Risk
U870,2024,10,913832.0,Stable Salary & Stable Fixed Expenses,251621,89782.0,99643,189425.0,62196.0,24.72,-0.04,Medium Risk
U870,2024,11,976028.0,Stable Salary & Stable Fixed Expenses,251621,89782.0,99473,189255.0,62366.0,24.79,-0.0,Medium Risk
U870,2024,12,1038394.0,Stable Salary & Stable Fixed Expenses,251621,89782.0,111351,201133.0,50488.0,20.07,-0.02,Medium Risk
U871,2024,1,218782.0,Stable Salary & Stable Fixed Expenses,236186,79301.0,98771,178072.0,58114.0,24.61,0.01,Medium Risk
U871,2024,2,276896.0,Stable Salary & Stable Fixed Expenses,236186,79301.0,101613,180914.0,55272.0,23.4,-0.04,Medium Risk
U871,2024,3,332168.0,Stable Salary & Stable Fixed Expenses,236186,79301.0,121984,201285.0,34901.0,14.78,-0.0,High Risk
U871,2024,4,367069.0,Stable Salary & Stable Fixed Expenses,236186,79301.0,127450,206751.0,29435.0,12.46,0.02,High Risk
U871,2024,5,396504.0,Stable Salary & Stable Fixed Expenses,236186,79301.0,98744,178045.0,58141.0,24.62,-0.0,Medium Risk
U871,2024,6,454645.0,Stable Salary & Stable Fixed Expenses,236186,79301.0,95817,175118.0,61068.0,25.86,0.02,Low Risk
U871,2024,7,515713.0,Stable Salary & Stable Fixed Expenses,236186,79301.0,141420,220721.0,15465.0,6.55,-0.04,High Risk
U871,2024,8,531178.0,Stable Salary & Stable Fixed Expenses,236186,79301.0,137460,216761.0,19425.0,8.22,0.04,High Risk
U871,2024,9,550603.0,Stable Salary & Stable Fixed Expenses,236186,79301.0,120519,199820.0,36366.0,15.4,-0.01,Medium Risk
U871,2024,10,586969.0,Stable Salary & Stable Fixed Expenses,236186,79301.0,129449,208750.0,27436.0,11.62,-0.05,High Risk
U871,2024,11,614405.0,Stable Salary & Stable Fixed Expenses,236186,79301.0,118127,197428.0,38758.0,16.41,0.03,Medium Risk
U871,2024,12,653163.0,Stable Salary & Stable Fixed Expenses,236186,79301.0,131165,210466.0,25720.0,10.89,-0.01,High Risk
U872,2024,1,246717.0,Stable Salary & Stable Fixed Expenses,231697,116089.0,100242,216331.0,15366.0,6.63,0.04,High Risk
U872,2024,2,262083.0,Stable Salary & Stable Fixed Expenses,231697,116089.0,122426,238515.0,-6818.0,-2.94,-0.0,High Risk
U872,2024,3,255265.0,Stable Salary & Stable Fixed Expenses,231697,116089.0,137379,253468.0,-21771.0,-9.4,-0.03,High Risk
U872,2024,4,233494.0,Stable Salary & Stable Fixed Expenses,231697,116089.0,113609,229698.0,1999.0,0.86,0.03,High Risk
U872,2024,5,235493.0,Stable Salary & Stable Fixed Expenses,231697,116089.0,101909,217998.0,13699.0,5.91,-0.04,High Risk
U872,2024,6,249192.0,Stable Salary & Stable Fixed Expenses,231697,116089.0,102294,218383.0,13314.0,5.75,-0.04,High Risk
U872,2024,7,262506.0,Stable Salary & Stable Fixed Expenses,231697,116089.0,130745,246834.0,-15137.0,-6.53,0.05,High Risk
U872,2024,8,247369.0,Stable Salary & Stable Fixed Expenses,231697,116089.0,125307,241396.0,-9699.0,-4.19,-0.05,High Risk
U872,2024,9,237670.0,Stable Salary & Stable Fixed Expenses,231697,116089.0,103735,219824.0,11873.0,5.12,0.03,High Risk
U872,2024,10,249543.0,Stable Salary & Stable Fixed Expenses,231697,116089.0,129522,245611.0,-13914.0,-6.01,0.02,High Risk
U872,2024,11,235629.0,Stable Salary & Stable Fixed Expenses,231697,116089.0,107815,223904.0,7793.0,3.36,-0.02,High Risk
U872,2024,12,243422.0,Stable Salary & Stable Fixed Expenses,231697,116089.0,118477,234566.0,-2869.0,-1.24,-0.03,High Risk
U873,2024,1,233875.0,Stable Salary & Stable Fixed Expenses,27826,11309.0,13221,24530.0,3296.0,11.85,0.0,High Risk
U873,2024,2,237171.0,Stable Salary & Stable Fixed Expenses,27826,11309.0,14199,25508.0,2318.0,8.33,0.01,High Risk
U873,2024,3,239489.0,Stable Salary & Stable Fixed Expenses,27826,11309.0,16012,27321.0,505.0,1.81,0.03,High Risk
U873,2024,4,239994.0,Stable Salary & Stable Fixed Expenses,27826,11309.0,12841,24150.0,3676.0,13.21,-0.05,High Risk
U873,2024,5,243670.0,Stable Salary & Stable Fixed Expenses,27826,11309.0,12250,23559.0,4267.0,15.33,-0.03,Medium Risk
U873,2024,6,247937.0,Stable Salary & Stable Fixed Expenses,27826,11309.0,14950,26259.0,1567.0,5.63,0.02,High Risk
U873,2024,7,249504.0,Stable Salary & Stable Fixed Expenses,27826,11309.0,13064,24373.0,3453.0,12.41,-0.02,High Risk
U873,2024,8,252957.0,Stable Salary & Stable Fixed Expenses,27826,11309.0,15367,26676.0,1150.0,4.13,-0.04,High Risk
U873,2024,9,254107.0,Stable Salary & Stable Fixed Expenses,27826,11309.0,14476,25785.0,2041.0,7.33,-0.0,High Risk
U873,2024,10,256148.0,Stable Salary & Stable Fixed Expenses,27826,11309.0,14854,26163.0,1663.0,5.98,-0.02,High Risk
U873,2024,11,257811.0,Stable Salary & Stable Fixed Expenses,27826,11309.0,11866,23175.0,4651.0,16.71,0.04,Medium Risk
U873,2024,12,262462.0,Stable Salary & Stable Fixed Expenses,27826,11309.0,12177,23486.0,4340.0,15.6,-0.01,Medium Risk
U874,2024,1,231514.0,Stable Salary & Stable Fixed Expenses,25761,22327.0,14377,36704.0,-10943.0,-42.48,0.01,High Risk
U874,2024,2,220571.0,Stable Salary & Stable Fixed Expenses,25761,22327.0,12904,35231.0,-9470.0,-36.76,0.03,High Risk
U874,2024,3,211101.0,Stable Salary & Stable Fixed Expenses,25761,22327.0,16427,38754.0,-12993.0,-50.44,-0.01,High Risk
U874,2024,4,198108.0,Stable Salary & Stable Fixed Expenses,25761,22327.0,14251,36578.0,-10817.0,-41.99,-0.01,High Risk
U874,2024,5,187291.0,Stable Salary & Stable Fixed Expenses,25761,22327.0,11507,33834.0,-8073.0,-31.34,-0.04,High Risk
U874,2024,6,179218.0,Stable Salary & Stable Fixed Expenses,25761,22327.0,15034,37361.0,-11600.0,-45.03,0.05,High Risk
U874,2024,7,167618.0,Stable Salary & Stable Fixed Expenses,25761,22327.0,11019,33346.0,-7585.0,-29.44,-0.01,High Risk
U874,2024,8,160033.0,Stable Salary & Stable Fixed Expenses,25761,22327.0,14168,36495.0,-10734.0,-41.67,0.04,High Risk
U874,2024,9,149299.0,Stable Salary & Stable Fixed Expenses,25761,22327.0,14693,37020.0,-11259.0,-43.71,-0.02,High Risk
U874,2024,10,138040.0,Stable Salary & Stable Fixed Expenses,25761,22327.0,13715,36042.0,-10281.0,-39.91,0.03,High Risk
U874,2024,11,127759.0,Stable Salary & Stable Fixed Expenses,25761,22327.0,12936,35263.0,-9502.0,-36.89,-0.02,High Risk
U874,2024,12,118257.0,Stable Salary & Stable Fixed Expenses,25761,22327.0,17529,39856.0,-14095.0,-54.71,-0.02,High Risk
U875,2024,1,227949.0,Salary Increases & Fixed Expenses Remain Stable,89666,25791.0,64627,90418.0,-752.0,-0.84,-0.02,High Risk
U875,2024,2,227197.0,Salary Increases & Fixed Expenses Remain Stable,89666,25791.0,55705,81496.0,8170.0,9.11,-0.02,High Risk
U875,2024,3,235367.0,Salary Increases & Fixed Expenses Remain Stable,89666,25791.0,61544,87335.0,2331.0,2.6,-0.03,High Risk
U875,2024,4,237698.0,Salary Increases & Fixed Expenses Remain Stable,89666,25791.0,62237,88028.0,1638.0,1.83,0.02,High Risk
U875,2024,5,239336.0,Salary Increases & Fixed Expenses Remain Stable,89666,25791.0,66558,92349.0,-2683.0,-2.99,0.03,High Risk
U875,2024,6,236653.0,Salary Increases & Fixed Expenses Remain Stable,89666,25791.0,54136,79927.0,9739.0,10.86,-0.05,High Risk
U875,2024,7,246392.0,Salary Increases & Fixed Expenses Remain Stable,89666,25791.0,70898,96689.0,-7023.0,-7.83,-0.01,High Risk
U875,2024,8,239369.0,Salary Increases & Fixed Expenses Remain Stable,119664,25791.0,85841,111632.0,8032.0,6.71,-0.01,High Risk
U875,2024,9,247401.0,Salary Increases & Fixed Expenses Remain Stable,119664,25791.0,87136,112927.0,6737.0,5.63,-0.0,High Risk
U875,2024,10,254138.0,Salary Increases & Fixed Expenses Remain Stable,119664,25791.0,91571,117362.0,2302.0,1.92,0.04,High Risk
U875,2024,11,256440.0,Salary Increases & Fixed Expenses Remain Stable,119664,25791.0,85099,110890.0,8774.0,7.33,-0.01,High Risk
U875,2024,12,265214.0,Salary Increases & Fixed Expenses Remain Stable,119664,25791.0,76435,102226.0,17438.0,14.57,0.0,High Risk
U876,2024,1,246734.0,Salary Increases & Fixed Expenses Remain Stable,265053,67747.0,132245,199992.0,65061.0,24.55,-0.04,Medium Risk
U876,2024,2,311795.0,Salary Increases & Fixed Expenses Remain Stable,265053,67747.0,144502,212249.0,52804.0,19.92,0.05,Medium Risk
U876,2024,3,364599.0,Salary Increases & Fixed Expenses Remain Stable,265053,67747.0,155404,223151.0,41902.0,15.81,0.01,Medium Risk
U876,2024,4,406501.0,Salary Increases & Fixed Expenses Remain Stable,265053,67747.0,149973,217720.0,47333.0,17.86,0.01,Medium Risk
U876,2024,5,453834.0,Salary Increases & Fixed Expenses Remain Stable,265053,67747.0,124797,192544.0,72509.0,27.36,0.03,Low Risk
U876,2024,6,526343.0,Salary Increases & Fixed Expenses Remain Stable,265053,67747.0,123963,191710.0,73343.0,27.67,0.0,Low Risk
U876,2024,7,599686.0,Salary Increases & Fixed Expenses Remain Stable,265053,67747.0,120275,188022.0,77031.0,29.06,-0.02,Low Risk
U876,2024,8,676717.0,Salary Increases & Fixed Expenses Remain Stable,294690,67747.0,121011,188758.0,105932.0,35.95,-0.01,Low Risk
U876,2024,9,782649.0,Salary Increases & Fixed Expenses Remain Stable,294690,67747.0,170813,238560.0,56130.0,19.05,0.03,Medium Risk
U876,2024,10,838779.0,Salary Increases & Fixed Expenses Remain Stable,294690,67747.0,146388,214135.0,80555.0,27.34,0.01,Low Risk
U876,2024,11,919334.0,Salary Increases & Fixed Expenses Remain Stable,294690,67747.0,123113,190860.0,103830.0,35.23,0.0,Low Risk
U876,2024,12,1023164.0,Salary Increases & Fixed Expenses Remain Stable,294690,67747.0,126397,194144.0,100546.0,34.12,0.02,Low Risk
U877,2024,1,205169.0,Stable Salary & Decreasing Fixed Expenses,32064,10453.0,14926,25379.0,6685.0,20.85,0.05,Medium Risk
U877,2024,2,211854.0,Stable Salary & Decreasing Fixed Expenses,32064,10453.0,17079,27532.0,4532.0,14.13,-0.01,High Risk
U877,2024,3,216386.0,Stable Salary & Decreasing Fixed Expenses,32064,10453.0,15499,25952.0,6112.0,19.06,0.05,Medium Risk
U877,2024,4,222498.0,Stable Salary & Decreasing Fixed Expenses,32064,10453.0,15873,26326.0,5738.0,17.9,0.05,Medium Risk
U877,2024,5,228236.0,Stable Salary & Decreasing Fixed Expenses,32064,10453.0,17075,27528.0,4536.0,14.15,0.0,High Risk
U877,2024,6,232772.0,Stable Salary & Decreasing Fixed Expenses,32064,10453.0,16721,27174.0,4890.0,15.25,0.02,Medium Risk
U877,2024,7,237662.0,Stable Salary & Decreasing Fixed Expenses,32064,10453.0,16264,26717.0,5347.0,16.68,-0.01,Medium Risk
U877,2024,8,243009.0,Stable Salary & Decreasing Fixed Expenses,32064,10453.0,15149,25602.0,6462.0,20.15,0.0,Medium Risk
U877,2024,9,249471.0,Stable Salary & Decreasing Fixed Expenses,32064,9407.7,16351,25758.7,6305.299999999999,19.66,-0.03,Medium Risk
U877,2024,10,255776.3,Stable Salary & Decreasing Fixed Expenses,32064,9407.7,19270,28677.7,3386.2999999999993,10.56,0.02,High Risk
U877,2024,11,259162.59999999998,Stable Salary & Decreasing Fixed Expenses,32064,9407.7,15202,24609.7,7454.299999999999,23.25,-0.03,Medium Risk
U877,2024,12,266616.89999999997,Stable Salary & Decreasing Fixed Expenses,32064,9407.7,17699,27106.7,4957.299999999999,15.46,0.03,Medium Risk
U878,2024,1,228913.0,Salary Increases & Fixed Expenses Remain Stable,266595,110796.0,118338,229134.0,37461.0,14.05,-0.02,High Risk
U878,2024,2,266374.0,Salary Increases & Fixed Expenses Remain Stable,266595,110796.0,122739,233535.0,33060.0,12.4,-0.03,High Risk
U878,2024,3,299434.0,Salary Increases & Fixed Expenses Remain Stable,266595,110796.0,121911,232707.0,33888.0,12.71,0.02,High Risk
U878,2024,4,333322.0,Salary Increases & Fixed Expenses Remain Stable,266595,110796.0,142902,253698.0,12897.0,4.84,0.01,High Risk
U878,2024,5,346219.0,Salary Increases & Fixed Expenses Remain Stable,266595,110796.0,141779,252575.0,14020.0,5.26,0.04,High Risk
U878,2024,6,360239.0,Salary Increases & Fixed Expenses Remain Stable,266595,110796.0,113409,224205.0,42390.0,15.9,0.02,Medium Risk
U878,2024,7,402629.0,Salary Increases & Fixed Expenses Remain Stable,266595,110796.0,108036,218832.0,47763.0,17.92,-0.01,Medium Risk
U878,2024,8,450392.0,Salary Increases & Fixed Expenses Remain Stable,278398,110796.0,162743,273539.0,4859.0,1.75,0.03,High Risk
U878,2024,9,455251.0,Salary Increases & Fixed Expenses Remain Stable,278398,110796.0,135127,245923.0,32475.0,11.66,-0.02,High Risk
U878,2024,10,487726.0,Salary Increases & Fixed Expenses Remain Stable,278398,110796.0,156053,266849.0,11549.0,4.15,0.02,High Risk
U878,2024,11,499275.0,Salary Increases & Fixed Expenses Remain Stable,278398,110796.0,131074,241870.0,36528.0,13.12,0.04,High Risk
U878,2024,12,535803.0,Salary Increases & Fixed Expenses Remain Stable,278398,110796.0,146171,256967.0,21431.0,7.7,-0.02,High Risk
U879,2024,1,202296.0,Stable Salary & Increasing Fixed Expenses,157919,53979.0,52801,106780.0,51139.0,32.38,-0.03,Low Risk
U879,2024,2,253435.0,Stable Salary & Increasing Fixed Expenses,157919,53979.0,48282,102261.0,55658.0,35.24,-0.04,Low Risk
U879,2024,3,309093.0,Stable Salary & Increasing Fixed Expenses,157919,53979.0,61568,115547.0,42372.0,26.83,-0.05,Low Risk
U879,2024,4,351465.0,Stable Salary & Increasing Fixed Expenses,157919,53979.0,55703,109682.0,48237.0,30.55,-0.04,Low Risk
U879,2024,5,399702.0,Stable Salary & Increasing Fixed Expenses,157919,53979.0,48025,102004.0,55915.0,35.41,0.0,Low Risk
U879,2024,6,455617.0,Stable Salary & Increasing Fixed Expenses,157919,53979.0,49786,103765.0,54154.0,34.29,-0.03,Low Risk
U879,2024,7,509771.0,Stable Salary & Increasing Fixed Expenses,157919,55828.0,57747,113575.0,44344.0,28.08,0.02,Low Risk
U879,2024,8,554115.0,Stable Salary & Increasing Fixed Expenses,157919,55828.0,49639,105467.0,52452.0,33.21,0.04,Low Risk
U879,2024,9,606567.0,Stable Salary & Increasing Fixed Expenses,157919,55828.0,50070,105898.0,52021.0,32.94,-0.02,Low Risk
U879,2024,10,658588.0,Stable Salary & Increasing Fixed Expenses,157919,55828.0,57196,113024.0,44895.0,28.43,-0.04,Low Risk
U879,2024,11,703483.0,Stable Salary & Increasing Fixed Expenses,157919,55828.0,54597,110425.0,47494.0,30.07,0.03,Low Risk
U879,2024,12,750977.0,Stable Salary & Increasing Fixed Expenses,157919,55828.0,50335,106163.0,51756.0,32.77,-0.02,Low Risk
U880,2024,1,224705.0,Stable Salary & Stable Fixed Expenses,216275,82493.0,139312,221805.0,-5530.0,-2.56,0.03,High Risk
U880,2024,2,219175.0,Stable Salary & Stable Fixed Expenses,216275,82493.0,169112,251605.0,-35330.0,-16.34,0.04,High Risk
U880,2024,3,183845.0,Stable Salary & Stable Fixed Expenses,216275,82493.0,164117,246610.0,-30335.0,-14.03,-0.02,High Risk
U880,2024,4,153510.0,Stable Salary & Stable Fixed Expenses,216275,82493.0,150232,232725.0,-16450.0,-7.61,-0.01,High Risk
U880,2024,5,137060.0,Stable Salary & Stable Fixed Expenses,216275,82493.0,141503,223996.0,-7721.0,-3.57,-0.04,High Risk
U880,2024,6,129339.0,Stable Salary & Stable Fixed Expenses,216275,82493.0,139050,221543.0,-5268.0,-2.44,-0.01,High Risk
U880,2024,7,124071.0,Stable Salary & Stable Fixed Expenses,216275,82493.0,139714,222207.0,-5932.0,-2.74,0.02,High Risk
U880,2024,8,118139.0,Stable Salary & Stable Fixed Expenses,216275,82493.0,162729,245222.0,-28947.0,-13.38,-0.02,High Risk
U880,2024,9,89192.0,Stable Salary & Stable Fixed Expenses,216275,82493.0,153195,235688.0,-19413.0,-8.98,0.02,High Risk
U880,2024,10,69779.0,Stable Salary & Stable Fixed Expenses,216275,82493.0,191054,273547.0,-57272.0,-26.48,0.04,High Risk
U880,2024,11,12507.0,Stable Salary & Stable Fixed Expenses,216275,82493.0,142105,224598.0,-8323.0,-3.85,-0.04,High Risk
U880,2024,12,4184.0,Stable Salary & Stable Fixed Expenses,216275,82493.0,143560,226053.0,-9778.0,-4.52,0.03,High Risk
U881,2024,1,224118.0,Salary Increases & Fixed Expenses Decrease,158094,61800.0,63870,125670.0,32424.0,20.51,-0.03,Medium Risk
U881,2024,2,256542.0,Salary Increases & Fixed Expenses Decrease,158094,61800.0,67046,128846.0,29248.0,18.5,-0.03,Medium Risk
U881,2024,3,285790.0,Salary Increases & Fixed Expenses Decrease,158094,61800.0,99376,161176.0,-3082.0,-1.95,0.03,High Risk
U881,2024,4,282708.0,Salary Increases & Fixed Expenses Decrease,158094,61800.0,76994,138794.0,19300.0,12.21,0.04,High Risk
U881,2024,5,302008.0,Salary Increases & Fixed Expenses Decrease,158094,61800.0,94110,155910.0,2184.0,1.38,0.04,High Risk
U881,2024,6,304192.0,Salary Increases & Fixed Expenses Decrease,158094,61800.0,78565,140365.0,17729.0,11.21,0.04,High Risk
U881,2024,7,321921.0,Salary Increases & Fixed Expenses Decrease,180509,61800.0,89182,150982.0,29527.0,16.36,0.03,Medium Risk
U881,2024,8,351448.0,Salary Increases & Fixed Expenses Decrease,180509,61800.0,86025,147825.0,32684.0,18.11,-0.01,Medium Risk
U881,2024,9,384132.0,Salary Increases & Fixed Expenses Decrease,180509,61800.0,104397,166197.0,14312.0,7.93,0.05,High Risk
U881,2024,10,398444.0,Salary Increases & Fixed Expenses Decrease,180509,61800.0,131597,193397.0,-12888.0,-7.14,-0.02,High Risk
U881,2024,11,385556.0,Salary Increases & Fixed Expenses Decrease,180509,61800.0,99239,161039.0,19470.0,10.79,-0.02,High Risk
U881,2024,12,405026.0,Salary Increases & Fixed Expenses Decrease,180509,61800.0,96578,158378.0,22131.0,12.26,0.04,High Risk
U882,2024,1,247106.0,Stable Salary & Increasing Fixed Expenses,225486,94917.0,156076,250993.0,-25507.0,-11.31,-0.01,High Risk
U882,2024,2,221599.0,Stable Salary & Increasing Fixed Expenses,225486,94917.0,157149,252066.0,-26580.0,-11.79,0.05,High Risk
U882,2024,3,195019.0,Stable Salary & Increasing Fixed Expenses,225486,94917.0,202057,296974.0,-71488.0,-31.7,-0.01,High Risk
U882,2024,4,123531.0,Stable Salary & Increasing Fixed Expenses,225486,96147.0,141162,237309.0,-11823.0,-5.24,0.04,High Risk
U882,2024,5,111708.0,Stable Salary & Increasing Fixed Expenses,225486,96147.0,172026,268173.0,-42687.0,-18.93,-0.01,High Risk
U882,2024,6,69021.0,Stable Salary & Increasing Fixed Expenses,225486,96147.0,164159,260306.0,-34820.0,-15.44,0.01,High Risk
U882,2024,7,34201.0,Stable Salary & Increasing Fixed Expenses,225486,96147.0,135501,231648.0,-6162.0,-2.73,0.04,High Risk
U882,2024,8,28039.0,Stable Salary & Increasing Fixed Expenses,225486,96147.0,151515,247662.0,-22176.0,-9.83,-0.02,High Risk
U882,2024,9,5863.0,Stable Salary & Increasing Fixed Expenses,225486,96147.0,170146,266293.0,-40807.0,-18.1,-0.02,High Risk
U882,2024,10,-34944.0,Stable Salary & Increasing Fixed Expenses,225486,96147.0,187465,283612.0,-58126.0,-25.78,-0.01,High Risk
U882,2024,11,-93070.0,Stable Salary & Increasing Fixed Expenses,225486,97061.0,137507,234568.0,-9082.0,-4.03,0.02,High Risk
U882,2024,12,-102152.0,Stable Salary & Increasing Fixed Expenses,225486,97061.0,161150,258211.0,-32725.0,-14.51,0.04,High Risk
U883,2024,1,240028.0,Salary Increases & Fixed Expenses Remain Stable,52110,38210.0,24029,62239.0,-10129.0,-19.44,0.01,High Risk
U883,2024,2,229899.0,Salary Increases & Fixed Expenses Remain Stable,52110,38210.0,22064,60274.0,-8164.0,-15.67,-0.01,High Risk
U883,2024,3,221735.0,Salary Increases & Fixed Expenses Remain Stable,52110,38210.0,30407,68617.0,-16507.0,-31.68,0.02,High Risk
U883,2024,4,205228.0,Salary Increases & Fixed Expenses Remain Stable,52110,38210.0,26708,64918.0,-12808.0,-24.58,-0.02,High Risk
U883,2024,5,192420.0,Salary Increases & Fixed Expenses Remain Stable,52110,38210.0,29746,67956.0,-15846.0,-30.41,0.03,High Risk
U883,2024,6,176574.0,Salary Increases & Fixed Expenses Remain Stable,80880,38210.0,36832,75042.0,5838.0,7.22,-0.03,High Risk
U883,2024,7,182412.0,Salary Increases & Fixed Expenses Remain Stable,80880,38210.0,47323,85533.0,-4653.0,-5.75,0.04,High Risk
U883,2024,8,177759.0,Salary Increases & Fixed Expenses Remain Stable,80880,38210.0,44415,82625.0,-1745.0,-2.16,0.02,High Risk
U883,2024,9,176014.0,Salary Increases & Fixed Expenses Remain Stable,80880,38210.0,47099,85309.0,-4429.0,-5.48,-0.01,High Risk
U883,2024,10,171585.0,Salary Increases & Fixed Expenses Remain Stable,80880,38210.0,46643,84853.0,-3973.0,-4.91,-0.03,High Risk
U883,2024,11,167612.0,Salary Increases & Fixed Expenses Remain Stable,80880,38210.0,38618,76828.0,4052.0,5.01,0.05,High Risk
U883,2024,12,171664.0,Salary Increases & Fixed Expenses Remain Stable,80880,38210.0,50589,88799.0,-7919.0,-9.79,0.05,High Risk
U884,2024,1,213322.0,Stable Salary & Decreasing Fixed Expenses,200383,103760.0,68753,172513.0,27870.0,13.91,0.03,High Risk
U884,2024,2,241192.0,Stable Salary & Decreasing Fixed Expenses,200383,103760.0,63536,167296.0,33087.0,16.51,0.04,Medium Risk
U884,2024,3,274279.0,Stable Salary & Decreasing Fixed Expenses,200383,103760.0,87748,191508.0,8875.0,4.43,-0.01,High Risk
U884,2024,4,283154.0,Stable Salary & Decreasing Fixed Expenses,200383,103760.0,69363,173123.0,27260.0,13.6,-0.02,High Risk
U884,2024,5,310414.0,Stable Salary & Decreasing Fixed Expenses,200383,103760.0,74369,178129.0,22254.0,11.11,0.0,High Risk
U884,2024,6,332668.0,Stable Salary & Decreasing Fixed Expenses,200383,103760.0,65799,169559.0,30824.0,15.38,0.04,Medium Risk
U884,2024,7,363492.0,Stable Salary & Decreasing Fixed Expenses,200383,103760.0,79528,183288.0,17095.0,8.53,0.03,High Risk
U884,2024,8,380587.0,Stable Salary & Decreasing Fixed Expenses,200383,103760.0,72040,175800.0,24583.0,12.27,0.02,High Risk
U884,2024,9,405170.0,Stable Salary & Decreasing Fixed Expenses,200383,103760.0,80057,183817.0,16566.0,8.27,0.04,High Risk
U884,2024,10,421736.0,Stable Salary & Decreasing Fixed Expenses,200383,103760.0,93703,197463.0,2920.0,1.46,-0.03,High Risk
U884,2024,11,424656.0,Stable Salary & Decreasing Fixed Expenses,200383,103760.0,79485,183245.0,17138.0,8.55,0.04,High Risk
U884,2024,12,441794.0,Stable Salary & Decreasing Fixed Expenses,200383,103760.0,71160,174920.0,25463.0,12.71,0.05,High Risk
U885,2024,1,236120.0,Stable Salary & Decreasing Fixed Expenses,151140,40617.0,55918,96535.0,54605.0,36.13,0.05,Low Risk
U885,2024,2,290725.0,Stable Salary & Decreasing Fixed Expenses,151140,40617.0,55790,96407.0,54733.0,36.21,-0.01,Low Risk
U885,2024,3,345458.0,Stable Salary & Decreasing Fixed Expenses,151140,40617.0,50208,90825.0,60315.0,39.91,0.04,Low Risk
U885,2024,4,405773.0,Stable Salary & Decreasing Fixed Expenses,151140,40617.0,55636,96253.0,54887.0,36.32,-0.03,Low Risk
U885,2024,5,460660.0,Stable Salary & Decreasing Fixed Expenses,151140,40617.0,56252,96869.0,54271.0,35.91,0.03,Low Risk
U885,2024,6,514931.0,Stable Salary & Decreasing Fixed Expenses,151140,40617.0,59845,100462.0,50678.0,33.53,0.0,Low Risk
U885,2024,7,565609.0,Stable Salary & Decreasing Fixed Expenses,151140,38696.0,51185,89881.0,61259.0,40.53,-0.04,Low Risk
U885,2024,8,626868.0,Stable Salary & Decreasing Fixed Expenses,151140,38696.0,57808,96504.0,54636.0,36.15,-0.04,Low Risk
U885,2024,9,681504.0,Stable Salary & Decreasing Fixed Expenses,151140,38696.0,52396,91092.0,60048.0,39.73,0.0,Low Risk
U885,2024,10,741552.0,Stable Salary & Decreasing Fixed Expenses,151140,38696.0,46511,85207.0,65933.0,43.62,0.0,Low Risk
U885,2024,11,807485.0,Stable Salary & Decreasing Fixed Expenses,151140,38696.0,56082,94778.0,56362.0,37.29,-0.01,Low Risk
U885,2024,12,863847.0,Stable Salary & Decreasing Fixed Expenses,151140,38696.0,56472,95168.0,55972.0,37.03,-0.0,Low Risk
U886,2024,1,228770.0,Salary Increases & Fixed Expenses Remain Stable,95496,38870.0,37229,76099.0,19397.0,20.31,0.02,Medium Risk
U886,2024,2,248167.0,Salary Increases & Fixed Expenses Remain Stable,95496,38870.0,33733,72603.0,22893.0,23.97,-0.04,Medium Risk
U886,2024,3,271060.0,Salary Increases & Fixed Expenses Remain Stable,95496,38870.0,37129,75999.0,19497.0,20.42,-0.03,Medium Risk
U886,2024,4,290557.0,Salary Increases & Fixed Expenses Remain Stable,95496,38870.0,35770,74640.0,20856.0,21.84,-0.05,Medium Risk
U886,2024,5,311413.0,Salary Increases & Fixed Expenses Remain Stable,95496,38870.0,33328,72198.0,23298.0,24.4,-0.0,Medium Risk
U886,2024,6,334711.0,Salary Increases & Fixed Expenses Remain Stable,112679,38870.0,41259,80129.0,32550.0,28.89,0.02,Low Risk
U886,2024,7,367261.0,Salary Increases & Fixed Expenses Remain Stable,112679,38870.0,43549,82419.0,30260.0,26.86,-0.04,Low Risk
U886,2024,8,397521.0,Salary Increases & Fixed Expenses Remain Stable,112679,38870.0,39757,78627.0,34052.0,30.22,-0.01,Low Risk
U886,2024,9,431573.0,Salary Increases & Fixed Expenses Remain Stable,112679,38870.0,39262,78132.0,34547.0,30.66,0.05,Low Risk
U886,2024,10,466120.0,Salary Increases & Fixed Expenses Remain Stable,112679,38870.0,48527,87397.0,25282.0,22.44,-0.01,Medium Risk
U886,2024,11,491402.0,Salary Increases & Fixed Expenses Remain Stable,112679,38870.0,34821,73691.0,38988.0,34.6,-0.05,Low Risk
U886,2024,12,530390.0,Salary Increases & Fixed Expenses Remain Stable,112679,38870.0,43661,82531.0,30148.0,26.76,0.02,Low Risk
U887,2024,1,245440.0,Stable Salary & Stable Fixed Expenses,126603,72452.0,94159,166611.0,-40008.0,-31.6,-0.02,High Risk
U887,2024,2,205432.0,Stable Salary & Stable Fixed Expenses,126603,72452.0,98650,171102.0,-44499.0,-35.15,-0.01,High Risk
U887,2024,3,160933.0,Stable Salary & Stable Fixed Expenses,126603,72452.0,96480,168932.0,-42329.0,-33.43,-0.05,High Risk
U887,2024,4,118604.0,Stable Salary & Stable Fixed Expenses,126603,72452.0,92196,164648.0,-38045.0,-30.05,-0.04,High Risk
U887,2024,5,80559.0,Stable Salary & Stable Fixed Expenses,126603,72452.0,92589,165041.0,-38438.0,-30.36,0.02,High Risk
U887,2024,6,42121.0,Stable Salary & Stable Fixed Expenses,126603,72452.0,82109,154561.0,-27958.0,-22.08,-0.02,High Risk
U887,2024,7,14163.0,Stable Salary & Stable Fixed Expenses,126603,72452.0,76147,148599.0,-21996.0,-17.37,-0.0,High Risk
U887,2024,8,-7833.0,Stable Salary & Stable Fixed Expenses,126603,72452.0,90062,162514.0,-35911.0,-28.37,-0.04,High Risk
U887,2024,9,-43744.0,Stable Salary & Stable Fixed Expenses,126603,72452.0,98624,171076.0,-44473.0,-35.13,0.01,High Risk
U887,2024,10,-88217.0,Stable Salary & Stable Fixed Expenses,126603,72452.0,85706,158158.0,-31555.0,-24.92,0.01,High Risk
U887,2024,11,-119772.0,Stable Salary & Stable Fixed Expenses,126603,72452.0,94993,167445.0,-40842.0,-32.26,0.05,High Risk
U887,2024,12,-160614.0,Stable Salary & Stable Fixed Expenses,126603,72452.0,98540,170992.0,-44389.0,-35.06,0.02,High Risk
U888,2024,1,204519.0,Salary Increases & Fixed Expenses Increase,24507,21207.0,19248,40455.0,-15948.0,-65.08,-0.01,High Risk
U888,2024,2,188571.0,Salary Increases & Fixed Expenses Increase,24507,21207.0,17703,38910.0,-14403.0,-58.77,-0.03,High Risk
U888,2024,3,174168.0,Salary Increases & Fixed Expenses Increase,24507,23082.0,15574,38656.0,-14149.0,-57.73,-0.04,High Risk
U888,2024,4,160019.0,Salary Increases & Fixed Expenses Increase,42078,23082.0,28560,51642.0,-9564.0,-22.73,-0.03,High Risk
U888,2024,5,150455.0,Salary Increases & Fixed Expenses Increase,42078,23082.0,27264,50346.0,-8268.0,-19.65,0.04,High Risk
U888,2024,6,142187.0,Salary Increases & Fixed Expenses Increase,42078,23082.0,33013,56095.0,-14017.0,-33.31,-0.03,High Risk
U888,2024,7,128170.0,Salary Increases & Fixed Expenses Increase,42078,23082.0,31120,54202.0,-12124.0,-28.81,0.04,High Risk
U888,2024,8,116046.0,Salary Increases & Fixed Expenses Increase,42078,23082.0,32589,55671.0,-13593.0,-32.3,0.04,High Risk
U888,2024,9,102453.0,Salary Increases & Fixed Expenses Increase,42078,23082.0,25775,48857.0,-6779.0,-16.11,-0.03,High Risk
U888,2024,10,95674.0,Salary Increases & Fixed Expenses Increase,42078,23082.0,27071,50153.0,-8075.0,-19.19,-0.02,High Risk
U888,2024,11,87599.0,Salary Increases & Fixed Expenses Increase,42078,23082.0,27711,50793.0,-8715.0,-20.71,-0.02,High Risk
U888,2024,12,78884.0,Salary Increases & Fixed Expenses Increase,42078,23082.0,27164,50246.0,-8168.0,-19.41,0.03,High Risk
U889,2024,1,210522.0,Salary Increases & Fixed Expenses Remain Stable,138682,44718.0,58820,103538.0,35144.0,25.34,0.04,Low Risk
U889,2024,2,245666.0,Salary Increases & Fixed Expenses Remain Stable,138682,44718.0,82152,126870.0,11812.0,8.52,-0.05,High Risk
U889,2024,3,257478.0,Salary Increases & Fixed Expenses Remain Stable,138682,44718.0,57981,102699.0,35983.0,25.95,0.03,Low Risk
U889,2024,4,293461.0,Salary Increases & Fixed Expenses Remain Stable,138682,44718.0,70274,114992.0,23690.0,17.08,-0.01,Medium Risk
U889,2024,5,317151.0,Salary Increases & Fixed Expenses Remain Stable,160841,44718.0,88427,133145.0,27696.0,17.22,0.05,Medium Risk
U889,2024,6,344847.0,Salary Increases & Fixed Expenses Remain Stable,160841,44718.0,72466,117184.0,43657.0,27.14,0.05,Low Risk
U889,2024,7,388504.0,Salary Increases & Fixed Expenses Remain Stable,160841,44718.0,88682,133400.0,27441.0,17.06,-0.01,Medium Risk
U889,2024,8,415945.0,Salary Increases & Fixed Expenses Remain Stable,160841,44718.0,70414,115132.0,45709.0,28.42,-0.01,Low Risk
U889,2024,9,461654.0,Salary Increases & Fixed Expenses Remain Stable,160841,44718.0,65222,109940.0,50901.0,31.65,-0.04,Low Risk
U889,2024,10,512555.0,Salary Increases & Fixed Expenses Remain Stable,160841,44718.0,95163,139881.0,20960.0,13.03,-0.04,High Risk
U889,2024,11,533515.0,Salary Increases & Fixed Expenses Remain Stable,160841,44718.0,66446,111164.0,49677.0,30.89,-0.01,Low Risk
U889,2024,12,583192.0,Salary Increases & Fixed Expenses Remain Stable,160841,44718.0,91627,136345.0,24496.0,15.23,0.03,Medium Risk
U890,2024,1,219358.0,Stable Salary & Stable Fixed Expenses,68782,27110.0,21699,48809.0,19973.0,29.04,-0.02,Low Risk
U890,2024,2,239331.0,Stable Salary & Stable Fixed Expenses,68782,27110.0,24873,51983.0,16799.0,24.42,-0.0,Medium Risk
U890,2024,3,256130.0,Stable Salary & Stable Fixed Expenses,68782,27110.0,31924,59034.0,9748.0,14.17,-0.0,High Risk
U890,2024,4,265878.0,Stable Salary & Stable Fixed Expenses,68782,27110.0,24541,51651.0,17131.0,24.91,-0.03,Medium Risk
U890,2024,5,283009.0,Stable Salary & Stable Fixed Expenses,68782,27110.0,21303,48413.0,20369.0,29.61,-0.05,Low Risk
U890,2024,6,303378.0,Stable Salary & Stable Fixed Expenses,68782,27110.0,22826,49936.0,18846.0,27.4,0.02,Low Risk
U890,2024,7,322224.0,Stable Salary & Stable Fixed Expenses,68782,27110.0,21128,48238.0,20544.0,29.87,-0.02,Low Risk
U890,2024,8,342768.0,Stable Salary & Stable Fixed Expenses,68782,27110.0,25084,52194.0,16588.0,24.12,-0.05,Medium Risk
U890,2024,9,359356.0,Stable Salary & Stable Fixed Expenses,68782,27110.0,23406,50516.0,18266.0,26.56,0.01,Low Risk
U890,2024,10,377622.0,Stable Salary & Stable Fixed Expenses,68782,27110.0,30635,57745.0,11037.0,16.05,0.01,Medium Risk
U890,2024,11,388659.0,Stable Salary & Stable Fixed Expenses,68782,27110.0,24097,51207.0,17575.0,25.55,0.01,Low Risk
U890,2024,12,406234.0,Stable Salary & Stable Fixed Expenses,68782,27110.0,23718,50828.0,17954.0,26.1,-0.0,Low Risk
U891,2024,1,232932.0,Stable Salary & Stable Fixed Expenses,131420,42302.0,60848,103150.0,28270.0,21.51,-0.02,Medium Risk
U891,2024,2,261202.0,Stable Salary & Stable Fixed Expenses,131420,42302.0,69872,112174.0,19246.0,14.64,-0.01,High Risk
U891,2024,3,280448.0,Stable Salary & Stable Fixed Expenses,131420,42302.0,69779,112081.0,19339.0,14.72,-0.01,High Risk
U891,2024,4,299787.0,Stable Salary & Stable Fixed Expenses,131420,42302.0,65261,107563.0,23857.0,18.15,-0.04,Medium Risk
U891,2024,5,323644.0,Stable Salary & Stable Fixed Expenses,131420,42302.0,65340,107642.0,23778.0,18.09,0.04,Medium Risk
U891,2024,6,347422.0,Stable Salary & Stable Fixed Expenses,131420,42302.0,71309,113611.0,17809.0,13.55,-0.03,High Risk
U891,2024,7,365231.0,Stable Salary & Stable Fixed Expenses,131420,42302.0,70084,112386.0,19034.0,14.48,0.0,High Risk
U891,2024,8,384265.0,Stable Salary & Stable Fixed Expenses,131420,42302.0,71580,113882.0,17538.0,13.35,0.03,High Risk
U891,2024,9,401803.0,Stable Salary & Stable Fixed Expenses,131420,42302.0,71571,113873.0,17547.0,13.35,0.04,High Risk
U891,2024,10,419350.0,Stable Salary & Stable Fixed Expenses,131420,42302.0,64961,107263.0,24157.0,18.38,0.04,Medium Risk
U891,2024,11,443507.0,Stable Salary & Stable Fixed Expenses,131420,42302.0,58047,100349.0,31071.0,23.64,0.04,Medium Risk
U891,2024,12,474578.0,Stable Salary & Stable Fixed Expenses,131420,42302.0,63904,106206.0,25214.0,19.19,0.04,Medium Risk
U892,2024,1,228992.0,Salary Increases & Fixed Expenses Decrease,38077,15564.0,20251,35815.0,2262.0,5.94,0.05,High Risk
U892,2024,2,231254.0,Salary Increases & Fixed Expenses Decrease,38077,15564.0,21902,37466.0,611.0,1.6,0.05,High Risk
U892,2024,3,231865.0,Salary Increases & Fixed Expenses Decrease,64424,15564.0,41465,57029.0,7395.0,11.48,0.03,High Risk
U892,2024,4,239260.0,Salary Increases & Fixed Expenses Decrease,64424,15564.0,32403,47967.0,16457.0,25.54,0.05,Low Risk
U892,2024,5,255717.0,Salary Increases & Fixed Expenses Decrease,64424,15564.0,30094,45658.0,18766.0,29.13,0.0,Low Risk
U892,2024,6,274483.0,Salary Increases & Fixed Expenses Decrease,64424,15564.0,35340,50904.0,13520.0,20.99,-0.04,Medium Risk
U892,2024,7,288003.0,Salary Increases & Fixed Expenses Decrease,64424,15564.0,36270,51834.0,12590.0,19.54,0.02,Medium Risk
U892,2024,8,300593.0,Salary Increases & Fixed Expenses Decrease,64424,15564.0,33964,49528.0,14896.0,23.12,0.05,Medium Risk
U892,2024,9,315489.0,Salary Increases & Fixed Expenses Decrease,64424,15564.0,29112,44676.0,19748.0,30.65,-0.03,Low Risk
U892,2024,10,335237.0,Salary Increases & Fixed Expenses Decrease,64424,15564.0,45696,61260.0,3164.0,4.91,0.02,High Risk
U892,2024,11,338401.0,Salary Increases & Fixed Expenses Decrease,64424,15564.0,32380,47944.0,16480.0,25.58,0.02,Low Risk
U892,2024,12,354881.0,Salary Increases & Fixed Expenses Decrease,64424,15564.0,35740,51304.0,13120.0,20.37,-0.01,Medium Risk
U893,2024,1,210559.0,Stable Salary & Stable Fixed Expenses,25047,11584.0,12893,24477.0,570.0,2.28,-0.0,High Risk
U893,2024,2,211129.0,Stable Salary & Stable Fixed Expenses,25047,11584.0,12968,24552.0,495.0,1.98,0.0,High Risk
U893,2024,3,211624.0,Stable Salary & Stable Fixed Expenses,25047,11584.0,13826,25410.0,-363.0,-1.45,-0.03,High Risk
U893,2024,4,211261.0,Stable Salary & Stable Fixed Expenses,25047,11584.0,11335,22919.0,2128.0,8.5,-0.02,High Risk
U893,2024,5,213389.0,Stable Salary & Stable Fixed Expenses,25047,11584.0,10838,22422.0,2625.0,10.48,0.01,High Risk
U893,2024,6,216014.0,Stable Salary & Stable Fixed Expenses,25047,11584.0,12596,24180.0,867.0,3.46,0.03,High Risk
U893,2024,7,216881.0,Stable Salary & Stable Fixed Expenses,25047,11584.0,10541,22125.0,2922.0,11.67,0.01,High Risk
U893,2024,8,219803.0,Stable Salary & Stable Fixed Expenses,25047,11584.0,11683,23267.0,1780.0,7.11,0.01,High Risk
U893,2024,9,221583.0,Stable Salary & Stable Fixed Expenses,25047,11584.0,14652,26236.0,-1189.0,-4.75,0.01,High Risk
U893,2024,10,220394.0,Stable Salary & Stable Fixed Expenses,25047,11584.0,15257,26841.0,-1794.0,-7.16,-0.02,High Risk
U893,2024,11,218600.0,Stable Salary & Stable Fixed Expenses,25047,11584.0,10907,22491.0,2556.0,10.2,-0.03,High Risk
U893,2024,12,221156.0,Stable Salary & Stable Fixed Expenses,25047,11584.0,13381,24965.0,82.0,0.33,0.04,High Risk
U894,2024,1,214456.0,Salary Increases & Fixed Expenses Remain Stable,206747,77767.0,104963,182730.0,24017.0,11.62,0.05,High Risk
U894,2024,2,238473.0,Salary Increases & Fixed Expenses Remain Stable,206747,77767.0,119768,197535.0,9212.0,4.46,0.0,High Risk
U894,2024,3,247685.0,Salary Increases & Fixed Expenses Remain Stable,206747,77767.0,124842,202609.0,4138.0,2.0,-0.02,High Risk
U894,2024,4,251823.0,Salary Increases & Fixed Expenses Remain Stable,206747,77767.0,105729,183496.0,23251.0,11.25,0.03,High Risk
U894,2024,5,275074.0,Salary Increases & Fixed Expenses Remain Stable,235462,77767.0,121680,199447.0,36015.0,15.3,0.04,Medium Risk
U894,2024,6,311089.0,Salary Increases & Fixed Expenses Remain Stable,235462,77767.0,120536,198303.0,37159.0,15.78,0.02,Medium Risk
U894,2024,7,348248.0,Salary Increases & Fixed Expenses Remain Stable,235462,77767.0,131875,209642.0,25820.0,10.97,-0.04,High Risk
U894,2024,8,374068.0,Salary Increases & Fixed Expenses Remain Stable,235462,77767.0,106632,184399.0,51063.0,21.69,-0.04,Medium Risk
U894,2024,9,425131.0,Salary Increases & Fixed Expenses Remain Stable,235462,77767.0,116484,194251.0,41211.0,17.5,0.01,Medium Risk
U894,2024,10,466342.0,Salary Increases & Fixed Expenses Remain Stable,235462,77767.0,127651,205418.0,30044.0,12.76,0.03,High Risk
U894,2024,11,496386.0,Salary Increases & Fixed Expenses Remain Stable,235462,77767.0,96932,174699.0,60763.0,25.81,0.01,Low Risk
U894,2024,12,557149.0,Salary Increases & Fixed Expenses Remain Stable,235462,77767.0,117809,195576.0,39886.0,16.94,-0.03,Medium Risk
U895,2024,1,202495.0,Salary Increases & Fixed Expenses Remain Stable,179391,79384.0,66916,146300.0,33091.0,18.45,-0.01,Medium Risk
U895,2024,2,235586.0,Salary Increases & Fixed Expenses Remain Stable,179391,79384.0,55559,134943.0,44448.0,24.78,0.04,Medium Risk
U895,2024,3,280034.0,Salary Increases & Fixed Expenses Remain Stable,179391,79384.0,79455,158839.0,20552.0,11.46,0.02,High Risk
U895,2024,4,300586.0,Salary Increases & Fixed Expenses Remain Stable,179391,79384.0,65527,144911.0,34480.0,19.22,0.05,Medium Risk
U895,2024,5,335066.0,Salary Increases & Fixed Expenses Remain Stable,179391,79384.0,69832,149216.0,30175.0,16.82,0.03,Medium Risk
U895,2024,6,365241.0,Salary Increases & Fixed Expenses Remain Stable,179391,79384.0,63854,143238.0,36153.0,20.15,0.02,Medium Risk
U895,2024,7,401394.0,Salary Increases & Fixed Expenses Remain Stable,179391,79384.0,56429,135813.0,43578.0,24.29,-0.04,Medium Risk
U895,2024,8,444972.0,Salary Increases & Fixed Expenses Remain Stable,199974,79384.0,79703,159087.0,40887.0,20.45,-0.05,Medium Risk
U895,2024,9,485859.0,Salary Increases & Fixed Expenses Remain Stable,199974,79384.0,74700,154084.0,45890.0,22.95,-0.05,Medium Risk
U895,2024,10,531749.0,Salary Increases & Fixed Expenses Remain Stable,199974,79384.0,84538,163922.0,36052.0,18.03,-0.0,Medium Risk
U895,2024,11,567801.0,Salary Increases & Fixed Expenses Remain Stable,199974,79384.0,67847,147231.0,52743.0,26.37,-0.03,Low Risk
U895,2024,12,620544.0,Salary Increases & Fixed Expenses Remain Stable,199974,79384.0,81773,161157.0,38817.0,19.41,0.04,Medium Risk
U896,2024,1,249845.0,Salary Increases & Fixed Expenses Remain Stable,140529,78971.0,45914,124885.0,15644.0,11.13,0.0,High Risk
U896,2024,2,265489.0,Salary Increases & Fixed Expenses Remain Stable,140529,78971.0,48649,127620.0,12909.0,9.19,-0.01,High Risk
U896,2024,3,278398.0,Salary Increases & Fixed Expenses Remain Stable,140529,78971.0,57220,136191.0,4338.0,3.09,-0.04,High Risk
U896,2024,4,282736.0,Salary Increases & Fixed Expenses Remain Stable,149578,78971.0,45632,124603.0,24975.0,16.7,0.03,Medium Risk
U896,2024,5,307711.0,Salary Increases & Fixed Expenses Remain Stable,149578,78971.0,45024,123995.0,25583.0,17.1,-0.04,Medium Risk
U896,2024,6,333294.0,Salary Increases & Fixed Expenses Remain Stable,149578,78971.0,46622,125593.0,23985.0,16.04,-0.04,Medium Risk
U896,2024,7,357279.0,Salary Increases & Fixed Expenses Remain Stable,149578,78971.0,54466,133437.0,16141.0,10.79,-0.01,High Risk
U896,2024,8,373420.0,Salary Increases & Fixed Expenses Remain Stable,149578,78971.0,49219,128190.0,21388.0,14.3,-0.03,High Risk
U896,2024,9,394808.0,Salary Increases & Fixed Expenses Remain Stable,149578,78971.0,65663,144634.0,4944.0,3.31,0.03,High Risk
U896,2024,10,399752.0,Salary Increases & Fixed Expenses Remain Stable,149578,78971.0,71255,150226.0,-648.0,-0.43,-0.03,High Risk
U896,2024,11,399104.0,Salary Increases & Fixed Expenses Remain Stable,149578,78971.0,61257,140228.0,9350.0,6.25,-0.01,High Risk
U896,2024,12,408454.0,Salary Increases & Fixed Expenses Remain Stable,149578,78971.0,61793,140764.0,8814.0,5.89,-0.04,High Risk
U897,2024,1,227894.0,Salary Increases & Fixed Expenses Remain Stable,68141,33311.0,32476,65787.0,2354.0,3.45,-0.01,High Risk
U897,2024,2,230248.0,Salary Increases & Fixed Expenses Remain Stable,68141,33311.0,29734,63045.0,5096.0,7.48,0.03,High Risk
U897,2024,3,235344.0,Salary Increases & Fixed Expenses Remain Stable,68141,33311.0,46123,79434.0,-11293.0,-16.57,0.04,High Risk
U897,2024,4,224051.0,Salary Increases & Fixed Expenses Remain Stable,68141,33311.0,35219,68530.0,-389.0,-0.57,-0.05,High Risk
U897,2024,5,223662.0,Salary Increases & Fixed Expenses Remain Stable,68141,33311.0,33002,66313.0,1828.0,2.68,0.01,High Risk
U897,2024,6,225490.0,Salary Increases & Fixed Expenses Remain Stable,68141,33311.0,36968,70279.0,-2138.0,-3.14,-0.04,High Risk
U897,2024,7,223352.0,Salary Increases & Fixed Expenses Remain Stable,88010,33311.0,49655,82966.0,5044.0,5.73,0.04,High Risk
U897,2024,8,228396.0,Salary Increases & Fixed Expenses Remain Stable,88010,33311.0,36584,69895.0,18115.0,20.58,0.0,Medium Risk
U897,2024,9,246511.0,Salary Increases & Fixed Expenses Remain Stable,88010,33311.0,58604,91915.0,-3905.0,-4.44,0.0,High Risk
U897,2024,10,242606.0,Salary Increases & Fixed Expenses Remain Stable,88010,33311.0,54266,87577.0,433.0,0.49,0.04,High Risk
U897,2024,11,243039.0,Salary Increases & Fixed Expenses Remain Stable,88010,33311.0,43582,76893.0,11117.0,12.63,-0.01,High Risk
U897,2024,12,254156.0,Salary Increases & Fixed Expenses Remain Stable,88010,33311.0,55173,88484.0,-474.0,-0.54,-0.03,High Risk
U898,2024,1,204333.0,Stable Salary & Stable Fixed Expenses,258995,60431.0,100690,161121.0,97874.0,37.79,0.05,Low Risk
U898,2024,2,302207.0,Stable Salary & Stable Fixed Expenses,258995,60431.0,94536,154967.0,104028.0,40.17,-0.02,Low Risk
U898,2024,3,406235.0,Stable Salary & Stable Fixed Expenses,258995,60431.0,123785,184216.0,74779.0,28.87,0.0,Low Risk
U898,2024,4,481014.0,Stable Salary & Stable Fixed Expenses,258995,60431.0,84773,145204.0,113791.0,43.94,0.02,Low Risk
U898,2024,5,594805.0,Stable Salary & Stable Fixed Expenses,258995,60431.0,92107,152538.0,106457.0,41.1,0.03,Low Risk
U898,2024,6,701262.0,Stable Salary & Stable Fixed Expenses,258995,60431.0,83418,143849.0,115146.0,44.46,-0.04,Low Risk
U898,2024,7,816408.0,Stable Salary & Stable Fixed Expenses,258995,60431.0,98010,158441.0,100554.0,38.82,0.04,Low Risk
U898,2024,8,916962.0,Stable Salary & Stable Fixed Expenses,258995,60431.0,90141,150572.0,108423.0,41.86,0.04,Low Risk
U898,2024,9,1025385.0,Stable Salary & Stable Fixed Expenses,258995,60431.0,102746,163177.0,95818.0,37.0,0.0,Low Risk
U898,2024,10,1121203.0,Stable Salary & Stable Fixed Expenses,258995,60431.0,110380,170811.0,88184.0,34.05,-0.01,Low Risk
U898,2024,11,1209387.0,Stable Salary & Stable Fixed Expenses,258995,60431.0,80717,141148.0,117847.0,45.5,-0.03,Low Risk
U898,2024,12,1327234.0,Stable Salary & Stable Fixed Expenses,258995,60431.0,83268,143699.0,115296.0,44.52,-0.03,Low Risk
U899,2024,1,239216.0,Stable Salary & Increasing Fixed Expenses,234902,100699.0,138375,239074.0,-4172.0,-1.78,0.02,High Risk
U899,2024,2,235044.0,Stable Salary & Increasing Fixed Expenses,234902,100699.0,107512,208211.0,26691.0,11.36,0.01,High Risk
U899,2024,3,261735.0,Stable Salary & Increasing Fixed Expenses,234902,100699.0,168203,268902.0,-34000.0,-14.47,0.01,High Risk
U899,2024,4,227735.0,Stable Salary & Increasing Fixed Expenses,234902,100699.0,125676,226375.0,8527.0,3.63,0.02,High Risk
U899,2024,5,236262.0,Stable Salary & Increasing Fixed Expenses,234902,100699.0,139009,239708.0,-4806.0,-2.05,-0.05,High Risk
U899,2024,6,231456.0,Stable Salary & Increasing Fixed Expenses,234902,100699.0,123024,223723.0,11179.0,4.76,-0.01,High Risk
U899,2024,7,242635.0,Stable Salary & Increasing Fixed Expenses,234902,100699.0,108065,208764.0,26138.0,11.13,-0.02,High Risk
U899,2024,8,268773.0,Stable Salary & Increasing Fixed Expenses,234902,100699.0,134063,234762.0,140.0,0.06,0.03,High Risk
U899,2024,9,268913.0,Stable Salary & Increasing Fixed Expenses,234902,100699.0,106932,207631.0,27271.0,11.61,-0.03,High Risk
U899,2024,10,296184.0,Stable Salary & Increasing Fixed Expenses,234902,100699.0,111816,212515.0,22387.0,9.53,-0.01,High Risk
U899,2024,11,318571.0,Stable Salary & Increasing Fixed Expenses,234902,100699.0,108284,208983.0,25919.0,11.03,-0.02,High Risk
U899,2024,12,344490.0,Stable Salary & Increasing Fixed Expenses,234902,100699.0,137675,238374.0,-3472.0,-1.48,0.03,High Risk
U900,2024,1,232852.0,Salary Increases & Fixed Expenses Remain Stable,46075,12368.0,23615,35983.0,10092.0,21.9,0.05,Medium Risk
U900,2024,2,242944.0,Salary Increases & Fixed Expenses Remain Stable,46075,12368.0,22557,34925.0,11150.0,24.2,0.02,Medium Risk
U900,2024,3,254094.0,Salary Increases & Fixed Expenses Remain Stable,46075,12368.0,26025,38393.0,7682.0,16.67,0.05,Medium Risk
U900,2024,4,261776.0,Salary Increases & Fixed Expenses Remain Stable,46075,12368.0,25720,38088.0,7987.0,17.33,0.04,Medium Risk
U900,2024,5,269763.0,Salary Increases & Fixed Expenses Remain Stable,46075,12368.0,19649,32017.0,14058.0,30.51,0.04,Low Risk
U900,2024,6,283821.0,Salary Increases & Fixed Expenses Remain Stable,46075,12368.0,24232,36600.0,9475.0,20.56,-0.02,Medium Risk
U900,2024,7,293296.0,Salary Increases & Fixed Expenses Remain Stable,73045,12368.0,41441,53809.0,19236.0,26.33,0.05,Low Risk
U900,2024,8,312532.0,Salary Increases & Fixed Expenses Remain Stable,73045,12368.0,34518,46886.0,26159.0,35.81,-0.03,Low Risk
U900,2024,9,338691.0,Salary Increases & Fixed Expenses Remain Stable,73045,12368.0,37375,49743.0,23302.0,31.9,0.05,Low Risk
U900,2024,10,361993.0,Salary Increases & Fixed Expenses Remain Stable,73045,12368.0,37865,50233.0,22812.0,31.23,-0.03,Low Risk
U900,2024,11,384805.0,Salary Increases & Fixed Expenses Remain Stable,73045,12368.0,33436,45804.0,27241.0,37.29,-0.02,Low Risk
U900,2024,12,412046.0,Salary Increases & Fixed Expenses Remain Stable,73045,12368.0,36938,49306.0,23739.0,32.5,0.04,Low Risk
U901,2024,1,248369.0,Stable Salary & Increasing Fixed Expenses,253477,109376.0,77138,186514.0,66963.0,26.42,-0.01,Low Risk
U901,2024,2,315332.0,Stable Salary & Increasing Fixed Expenses,253477,110626.0,92819,203445.0,50032.0,19.74,-0.0,Medium Risk
U901,2024,3,365364.0,Stable Salary & Increasing Fixed Expenses,253477,111996.0,94150,206146.0,47331.0,18.67,-0.03,Medium Risk
U901,2024,4,412695.0,Stable Salary & Increasing Fixed Expenses,253477,113624.0,78624,192248.0,61229.0,24.16,-0.02,Medium Risk
U901,2024,5,473924.0,Stable Salary & Increasing Fixed Expenses,253477,113624.0,78240,191864.0,61613.0,24.31,0.02,Medium Risk
U901,2024,6,535537.0,Stable Salary & Increasing Fixed Expenses,253477,113624.0,99111,212735.0,40742.0,16.07,0.01,Medium Risk
U901,2024,7,576279.0,Stable Salary & Increasing Fixed Expenses,253477,113624.0,82875,196499.0,56978.0,22.48,0.01,Medium Risk
U901,2024,8,633257.0,Stable Salary & Increasing Fixed Expenses,253477,113624.0,96758,210382.0,43095.0,17.0,-0.02,Medium Risk
U901,2024,9,676352.0,Stable Salary & Increasing Fixed Expenses,253477,114736.0,77546,192282.0,61195.0,24.14,-0.01,Medium Risk
U901,2024,10,737547.0,Stable Salary & Increasing Fixed Expenses,253477,114736.0,87473,202209.0,51268.0,20.23,-0.02,Medium Risk
U901,2024,11,788815.0,Stable Salary & Increasing Fixed Expenses,253477,114736.0,96511,211247.0,42230.0,16.66,-0.04,Medium Risk
U901,2024,12,831045.0,Stable Salary & Increasing Fixed Expenses,253477,114736.0,88369,203105.0,50372.0,19.87,0.03,Medium Risk
U902,2024,1,243810.0,Stable Salary & Stable Fixed Expenses,290464,116933.0,183681,300614.0,-10150.0,-3.49,0.01,High Risk
U902,2024,2,233660.0,Stable Salary & Stable Fixed Expenses,290464,116933.0,202649,319582.0,-29118.0,-10.02,-0.01,High Risk
U902,2024,3,204542.0,Stable Salary & Stable Fixed Expenses,290464,116933.0,234126,351059.0,-60595.0,-20.86,0.05,High Risk
U902,2024,4,143947.0,Stable Salary & Stable Fixed Expenses,290464,116933.0,209796,326729.0,-36265.0,-12.49,0.02,High Risk
U902,2024,5,107682.0,Stable Salary & Stable Fixed Expenses,290464,116933.0,201721,318654.0,-28190.0,-9.71,-0.02,High Risk
U902,2024,6,79492.0,Stable Salary & Stable Fixed Expenses,290464,116933.0,193742,310675.0,-20211.0,-6.96,0.02,High Risk
U902,2024,7,59281.0,Stable Salary & Stable Fixed Expenses,290464,116933.0,226064,342997.0,-52533.0,-18.09,0.0,High Risk
U902,2024,8,6748.0,Stable Salary & Stable Fixed Expenses,290464,116933.0,219658,336591.0,-46127.0,-15.88,-0.04,High Risk
U902,2024,9,-39379.0,Stable Salary & Stable Fixed Expenses,290464,116933.0,175626,292559.0,-2095.0,-0.72,-0.01,High Risk
U902,2024,10,-41474.0,Stable Salary & Stable Fixed Expenses,290464,116933.0,206953,323886.0,-33422.0,-11.51,0.03,High Risk
U902,2024,11,-74896.0,Stable Salary & Stable Fixed Expenses,290464,116933.0,223454,340387.0,-49923.0,-17.19,0.03,High Risk
U902,2024,12,-124819.0,Stable Salary & Stable Fixed Expenses,290464,116933.0,194198,311131.0,-20667.0,-7.12,-0.03,High Risk
U903,2024,1,204324.0,Stable Salary & Increasing Fixed Expenses,174804,51520.0,69771,121291.0,53513.0,30.61,0.01,Low Risk
U903,2024,2,257837.0,Stable Salary & Increasing Fixed Expenses,174804,51520.0,56340,107860.0,66944.0,38.3,-0.04,Low Risk
U903,2024,3,324781.0,Stable Salary & Increasing Fixed Expenses,174804,51520.0,69855,121375.0,53429.0,30.57,-0.04,Low Risk
U903,2024,4,378210.0,Stable Salary & Increasing Fixed Expenses,174804,51520.0,66976,118496.0,56308.0,32.21,0.04,Low Risk
U903,2024,5,434518.0,Stable Salary & Increasing Fixed Expenses,174804,52199.0,56851,109050.0,65754.0,37.62,-0.01,Low Risk
U903,2024,6,500272.0,Stable Salary & Increasing Fixed Expenses,174804,54128.0,57865,111993.0,62811.0,35.93,-0.04,Low Risk
U903,2024,7,563083.0,Stable Salary & Increasing Fixed Expenses,174804,55999.0,62050,118049.0,56755.0,32.47,-0.01,Low Risk
U903,2024,8,619838.0,Stable Salary & Increasing Fixed Expenses,174804,55999.0,69600,125599.0,49205.0,28.15,-0.01,Low Risk
U903,2024,9,669043.0,Stable Salary & Increasing Fixed Expenses,174804,55999.0,59549,115548.0,59256.0,33.9,-0.03,Low Risk
U903,2024,10,728299.0,Stable Salary & Increasing Fixed Expenses,174804,55999.0,66525,122524.0,52280.0,29.91,0.03,Low Risk
U903,2024,11,780579.0,Stable Salary & Increasing Fixed Expenses,174804,55999.0,63391,119390.0,55414.0,31.7,0.01,Low Risk
U903,2024,12,835993.0,Stable Salary & Increasing Fixed Expenses,174804,55999.0,61686,117685.0,57119.0,32.68,-0.04,Low Risk
U904,2024,1,226966.0,Stable Salary & Decreasing Fixed Expenses,205820,97563.0,92790,190353.0,15467.0,7.51,0.02,High Risk
U904,2024,2,242433.0,Stable Salary & Decreasing Fixed Expenses,205820,97563.0,102012,199575.0,6245.0,3.03,-0.04,High Risk
U904,2024,3,248678.0,Stable Salary & Decreasing Fixed Expenses,205820,97563.0,133299,230862.0,-25042.0,-12.17,0.04,High Risk
U904,2024,4,223636.0,Stable Salary & Decreasing Fixed Expenses,205820,97563.0,95485,193048.0,12772.0,6.21,-0.04,High Risk
U904,2024,5,236408.0,Stable Salary & Decreasing Fixed Expenses,205820,96866.0,95582,192448.0,13372.0,6.5,-0.01,High Risk
U904,2024,6,249780.0,Stable Salary & Decreasing Fixed Expenses,205820,96866.0,93347,190213.0,15607.0,7.58,0.03,High Risk
U904,2024,7,265387.0,Stable Salary & Decreasing Fixed Expenses,205820,96866.0,97569,194435.0,11385.0,5.53,-0.01,High Risk
U904,2024,8,276772.0,Stable Salary & Decreasing Fixed Expenses,205820,96866.0,91277,188143.0,17677.0,8.59,-0.0,High Risk
U904,2024,9,294449.0,Stable Salary & Decreasing Fixed Expenses,205820,96866.0,118621,215487.0,-9667.0,-4.7,0.02,High Risk
U904,2024,10,284782.0,Stable Salary & Decreasing Fixed Expenses,205820,96866.0,103964,200830.0,4990.0,2.42,0.01,High Risk
U904,2024,11,289772.0,Stable Salary & Decreasing Fixed Expenses,205820,96204.0,91386,187590.0,18230.0,8.86,-0.05,High Risk
U904,2024,12,308002.0,Stable Salary & Decreasing Fixed Expenses,205820,96204.0,87714,183918.0,21902.0,10.64,-0.01,High Risk
U905,2024,1,245845.0,Stable Salary & Increasing Fixed Expenses,209413,62857.0,107323,170180.0,39233.0,18.73,-0.04,Medium Risk
U905,2024,2,285078.0,Stable Salary & Increasing Fixed Expenses,209413,64473.0,95688,160161.0,49252.0,23.52,-0.0,Medium Risk
U905,2024,3,334330.0,Stable Salary & Increasing Fixed Expenses,209413,64473.0,85155,149628.0,59785.0,28.55,0.01,Low Risk
U905,2024,4,394115.0,Stable Salary & Increasing Fixed Expenses,209413,64473.0,108451,172924.0,36489.0,17.42,-0.02,Medium Risk
U905,2024,5,430604.0,Stable Salary & Increasing Fixed Expenses,209413,64473.0,123717,188190.0,21223.0,10.13,0.04,High Risk
U905,2024,6,451827.0,Stable Salary & Increasing Fixed Expenses,209413,66247.0,84722,150969.0,58444.0,27.91,0.03,Low Risk
U905,2024,7,510271.0,Stable Salary & Increasing Fixed Expenses,209413,66247.0,89440,155687.0,53726.0,25.66,0.05,Low Risk
U905,2024,8,563997.0,Stable Salary & Increasing Fixed Expenses,209413,66247.0,86366,152613.0,56800.0,27.12,0.04,Low Risk
U905,2024,9,620797.0,Stable Salary & Increasing Fixed Expenses,209413,66247.0,116721,182968.0,26445.0,12.63,0.01,High Risk
U905,2024,10,647242.0,Stable Salary & Increasing Fixed Expenses,209413,66247.0,114767,181014.0,28399.0,13.56,0.05,High Risk
U905,2024,11,675641.0,Stable Salary & Increasing Fixed Expenses,209413,68115.0,92977,161092.0,48321.0,23.07,-0.0,Medium Risk
U905,2024,12,723962.0,Stable Salary & Increasing Fixed Expenses,209413,68115.0,101912,170027.0,39386.0,18.81,0.04,Medium Risk
U906,2024,1,226386.0,Salary Increases & Fixed Expenses Increase,72930,28449.0,53869,82318.0,-9388.0,-12.87,-0.03,High Risk
U906,2024,2,216998.0,Salary Increases & Fixed Expenses Increase,72930,28449.0,44852,73301.0,-371.0,-0.51,-0.04,High Risk
U906,2024,3,216627.0,Salary Increases & Fixed Expenses Increase,72930,28449.0,63582,92031.0,-19101.0,-26.19,-0.01,High Risk
U906,2024,4,197526.0,Salary Increases & Fixed Expenses Increase,98577,28449.0,59340,87789.0,10788.0,10.94,0.03,High Risk
U906,2024,5,208314.0,Salary Increases & Fixed Expenses Increase,98577,28449.0,63936,92385.0,6192.0,6.28,0.0,High Risk
U906,2024,6,214506.0,Salary Increases & Fixed Expenses Increase,98577,29593.0,77603,107196.0,-8619.0,-8.74,-0.02,High Risk
U906,2024,7,205887.0,Salary Increases & Fixed Expenses Increase,98577,30835.0,78049,108884.0,-10307.0,-10.46,-0.01,High Risk
U906,2024,8,195580.0,Salary Increases & Fixed Expenses Increase,98577,32648.0,59163,91811.0,6766.0,6.86,-0.04,High Risk
U906,2024,9,202346.0,Salary Increases & Fixed Expenses Increase,98577,32648.0,75352,108000.0,-9423.0,-9.56,0.0,High Risk
U906,2024,10,192923.0,Salary Increases & Fixed Expenses Increase,98577,32648.0,78114,110762.0,-12185.0,-12.36,0.02,High Risk
U906,2024,11,180738.0,Salary Increases & Fixed Expenses Increase,98577,32648.0,84151,116799.0,-18222.0,-18.49,-0.02,High Risk
U906,2024,12,162516.0,Salary Increases & Fixed Expenses Increase,98577,32648.0,77650,110298.0,-11721.0,-11.89,0.04,High Risk
U907,2024,1,213017.0,Salary Increases & Fixed Expenses Remain Stable,212353,65159.0,110250,175409.0,36944.0,17.4,-0.02,Medium Risk
U907,2024,2,249961.0,Salary Increases & Fixed Expenses Remain Stable,212353,65159.0,114833,179992.0,32361.0,15.24,0.03,Medium Risk
U907,2024,3,282322.0,Salary Increases & Fixed Expenses Remain Stable,220009,65159.0,151696,216855.0,3154.0,1.43,-0.04,High Risk
U907,2024,4,285476.0,Salary Increases & Fixed Expenses Remain Stable,220009,65159.0,119268,184427.0,35582.0,16.17,0.05,Medium Risk
U907,2024,5,321058.0,Salary Increases & Fixed Expenses Remain Stable,220009,65159.0,123287,188446.0,31563.0,14.35,0.04,High Risk
U907,2024,6,352621.0,Salary Increases & Fixed Expenses Remain Stable,220009,65159.0,125844,191003.0,29006.0,13.18,-0.01,High Risk
U907,2024,7,381627.0,Salary Increases & Fixed Expenses Remain Stable,220009,65159.0,130517,195676.0,24333.0,11.06,0.04,High Risk
U907,2024,8,405960.0,Salary Increases & Fixed Expenses Remain Stable,220009,65159.0,112543,177702.0,42307.0,19.23,0.04,Medium Risk
U907,2024,9,448267.0,Salary Increases & Fixed Expenses Remain Stable,220009,65159.0,131181,196340.0,23669.0,10.76,-0.0,High Risk
U907,2024,10,471936.0,Salary Increases & Fixed Expenses Remain Stable,220009,65159.0,140141,205300.0,14709.0,6.69,-0.02,High Risk
U907,2024,11,486645.0,Salary Increases & Fixed Expenses Remain Stable,220009,65159.0,93779,158938.0,61071.0,27.76,-0.01,Low Risk
U907,2024,12,547716.0,Salary Increases & Fixed Expenses Remain Stable,220009,65159.0,121079,186238.0,33771.0,15.35,0.01,Medium Risk
U908,2024,1,233744.0,Stable Salary & Increasing Fixed Expenses,256545,74947.0,127569,202516.0,54029.0,21.06,-0.02,Medium Risk
U908,2024,2,287773.0,Stable Salary & Increasing Fixed Expenses,256545,74947.0,120668,195615.0,60930.0,23.75,-0.02,Medium Risk
U908,2024,3,348703.0,Stable Salary & Increasing Fixed Expenses,256545,76796.0,129678,206474.0,50071.0,19.52,0.02,Medium Risk
U908,2024,4,398774.0,Stable Salary & Increasing Fixed Expenses,256545,76796.0,109981,186777.0,69768.0,27.2,0.04,Low Risk
U908,2024,5,468542.0,Stable Salary & Increasing Fixed Expenses,256545,76796.0,137824,214620.0,41925.0,16.34,-0.04,Medium Risk
U908,2024,6,510467.0,Stable Salary & Increasing Fixed Expenses,256545,76796.0,131284,208080.0,48465.0,18.89,0.02,Medium Risk
U908,2024,7,558932.0,Stable Salary & Increasing Fixed Expenses,256545,76796.0,149997,226793.0,29752.0,11.6,-0.01,High Risk
U908,2024,8,588684.0,Stable Salary & Increasing Fixed Expenses,256545,76796.0,119980,196776.0,59769.0,23.3,0.03,Medium Risk
U908,2024,9,648453.0,Stable Salary & Increasing Fixed Expenses,256545,76796.0,153259,230055.0,26490.0,10.33,0.04,High Risk
U908,2024,10,674943.0,Stable Salary & Increasing Fixed Expenses,256545,76796.0,183519,260315.0,-3770.0,-1.47,0.01,High Risk
U908,2024,11,671173.0,Stable Salary & Increasing Fixed Expenses,256545,76796.0,105547,182343.0,74202.0,28.92,0.03,Low Risk
U908,2024,12,745375.0,Stable Salary & Increasing Fixed Expenses,256545,76796.0,135223,212019.0,44526.0,17.36,-0.05,Medium Risk
U909,2024,1,211822.0,Stable Salary & Stable Fixed Expenses,231301,65320.0,118134,183454.0,47847.0,20.69,-0.03,Medium Risk
U909,2024,2,259669.0,Stable Salary & Stable Fixed Expenses,231301,65320.0,136266,201586.0,29715.0,12.85,0.03,High Risk
U909,2024,3,289384.0,Stable Salary & Stable Fixed Expenses,231301,65320.0,113319,178639.0,52662.0,22.77,-0.01,Medium Risk
U909,2024,4,342046.0,Stable Salary & Stable Fixed Expenses,231301,65320.0,113908,179228.0,52073.0,22.51,-0.05,Medium Risk
U909,2024,5,394119.0,Stable Salary & Stable Fixed Expenses,231301,65320.0,100321,165641.0,65660.0,28.39,0.04,Low Risk
U909,2024,6,459779.0,Stable Salary & Stable Fixed Expenses,231301,65320.0,99264,164584.0,66717.0,28.84,0.02,Low Risk
U909,2024,7,526496.0,Stable Salary & Stable Fixed Expenses,231301,65320.0,99645,164965.0,66336.0,28.68,-0.01,Low Risk
U909,2024,8,592832.0,Stable Salary & Stable Fixed Expenses,231301,65320.0,130015,195335.0,35966.0,15.55,-0.02,Medium Risk
U909,2024,9,628798.0,Stable Salary & Stable Fixed Expenses,231301,65320.0,101204,166524.0,64777.0,28.01,0.04,Low Risk
U909,2024,10,693575.0,Stable Salary & Stable Fixed Expenses,231301,65320.0,114507,179827.0,51474.0,22.25,-0.04,Medium Risk
U909,2024,11,745049.0,Stable Salary & Stable Fixed Expenses,231301,65320.0,104411,169731.0,61570.0,26.62,-0.0,Low Risk
U909,2024,12,806619.0,Stable Salary & Stable Fixed Expenses,231301,65320.0,126458,191778.0,39523.0,17.09,0.02,Medium Risk
U910,2024,1,212517.0,Stable Salary & Stable Fixed Expenses,232477,80775.0,177153,257928.0,-25451.0,-10.95,0.03,High Risk
U910,2024,2,187066.0,Stable Salary & Stable Fixed Expenses,232477,80775.0,146214,226989.0,5488.0,2.36,0.01,High Risk
U910,2024,3,192554.0,Stable Salary & Stable Fixed Expenses,232477,80775.0,202370,283145.0,-50668.0,-21.79,-0.0,High Risk
U910,2024,4,141886.0,Stable Salary & Stable Fixed Expenses,232477,80775.0,172701,253476.0,-20999.0,-9.03,-0.03,High Risk
U910,2024,5,120887.0,Stable Salary & Stable Fixed Expenses,232477,80775.0,142769,223544.0,8933.0,3.84,0.02,High Risk
U910,2024,6,129820.0,Stable Salary & Stable Fixed Expenses,232477,80775.0,176790,257565.0,-25088.0,-10.79,0.02,High Risk
U910,2024,7,104732.0,Stable Salary & Stable Fixed Expenses,232477,80775.0,157787,238562.0,-6085.0,-2.62,0.03,High Risk
U910,2024,8,98647.0,Stable Salary & Stable Fixed Expenses,232477,80775.0,175315,256090.0,-23613.0,-10.16,-0.01,High Risk
U910,2024,9,75034.0,Stable Salary & Stable Fixed Expenses,232477,80775.0,178040,258815.0,-26338.0,-11.33,0.02,High Risk
U910,2024,10,48696.0,Stable Salary & Stable Fixed Expenses,232477,80775.0,202996,283771.0,-51294.0,-22.06,0.04,High Risk
U910,2024,11,-2598.0,Stable Salary & Stable Fixed Expenses,232477,80775.0,167567,248342.0,-15865.0,-6.82,0.03,High Risk
U910,2024,12,-18463.0,Stable Salary & Stable Fixed Expenses,232477,80775.0,191289,272064.0,-39587.0,-17.03,0.01,High Risk
U911,2024,1,223804.0,Salary Increases & Fixed Expenses Increase,58008,34878.0,30485,65363.0,-7355.0,-12.68,0.02,High Risk
U911,2024,2,216449.0,Salary Increases & Fixed Expenses Increase,58008,36178.0,25301,61479.0,-3471.0,-5.98,-0.03,High Risk
U911,2024,3,212978.0,Salary Increases & Fixed Expenses Increase,58008,36178.0,33076,69254.0,-11246.0,-19.39,0.0,High Risk
U911,2024,4,201732.0,Salary Increases & Fixed Expenses Increase,83299,36178.0,36722,72900.0,10399.0,12.48,0.03,High Risk
U911,2024,5,212131.0,Salary Increases & Fixed Expenses Increase,83299,36178.0,47574,83752.0,-453.0,-0.54,0.03,High Risk
U911,2024,6,211678.0,Salary Increases & Fixed Expenses Increase,83299,36178.0,34238,70416.0,12883.0,15.47,-0.05,Medium Risk
U911,2024,7,224561.0,Salary Increases & Fixed Expenses Increase,83299,37754.0,44839,82593.0,706.0,0.85,0.03,High Risk
U911,2024,8,225267.0,Salary Increases & Fixed Expenses Increase,83299,37754.0,36087,73841.0,9458.0,11.35,-0.01,High Risk
U911,2024,9,234725.0,Salary Increases & Fixed Expenses Increase,83299,39507.0,48486,87993.0,-4694.0,-5.64,-0.04,High Risk
U911,2024,10,230031.0,Salary Increases & Fixed Expenses Increase,83299,39507.0,35599,75106.0,8193.0,9.84,-0.03,High Risk
U911,2024,11,238224.0,Salary Increases & Fixed Expenses Increase,83299,41206.0,41038,82244.0,1055.0,1.27,0.03,High Risk
U911,2024,12,239279.0,Salary Increases & Fixed Expenses Increase,83299,41206.0,47453,88659.0,-5360.0,-6.43,0.01,High Risk
U912,2024,1,245394.0,Salary Increases & Fixed Expenses Decrease,255938,67700.0,182385,250085.0,5853.0,2.29,0.02,High Risk
U912,2024,2,251247.0,Salary Increases & Fixed Expenses Decrease,255938,67700.0,201338,269038.0,-13100.0,-5.12,-0.04,High Risk
U912,2024,3,238147.0,Salary Increases & Fixed Expenses Decrease,270777,67700.0,225588,293288.0,-22511.0,-8.31,0.01,High Risk
U912,2024,4,215636.0,Salary Increases & Fixed Expenses Decrease,270777,67700.0,172922,240622.0,30155.0,11.14,-0.05,High Risk
U912,2024,5,245791.0,Salary Increases & Fixed Expenses Decrease,270777,67700.0,199256,266956.0,3821.0,1.41,-0.02,High Risk
U912,2024,6,249612.0,Salary Increases & Fixed Expenses Decrease,270777,67700.0,206202,273902.0,-3125.0,-1.15,0.01,High Risk
U912,2024,7,246487.0,Salary Increases & Fixed Expenses Decrease,270777,67700.0,167653,235353.0,35424.0,13.08,-0.02,High Risk
U912,2024,8,281911.0,Salary Increases & Fixed Expenses Decrease,270777,67700.0,173579,241279.0,29498.0,10.89,-0.03,High Risk
U912,2024,9,311409.0,Salary Increases & Fixed Expenses Decrease,270777,66317.0,167618,233935.0,36842.0,13.61,-0.02,High Risk
U912,2024,10,348251.0,Salary Increases & Fixed Expenses Decrease,270777,66317.0,206715,273032.0,-2255.0,-0.83,0.05,High Risk
U912,2024,11,345996.0,Salary Increases & Fixed Expenses Decrease,270777,66317.0,169138,235455.0,35322.0,13.04,0.02,High Risk
U912,2024,12,381318.0,Salary Increases & Fixed Expenses Decrease,270777,66317.0,180305,246622.0,24155.0,8.92,0.04,High Risk
U913,2024,1,227338.0,Stable Salary & Stable Fixed Expenses,75322,38379.0,32597,70976.0,4346.0,5.77,-0.02,High Risk
U913,2024,2,231684.0,Stable Salary & Stable Fixed Expenses,75322,38379.0,34770,73149.0,2173.0,2.88,-0.0,High Risk
U913,2024,3,233857.0,Stable Salary & Stable Fixed Expenses,75322,38379.0,41752,80131.0,-4809.0,-6.38,0.01,High Risk
U913,2024,4,229048.0,Stable Salary & Stable Fixed Expenses,75322,38379.0,30464,68843.0,6479.0,8.6,-0.02,High Risk
U913,2024,5,235527.0,Stable Salary & Stable Fixed Expenses,75322,38379.0,45087,83466.0,-8144.0,-10.81,0.04,High Risk
U913,2024,6,227383.0,Stable Salary & Stable Fixed Expenses,75322,38379.0,41737,80116.0,-4794.0,-6.36,-0.03,High Risk
U913,2024,7,222589.0,Stable Salary & Stable Fixed Expenses,75322,38379.0,36206,74585.0,737.0,0.98,0.03,High Risk
U913,2024,8,223326.0,Stable Salary & Stable Fixed Expenses,75322,38379.0,40709,79088.0,-3766.0,-5.0,0.02,High Risk
U913,2024,9,219560.0,Stable Salary & Stable Fixed Expenses,75322,38379.0,31092,69471.0,5851.0,7.77,0.05,High Risk
U913,2024,10,225411.0,Stable Salary & Stable Fixed Expenses,75322,38379.0,37136,75515.0,-193.0,-0.26,-0.04,High Risk
U913,2024,11,225218.0,Stable Salary & Stable Fixed Expenses,75322,38379.0,37164,75543.0,-221.0,-0.29,-0.03,High Risk
U913,2024,12,224997.0,Stable Salary & Stable Fixed Expenses,75322,38379.0,36770,75149.0,173.0,0.23,-0.03,High Risk
U914,2024,1,231749.0,Salary Increases & Fixed Expenses Remain Stable,157271,47691.0,86817,134508.0,22763.0,14.47,0.01,High Risk
U914,2024,2,254512.0,Salary Increases & Fixed Expenses Remain Stable,157271,47691.0,71661,119352.0,37919.0,24.11,0.02,Medium Risk
U914,2024,3,292431.0,Salary Increases & Fixed Expenses Remain Stable,157271,47691.0,97573,145264.0,12007.0,7.63,-0.04,High Risk
U914,2024,4,304438.0,Salary Increases & Fixed Expenses Remain Stable,157271,47691.0,64133,111824.0,45447.0,28.9,0.02,Low Risk
U914,2024,5,349885.0,Salary Increases & Fixed Expenses Remain Stable,157271,47691.0,92989,140680.0,16591.0,10.55,-0.02,High Risk
U914,2024,6,366476.0,Salary Increases & Fixed Expenses Remain Stable,172980,47691.0,98194,145885.0,27095.0,15.66,0.04,Medium Risk
U914,2024,7,393571.0,Salary Increases & Fixed Expenses Remain Stable,172980,47691.0,74723,122414.0,50566.0,29.23,-0.02,Low Risk
U914,2024,8,444137.0,Salary Increases & Fixed Expenses Remain Stable,172980,47691.0,83903,131594.0,41386.0,23.93,-0.04,Medium Risk
U914,2024,9,485523.0,Salary Increases & Fixed Expenses Remain Stable,172980,47691.0,110723,158414.0,14566.0,8.42,-0.02,High Risk
U914,2024,10,500089.0,Salary Increases & Fixed Expenses Remain Stable,172980,47691.0,90469,138160.0,34820.0,20.13,-0.02,Medium Risk
U914,2024,11,534909.0,Salary Increases & Fixed Expenses Remain Stable,172980,47691.0,91516,139207.0,33773.0,19.52,-0.02,Medium Risk
U914,2024,12,568682.0,Salary Increases & Fixed Expenses Remain Stable,172980,47691.0,110950,158641.0,14339.0,8.29,0.02,High Risk
U915,2024,1,212223.0,Stable Salary & Stable Fixed Expenses,56435,32638.0,34001,66639.0,-10204.0,-18.08,-0.02,High Risk
U915,2024,2,202019.0,Stable Salary & Stable Fixed Expenses,56435,32638.0,36061,68699.0,-12264.0,-21.73,-0.0,High Risk
U915,2024,3,189755.0,Stable Salary & Stable Fixed Expenses,56435,32638.0,47206,79844.0,-23409.0,-41.48,-0.04,High Risk
U915,2024,4,166346.0,Stable Salary & Stable Fixed Expenses,56435,32638.0,42055,74693.0,-18258.0,-32.35,0.01,High Risk
U915,2024,5,148088.0,Stable Salary & Stable Fixed Expenses,56435,32638.0,35782,68420.0,-11985.0,-21.24,-0.03,High Risk
U915,2024,6,136103.0,Stable Salary & Stable Fixed Expenses,56435,32638.0,37229,69867.0,-13432.0,-23.8,-0.02,High Risk
U915,2024,7,122671.0,Stable Salary & Stable Fixed Expenses,56435,32638.0,42895,75533.0,-19098.0,-33.84,-0.02,High Risk
U915,2024,8,103573.0,Stable Salary & Stable Fixed Expenses,56435,32638.0,39843,72481.0,-16046.0,-28.43,-0.01,High Risk
U915,2024,9,87527.0,Stable Salary & Stable Fixed Expenses,56435,32638.0,35321,67959.0,-11524.0,-20.42,-0.04,High Risk
U915,2024,10,76003.0,Stable Salary & Stable Fixed Expenses,56435,32638.0,48565,81203.0,-24768.0,-43.89,0.02,High Risk
U915,2024,11,51235.0,Stable Salary & Stable Fixed Expenses,56435,32638.0,36993,69631.0,-13196.0,-23.38,-0.04,High Risk
U915,2024,12,38039.0,Stable Salary & Stable Fixed Expenses,56435,32638.0,36599,69237.0,-12802.0,-22.68,0.03,High Risk
U916,2024,1,236001.0,Salary Increases & Fixed Expenses Increase,251962,106646.0,94450,201096.0,50866.0,20.19,-0.02,Medium Risk
U916,2024,2,286867.0,Salary Increases & Fixed Expenses Increase,251962,106646.0,96720,203366.0,48596.0,19.29,-0.01,Medium Risk
U916,2024,3,335463.0,Salary Increases & Fixed Expenses Increase,274571,108324.0,92251,200575.0,73996.0,26.95,0.02,Low Risk
U916,2024,4,409459.0,Salary Increases & Fixed Expenses Increase,274571,108324.0,95815,204139.0,70432.0,25.65,-0.02,Low Risk
U916,2024,5,479891.0,Salary Increases & Fixed Expenses Increase,274571,108324.0,93573,201897.0,72674.0,26.47,-0.01,Low Risk
U916,2024,6,552565.0,Salary Increases & Fixed Expenses Increase,274571,108324.0,91326,199650.0,74921.0,27.29,-0.03,Low Risk
U916,2024,7,627486.0,Salary Increases & Fixed Expenses Increase,274571,108324.0,84766,193090.0,81481.0,29.68,-0.03,Low Risk
U916,2024,8,708967.0,Salary Increases & Fixed Expenses Increase,274571,108324.0,109249,217573.0,56998.0,20.76,-0.03,Medium Risk
U916,2024,9,765965.0,Salary Increases & Fixed Expenses Increase,274571,108324.0,90397,198721.0,75850.0,27.62,-0.0,Low Risk
U916,2024,10,841815.0,Salary Increases & Fixed Expenses Increase,274571,108324.0,100518,208842.0,65729.0,23.94,0.05,Medium Risk
U916,2024,11,907544.0,Salary Increases & Fixed Expenses Increase,274571,108324.0,98444,206768.0,67803.0,24.69,-0.0,Medium Risk
U916,2024,12,975347.0,Salary Increases & Fixed Expenses Increase,274571,108324.0,104069,212393.0,62178.0,22.65,0.03,Medium Risk
U917,2024,1,230321.0,Stable Salary & Decreasing Fixed Expenses,218769,98487.0,158904,257391.0,-38622.0,-17.65,-0.02,High Risk
U917,2024,2,191699.0,Stable Salary & Decreasing Fixed Expenses,218769,98487.0,173128,271615.0,-52846.0,-24.16,-0.04,High Risk
U917,2024,3,138853.0,Stable Salary & Decreasing Fixed Expenses,218769,98487.0,193143,291630.0,-72861.0,-33.3,-0.03,High Risk
U917,2024,4,65992.0,Stable Salary & Decreasing Fixed Expenses,218769,98487.0,137702,236189.0,-17420.0,-7.96,0.0,High Risk
U917,2024,5,48572.0,Stable Salary & Decreasing Fixed Expenses,218769,96678.0,139707,236385.0,-17616.0,-8.05,-0.03,High Risk
U917,2024,6,30956.0,Stable Salary & Decreasing Fixed Expenses,218769,96678.0,174242,270920.0,-52151.0,-23.84,-0.01,High Risk
U917,2024,7,-21195.0,Stable Salary & Decreasing Fixed Expenses,218769,96678.0,170452,267130.0,-48361.0,-22.11,0.02,High Risk
U917,2024,8,-69556.0,Stable Salary & Decreasing Fixed Expenses,218769,96678.0,149189,245867.0,-27098.0,-12.39,-0.03,High Risk
U917,2024,9,-96654.0,Stable Salary & Decreasing Fixed Expenses,218769,96678.0,182624,279302.0,-60533.0,-27.67,0.0,High Risk
U917,2024,10,-157187.0,Stable Salary & Decreasing Fixed Expenses,218769,96678.0,189425,286103.0,-67334.0,-30.78,-0.01,High Risk
U917,2024,11,-224521.0,Stable Salary & Decreasing Fixed Expenses,218769,96678.0,171884,268562.0,-49793.0,-22.76,-0.01,High Risk
U917,2024,12,-274314.0,Stable Salary & Decreasing Fixed Expenses,218769,96678.0,157986,254664.0,-35895.0,-16.41,-0.04,High Risk
U918,2024,1,204074.0,Salary Increases & Fixed Expenses Remain Stable,180201,52904.0,124323,177227.0,2974.0,1.65,0.03,High Risk
U918,2024,2,207048.0,Salary Increases & Fixed Expenses Remain Stable,180201,52904.0,127993,180897.0,-696.0,-0.39,-0.02,High Risk
U918,2024,3,206352.0,Salary Increases & Fixed Expenses Remain Stable,180201,52904.0,153155,206059.0,-25858.0,-14.35,-0.02,High Risk
U918,2024,4,180494.0,Salary Increases & Fixed Expenses Remain Stable,180201,52904.0,127782,180686.0,-485.0,-0.27,0.04,High Risk
U918,2024,5,180009.0,Salary Increases & Fixed Expenses Remain Stable,180201,52904.0,121446,174350.0,5851.0,3.25,0.02,High Risk
U918,2024,6,185860.0,Salary Increases & Fixed Expenses Remain Stable,180201,52904.0,109460,162364.0,17837.0,9.9,-0.04,High Risk
U918,2024,7,203697.0,Salary Increases & Fixed Expenses Remain Stable,199258,52904.0,134652,187556.0,11702.0,5.87,-0.01,High Risk
U918,2024,8,215399.0,Salary Increases & Fixed Expenses Remain Stable,199258,52904.0,141818,194722.0,4536.0,2.28,0.03,High Risk
U918,2024,9,219935.0,Salary Increases & Fixed Expenses Remain Stable,199258,52904.0,158914,211818.0,-12560.0,-6.3,0.04,High Risk
U918,2024,10,207375.0,Salary Increases & Fixed Expenses Remain Stable,199258,52904.0,160072,212976.0,-13718.0,-6.88,0.0,High Risk
U918,2024,11,193657.0,Salary Increases & Fixed Expenses Remain Stable,199258,52904.0,151399,204303.0,-5045.0,-2.53,0.01,High Risk
U918,2024,12,188612.0,Salary Increases & Fixed Expenses Remain Stable,199258,52904.0,151565,204469.0,-5211.0,-2.62,-0.02,High Risk
U919,2024,1,229949.0,Salary Increases & Fixed Expenses Decrease,166731,69201.0,70188,139389.0,27342.0,16.4,0.03,Medium Risk
U919,2024,2,257291.0,Salary Increases & Fixed Expenses Decrease,166731,69201.0,85679,154880.0,11851.0,7.11,-0.0,High Risk
U919,2024,3,269142.0,Salary Increases & Fixed Expenses Decrease,166731,69201.0,95005,164206.0,2525.0,1.51,0.0,High Risk
U919,2024,4,271667.0,Salary Increases & Fixed Expenses Decrease,166731,69201.0,71804,141005.0,25726.0,15.43,-0.01,Medium Risk
U919,2024,5,297393.0,Salary Increases & Fixed Expenses Decrease,166731,69201.0,89193,158394.0,8337.0,5.0,0.01,High Risk
U919,2024,6,305730.0,Salary Increases & Fixed Expenses Decrease,166731,69201.0,71841,141042.0,25689.0,15.41,-0.03,Medium Risk
U919,2024,7,331419.0,Salary Increases & Fixed Expenses Decrease,166731,69201.0,70520,139721.0,27010.0,16.2,-0.02,Medium Risk
U919,2024,8,358429.0,Salary Increases & Fixed Expenses Decrease,187829,69201.0,104588,173789.0,14040.0,7.47,0.02,High Risk
U919,2024,9,372469.0,Salary Increases & Fixed Expenses Decrease,187829,69201.0,100153,169354.0,18475.0,9.84,0.02,High Risk
U919,2024,10,390944.0,Salary Increases & Fixed Expenses Decrease,187829,69201.0,96561,165762.0,22067.0,11.75,0.05,High Risk
U919,2024,11,413011.0,Salary Increases & Fixed Expenses Decrease,187829,69201.0,93567,162768.0,25061.0,13.34,-0.01,High Risk
U919,2024,12,438072.0,Salary Increases & Fixed Expenses Decrease,187829,69201.0,96118,165319.0,22510.0,11.98,0.03,High Risk
U920,2024,1,237654.0,Stable Salary & Increasing Fixed Expenses,123598,70595.0,62956,133551.0,-9953.0,-8.05,0.01,High Risk
U920,2024,2,227701.0,Stable Salary & Increasing Fixed Expenses,123598,70595.0,60323,130918.0,-7320.0,-5.92,-0.04,High Risk
U920,2024,3,220381.0,Stable Salary & Increasing Fixed Expenses,123598,70595.0,63166,133761.0,-10163.0,-8.22,-0.01,High Risk
U920,2024,4,210218.0,Stable Salary & Increasing Fixed Expenses,123598,70595.0,64853,135448.0,-11850.0,-9.59,-0.01,High Risk
U920,2024,5,198368.0,Stable Salary & Increasing Fixed Expenses,123598,70595.0,71233,141828.0,-18230.0,-14.75,0.01,High Risk
U920,2024,6,180138.0,Stable Salary & Increasing Fixed Expenses,123598,70595.0,64333,134928.0,-11330.0,-9.17,0.01,High Risk
U920,2024,7,168808.0,Stable Salary & Increasing Fixed Expenses,123598,70595.0,52686,123281.0,317.0,0.26,0.01,High Risk
U920,2024,8,169125.0,Stable Salary & Increasing Fixed Expenses,123598,70595.0,61235,131830.0,-8232.0,-6.66,0.0,High Risk
U920,2024,9,160893.0,Stable Salary & Increasing Fixed Expenses,123598,70595.0,58030,128625.0,-5027.0,-4.07,-0.02,High Risk
U920,2024,10,155866.0,Stable Salary & Increasing Fixed Expenses,123598,70595.0,63017,133612.0,-10014.0,-8.1,0.02,High Risk
U920,2024,11,145852.0,Stable Salary & Increasing Fixed Expenses,123598,70595.0,74138,144733.0,-21135.0,-17.1,-0.01,High Risk
U920,2024,12,124717.0,Stable Salary & Increasing Fixed Expenses,123598,70595.0,72349,142944.0,-19346.0,-15.65,-0.04,High Risk
U921,2024,1,216190.0,Stable Salary & Increasing Fixed Expenses,154495,79326.0,61247,140573.0,13922.0,9.01,-0.01,High Risk
U921,2024,2,230112.0,Stable Salary & Increasing Fixed Expenses,154495,80711.0,60566,141277.0,13218.0,8.56,-0.0,High Risk
U921,2024,3,243330.0,Stable Salary & Increasing Fixed Expenses,154495,80711.0,62607,143318.0,11177.0,7.23,-0.04,High Risk
U921,2024,4,254507.0,Stable Salary & Increasing Fixed Expenses,154495,80711.0,53784,134495.0,20000.0,12.95,0.01,High Risk
U921,2024,5,274507.0,Stable Salary & Increasing Fixed Expenses,154495,80711.0,55781,136492.0,18003.0,11.65,-0.02,High Risk
U921,2024,6,292510.0,Stable Salary & Increasing Fixed Expenses,154495,80711.0,58696,139407.0,15088.0,9.77,0.0,High Risk
U921,2024,7,307598.0,Stable Salary & Increasing Fixed Expenses,154495,81912.0,50816,132728.0,21767.0,14.09,0.05,High Risk
U921,2024,8,329365.0,Stable Salary & Increasing Fixed Expenses,154495,81912.0,61155,143067.0,11428.0,7.4,0.01,High Risk
U921,2024,9,340793.0,Stable Salary & Increasing Fixed Expenses,154495,81912.0,48074,129986.0,24509.0,15.86,-0.03,Medium Risk
U921,2024,10,365302.0,Stable Salary & Increasing Fixed Expenses,154495,81912.0,76026,157938.0,-3443.0,-2.23,0.04,High Risk
U921,2024,11,361859.0,Stable Salary & Increasing Fixed Expenses,154495,83219.0,51880,135099.0,19396.0,12.55,0.03,High Risk
U921,2024,12,381255.0,Stable Salary & Increasing Fixed Expenses,154495,83219.0,53201,136420.0,18075.0,11.7,-0.02,High Risk
U922,2024,1,241082.0,Salary Increases & Fixed Expenses Increase,190423,58151.0,105170,163321.0,27102.0,14.23,0.01,High Risk
U922,2024,2,268184.0,Salary Increases & Fixed Expenses Increase,190423,58151.0,96941,155092.0,35331.0,18.55,-0.01,Medium Risk
U922,2024,3,303515.0,Salary Increases & Fixed Expenses Increase,190423,59586.0,140061,199647.0,-9224.0,-4.84,0.04,High Risk
U922,2024,4,294291.0,Salary Increases & Fixed Expenses Increase,190423,59586.0,100649,160235.0,30188.0,15.85,0.04,Medium Risk
U922,2024,5,324479.0,Salary Increases & Fixed Expenses Increase,190423,59586.0,83349,142935.0,47488.0,24.94,0.01,Medium Risk
U922,2024,6,371967.0,Salary Increases & Fixed Expenses Increase,203108,59586.0,110121,169707.0,33401.0,16.44,0.02,Medium Risk
U922,2024,7,405368.0,Salary Increases & Fixed Expenses Increase,203108,59586.0,112504,172090.0,31018.0,15.27,-0.02,Medium Risk
U922,2024,8,436386.0,Salary Increases & Fixed Expenses Increase,203108,59586.0,82934,142520.0,60588.0,29.83,-0.02,Low Risk
U922,2024,9,496974.0,Salary Increases & Fixed Expenses Increase,203108,59586.0,102945,162531.0,40577.0,19.98,0.04,Medium Risk
U922,2024,10,537551.0,Salary Increases & Fixed Expenses Increase,203108,59586.0,107515,167101.0,36007.0,17.73,-0.0,Medium Risk
U922,2024,11,573558.0,Salary Increases & Fixed Expenses Increase,203108,59586.0,119502,179088.0,24020.0,11.83,0.01,High Risk
U922,2024,12,597578.0,Salary Increases & Fixed Expenses Increase,203108,59586.0,96968,156554.0,46554.0,22.92,-0.02,Medium Risk
U923,2024,1,221605.0,Salary Increases & Fixed Expenses Decrease,131798,77249.0,64603,141852.0,-10054.0,-7.63,0.03,High Risk
U923,2024,2,211551.0,Salary Increases & Fixed Expenses Decrease,131798,77249.0,52989,130238.0,1560.0,1.18,-0.03,High Risk
U923,2024,3,213111.0,Salary Increases & Fixed Expenses Decrease,131798,77249.0,89850,167099.0,-35301.0,-26.78,0.01,High Risk
U923,2024,4,177810.0,Salary Increases & Fixed Expenses Decrease,131798,77249.0,70961,148210.0,-16412.0,-12.45,-0.04,High Risk
U923,2024,5,161398.0,Salary Increases & Fixed Expenses Decrease,131798,77249.0,71368,148617.0,-16819.0,-12.76,0.03,High Risk
U923,2024,6,144579.0,Salary Increases & Fixed Expenses Decrease,141274,77249.0,61563,138812.0,2462.0,1.74,0.04,High Risk
U923,2024,7,147041.0,Salary Increases & Fixed Expenses Decrease,141274,77249.0,68457,145706.0,-4432.0,-3.14,-0.04,High Risk
U923,2024,8,142609.0,Salary Increases & Fixed Expenses Decrease,141274,77249.0,72197,149446.0,-8172.0,-5.78,0.01,High Risk
U923,2024,9,134437.0,Salary Increases & Fixed Expenses Decrease,141274,77249.0,71892,149141.0,-7867.0,-5.57,0.01,High Risk
U923,2024,10,126570.0,Salary Increases & Fixed Expenses Decrease,141274,77249.0,74248,151497.0,-10223.0,-7.24,0.0,High Risk
U923,2024,11,116347.0,Salary Increases & Fixed Expenses Decrease,141274,77249.0,66911,144160.0,-2886.0,-2.04,0.03,High Risk
U923,2024,12,113461.0,Salary Increases & Fixed Expenses Decrease,141274,77249.0,86247,163496.0,-22222.0,-15.73,0.01,High Risk
U924,2024,1,242622.0,Salary Increases & Fixed Expenses Increase,140440,72346.0,45772,118118.0,22322.0,15.89,0.01,Medium Risk
U924,2024,2,264944.0,Salary Increases & Fixed Expenses Increase,140440,74098.0,45895,119993.0,20447.0,14.56,-0.04,High Risk
U924,2024,3,285391.0,Salary Increases & Fixed Expenses Increase,140440,74098.0,56727,130825.0,9615.0,6.85,0.05,High Risk
U924,2024,4,295006.0,Salary Increases & Fixed Expenses Increase,140440,74098.0,50872,124970.0,15470.0,11.02,-0.03,High Risk
U924,2024,5,310476.0,Salary Increases & Fixed Expenses Increase,140440,74098.0,42205,116303.0,24137.0,17.19,0.02,Medium Risk
U924,2024,6,334613.0,Salary Increases & Fixed Expenses Increase,166402,74098.0,61753,135851.0,30551.0,18.36,0.03,Medium Risk
U924,2024,7,365164.0,Salary Increases & Fixed Expenses Increase,166402,74098.0,61096,135194.0,31208.0,18.75,-0.01,Medium Risk
U924,2024,8,396372.0,Salary Increases & Fixed Expenses Increase,166402,74098.0,56475,130573.0,35829.0,21.53,-0.04,Medium Risk
U924,2024,9,432201.0,Salary Increases & Fixed Expenses Increase,166402,74098.0,56713,130811.0,35591.0,21.39,0.02,Medium Risk
U924,2024,10,467792.0,Salary Increases & Fixed Expenses Increase,166402,75119.0,77064,152183.0,14219.0,8.54,0.0,High Risk
U924,2024,11,482011.0,Salary Increases & Fixed Expenses Increase,166402,75119.0,61358,136477.0,29925.0,17.98,0.05,Medium Risk
U924,2024,12,511936.0,Salary Increases & Fixed Expenses Increase,166402,75119.0,64599,139718.0,26684.0,16.04,0.03,Medium Risk
U925,2024,1,232878.0,Salary Increases & Fixed Expenses Increase,216952,113565.0,126586,240151.0,-23199.0,-10.69,0.0,High Risk
U925,2024,2,209679.0,Salary Increases & Fixed Expenses Increase,216952,113565.0,97135,210700.0,6252.0,2.88,-0.04,High Risk
U925,2024,3,215931.0,Salary Increases & Fixed Expenses Increase,216952,114096.0,109027,223123.0,-6171.0,-2.84,0.01,High Risk
U925,2024,4,209760.0,Salary Increases & Fixed Expenses Increase,216952,114096.0,94480,208576.0,8376.0,3.86,0.03,High Risk
U925,2024,5,218136.0,Salary Increases & Fixed Expenses Increase,216952,114096.0,92050,206146.0,10806.0,4.98,0.05,High Risk
U925,2024,6,228942.0,Salary Increases & Fixed Expenses Increase,216952,114096.0,121775,235871.0,-18919.0,-8.72,0.04,High Risk
U925,2024,7,210023.0,Salary Increases & Fixed Expenses Increase,216952,114096.0,88647,202743.0,14209.0,6.55,-0.05,High Risk
U925,2024,8,224232.0,Salary Increases & Fixed Expenses Increase,224161,115783.0,122143,237926.0,-13765.0,-6.14,-0.04,High Risk
U925,2024,9,210467.0,Salary Increases & Fixed Expenses Increase,224161,115783.0,109424,225207.0,-1046.0,-0.47,0.01,High Risk
U925,2024,10,209421.0,Salary Increases & Fixed Expenses Increase,224161,117542.0,122268,239810.0,-15649.0,-6.98,0.02,High Risk
U925,2024,11,193772.0,Salary Increases & Fixed Expenses Increase,224161,118055.0,116266,234321.0,-10160.0,-4.53,-0.04,High Risk
U925,2024,12,183612.0,Salary Increases & Fixed Expenses Increase,224161,118055.0,92402,210457.0,13704.0,6.11,0.0,High Risk
U926,2024,1,220255.0,Stable Salary & Increasing Fixed Expenses,115675,52693.0,37042,89735.0,25940.0,22.42,-0.01,Medium Risk
U926,2024,2,246195.0,Stable Salary & Increasing Fixed Expenses,115675,52693.0,37867,90560.0,25115.0,21.71,0.0,Medium Risk
U926,2024,3,271310.0,Stable Salary & Increasing Fixed Expenses,115675,52693.0,45015,97708.0,17967.0,15.53,-0.0,Medium Risk
U926,2024,4,289277.0,Stable Salary & Increasing Fixed Expenses,115675,52693.0,43564,96257.0,19418.0,16.79,0.04,Medium Risk
U926,2024,5,308695.0,Stable Salary & Increasing Fixed Expenses,115675,52693.0,39202,91895.0,23780.0,20.56,-0.02,Medium Risk
U926,2024,6,332475.0,Stable Salary & Increasing Fixed Expenses,115675,52693.0,35992,88685.0,26990.0,23.33,-0.01,Medium Risk
U926,2024,7,359465.0,Stable Salary & Increasing Fixed Expenses,115675,52693.0,41668,94361.0,21314.0,18.43,-0.05,Medium Risk
U926,2024,8,380779.0,Stable Salary & Increasing Fixed Expenses,115675,52693.0,40478,93171.0,22504.0,19.45,0.02,Medium Risk
U926,2024,9,403283.0,Stable Salary & Increasing Fixed Expenses,115675,52693.0,35682,88375.0,27300.0,23.6,0.01,Medium Risk
U926,2024,10,430583.0,Stable Salary & Increasing Fixed Expenses,115675,52693.0,43953,96646.0,19029.0,16.45,0.03,Medium Risk
U926,2024,11,449612.0,Stable Salary & Increasing Fixed Expenses,115675,52693.0,44725,97418.0,18257.0,15.78,-0.04,Medium Risk
U926,2024,12,467869.0,Stable Salary & Increasing Fixed Expenses,115675,52693.0,40923,93616.0,22059.0,19.07,0.0,Medium Risk
U927,2024,1,206245.0,Stable Salary & Stable Fixed Expenses,224092,91297.0,70190,161487.0,62605.0,27.94,0.02,Low Risk
U927,2024,2,268850.0,Stable Salary & Stable Fixed Expenses,224092,91297.0,69564,160861.0,63231.0,28.22,-0.01,Low Risk
U927,2024,3,332081.0,Stable Salary & Stable Fixed Expenses,224092,91297.0,84086,175383.0,48709.0,21.74,-0.01,Medium Risk
U927,2024,4,380790.0,Stable Salary & Stable Fixed Expenses,224092,91297.0,67727,159024.0,65068.0,29.04,0.0,Low Risk
U927,2024,5,445858.0,Stable Salary & Stable Fixed Expenses,224092,91297.0,83887,175184.0,48908.0,21.82,0.03,Medium Risk
U927,2024,6,494766.0,Stable Salary & Stable Fixed Expenses,224092,91297.0,87587,178884.0,45208.0,20.17,-0.05,Medium Risk
U927,2024,7,539974.0,Stable Salary & Stable Fixed Expenses,224092,91297.0,70736,162033.0,62059.0,27.69,0.03,Low Risk
U927,2024,8,602033.0,Stable Salary & Stable Fixed Expenses,224092,91297.0,87054,178351.0,45741.0,20.41,0.04,Medium Risk
U927,2024,9,647774.0,Stable Salary & Stable Fixed Expenses,224092,91297.0,73571,164868.0,59224.0,26.43,0.0,Low Risk
U927,2024,10,706998.0,Stable Salary & Stable Fixed Expenses,224092,91297.0,74882,166179.0,57913.0,25.84,-0.04,Low Risk
U927,2024,11,764911.0,Stable Salary & Stable Fixed Expenses,224092,91297.0,86939,178236.0,45856.0,20.46,-0.01,Medium Risk
U927,2024,12,810767.0,Stable Salary & Stable Fixed Expenses,224092,91297.0,83204,174501.0,49591.0,22.13,-0.04,Medium Risk
U928,2024,1,223650.0,Salary Increases & Fixed Expenses Remain Stable,25888,17007.0,13832,30839.0,-4951.0,-19.12,0.04,High Risk
U928,2024,2,218699.0,Salary Increases & Fixed Expenses Remain Stable,25888,17007.0,14030,31037.0,-5149.0,-19.89,-0.05,High Risk
U928,2024,3,213550.0,Salary Increases & Fixed Expenses Remain Stable,25888,17007.0,15781,32788.0,-6900.0,-26.65,0.03,High Risk
U928,2024,4,206650.0,Salary Increases & Fixed Expenses Remain Stable,25888,17007.0,12183,29190.0,-3302.0,-12.75,-0.0,High Risk
U928,2024,5,203348.0,Salary Increases & Fixed Expenses Remain Stable,35290,17007.0,14676,31683.0,3607.0,10.22,-0.05,High Risk
U928,2024,6,206955.0,Salary Increases & Fixed Expenses Remain Stable,35290,17007.0,16326,33333.0,1957.0,5.55,0.04,High Risk
U928,2024,7,208912.0,Salary Increases & Fixed Expenses Remain Stable,35290,17007.0,19390,36397.0,-1107.0,-3.14,0.02,High Risk
U928,2024,8,207805.0,Salary Increases & Fixed Expenses Remain Stable,35290,17007.0,17201,34208.0,1082.0,3.07,-0.02,High Risk
U928,2024,9,208887.0,Salary Increases & Fixed Expenses Remain Stable,35290,17007.0,15910,32917.0,2373.0,6.72,-0.03,High Risk
U928,2024,10,211260.0,Salary Increases & Fixed Expenses Remain Stable,35290,17007.0,21668,38675.0,-3385.0,-9.59,-0.04,High Risk
U928,2024,11,207875.0,Salary Increases & Fixed Expenses Remain Stable,35290,17007.0,17799,34806.0,484.0,1.37,-0.02,High Risk
U928,2024,12,208359.0,Salary Increases & Fixed Expenses Remain Stable,35290,17007.0,22124,39131.0,-3841.0,-10.88,-0.03,High Risk
U929,2024,1,237795.0,Salary Increases & Fixed Expenses Remain Stable,92592,32100.0,43310,75410.0,17182.0,18.56,0.03,Medium Risk
U929,2024,2,254977.0,Salary Increases & Fixed Expenses Remain Stable,92592,32100.0,54492,86592.0,6000.0,6.48,-0.03,High Risk
U929,2024,3,260977.0,Salary Increases & Fixed Expenses Remain Stable,92592,32100.0,57624,89724.0,2868.0,3.1,-0.04,High Risk
U929,2024,4,263845.0,Salary Increases & Fixed Expenses Remain Stable,92592,32100.0,52376,84476.0,8116.0,8.77,-0.01,High Risk
U929,2024,5,271961.0,Salary Increases & Fixed Expenses Remain Stable,92592,32100.0,50022,82122.0,10470.0,11.31,0.03,High Risk
U929,2024,6,282431.0,Salary Increases & Fixed Expenses Remain Stable,92592,32100.0,51598,83698.0,8894.0,9.61,0.04,High Risk
U929,2024,7,291325.0,Salary Increases & Fixed Expenses Remain Stable,92592,32100.0,50951,83051.0,9541.0,10.3,-0.02,High Risk
U929,2024,8,300866.0,Salary Increases & Fixed Expenses Remain Stable,98484,32100.0,44052,76152.0,22332.0,22.68,0.02,Medium Risk
U929,2024,9,323198.0,Salary Increases & Fixed Expenses Remain Stable,98484,32100.0,50262,82362.0,16122.0,16.37,-0.03,Medium Risk
U929,2024,10,339320.0,Salary Increases & Fixed Expenses Remain Stable,98484,32100.0,48806,80906.0,17578.0,17.85,0.05,Medium Risk
U929,2024,11,356898.0,Salary Increases & Fixed Expenses Remain Stable,98484,32100.0,44816,76916.0,21568.0,21.9,0.03,Medium Risk
U929,2024,12,378466.0,Salary Increases & Fixed Expenses Remain Stable,98484,32100.0,67532,99632.0,-1148.0,-1.17,-0.01,High Risk
U930,2024,1,249189.0,Salary Increases & Fixed Expenses Remain Stable,100865,78098.0,42891,120989.0,-20124.0,-19.95,-0.03,High Risk
U930,2024,2,229065.0,Salary Increases & Fixed Expenses Remain Stable,100865,78098.0,46661,124759.0,-23894.0,-23.69,0.02,High Risk
U930,2024,3,205171.0,Salary Increases & Fixed Expenses Remain Stable,100865,78098.0,56635,134733.0,-33868.0,-33.58,-0.03,High Risk
U930,2024,4,171303.0,Salary Increases & Fixed Expenses Remain Stable,100865,78098.0,59819,137917.0,-37052.0,-36.73,-0.04,High Risk
U930,2024,5,134251.0,Salary Increases & Fixed Expenses Remain Stable,100865,78098.0,47636,125734.0,-24869.0,-24.66,0.04,High Risk
U930,2024,6,109382.0,Salary Increases & Fixed Expenses Remain Stable,127776,78098.0,51512,129610.0,-1834.0,-1.44,-0.01,High Risk
U930,2024,7,107548.0,Salary Increases & Fixed Expenses Remain Stable,127776,78098.0,72712,150810.0,-23034.0,-18.03,0.02,High Risk
U930,2024,8,84514.0,Salary Increases & Fixed Expenses Remain Stable,127776,78098.0,57900,135998.0,-8222.0,-6.43,-0.02,High Risk
U930,2024,9,76292.0,Salary Increases & Fixed Expenses Remain Stable,127776,78098.0,58903,137001.0,-9225.0,-7.22,0.01,High Risk
U930,2024,10,67067.0,Salary Increases & Fixed Expenses Remain Stable,127776,78098.0,79857,157955.0,-30179.0,-23.62,0.0,High Risk
U930,2024,11,36888.0,Salary Increases & Fixed Expenses Remain Stable,127776,78098.0,63864,141962.0,-14186.0,-11.1,-0.01,High Risk
U930,2024,12,22702.0,Salary Increases & Fixed Expenses Remain Stable,127776,78098.0,73167,151265.0,-23489.0,-18.38,0.03,High Risk
U931,2024,1,231724.0,Stable Salary & Increasing Fixed Expenses,124370,77902.0,45263,123165.0,1205.0,0.97,-0.02,High Risk
U931,2024,2,232929.0,Stable Salary & Increasing Fixed Expenses,124370,77902.0,45638,123540.0,830.0,0.67,0.02,High Risk
U931,2024,3,233759.0,Stable Salary & Increasing Fixed Expenses,124370,77902.0,44757,122659.0,1711.0,1.38,0.01,High Risk
U931,2024,4,235470.0,Stable Salary & Increasing Fixed Expenses,124370,77902.0,41970,119872.0,4498.0,3.62,-0.02,High Risk
U931,2024,5,239968.0,Stable Salary & Increasing Fixed Expenses,124370,77902.0,38775,116677.0,7693.0,6.19,0.0,High Risk
U931,2024,6,247661.0,Stable Salary & Increasing Fixed Expenses,124370,77902.0,46917,124819.0,-449.0,-0.36,0.03,High Risk
U931,2024,7,247212.0,Stable Salary & Increasing Fixed Expenses,124370,77902.0,41794,119696.0,4674.0,3.76,-0.04,High Risk
U931,2024,8,251886.0,Stable Salary & Increasing Fixed Expenses,124370,78490.0,40591,119081.0,5289.0,4.25,-0.01,High Risk
U931,2024,9,257175.0,Stable Salary & Increasing Fixed Expenses,124370,78490.0,42631,121121.0,3249.0,2.61,0.04,High Risk
U931,2024,10,260424.0,Stable Salary & Increasing Fixed Expenses,124370,78490.0,56559,135049.0,-10679.0,-8.59,0.01,High Risk
U931,2024,11,249745.0,Stable Salary & Increasing Fixed Expenses,124370,78490.0,38423,116913.0,7457.0,6.0,-0.01,High Risk
U931,2024,12,257202.0,Stable Salary & Increasing Fixed Expenses,124370,78490.0,48357,126847.0,-2477.0,-1.99,0.03,High Risk
U932,2024,1,207365.0,Stable Salary & Stable Fixed Expenses,65522,31701.0,35270,66971.0,-1449.0,-2.21,0.04,High Risk
U932,2024,2,205916.0,Stable Salary & Stable Fixed Expenses,65522,31701.0,34931,66632.0,-1110.0,-1.69,-0.05,High Risk
U932,2024,3,204806.0,Stable Salary & Stable Fixed Expenses,65522,31701.0,37589,69290.0,-3768.0,-5.75,-0.04,High Risk
U932,2024,4,201038.0,Stable Salary & Stable Fixed Expenses,65522,31701.0,38143,69844.0,-4322.0,-6.6,-0.05,High Risk
U932,2024,5,196716.0,Stable Salary & Stable Fixed Expenses,65522,31701.0,29944,61645.0,3877.0,5.92,-0.03,High Risk
U932,2024,6,200593.0,Stable Salary & Stable Fixed Expenses,65522,31701.0,33905,65606.0,-84.0,-0.13,0.02,High Risk
U932,2024,7,200509.0,Stable Salary & Stable Fixed Expenses,65522,31701.0,28865,60566.0,4956.0,7.56,-0.03,High Risk
U932,2024,8,205465.0,Stable Salary & Stable Fixed Expenses,65522,31701.0,27032,58733.0,6789.0,10.36,0.04,High Risk
U932,2024,9,212254.0,Stable Salary & Stable Fixed Expenses,65522,31701.0,28943,60644.0,4878.0,7.44,0.02,High Risk
U932,2024,10,217132.0,Stable Salary & Stable Fixed Expenses,65522,31701.0,30639,62340.0,3182.0,4.86,-0.04,High Risk
U932,2024,11,220314.0,Stable Salary & Stable Fixed Expenses,65522,31701.0,38255,69956.0,-4434.0,-6.77,-0.02,High Risk
U932,2024,12,215880.0,Stable Salary & Stable Fixed Expenses,65522,31701.0,32124,63825.0,1697.0,2.59,0.03,High Risk
U933,2024,1,209344.0,Salary Increases & Fixed Expenses Remain Stable,220087,113391.0,100890,214281.0,5806.0,2.64,-0.03,High Risk
U933,2024,2,215150.0,Salary Increases & Fixed Expenses Remain Stable,220087,113391.0,115285,228676.0,-8589.0,-3.9,0.0,High Risk
U933,2024,3,206561.0,Salary Increases & Fixed Expenses Remain Stable,250040,113391.0,146871,260262.0,-10222.0,-4.09,0.01,High Risk
U933,2024,4,196339.0,Salary Increases & Fixed Expenses Remain Stable,250040,113391.0,112792,226183.0,23857.0,9.54,0.05,High Risk
U933,2024,5,220196.0,Salary Increases & Fixed Expenses Remain Stable,250040,113391.0,125521,238912.0,11128.0,4.45,0.01,High Risk
U933,2024,6,231324.0,Salary Increases & Fixed Expenses Remain Stable,250040,113391.0,125173,238564.0,11476.0,4.59,-0.01,High Risk
U933,2024,7,242800.0,Salary Increases & Fixed Expenses Remain Stable,250040,113391.0,131164,244555.0,5485.0,2.19,0.03,High Risk
U933,2024,8,248285.0,Salary Increases & Fixed Expenses Remain Stable,250040,113391.0,141627,255018.0,-4978.0,-1.99,-0.04,High Risk
U933,2024,9,243307.0,Salary Increases & Fixed Expenses Remain Stable,250040,113391.0,142518,255909.0,-5869.0,-2.35,0.03,High Risk
U933,2024,10,237438.0,Salary Increases & Fixed Expenses Remain Stable,250040,113391.0,142622,256013.0,-5973.0,-2.39,-0.01,High Risk
U933,2024,11,231465.0,Salary Increases & Fixed Expenses Remain Stable,250040,113391.0,148700,262091.0,-12051.0,-4.82,-0.01,High Risk
U933,2024,12,219414.0,Salary Increases & Fixed Expenses Remain Stable,250040,113391.0,142508,255899.0,-5859.0,-2.34,-0.02,High Risk
U934,2024,1,239835.0,Stable Salary & Increasing Fixed Expenses,50607,38420.0,33373,71793.0,-21186.0,-41.86,0.02,High Risk
U934,2024,2,218649.0,Stable Salary & Increasing Fixed Expenses,50607,38420.0,40064,78484.0,-27877.0,-55.09,0.04,High Risk
U934,2024,3,190772.0,Stable Salary & Increasing Fixed Expenses,50607,38420.0,45477,83897.0,-33290.0,-65.78,-0.01,High Risk
U934,2024,4,157482.0,Stable Salary & Increasing Fixed Expenses,50607,38420.0,38465,76885.0,-26278.0,-51.93,0.0,High Risk
U934,2024,5,131204.0,Stable Salary & Increasing Fixed Expenses,50607,38420.0,39406,77826.0,-27219.0,-53.79,0.03,High Risk
U934,2024,6,103985.0,Stable Salary & Increasing Fixed Expenses,50607,38420.0,32949,71369.0,-20762.0,-41.03,-0.03,High Risk
U934,2024,7,83223.0,Stable Salary & Increasing Fixed Expenses,50607,38420.0,30912,69332.0,-18725.0,-37.0,0.04,High Risk
U934,2024,8,64498.0,Stable Salary & Increasing Fixed Expenses,50607,38420.0,31553,69973.0,-19366.0,-38.27,0.03,High Risk
U934,2024,9,45132.0,Stable Salary & Increasing Fixed Expenses,50607,38420.0,42705,81125.0,-30518.0,-60.3,0.01,High Risk
U934,2024,10,14614.0,Stable Salary & Increasing Fixed Expenses,50607,38420.0,43487,81907.0,-31300.0,-61.85,-0.01,High Risk
U934,2024,11,-16686.0,Stable Salary & Increasing Fixed Expenses,50607,38420.0,39635,78055.0,-27448.0,-54.24,-0.04,High Risk
U934,2024,12,-44134.0,Stable Salary & Increasing Fixed Expenses,50607,38420.0,42882,81302.0,-30695.0,-60.65,-0.01,High Risk
U935,2024,1,230234.0,Salary Increases & Fixed Expenses Increase,100793,45878.0,50180,96058.0,4735.0,4.7,-0.01,High Risk
U935,2024,2,234969.0,Salary Increases & Fixed Expenses Increase,100793,47437.0,41935,89372.0,11421.0,11.33,0.01,High Risk
U935,2024,3,246390.0,Salary Increases & Fixed Expenses Increase,108181,47437.0,75993,123430.0,-15249.0,-14.1,0.03,High Risk
U935,2024,4,231141.0,Salary Increases & Fixed Expenses Increase,108181,47437.0,49986,97423.0,10758.0,9.94,-0.05,High Risk
U935,2024,5,241899.0,Salary Increases & Fixed Expenses Increase,108181,47437.0,57240,104677.0,3504.0,3.24,0.05,High Risk
U935,2024,6,245403.0,Salary Increases & Fixed Expenses Increase,108181,47437.0,55543,102980.0,5201.0,4.81,0.02,High Risk
U935,2024,7,250604.0,Salary Increases & Fixed Expenses Increase,108181,48569.0,43918,92487.0,15694.0,14.51,-0.04,High Risk
U935,2024,8,266298.0,Salary Increases & Fixed Expenses Increase,108181,48569.0,49332,97901.0,10280.0,9.5,0.04,High Risk
U935,2024,9,276578.0,Salary Increases & Fixed Expenses Increase,108181,48569.0,63852,112421.0,-4240.0,-3.92,-0.04,High Risk
U935,2024,10,272338.0,Salary Increases & Fixed Expenses Increase,108181,50503.0,60497,111000.0,-2819.0,-2.61,0.03,High Risk
U935,2024,11,269519.0,Salary Increases & Fixed Expenses Increase,108181,50503.0,64588,115091.0,-6910.0,-6.39,0.01,High Risk
U935,2024,12,262609.0,Salary Increases & Fixed Expenses Increase,108181,50503.0,58088,108591.0,-410.0,-0.38,-0.02,High Risk
U936,2024,1,219786.0,Salary Increases & Fixed Expenses Remain Stable,73759,32409.0,40458,72867.0,892.0,1.21,0.02,High Risk
U936,2024,2,220678.0,Salary Increases & Fixed Expenses Remain Stable,73759,32409.0,40265,72674.0,1085.0,1.47,-0.02,High Risk
U936,2024,3,221763.0,Salary Increases & Fixed Expenses Remain Stable,73759,32409.0,39105,71514.0,2245.0,3.04,0.03,High Risk
U936,2024,4,224008.0,Salary Increases & Fixed Expenses Remain Stable,73759,32409.0,29576,61985.0,11774.0,15.96,0.0,Medium Risk
U936,2024,5,235782.0,Salary Increases & Fixed Expenses Remain Stable,73759,32409.0,35915,68324.0,5435.0,7.37,0.02,High Risk
U936,2024,6,241217.0,Salary Increases & Fixed Expenses Remain Stable,80163,32409.0,35081,67490.0,12673.0,15.81,-0.02,Medium Risk
U936,2024,7,253890.0,Salary Increases & Fixed Expenses Remain Stable,80163,32409.0,46844,79253.0,910.0,1.14,-0.03,High Risk
U936,2024,8,254800.0,Salary Increases & Fixed Expenses Remain Stable,80163,32409.0,38838,71247.0,8916.0,11.12,-0.03,High Risk
U936,2024,9,263716.0,Salary Increases & Fixed Expenses Remain Stable,80163,32409.0,44347,76756.0,3407.0,4.25,-0.03,High Risk
U936,2024,10,267123.0,Salary Increases & Fixed Expenses Remain Stable,80163,32409.0,32281,64690.0,15473.0,19.3,0.01,Medium Risk
U936,2024,11,282596.0,Salary Increases & Fixed Expenses Remain Stable,80163,32409.0,47571,79980.0,183.0,0.23,0.04,High Risk
U936,2024,12,282779.0,Salary Increases & Fixed Expenses Remain Stable,80163,32409.0,38441,70850.0,9313.0,11.62,0.04,High Risk
U937,2024,1,242630.0,Salary Increases & Fixed Expenses Increase,144732,47971.0,56464,104435.0,40297.0,27.84,-0.03,Low Risk
U937,2024,2,282927.0,Salary Increases & Fixed Expenses Increase,144732,47971.0,44240,92211.0,52521.0,36.29,0.02,Low Risk
U937,2024,3,335448.0,Salary Increases & Fixed Expenses Increase,144732,47971.0,65294,113265.0,31467.0,21.74,-0.03,Medium Risk
U937,2024,4,366915.0,Salary Increases & Fixed Expenses Increase,144732,47971.0,45363,93334.0,51398.0,35.51,-0.02,Low Risk
U937,2024,5,418313.0,Salary Increases & Fixed Expenses Increase,144732,49609.0,44188,93797.0,50935.0,35.19,-0.0,Low Risk
U937,2024,6,469248.0,Salary Increases & Fixed Expenses Increase,144732,51204.0,47132,98336.0,46396.0,32.06,0.03,Low Risk
U937,2024,7,515644.0,Salary Increases & Fixed Expenses Increase,144732,51754.0,48880,100634.0,44098.0,30.47,0.02,Low Risk
U937,2024,8,559742.0,Salary Increases & Fixed Expenses Increase,159951,51754.0,58787,110541.0,49410.0,30.89,-0.04,Low Risk
U937,2024,9,609152.0,Salary Increases & Fixed Expenses Increase,159951,51754.0,55545,107299.0,52652.0,32.92,-0.02,Low Risk
U937,2024,10,661804.0,Salary Increases & Fixed Expenses Increase,159951,51754.0,80146,131900.0,28051.0,17.54,0.03,Medium Risk
U937,2024,11,689855.0,Salary Increases & Fixed Expenses Increase,159951,51754.0,49121,100875.0,59076.0,36.93,0.05,Low Risk
U937,2024,12,748931.0,Salary Increases & Fixed Expenses Increase,159951,51754.0,52918,104672.0,55279.0,34.56,0.01,Low Risk
U938,2024,1,225748.0,Stable Salary & Decreasing Fixed Expenses,27848,13623.0,8906,22529.0,5319.0,19.1,0.0,Medium Risk
U938,2024,2,231067.0,Stable Salary & Decreasing Fixed Expenses,27848,13623.0,10086,23709.0,4139.0,14.86,-0.0,High Risk
U938,2024,3,235206.0,Stable Salary & Decreasing Fixed Expenses,27848,13623.0,11637,25260.0,2588.0,9.29,0.04,High Risk
U938,2024,4,237794.0,Stable Salary & Decreasing Fixed Expenses,27848,13623.0,11099,24722.0,3126.0,11.23,0.03,High Risk
U938,2024,5,240920.0,Stable Salary & Decreasing Fixed Expenses,27848,13623.0,10152,23775.0,4073.0,14.63,-0.03,High Risk
U938,2024,6,244993.0,Stable Salary & Decreasing Fixed Expenses,27848,13623.0,9728,23351.0,4497.0,16.15,0.05,Medium Risk
U938,2024,7,249490.0,Stable Salary & Decreasing Fixed Expenses,27848,12934.0,8466,21400.0,6448.0,23.15,-0.03,Medium Risk
U938,2024,8,255938.0,Stable Salary & Decreasing Fixed Expenses,27848,12934.0,10033,22967.0,4881.0,17.53,-0.04,Medium Risk
U938,2024,9,260819.0,Stable Salary & Decreasing Fixed Expenses,27848,12934.0,10079,23013.0,4835.0,17.36,-0.01,Medium Risk
U938,2024,10,265654.0,Stable Salary & Decreasing Fixed Expenses,27848,12934.0,12086,25020.0,2828.0,10.16,-0.0,High Risk
U938,2024,11,268482.0,Stable Salary & Decreasing Fixed Expenses,27848,12934.0,12045,24979.0,2869.0,10.3,-0.01,High Risk
U938,2024,12,271351.0,Stable Salary & Decreasing Fixed Expenses,27848,12934.0,11654,24588.0,3260.0,11.71,0.01,High Risk
U939,2024,1,222684.0,Stable Salary & Stable Fixed Expenses,151702,52640.0,46423,99063.0,52639.0,34.7,0.04,Low Risk
U939,2024,2,275323.0,Stable Salary & Stable Fixed Expenses,151702,52640.0,49513,102153.0,49549.0,32.66,0.04,Low Risk
U939,2024,3,324872.0,Stable Salary & Stable Fixed Expenses,151702,52640.0,68582,121222.0,30480.0,20.09,-0.0,Medium Risk
U939,2024,4,355352.0,Stable Salary & Stable Fixed Expenses,151702,52640.0,51294,103934.0,47768.0,31.49,-0.03,Low Risk
U939,2024,5,403120.0,Stable Salary & Stable Fixed Expenses,151702,52640.0,54529,107169.0,44533.0,29.36,-0.03,Low Risk
U939,2024,6,447653.0,Stable Salary & Stable Fixed Expenses,151702,52640.0,57733,110373.0,41329.0,27.24,0.04,Low Risk
U939,2024,7,488982.0,Stable Salary & Stable Fixed Expenses,151702,52640.0,48935,101575.0,50127.0,33.04,0.03,Low Risk
U939,2024,8,539109.0,Stable Salary & Stable Fixed Expenses,151702,52640.0,48550,101190.0,50512.0,33.3,0.02,Low Risk
U939,2024,9,589621.0,Stable Salary & Stable Fixed Expenses,151702,52640.0,50478,103118.0,48584.0,32.03,0.05,Low Risk
U939,2024,10,638205.0,Stable Salary & Stable Fixed Expenses,151702,52640.0,64331,116971.0,34731.0,22.89,-0.05,Medium Risk
U939,2024,11,672936.0,Stable Salary & Stable Fixed Expenses,151702,52640.0,51498,104138.0,47564.0,31.35,-0.03,Low Risk
U939,2024,12,720500.0,Stable Salary & Stable Fixed Expenses,151702,52640.0,59288,111928.0,39774.0,26.22,0.02,Low Risk
U940,2024,1,221237.0,Salary Increases & Fixed Expenses Remain Stable,70075,38605.0,41834,80439.0,-10364.0,-14.79,0.03,High Risk
U940,2024,2,210873.0,Salary Increases & Fixed Expenses Remain Stable,70075,38605.0,34126,72731.0,-2656.0,-3.79,-0.02,High Risk
U940,2024,3,208217.0,Salary Increases & Fixed Expenses Remain Stable,88540,38605.0,42021,80626.0,7914.0,8.94,0.02,High Risk
U940,2024,4,216131.0,Salary Increases & Fixed Expenses Remain Stable,88540,38605.0,38664,77269.0,11271.0,12.73,0.01,High Risk
U940,2024,5,227402.0,Salary Increases & Fixed Expenses Remain Stable,88540,38605.0,46373,84978.0,3562.0,4.02,-0.04,High Risk
U940,2024,6,230964.0,Salary Increases & Fixed Expenses Remain Stable,88540,38605.0,36712,75317.0,13223.0,14.93,-0.02,High Risk
U940,2024,7,244187.0,Salary Increases & Fixed Expenses Remain Stable,88540,38605.0,35588,74193.0,14347.0,16.2,-0.01,Medium Risk
U940,2024,8,258534.0,Salary Increases & Fixed Expenses Remain Stable,88540,38605.0,36208,74813.0,13727.0,15.5,-0.0,Medium Risk
U940,2024,9,272261.0,Salary Increases & Fixed Expenses Remain Stable,88540,38605.0,43853,82458.0,6082.0,6.87,-0.03,High Risk
U940,2024,10,278343.0,Salary Increases & Fixed Expenses Remain Stable,88540,38605.0,48078,86683.0,1857.0,2.1,-0.05,High Risk
U940,2024,11,280200.0,Salary Increases & Fixed Expenses Remain Stable,88540,38605.0,41498,80103.0,8437.0,9.53,0.02,High Risk
U940,2024,12,288637.0,Salary Increases & Fixed Expenses Remain Stable,88540,38605.0,44592,83197.0,5343.0,6.03,-0.01,High Risk
U941,2024,1,245777.0,Salary Increases & Fixed Expenses Increase,167514,41293.0,67790,109083.0,58431.0,34.88,0.04,Low Risk
U941,2024,2,304208.0,Salary Increases & Fixed Expenses Increase,167514,42055.0,94338,136393.0,31121.0,18.58,-0.02,Medium Risk
U941,2024,3,335329.0,Salary Increases & Fixed Expenses Increase,167514,42055.0,114974,157029.0,10485.0,6.26,-0.01,High Risk
U941,2024,4,345814.0,Salary Increases & Fixed Expenses Increase,182891,42895.0,79808,122703.0,60188.0,32.91,-0.03,Low Risk
U941,2024,5,406002.0,Salary Increases & Fixed Expenses Increase,182891,42895.0,79497,122392.0,60499.0,33.08,-0.03,Low Risk
U941,2024,6,466501.0,Salary Increases & Fixed Expenses Increase,182891,42895.0,76170,119065.0,63826.0,34.9,-0.03,Low Risk
U941,2024,7,530327.0,Salary Increases & Fixed Expenses Increase,182891,42895.0,109300,152195.0,30696.0,16.78,-0.01,Medium Risk
U941,2024,8,561023.0,Salary Increases & Fixed Expenses Increase,182891,42895.0,107268,150163.0,32728.0,17.89,0.0,Medium Risk
U941,2024,9,593751.0,Salary Increases & Fixed Expenses Increase,182891,43822.0,94202,138024.0,44867.0,24.53,0.02,Medium Risk
U941,2024,10,638618.0,Salary Increases & Fixed Expenses Increase,182891,43822.0,107042,150864.0,32027.0,17.51,-0.03,Medium Risk
U941,2024,11,670645.0,Salary Increases & Fixed Expenses Increase,182891,43822.0,101595,145417.0,37474.0,20.49,-0.04,Medium Risk
U941,2024,12,708119.0,Salary Increases & Fixed Expenses Increase,182891,43822.0,80801,124623.0,58268.0,31.86,0.01,Low Risk
U942,2024,1,211776.0,Salary Increases & Fixed Expenses Remain Stable,158700,79233.0,55009,134242.0,24458.0,15.41,0.01,Medium Risk
U942,2024,2,236234.0,Salary Increases & Fixed Expenses Remain Stable,158700,79233.0,62954,142187.0,16513.0,10.41,0.02,High Risk
U942,2024,3,252747.0,Salary Increases & Fixed Expenses Remain Stable,158700,79233.0,56682,135915.0,22785.0,14.36,0.0,High Risk
U942,2024,4,275532.0,Salary Increases & Fixed Expenses Remain Stable,158700,79233.0,59648,138881.0,19819.0,12.49,0.01,High Risk
U942,2024,5,295351.0,Salary Increases & Fixed Expenses Remain Stable,158700,79233.0,48207,127440.0,31260.0,19.7,0.01,Medium Risk
U942,2024,6,326611.0,Salary Increases & Fixed Expenses Remain Stable,168924,79233.0,52423,131656.0,37268.0,22.06,-0.0,Medium Risk
U942,2024,7,363879.0,Salary Increases & Fixed Expenses Remain Stable,168924,79233.0,51390,130623.0,38301.0,22.67,0.01,Medium Risk
U942,2024,8,402180.0,Salary Increases & Fixed Expenses Remain Stable,168924,79233.0,57765,136998.0,31926.0,18.9,-0.03,Medium Risk
U942,2024,9,434106.0,Salary Increases & Fixed Expenses Remain Stable,168924,79233.0,51672,130905.0,38019.0,22.51,-0.0,Medium Risk
U942,2024,10,472125.0,Salary Increases & Fixed Expenses Remain Stable,168924,79233.0,52605,131838.0,37086.0,21.95,-0.02,Medium Risk
U942,2024,11,509211.0,Salary Increases & Fixed Expenses Remain Stable,168924,79233.0,52595,131828.0,37096.0,21.96,0.05,Medium Risk
U942,2024,12,546307.0,Salary Increases & Fixed Expenses Remain Stable,168924,79233.0,58414,137647.0,31277.0,18.52,0.03,Medium Risk
U943,2024,1,223634.0,Salary Increases & Fixed Expenses Remain Stable,101397,45417.0,50164,95581.0,5816.0,5.74,0.03,High Risk
U943,2024,2,229450.0,Salary Increases & Fixed Expenses Remain Stable,101397,45417.0,45768,91185.0,10212.0,10.07,-0.04,High Risk
U943,2024,3,239662.0,Salary Increases & Fixed Expenses Remain Stable,101397,45417.0,57029,102446.0,-1049.0,-1.03,-0.01,High Risk
U943,2024,4,238613.0,Salary Increases & Fixed Expenses Remain Stable,101397,45417.0,54743,100160.0,1237.0,1.22,-0.03,High Risk
U943,2024,5,239850.0,Salary Increases & Fixed Expenses Remain Stable,101397,45417.0,52711,98128.0,3269.0,3.22,0.02,High Risk
U943,2024,6,243119.0,Salary Increases & Fixed Expenses Remain Stable,101397,45417.0,60034,105451.0,-4054.0,-4.0,-0.02,High Risk
U943,2024,7,239065.0,Salary Increases & Fixed Expenses Remain Stable,101397,45417.0,51078,96495.0,4902.0,4.83,-0.02,High Risk
U943,2024,8,243967.0,Salary Increases & Fixed Expenses Remain Stable,122105,45417.0,55962,101379.0,20726.0,16.97,0.05,Medium Risk
U943,2024,9,264693.0,Salary Increases & Fixed Expenses Remain Stable,122105,45417.0,69554,114971.0,7134.0,5.84,0.03,High Risk
U943,2024,10,271827.0,Salary Increases & Fixed Expenses Remain Stable,122105,45417.0,75306,120723.0,1382.0,1.13,-0.02,High Risk
U943,2024,11,273209.0,Salary Increases & Fixed Expenses Remain Stable,122105,45417.0,70798,116215.0,5890.0,4.82,0.05,High Risk
U943,2024,12,279099.0,Salary Increases & Fixed Expenses Remain Stable,122105,45417.0,68562,113979.0,8126.0,6.65,-0.04,High Risk
U944,2024,1,205498.0,Salary Increases & Fixed Expenses Remain Stable,192852,63293.0,85554,148847.0,44005.0,22.82,0.04,Medium Risk
U944,2024,2,249503.0,Salary Increases & Fixed Expenses Remain Stable,192852,63293.0,104098,167391.0,25461.0,13.2,0.01,High Risk
U944,2024,3,274964.0,Salary Increases & Fixed Expenses Remain Stable,210108,63293.0,111176,174469.0,35639.0,16.96,0.05,Medium Risk
U944,2024,4,310603.0,Salary Increases & Fixed Expenses Remain Stable,210108,63293.0,85269,148562.0,61546.0,29.29,0.01,Low Risk
U944,2024,5,372149.0,Salary Increases & Fixed Expenses Remain Stable,210108,63293.0,95753,159046.0,51062.0,24.3,0.01,Medium Risk
U944,2024,6,423211.0,Salary Increases & Fixed Expenses Remain Stable,210108,63293.0,100948,164241.0,45867.0,21.83,-0.02,Medium Risk
U944,2024,7,469078.0,Salary Increases & Fixed Expenses Remain Stable,210108,63293.0,84878,148171.0,61937.0,29.48,-0.04,Low Risk
U944,2024,8,531015.0,Salary Increases & Fixed Expenses Remain Stable,210108,63293.0,124005,187298.0,22810.0,10.86,-0.04,High Risk
U944,2024,9,553825.0,Salary Increases & Fixed Expenses Remain Stable,210108,63293.0,119564,182857.0,27251.0,12.97,0.01,High Risk
U944,2024,10,581076.0,Salary Increases & Fixed Expenses Remain Stable,210108,63293.0,118553,181846.0,28262.0,13.45,-0.05,High Risk
U944,2024,11,609338.0,Salary Increases & Fixed Expenses Remain Stable,210108,63293.0,98820,162113.0,47995.0,22.84,0.04,Medium Risk
U944,2024,12,657333.0,Salary Increases & Fixed Expenses Remain Stable,210108,63293.0,124260,187553.0,22555.0,10.73,-0.02,High Risk
U945,2024,1,220161.0,Salary Increases & Fixed Expenses Increase,276138,105230.0,112352,217582.0,58556.0,21.21,0.04,Medium Risk
U945,2024,2,278717.0,Salary Increases & Fixed Expenses Increase,276138,105230.0,145510,250740.0,25398.0,9.2,0.0,High Risk
U945,2024,3,304115.0,Salary Increases & Fixed Expenses Increase,276138,105230.0,137351,242581.0,33557.0,12.15,0.04,High Risk
U945,2024,4,337672.0,Salary Increases & Fixed Expenses Increase,276138,105230.0,118931,224161.0,51977.0,18.82,0.03,Medium Risk
U945,2024,5,389649.0,Salary Increases & Fixed Expenses Increase,276138,105230.0,124079,229309.0,46829.0,16.96,-0.03,Medium Risk
U945,2024,6,436478.0,Salary Increases & Fixed Expenses Increase,276138,106320.0,146922,253242.0,22896.0,8.29,-0.05,High Risk
U945,2024,7,459374.0,Salary Increases & Fixed Expenses Increase,288334,106320.0,126026,232346.0,55988.0,19.42,0.04,Medium Risk
U945,2024,8,515362.0,Salary Increases & Fixed Expenses Increase,288334,106320.0,126161,232481.0,55853.0,19.37,-0.0,Medium Risk
U945,2024,9,571215.0,Salary Increases & Fixed Expenses Increase,288334,106320.0,121740,228060.0,60274.0,20.9,-0.0,Medium Risk
U945,2024,10,631489.0,Salary Increases & Fixed Expenses Increase,288334,106320.0,126647,232967.0,55367.0,19.2,-0.03,Medium Risk
U945,2024,11,686856.0,Salary Increases & Fixed Expenses Increase,288334,106320.0,162449,268769.0,19565.0,6.79,-0.0,High Risk
U945,2024,12,706421.0,Salary Increases & Fixed Expenses Increase,288334,106320.0,171700,278020.0,10314.0,3.58,0.0,High Risk
U946,2024,1,212381.0,Salary Increases & Fixed Expenses Remain Stable,73196,29475.0,27489,56964.0,16232.0,22.18,0.05,Medium Risk
U946,2024,2,228613.0,Salary Increases & Fixed Expenses Remain Stable,73196,29475.0,25025,54500.0,18696.0,25.54,-0.0,Low Risk
U946,2024,3,247309.0,Salary Increases & Fixed Expenses Remain Stable,73196,29475.0,26173,55648.0,17548.0,23.97,0.02,Medium Risk
U946,2024,4,264857.0,Salary Increases & Fixed Expenses Remain Stable,73196,29475.0,28646,58121.0,15075.0,20.6,-0.03,Medium Risk
U946,2024,5,279932.0,Salary Increases & Fixed Expenses Remain Stable,81876,29475.0,30750,60225.0,21651.0,26.44,-0.02,Low Risk
U946,2024,6,301583.0,Salary Increases & Fixed Expenses Remain Stable,81876,29475.0,31676,61151.0,20725.0,25.31,0.0,Low Risk
U946,2024,7,322308.0,Salary Increases & Fixed Expenses Remain Stable,81876,29475.0,31497,60972.0,20904.0,25.53,-0.02,Low Risk
U946,2024,8,343212.0,Salary Increases & Fixed Expenses Remain Stable,81876,29475.0,30183,59658.0,22218.0,27.14,0.03,Low Risk
U946,2024,9,365430.0,Salary Increases & Fixed Expenses Remain Stable,81876,29475.0,26271,55746.0,26130.0,31.91,0.01,Low Risk
U946,2024,10,391560.0,Salary Increases & Fixed Expenses Remain Stable,81876,29475.0,29265,58740.0,23136.0,28.26,0.03,Low Risk
U946,2024,11,414696.0,Salary Increases & Fixed Expenses Remain Stable,81876,29475.0,26127,55602.0,26274.0,32.09,0.04,Low Risk
U946,2024,12,440970.0,Salary Increases & Fixed Expenses Remain Stable,81876,29475.0,25939,55414.0,26462.0,32.32,0.04,Low Risk
U947,2024,1,245164.0,Salary Increases & Fixed Expenses Remain Stable,56333,38546.0,42840,81386.0,-25053.0,-44.47,-0.04,High Risk
U947,2024,2,220111.0,Salary Increases & Fixed Expenses Remain Stable,56333,38546.0,41579,80125.0,-23792.0,-42.23,0.04,High Risk
U947,2024,3,196319.0,Salary Increases & Fixed Expenses Remain Stable,56333,38546.0,43017,81563.0,-25230.0,-44.79,-0.01,High Risk
U947,2024,4,171089.0,Salary Increases & Fixed Expenses Remain Stable,84115,38546.0,67085,105631.0,-21516.0,-25.58,-0.02,High Risk
U947,2024,5,149573.0,Salary Increases & Fixed Expenses Remain Stable,84115,38546.0,65790,104336.0,-20221.0,-24.04,-0.01,High Risk
U947,2024,6,129352.0,Salary Increases & Fixed Expenses Remain Stable,84115,38546.0,56815,95361.0,-11246.0,-13.37,-0.04,High Risk
U947,2024,7,118106.0,Salary Increases & Fixed Expenses Remain Stable,84115,38546.0,59358,97904.0,-13789.0,-16.39,-0.02,High Risk
U947,2024,8,104317.0,Salary Increases & Fixed Expenses Remain Stable,84115,38546.0,63906,102452.0,-18337.0,-21.8,0.01,High Risk
U947,2024,9,85980.0,Salary Increases & Fixed Expenses Remain Stable,84115,38546.0,50799,89345.0,-5230.0,-6.22,0.01,High Risk
U947,2024,10,80750.0,Salary Increases & Fixed Expenses Remain Stable,84115,38546.0,68911,107457.0,-23342.0,-27.75,0.04,High Risk
U947,2024,11,57408.0,Salary Increases & Fixed Expenses Remain Stable,84115,38546.0,64477,103023.0,-18908.0,-22.48,0.04,High Risk
U947,2024,12,38500.0,Salary Increases & Fixed Expenses Remain Stable,84115,38546.0,64989,103535.0,-19420.0,-23.09,0.03,High Risk
U948,2024,1,227854.0,Salary Increases & Fixed Expenses Increase,233477,84076.0,154623,238699.0,-5222.0,-2.24,0.03,High Risk
U948,2024,2,222632.0,Salary Increases & Fixed Expenses Increase,233477,84076.0,166685,250761.0,-17284.0,-7.4,-0.0,High Risk
U948,2024,3,205348.0,Salary Increases & Fixed Expenses Increase,233477,84076.0,222343,306419.0,-72942.0,-31.24,0.03,High Risk
U948,2024,4,132406.0,Salary Increases & Fixed Expenses Increase,233477,84076.0,183565,267641.0,-34164.0,-14.63,-0.03,High Risk
U948,2024,5,98242.0,Salary Increases & Fixed Expenses Increase,242153,84076.0,176684,260760.0,-18607.0,-7.68,0.03,High Risk
U948,2024,6,79635.0,Salary Increases & Fixed Expenses Increase,242153,84076.0,180074,264150.0,-21997.0,-9.08,-0.01,High Risk
U948,2024,7,57638.0,Salary Increases & Fixed Expenses Increase,242153,85720.0,159361,245081.0,-2928.0,-1.21,-0.0,High Risk
U948,2024,8,54710.0,Salary Increases & Fixed Expenses Increase,242153,85720.0,175188,260908.0,-18755.0,-7.75,-0.02,High Risk
U948,2024,9,35955.0,Salary Increases & Fixed Expenses Increase,242153,85720.0,155581,241301.0,852.0,0.35,-0.05,High Risk
U948,2024,10,36807.0,Salary Increases & Fixed Expenses Increase,242153,85720.0,219376,305096.0,-62943.0,-25.99,0.01,High Risk
U948,2024,11,-26136.0,Salary Increases & Fixed Expenses Increase,242153,85720.0,180859,266579.0,-24426.0,-10.09,0.04,High Risk
U948,2024,12,-50562.0,Salary Increases & Fixed Expenses Increase,242153,85720.0,184683,270403.0,-28250.0,-11.67,0.0,High Risk
U949,2024,1,205438.0,Salary Increases & Fixed Expenses Remain Stable,66923,27879.0,36158,64037.0,2886.0,4.31,-0.04,High Risk
U949,2024,2,208324.0,Salary Increases & Fixed Expenses Remain Stable,66923,27879.0,30961,58840.0,8083.0,12.08,-0.02,High Risk
U949,2024,3,216407.0,Salary Increases & Fixed Expenses Remain Stable,66923,27879.0,40121,68000.0,-1077.0,-1.61,0.03,High Risk
U949,2024,4,215330.0,Salary Increases & Fixed Expenses Remain Stable,83352,27879.0,44142,72021.0,11331.0,13.59,-0.01,High Risk
U949,2024,5,226661.0,Salary Increases & Fixed Expenses Remain Stable,83352,27879.0,37790,65669.0,17683.0,21.21,0.0,Medium Risk
U949,2024,6,244344.0,Salary Increases & Fixed Expenses Remain Stable,83352,27879.0,43668,71547.0,11805.0,14.16,0.02,High Risk
U949,2024,7,256149.0,Salary Increases & Fixed Expenses Remain Stable,83352,27879.0,47769,75648.0,7704.0,9.24,-0.03,High Risk
U949,2024,8,263853.0,Salary Increases & Fixed Expenses Remain Stable,83352,27879.0,48741,76620.0,6732.0,8.08,0.02,High Risk
U949,2024,9,270585.0,Salary Increases & Fixed Expenses Remain Stable,83352,27879.0,46213,74092.0,9260.0,11.11,-0.02,High Risk
U949,2024,10,279845.0,Salary Increases & Fixed Expenses Remain Stable,83352,27879.0,54216,82095.0,1257.0,1.51,-0.0,High Risk
U949,2024,11,281102.0,Salary Increases & Fixed Expenses Remain Stable,83352,27879.0,49553,77432.0,5920.0,7.1,-0.0,High Risk
U949,2024,12,287022.0,Salary Increases & Fixed Expenses Remain Stable,83352,27879.0,50107,77986.0,5366.0,6.44,-0.04,High Risk
U950,2024,1,246170.0,Salary Increases & Fixed Expenses Increase,274324,119078.0,146092,265170.0,9154.0,3.34,0.04,High Risk
U950,2024,2,255324.0,Salary Increases & Fixed Expenses Increase,274324,119078.0,155914,274992.0,-668.0,-0.24,-0.02,High Risk
U950,2024,3,254656.0,Salary Increases & Fixed Expenses Increase,274324,119078.0,179286,298364.0,-24040.0,-8.76,-0.0,High Risk
U950,2024,4,230616.0,Salary Increases & Fixed Expenses Increase,274324,119078.0,148920,267998.0,6326.0,2.31,-0.03,High Risk
U950,2024,5,236942.0,Salary Increases & Fixed Expenses Increase,274324,119078.0,118725,237803.0,36521.0,13.31,0.03,High Risk
U950,2024,6,273463.0,Salary Increases & Fixed Expenses Increase,286986,119078.0,167685,286763.0,223.0,0.08,0.02,High Risk
U950,2024,7,273686.0,Salary Increases & Fixed Expenses Increase,286986,119770.0,140731,260501.0,26485.0,9.23,-0.05,High Risk
U950,2024,8,300171.0,Salary Increases & Fixed Expenses Increase,286986,119770.0,160810,280580.0,6406.0,2.23,0.03,High Risk
U950,2024,9,306577.0,Salary Increases & Fixed Expenses Increase,286986,119770.0,136273,256043.0,30943.0,10.78,-0.02,High Risk
U950,2024,10,337520.0,Salary Increases & Fixed Expenses Increase,286986,119770.0,160400,280170.0,6816.0,2.38,0.04,High Risk
U950,2024,11,344336.0,Salary Increases & Fixed Expenses Increase,286986,119770.0,174226,293996.0,-7010.0,-2.44,0.01,High Risk
U950,2024,12,337326.0,Salary Increases & Fixed Expenses Increase,286986,119770.0,200023,319793.0,-32807.0,-11.43,0.05,High Risk
U951,2024,1,215768.0,Stable Salary & Stable Fixed Expenses,178301,72463.0,103421,175884.0,2417.0,1.36,0.03,High Risk
U951,2024,2,218185.0,Stable Salary & Stable Fixed Expenses,178301,72463.0,100555,173018.0,5283.0,2.96,0.03,High Risk
U951,2024,3,223468.0,Stable Salary & Stable Fixed Expenses,178301,72463.0,110784,183247.0,-4946.0,-2.77,0.02,High Risk
U951,2024,4,218522.0,Stable Salary & Stable Fixed Expenses,178301,72463.0,71750,144213.0,34088.0,19.12,0.0,Medium Risk
U951,2024,5,252610.0,Stable Salary & Stable Fixed Expenses,178301,72463.0,77518,149981.0,28320.0,15.88,0.04,Medium Risk
U951,2024,6,280930.0,Stable Salary & Stable Fixed Expenses,178301,72463.0,106282,178745.0,-444.0,-0.25,-0.01,High Risk
U951,2024,7,280486.0,Stable Salary & Stable Fixed Expenses,178301,72463.0,72963,145426.0,32875.0,18.44,0.0,Medium Risk
U951,2024,8,313361.0,Stable Salary & Stable Fixed Expenses,178301,72463.0,102475,174938.0,3363.0,1.89,0.04,High Risk
U951,2024,9,316724.0,Stable Salary & Stable Fixed Expenses,178301,72463.0,73626,146089.0,32212.0,18.07,0.05,Medium Risk
U951,2024,10,348936.0,Stable Salary & Stable Fixed Expenses,178301,72463.0,93253,165716.0,12585.0,7.06,0.0,High Risk
U951,2024,11,361521.0,Stable Salary & Stable Fixed Expenses,178301,72463.0,77049,149512.0,28789.0,16.15,0.04,Medium Risk
U951,2024,12,390310.0,Stable Salary & Stable Fixed Expenses,178301,72463.0,76520,148983.0,29318.0,16.44,0.04,Medium Risk
U952,2024,1,239760.0,Salary Increases & Fixed Expenses Remain Stable,28107,14471.0,13782,28253.0,-146.0,-0.52,0.04,High Risk
U952,2024,2,239614.0,Salary Increases & Fixed Expenses Remain Stable,28107,14471.0,12621,27092.0,1015.0,3.61,0.04,High Risk
U952,2024,3,240629.0,Salary Increases & Fixed Expenses Remain Stable,28107,14471.0,16690,31161.0,-3054.0,-10.87,-0.04,High Risk
U952,2024,4,237575.0,Salary Increases & Fixed Expenses Remain Stable,28107,14471.0,13054,27525.0,582.0,2.07,-0.0,High Risk
U952,2024,5,238157.0,Salary Increases & Fixed Expenses Remain Stable,28107,14471.0,15332,29803.0,-1696.0,-6.03,0.03,High Risk
U952,2024,6,236461.0,Salary Increases & Fixed Expenses Remain Stable,45620,14471.0,26175,40646.0,4974.0,10.9,0.03,High Risk
U952,2024,7,241435.0,Salary Increases & Fixed Expenses Remain Stable,45620,14471.0,20972,35443.0,10177.0,22.31,-0.02,Medium Risk
U952,2024,8,251612.0,Salary Increases & Fixed Expenses Remain Stable,45620,14471.0,23903,38374.0,7246.0,15.88,0.03,Medium Risk
U952,2024,9,258858.0,Salary Increases & Fixed Expenses Remain Stable,45620,14471.0,19040,33511.0,12109.0,26.54,-0.04,Low Risk
U952,2024,10,270967.0,Salary Increases & Fixed Expenses Remain Stable,45620,14471.0,21806,36277.0,9343.0,20.48,-0.0,Medium Risk
U952,2024,11,280310.0,Salary Increases & Fixed Expenses Remain Stable,45620,14471.0,23590,38061.0,7559.0,16.57,0.04,Medium Risk
U952,2024,12,287869.0,Salary Increases & Fixed Expenses Remain Stable,45620,14471.0,23066,37537.0,8083.0,17.72,-0.04,Medium Risk
U953,2024,1,238489.0,Salary Increases & Fixed Expenses Remain Stable,276833,75158.0,185466,260624.0,16209.0,5.86,-0.02,High Risk
U953,2024,2,254698.0,Salary Increases & Fixed Expenses Remain Stable,276833,75158.0,200351,275509.0,1324.0,0.48,-0.0,High Risk
U953,2024,3,256022.0,Salary Increases & Fixed Expenses Remain Stable,276833,75158.0,192128,267286.0,9547.0,3.45,-0.04,High Risk
U953,2024,4,265569.0,Salary Increases & Fixed Expenses Remain Stable,276833,75158.0,200529,275687.0,1146.0,0.41,-0.01,High Risk
U953,2024,5,266715.0,Salary Increases & Fixed Expenses Remain Stable,276833,75158.0,214536,289694.0,-12861.0,-4.65,0.0,High Risk
U953,2024,6,253854.0,Salary Increases & Fixed Expenses Remain Stable,276833,75158.0,201488,276646.0,187.0,0.07,0.02,High Risk
U953,2024,7,254041.0,Salary Increases & Fixed Expenses Remain Stable,276833,75158.0,185136,260294.0,16539.0,5.97,-0.05,High Risk
U953,2024,8,270580.0,Salary Increases & Fixed Expenses Remain Stable,300870,75158.0,194849,270007.0,30863.0,10.26,0.03,High Risk
U953,2024,9,301443.0,Salary Increases & Fixed Expenses Remain Stable,300870,75158.0,202504,277662.0,23208.0,7.71,0.01,High Risk
U953,2024,10,324651.0,Salary Increases & Fixed Expenses Remain Stable,300870,75158.0,211275,286433.0,14437.0,4.8,-0.0,High Risk
U953,2024,11,339088.0,Salary Increases & Fixed Expenses Remain Stable,300870,75158.0,213834,288992.0,11878.0,3.95,0.04,High Risk
U953,2024,12,350966.0,Salary Increases & Fixed Expenses Remain Stable,300870,75158.0,181271,256429.0,44441.0,14.77,0.01,High Risk
U954,2024,1,236239.0,Salary Increases & Fixed Expenses Remain Stable,289026,104755.0,164168,268923.0,20103.0,6.96,-0.04,High Risk
U954,2024,2,256342.0,Salary Increases & Fixed Expenses Remain Stable,289026,104755.0,118258,223013.0,66013.0,22.84,0.02,Medium Risk
U954,2024,3,322355.0,Salary Increases & Fixed Expenses Remain Stable,289026,104755.0,132014,236769.0,52257.0,18.08,-0.02,Medium Risk
U954,2024,4,374612.0,Salary Increases & Fixed Expenses Remain Stable,289026,104755.0,161148,265903.0,23123.0,8.0,-0.01,High Risk
U954,2024,5,397735.0,Salary Increases & Fixed Expenses Remain Stable,289026,104755.0,168782,273537.0,15489.0,5.36,0.02,High Risk
U954,2024,6,413224.0,Salary Increases & Fixed Expenses Remain Stable,289026,104755.0,147710,252465.0,36561.0,12.65,0.0,High Risk
U954,2024,7,449785.0,Salary Increases & Fixed Expenses Remain Stable,289026,104755.0,130246,235001.0,54025.0,18.69,0.0,Medium Risk
U954,2024,8,503810.0,Salary Increases & Fixed Expenses Remain Stable,302850,104755.0,147149,251904.0,50946.0,16.82,0.02,Medium Risk
U954,2024,9,554756.0,Salary Increases & Fixed Expenses Remain Stable,302850,104755.0,139228,243983.0,58867.0,19.44,0.02,Medium Risk
U954,2024,10,613623.0,Salary Increases & Fixed Expenses Remain Stable,302850,104755.0,157358,262113.0,40737.0,13.45,0.03,High Risk
U954,2024,11,654360.0,Salary Increases & Fixed Expenses Remain Stable,302850,104755.0,176727,281482.0,21368.0,7.06,-0.03,High Risk
U954,2024,12,675728.0,Salary Increases & Fixed Expenses Remain Stable,302850,104755.0,143702,248457.0,54393.0,17.96,0.04,Medium Risk
U955,2024,1,244523.0,Stable Salary & Stable Fixed Expenses,53296,28838.0,31674,60512.0,-7216.0,-13.54,-0.04,High Risk
U955,2024,2,237307.0,Stable Salary & Stable Fixed Expenses,53296,28838.0,22265,51103.0,2193.0,4.11,-0.04,High Risk
U955,2024,3,239500.0,Stable Salary & Stable Fixed Expenses,53296,28838.0,35676,64514.0,-11218.0,-21.05,0.04,High Risk
U955,2024,4,228282.0,Stable Salary & Stable Fixed Expenses,53296,28838.0,24942,53780.0,-484.0,-0.91,0.02,High Risk
U955,2024,5,227798.0,Stable Salary & Stable Fixed Expenses,53296,28838.0,28239,57077.0,-3781.0,-7.09,0.02,High Risk
U955,2024,6,224017.0,Stable Salary & Stable Fixed Expenses,53296,28838.0,27053,55891.0,-2595.0,-4.87,0.01,High Risk
U955,2024,7,221422.0,Stable Salary & Stable Fixed Expenses,53296,28838.0,30503,59341.0,-6045.0,-11.34,-0.0,High Risk
U955,2024,8,215377.0,Stable Salary & Stable Fixed Expenses,53296,28838.0,31470,60308.0,-7012.0,-13.16,-0.03,High Risk
U955,2024,9,208365.0,Stable Salary & Stable Fixed Expenses,53296,28838.0,30584,59422.0,-6126.0,-11.49,0.03,High Risk
U955,2024,10,202239.0,Stable Salary & Stable Fixed Expenses,53296,28838.0,31164,60002.0,-6706.0,-12.58,-0.02,High Risk
U955,2024,11,195533.0,Stable Salary & Stable Fixed Expenses,53296,28838.0,25943,54781.0,-1485.0,-2.79,-0.02,High Risk
U955,2024,12,194048.0,Stable Salary & Stable Fixed Expenses,53296,28838.0,29549,58387.0,-5091.0,-9.55,-0.02,High Risk
U956,2024,1,201395.0,Salary Increases & Fixed Expenses Remain Stable,80500,38535.0,24235,62770.0,17730.0,22.02,0.01,Medium Risk
U956,2024,2,219125.0,Salary Increases & Fixed Expenses Remain Stable,80500,38535.0,32067,70602.0,9898.0,12.3,-0.01,High Risk
U956,2024,3,229023.0,Salary Increases & Fixed Expenses Remain Stable,80500,38535.0,25421,63956.0,16544.0,20.55,-0.0,Medium Risk
U956,2024,4,245567.0,Salary Increases & Fixed Expenses Remain Stable,80500,38535.0,29690,68225.0,12275.0,15.25,-0.02,Medium Risk
U956,2024,5,257842.0,Salary Increases & Fixed Expenses Remain Stable,98185,38535.0,34229,72764.0,25421.0,25.89,0.03,Low Risk
U956,2024,6,283263.0,Salary Increases & Fixed Expenses Remain Stable,98185,38535.0,30423,68958.0,29227.0,29.77,0.01,Low Risk
U956,2024,7,312490.0,Salary Increases & Fixed Expenses Remain Stable,98185,38535.0,33767,72302.0,25883.0,26.36,0.0,Low Risk
U956,2024,8,338373.0,Salary Increases & Fixed Expenses Remain Stable,98185,38535.0,36601,75136.0,23049.0,23.48,-0.02,Medium Risk
U956,2024,9,361422.0,Salary Increases & Fixed Expenses Remain Stable,98185,38535.0,33410,71945.0,26240.0,26.73,-0.0,Low Risk
U956,2024,10,387662.0,Salary Increases & Fixed Expenses Remain Stable,98185,38535.0,32306,70841.0,27344.0,27.85,0.0,Low Risk
U956,2024,11,415006.0,Salary Increases & Fixed Expenses Remain Stable,98185,38535.0,31031,69566.0,28619.0,29.15,0.04,Low Risk
U956,2024,12,443625.0,Salary Increases & Fixed Expenses Remain Stable,98185,38535.0,38909,77444.0,20741.0,21.12,-0.04,Medium Risk
U957,2024,1,240643.0,Salary Increases & Fixed Expenses Increase,91562,36084.0,37852,73936.0,17626.0,19.25,0.0,Medium Risk
U957,2024,2,258269.0,Salary Increases & Fixed Expenses Increase,91562,36084.0,46878,82962.0,8600.0,9.39,-0.02,High Risk
U957,2024,3,266869.0,Salary Increases & Fixed Expenses Increase,99679,36084.0,44866,80950.0,18729.0,18.79,-0.03,Medium Risk
U957,2024,4,285598.0,Salary Increases & Fixed Expenses Increase,99679,36084.0,49082,85166.0,14513.0,14.56,-0.01,High Risk
U957,2024,5,300111.0,Salary Increases & Fixed Expenses Increase,99679,36084.0,48376,84460.0,15219.0,15.27,0.03,Medium Risk
U957,2024,6,315330.0,Salary Increases & Fixed Expenses Increase,99679,36084.0,44705,80789.0,18890.0,18.95,0.01,Medium Risk
U957,2024,7,334220.0,Salary Increases & Fixed Expenses Increase,99679,36084.0,58253,94337.0,5342.0,5.36,-0.01,High Risk
U957,2024,8,339562.0,Salary Increases & Fixed Expenses Increase,99679,36084.0,54743,90827.0,8852.0,8.88,0.03,High Risk
U957,2024,9,348414.0,Salary Increases & Fixed Expenses Increase,99679,36609.0,41561,78170.0,21509.0,21.58,0.01,Medium Risk
U957,2024,10,369923.0,Salary Increases & Fixed Expenses Increase,99679,38112.0,58781,96893.0,2786.0,2.79,0.0,High Risk
U957,2024,11,372709.0,Salary Increases & Fixed Expenses Increase,99679,38112.0,50528,88640.0,11039.0,11.07,0.05,High Risk
U957,2024,12,383748.0,Salary Increases & Fixed Expenses Increase,99679,38112.0,50541,88653.0,11026.0,11.06,0.02,High Risk
U958,2024,1,210479.0,Stable Salary & Increasing Fixed Expenses,100784,72076.0,46131,118207.0,-17423.0,-17.29,0.03,High Risk
U958,2024,2,193056.0,Stable Salary & Increasing Fixed Expenses,100784,72076.0,47473,119549.0,-18765.0,-18.62,0.03,High Risk
U958,2024,3,174291.0,Stable Salary & Increasing Fixed Expenses,100784,72076.0,59115,131191.0,-30407.0,-30.17,0.02,High Risk
U958,2024,4,143884.0,Stable Salary & Increasing Fixed Expenses,100784,72076.0,48388,120464.0,-19680.0,-19.53,-0.05,High Risk
U958,2024,5,124204.0,Stable Salary & Increasing Fixed Expenses,100784,72076.0,41376,113452.0,-12668.0,-12.57,-0.02,High Risk
U958,2024,6,111536.0,Stable Salary & Increasing Fixed Expenses,100784,72076.0,46137,118213.0,-17429.0,-17.29,0.02,High Risk
U958,2024,7,94107.0,Stable Salary & Increasing Fixed Expenses,100784,72076.0,52897,124973.0,-24189.0,-24.0,-0.03,High Risk
U958,2024,8,69918.0,Stable Salary & Increasing Fixed Expenses,100784,72076.0,54629,126705.0,-25921.0,-25.72,-0.01,High Risk
U958,2024,9,43997.0,Stable Salary & Increasing Fixed Expenses,100784,72814.0,58868,131682.0,-30898.0,-30.66,-0.03,High Risk
U958,2024,10,13099.0,Stable Salary & Increasing Fixed Expenses,100784,72814.0,47258,120072.0,-19288.0,-19.14,0.05,High Risk
U958,2024,11,-6189.0,Stable Salary & Increasing Fixed Expenses,100784,72814.0,61482,134296.0,-33512.0,-33.25,0.05,High Risk
U958,2024,12,-39701.0,Stable Salary & Increasing Fixed Expenses,100784,72814.0,61376,134190.0,-33406.0,-33.15,-0.05,High Risk
U959,2024,1,232249.0,Salary Increases & Fixed Expenses Increase,158137,55112.0,73249,128361.0,29776.0,18.83,0.0,Medium Risk
U959,2024,2,262025.0,Salary Increases & Fixed Expenses Increase,158137,55112.0,76144,131256.0,26881.0,17.0,0.01,Medium Risk
U959,2024,3,288906.0,Salary Increases & Fixed Expenses Increase,158137,55112.0,84490,139602.0,18535.0,11.72,-0.01,High Risk
U959,2024,4,307441.0,Salary Increases & Fixed Expenses Increase,158137,55112.0,73230,128342.0,29795.0,18.84,0.01,Medium Risk
U959,2024,5,337236.0,Salary Increases & Fixed Expenses Increase,168356,55112.0,90039,145151.0,23205.0,13.78,-0.05,High Risk
U959,2024,6,360441.0,Salary Increases & Fixed Expenses Increase,168356,55112.0,73157,128269.0,40087.0,23.81,-0.02,Medium Risk
U959,2024,7,400528.0,Salary Increases & Fixed Expenses Increase,168356,56838.0,89052,145890.0,22466.0,13.34,-0.04,High Risk
U959,2024,8,422994.0,Salary Increases & Fixed Expenses Increase,168356,56838.0,83849,140687.0,27669.0,16.43,-0.01,Medium Risk
U959,2024,9,450663.0,Salary Increases & Fixed Expenses Increase,168356,58781.0,81965,140746.0,27610.0,16.4,-0.02,Medium Risk
U959,2024,10,478273.0,Salary Increases & Fixed Expenses Increase,168356,58781.0,82591,141372.0,26984.0,16.03,-0.0,Medium Risk
U959,2024,11,505257.0,Salary Increases & Fixed Expenses Increase,168356,58781.0,70087,128868.0,39488.0,23.46,-0.02,Medium Risk
U959,2024,12,544745.0,Salary Increases & Fixed Expenses Increase,168356,58781.0,69624,128405.0,39951.0,23.73,0.02,Medium Risk
U960,2024,1,204100.0,Stable Salary & Decreasing Fixed Expenses,34965,21996.0,12140,34136.0,829.0,2.37,-0.03,High Risk
U960,2024,2,204929.0,Stable Salary & Decreasing Fixed Expenses,34965,21996.0,13306,35302.0,-337.0,-0.96,0.03,High Risk
U960,2024,3,204592.0,Stable Salary & Decreasing Fixed Expenses,34965,21996.0,15669,37665.0,-2700.0,-7.72,0.04,High Risk
U960,2024,4,201892.0,Stable Salary & Decreasing Fixed Expenses,34965,21996.0,11994,33990.0,975.0,2.79,0.02,High Risk
U960,2024,5,202867.0,Stable Salary & Decreasing Fixed Expenses,34965,21996.0,11248,33244.0,1721.0,4.92,-0.02,High Risk
U960,2024,6,204588.0,Stable Salary & Decreasing Fixed Expenses,34965,21996.0,12579,34575.0,390.0,1.12,-0.02,High Risk
U960,2024,7,204978.0,Stable Salary & Decreasing Fixed Expenses,34965,21996.0,13379,35375.0,-410.0,-1.17,-0.05,High Risk
U960,2024,8,204568.0,Stable Salary & Decreasing Fixed Expenses,34965,21996.0,13211,35207.0,-242.0,-0.69,0.01,High Risk
U960,2024,9,204326.0,Stable Salary & Decreasing Fixed Expenses,34965,21996.0,12482,34478.0,487.0,1.39,0.0,High Risk
U960,2024,10,204813.0,Stable Salary & Decreasing Fixed Expenses,34965,21996.0,15338,37334.0,-2369.0,-6.78,-0.02,High Risk
U960,2024,11,202444.0,Stable Salary & Decreasing Fixed Expenses,34965,21996.0,12447,34443.0,522.0,1.49,-0.03,High Risk
U960,2024,12,202966.0,Stable Salary & Decreasing Fixed Expenses,34965,21996.0,13807,35803.0,-838.0,-2.4,-0.0,High Risk
U961,2024,1,222995.0,Stable Salary & Increasing Fixed Expenses,293851,111891.0,165982,277873.0,15978.0,5.44,-0.02,High Risk
U961,2024,2,238973.0,Stable Salary & Increasing Fixed Expenses,293851,111891.0,125046,236937.0,56914.0,19.37,-0.05,Medium Risk
U961,2024,3,295887.0,Stable Salary & Increasing Fixed Expenses,293851,112764.0,155283,268047.0,25804.0,8.78,-0.03,High Risk
U961,2024,4,321691.0,Stable Salary & Increasing Fixed Expenses,293851,112764.0,131720,244484.0,49367.0,16.8,-0.01,Medium Risk
U961,2024,5,371058.0,Stable Salary & Increasing Fixed Expenses,293851,112764.0,123460,236224.0,57627.0,19.61,-0.02,Medium Risk
U961,2024,6,428685.0,Stable Salary & Increasing Fixed Expenses,293851,112764.0,165340,278104.0,15747.0,5.36,-0.04,High Risk
U961,2024,7,444432.0,Stable Salary & Increasing Fixed Expenses,293851,112764.0,137118,249882.0,43969.0,14.96,-0.02,High Risk
U961,2024,8,488401.0,Stable Salary & Increasing Fixed Expenses,293851,112764.0,162593,275357.0,18494.0,6.29,0.02,High Risk
U961,2024,9,506895.0,Stable Salary & Increasing Fixed Expenses,293851,112764.0,128803,241567.0,52284.0,17.79,-0.01,Medium Risk
U961,2024,10,559179.0,Stable Salary & Increasing Fixed Expenses,293851,112764.0,162489,275253.0,18598.0,6.33,-0.03,High Risk
U961,2024,11,577777.0,Stable Salary & Increasing Fixed Expenses,293851,112764.0,120440,233204.0,60647.0,20.64,-0.03,Medium Risk
U961,2024,12,638424.0,Stable Salary & Increasing Fixed Expenses,293851,112764.0,133976,246740.0,47111.0,16.03,0.01,Medium Risk
U962,2024,1,226181.0,Stable Salary & Stable Fixed Expenses,247830,119128.0,115144,234272.0,13558.0,5.47,0.04,High Risk
U962,2024,2,239739.0,Stable Salary & Stable Fixed Expenses,247830,119128.0,101870,220998.0,26832.0,10.83,-0.04,High Risk
U962,2024,3,266571.0,Stable Salary & Stable Fixed Expenses,247830,119128.0,118614,237742.0,10088.0,4.07,0.0,High Risk
U962,2024,4,276659.0,Stable Salary & Stable Fixed Expenses,247830,119128.0,109160,228288.0,19542.0,7.89,-0.0,High Risk
U962,2024,5,296201.0,Stable Salary & Stable Fixed Expenses,247830,119128.0,112973,232101.0,15729.0,6.35,0.03,High Risk
U962,2024,6,311930.0,Stable Salary & Stable Fixed Expenses,247830,119128.0,126685,245813.0,2017.0,0.81,0.01,High Risk
U962,2024,7,313947.0,Stable Salary & Stable Fixed Expenses,247830,119128.0,133418,252546.0,-4716.0,-1.9,-0.01,High Risk
U962,2024,8,309231.0,Stable Salary & Stable Fixed Expenses,247830,119128.0,130970,250098.0,-2268.0,-0.92,-0.01,High Risk
U962,2024,9,306963.0,Stable Salary & Stable Fixed Expenses,247830,119128.0,133566,252694.0,-4864.0,-1.96,-0.01,High Risk
U962,2024,10,302099.0,Stable Salary & Stable Fixed Expenses,247830,119128.0,142291,261419.0,-13589.0,-5.48,-0.04,High Risk
U962,2024,11,288510.0,Stable Salary & Stable Fixed Expenses,247830,119128.0,142941,262069.0,-14239.0,-5.75,-0.04,High Risk
U962,2024,12,274271.0,Stable Salary & Stable Fixed Expenses,247830,119128.0,137893,257021.0,-9191.0,-3.71,0.0,High Risk
U963,2024,1,223841.0,Salary Increases & Fixed Expenses Remain Stable,236908,87078.0,170094,257172.0,-20264.0,-8.55,-0.04,High Risk
U963,2024,2,203577.0,Salary Increases & Fixed Expenses Remain Stable,236908,87078.0,155399,242477.0,-5569.0,-2.35,-0.05,High Risk
U963,2024,3,198008.0,Salary Increases & Fixed Expenses Remain Stable,236908,87078.0,224342,311420.0,-74512.0,-31.45,-0.01,High Risk
U963,2024,4,123496.0,Salary Increases & Fixed Expenses Remain Stable,236908,87078.0,169525,256603.0,-19695.0,-8.31,-0.03,High Risk
U963,2024,5,103801.0,Salary Increases & Fixed Expenses Remain Stable,236908,87078.0,160012,247090.0,-10182.0,-4.3,0.04,High Risk
U963,2024,6,93619.0,Salary Increases & Fixed Expenses Remain Stable,236908,87078.0,153476,240554.0,-3646.0,-1.54,0.02,High Risk
U963,2024,7,89973.0,Salary Increases & Fixed Expenses Remain Stable,236908,87078.0,180519,267597.0,-30689.0,-12.95,-0.04,High Risk
U963,2024,8,59284.0,Salary Increases & Fixed Expenses Remain Stable,253313,87078.0,153659,240737.0,12576.0,4.96,-0.04,High Risk
U963,2024,9,71860.0,Salary Increases & Fixed Expenses Remain Stable,253313,87078.0,172257,259335.0,-6022.0,-2.38,0.01,High Risk
U963,2024,10,65838.0,Salary Increases & Fixed Expenses Remain Stable,253313,87078.0,223801,310879.0,-57566.0,-22.73,-0.0,High Risk
U963,2024,11,8272.0,Salary Increases & Fixed Expenses Remain Stable,253313,87078.0,163251,250329.0,2984.0,1.18,-0.04,High Risk
U963,2024,12,11256.0,Salary Increases & Fixed Expenses Remain Stable,253313,87078.0,200944,288022.0,-34709.0,-13.7,0.02,High Risk
U964,2024,1,231831.0,Salary Increases & Fixed Expenses Increase,27326,20654.0,14702,35356.0,-8030.0,-29.39,-0.02,High Risk
U964,2024,2,223801.0,Salary Increases & Fixed Expenses Increase,27326,20654.0,11829,32483.0,-5157.0,-18.87,-0.03,High Risk
U964,2024,3,218644.0,Salary Increases & Fixed Expenses Increase,27326,22407.0,14762,37169.0,-9843.0,-36.02,-0.02,High Risk
U964,2024,4,208801.0,Salary Increases & Fixed Expenses Increase,27326,22407.0,16334,38741.0,-11415.0,-41.77,-0.02,High Risk
U964,2024,5,197386.0,Salary Increases & Fixed Expenses Increase,27326,22407.0,12328,34735.0,-7409.0,-27.11,0.05,High Risk
U964,2024,6,189977.0,Salary Increases & Fixed Expenses Increase,51296,23641.0,22362,46003.0,5293.0,10.32,0.02,High Risk
U964,2024,7,195270.0,Salary Increases & Fixed Expenses Increase,51296,23641.0,27177,50818.0,478.0,0.93,0.05,High Risk
U964,2024,8,195748.0,Salary Increases & Fixed Expenses Increase,51296,23641.0,27579,51220.0,76.0,0.15,-0.05,High Risk
U964,2024,9,195824.0,Salary Increases & Fixed Expenses Increase,51296,23641.0,28229,51870.0,-574.0,-1.12,-0.03,High Risk
U964,2024,10,195250.0,Salary Increases & Fixed Expenses Increase,51296,23641.0,32301,55942.0,-4646.0,-9.06,0.02,High Risk
U964,2024,11,190604.0,Salary Increases & Fixed Expenses Increase,51296,24351.0,31310,55661.0,-4365.0,-8.51,-0.04,High Risk
U964,2024,12,186239.0,Salary Increases & Fixed Expenses Increase,51296,24351.0,38192,62543.0,-11247.0,-21.93,0.04,High Risk
U965,2024,1,249273.0,Salary Increases & Fixed Expenses Increase,87467,30336.0,35777,66113.0,21354.0,24.41,-0.02,Medium Risk
U965,2024,2,270627.0,Salary Increases & Fixed Expenses Increase,87467,30336.0,43198,73534.0,13933.0,15.93,-0.05,Medium Risk
U965,2024,3,284560.0,Salary Increases & Fixed Expenses Increase,87467,31850.0,46926,78776.0,8691.0,9.94,0.04,High Risk
U965,2024,4,293251.0,Salary Increases & Fixed Expenses Increase,87467,31850.0,51956,83806.0,3661.0,4.19,0.01,High Risk
U965,2024,5,296912.0,Salary Increases & Fixed Expenses Increase,87467,33432.0,40182,73614.0,13853.0,15.84,0.04,Medium Risk
U965,2024,6,310765.0,Salary Increases & Fixed Expenses Increase,87467,33432.0,43928,77360.0,10107.0,11.56,0.03,High Risk
U965,2024,7,320872.0,Salary Increases & Fixed Expenses Increase,105591,33432.0,48628,82060.0,23531.0,22.29,0.03,Medium Risk
U965,2024,8,344403.0,Salary Increases & Fixed Expenses Increase,105591,33432.0,48642,82074.0,23517.0,22.27,0.02,Medium Risk
U965,2024,9,367920.0,Salary Increases & Fixed Expenses Increase,105591,34388.0,58251,92639.0,12952.0,12.27,-0.02,High Risk
U965,2024,10,380872.0,Salary Increases & Fixed Expenses Increase,105591,34388.0,70055,104443.0,1148.0,1.09,-0.02,High Risk
U965,2024,11,382020.0,Salary Increases & Fixed Expenses Increase,105591,35685.0,45974,81659.0,23932.0,22.66,-0.02,Medium Risk
U965,2024,12,405952.0,Salary Increases & Fixed Expenses Increase,105591,35685.0,52150,87835.0,17756.0,16.82,0.02,Medium Risk
U966,2024,1,232724.0,Salary Increases & Fixed Expenses Remain Stable,36709,10757.0,19213,29970.0,6739.0,18.36,-0.0,Medium Risk
U966,2024,2,239463.0,Salary Increases & Fixed Expenses Remain Stable,36709,10757.0,17818,28575.0,8134.0,22.16,0.02,Medium Risk
U966,2024,3,247597.0,Salary Increases & Fixed Expenses Remain Stable,36709,10757.0,26317,37074.0,-365.0,-0.99,0.01,High Risk
U966,2024,4,247232.0,Salary Increases & Fixed Expenses Remain Stable,62288,10757.0,34548,45305.0,16983.0,27.27,-0.03,Low Risk
U966,2024,5,264215.0,Salary Increases & Fixed Expenses Remain Stable,62288,10757.0,31655,42412.0,19876.0,31.91,-0.04,Low Risk
U966,2024,6,284091.0,Salary Increases & Fixed Expenses Remain Stable,62288,10757.0,31422,42179.0,20109.0,32.28,-0.05,Low Risk
U966,2024,7,304200.0,Salary Increases & Fixed Expenses Remain Stable,62288,10757.0,32196,42953.0,19335.0,31.04,0.05,Low Risk
U966,2024,8,323535.0,Salary Increases & Fixed Expenses Remain Stable,62288,10757.0,35526,46283.0,16005.0,25.7,0.01,Low Risk
U966,2024,9,339540.0,Salary Increases & Fixed Expenses Remain Stable,62288,10757.0,42377,53134.0,9154.0,14.7,0.04,High Risk
U966,2024,10,348694.0,Salary Increases & Fixed Expenses Remain Stable,62288,10757.0,29372,40129.0,22159.0,35.58,0.02,Low Risk
U966,2024,11,370853.0,Salary Increases & Fixed Expenses Remain Stable,62288,10757.0,31776,42533.0,19755.0,31.72,0.04,Low Risk
U966,2024,12,390608.0,Salary Increases & Fixed Expenses Remain Stable,62288,10757.0,36871,47628.0,14660.0,23.54,-0.01,Medium Risk
U967,2024,1,215930.0,Salary Increases & Fixed Expenses Increase,97077,38145.0,33827,71972.0,25105.0,25.86,-0.01,Low Risk
U967,2024,2,241035.0,Salary Increases & Fixed Expenses Increase,97077,38145.0,33033,71178.0,25899.0,26.68,0.04,Low Risk
U967,2024,3,266934.0,Salary Increases & Fixed Expenses Increase,112896,39548.0,48797,88345.0,24551.0,21.75,-0.03,Medium Risk
U967,2024,4,291485.0,Salary Increases & Fixed Expenses Increase,112896,39548.0,38263,77811.0,35085.0,31.08,0.04,Low Risk
U967,2024,5,326570.0,Salary Increases & Fixed Expenses Increase,112896,39548.0,35156,74704.0,38192.0,33.83,0.0,Low Risk
U967,2024,6,364762.0,Salary Increases & Fixed Expenses Increase,112896,39548.0,42749,82297.0,30599.0,27.1,0.05,Low Risk
U967,2024,7,395361.0,Salary Increases & Fixed Expenses Increase,112896,39548.0,43870,83418.0,29478.0,26.11,0.04,Low Risk
U967,2024,8,424839.0,Salary Increases & Fixed Expenses Increase,112896,39548.0,40440,79988.0,32908.0,29.15,0.02,Low Risk
U967,2024,9,457747.0,Salary Increases & Fixed Expenses Increase,112896,39548.0,42700,82248.0,30648.0,27.15,0.01,Low Risk
U967,2024,10,488395.0,Salary Increases & Fixed Expenses Increase,112896,39548.0,57453,97001.0,15895.0,14.08,-0.0,High Risk
U967,2024,11,504290.0,Salary Increases & Fixed Expenses Increase,112896,39548.0,42291,81839.0,31057.0,27.51,0.03,Low Risk
U967,2024,12,535347.0,Salary Increases & Fixed Expenses Increase,112896,39548.0,42299,81847.0,31049.0,27.5,-0.03,Low Risk
U968,2024,1,222576.0,Stable Salary & Decreasing Fixed Expenses,223124,107159.0,71277,178436.0,44688.0,20.03,-0.02,Medium Risk
U968,2024,2,267264.0,Stable Salary & Decreasing Fixed Expenses,223124,105276.0,77381,182657.0,40467.0,18.14,0.04,Medium Risk
U968,2024,3,307731.0,Stable Salary & Decreasing Fixed Expenses,223124,105276.0,101751,207027.0,16097.0,7.21,-0.04,High Risk
U968,2024,4,323828.0,Stable Salary & Decreasing Fixed Expenses,223124,105276.0,68783,174059.0,49065.0,21.99,-0.02,Medium Risk
U968,2024,5,372893.0,Stable Salary & Decreasing Fixed Expenses,223124,105276.0,89114,194390.0,28734.0,12.88,0.0,High Risk
U968,2024,6,401627.0,Stable Salary & Decreasing Fixed Expenses,223124,105276.0,74972,180248.0,42876.0,19.22,0.01,Medium Risk
U968,2024,7,444503.0,Stable Salary & Decreasing Fixed Expenses,223124,105276.0,88739,194015.0,29109.0,13.05,-0.04,High Risk
U968,2024,8,473612.0,Stable Salary & Decreasing Fixed Expenses,223124,104155.0,80433,184588.0,38536.0,17.27,0.04,Medium Risk
U968,2024,9,512148.0,Stable Salary & Decreasing Fixed Expenses,223124,104155.0,83403,187558.0,35566.0,15.94,0.04,Medium Risk
U968,2024,10,547714.0,Stable Salary & Decreasing Fixed Expenses,223124,104155.0,103439,207594.0,15530.0,6.96,0.03,High Risk
U968,2024,11,563244.0,Stable Salary & Decreasing Fixed Expenses,223124,104155.0,74501,178656.0,44468.0,19.93,0.05,Medium Risk
U968,2024,12,607712.0,Stable Salary & Decreasing Fixed Expenses,223124,104155.0,70958,175113.0,48011.0,21.52,0.01,Medium Risk
U969,2024,1,222426.0,Stable Salary & Stable Fixed Expenses,35214,19996.0,23162,43158.0,-7944.0,-22.56,-0.02,High Risk
U969,2024,2,214482.0,Stable Salary & Stable Fixed Expenses,35214,19996.0,21538,41534.0,-6320.0,-17.95,-0.03,High Risk
U969,2024,3,208162.0,Stable Salary & Stable Fixed Expenses,35214,19996.0,27810,47806.0,-12592.0,-35.76,-0.02,High Risk
U969,2024,4,195570.0,Stable Salary & Stable Fixed Expenses,35214,19996.0,25504,45500.0,-10286.0,-29.21,0.0,High Risk
U969,2024,5,185284.0,Stable Salary & Stable Fixed Expenses,35214,19996.0,21580,41576.0,-6362.0,-18.07,0.0,High Risk
U969,2024,6,178922.0,Stable Salary & Stable Fixed Expenses,35214,19996.0,24322,44318.0,-9104.0,-25.85,0.04,High Risk
U969,2024,7,169818.0,Stable Salary & Stable Fixed Expenses,35214,19996.0,24922,44918.0,-9704.0,-27.56,0.01,High Risk
U969,2024,8,160114.0,Stable Salary & Stable Fixed Expenses,35214,19996.0,27926,47922.0,-12708.0,-36.09,0.0,High Risk
U969,2024,9,147406.0,Stable Salary & Stable Fixed Expenses,35214,19996.0,28142,48138.0,-12924.0,-36.7,-0.01,High Risk
U969,2024,10,134482.0,Stable Salary & Stable Fixed Expenses,35214,19996.0,23237,43233.0,-8019.0,-22.77,-0.04,High Risk
U969,2024,11,126463.0,Stable Salary & Stable Fixed Expenses,35214,19996.0,23233,43229.0,-8015.0,-22.76,-0.0,High Risk
U969,2024,12,118448.0,Stable Salary & Stable Fixed Expenses,35214,19996.0,24581,44577.0,-9363.0,-26.59,-0.01,High Risk
U970,2024,1,222484.0,Salary Increases & Fixed Expenses Increase,289826,91901.0,125690,217591.0,72235.0,24.92,-0.03,Medium Risk
U970,2024,2,294719.0,Salary Increases & Fixed Expenses Increase,289826,91901.0,163992,255893.0,33933.0,11.71,0.02,High Risk
U970,2024,3,328652.0,Salary Increases & Fixed Expenses Increase,289826,91901.0,172019,263920.0,25906.0,8.94,0.02,High Risk
U970,2024,4,354558.0,Salary Increases & Fixed Expenses Increase,289826,91901.0,134565,226466.0,63360.0,21.86,0.01,Medium Risk
U970,2024,5,417918.0,Salary Increases & Fixed Expenses Increase,289826,91901.0,163091,254992.0,34834.0,12.02,-0.03,High Risk
U970,2024,6,452752.0,Salary Increases & Fixed Expenses Increase,289826,92685.0,172767,265452.0,24374.0,8.41,-0.02,High Risk
U970,2024,7,477126.0,Salary Increases & Fixed Expenses Increase,289826,94170.0,144058,238228.0,51598.0,17.8,0.01,Medium Risk
U970,2024,8,528724.0,Salary Increases & Fixed Expenses Increase,306093,94170.0,168734,262904.0,43189.0,14.11,-0.04,High Risk
U970,2024,9,571913.0,Salary Increases & Fixed Expenses Increase,306093,94170.0,138010,232180.0,73913.0,24.15,-0.01,Medium Risk
U970,2024,10,645826.0,Salary Increases & Fixed Expenses Increase,306093,95550.0,204570,300120.0,5973.0,1.95,-0.02,High Risk
U970,2024,11,651799.0,Salary Increases & Fixed Expenses Increase,306093,95550.0,139997,235547.0,70546.0,23.05,-0.04,Medium Risk
U970,2024,12,722345.0,Salary Increases & Fixed Expenses Increase,306093,96915.0,157854,254769.0,51324.0,16.77,-0.03,Medium Risk
U971,2024,1,239656.0,Stable Salary & Stable Fixed Expenses,130200,63993.0,85995,149988.0,-19788.0,-15.2,-0.03,High Risk
U971,2024,2,219868.0,Stable Salary & Stable Fixed Expenses,130200,63993.0,103564,167557.0,-37357.0,-28.69,-0.01,High Risk
U971,2024,3,182511.0,Stable Salary & Stable Fixed Expenses,130200,63993.0,89954,153947.0,-23747.0,-18.24,-0.01,High Risk
U971,2024,4,158764.0,Stable Salary & Stable Fixed Expenses,130200,63993.0,87146,151139.0,-20939.0,-16.08,-0.04,High Risk
U971,2024,5,137825.0,Stable Salary & Stable Fixed Expenses,130200,63993.0,80212,144205.0,-14005.0,-10.76,0.01,High Risk
U971,2024,6,123820.0,Stable Salary & Stable Fixed Expenses,130200,63993.0,104101,168094.0,-37894.0,-29.1,0.03,High Risk
U971,2024,7,85926.0,Stable Salary & Stable Fixed Expenses,130200,63993.0,96233,160226.0,-30026.0,-23.06,0.05,High Risk
U971,2024,8,55900.0,Stable Salary & Stable Fixed Expenses,130200,63993.0,79406,143399.0,-13199.0,-10.14,-0.03,High Risk
U971,2024,9,42701.0,Stable Salary & Stable Fixed Expenses,130200,63993.0,100262,164255.0,-34055.0,-26.16,-0.0,High Risk
U971,2024,10,8646.0,Stable Salary & Stable Fixed Expenses,130200,63993.0,106824,170817.0,-40617.0,-31.2,-0.0,High Risk
U971,2024,11,-31971.0,Stable Salary & Stable Fixed Expenses,130200,63993.0,102569,166562.0,-36362.0,-27.93,-0.03,High Risk
U971,2024,12,-68333.0,Stable Salary & Stable Fixed Expenses,130200,63993.0,101028,165021.0,-34821.0,-26.74,0.04,High Risk
U972,2024,1,230023.0,Stable Salary & Stable Fixed Expenses,176181,75528.0,65472,141000.0,35181.0,19.97,0.02,Medium Risk
U972,2024,2,265204.0,Stable Salary & Stable Fixed Expenses,176181,75528.0,67226,142754.0,33427.0,18.97,-0.03,Medium Risk
U972,2024,3,298631.0,Stable Salary & Stable Fixed Expenses,176181,75528.0,81983,157511.0,18670.0,10.6,-0.03,High Risk
U972,2024,4,317301.0,Stable Salary & Stable Fixed Expenses,176181,75528.0,61057,136585.0,39596.0,22.47,0.01,Medium Risk
U972,2024,5,356897.0,Stable Salary & Stable Fixed Expenses,176181,75528.0,59888,135416.0,40765.0,23.14,-0.01,Medium Risk
U972,2024,6,397662.0,Stable Salary & Stable Fixed Expenses,176181,75528.0,68108,143636.0,32545.0,18.47,0.03,Medium Risk
U972,2024,7,430207.0,Stable Salary & Stable Fixed Expenses,176181,75528.0,67697,143225.0,32956.0,18.71,-0.03,Medium Risk
U972,2024,8,463163.0,Stable Salary & Stable Fixed Expenses,176181,75528.0,63823,139351.0,36830.0,20.9,0.04,Medium Risk
U972,2024,9,499993.0,Stable Salary & Stable Fixed Expenses,176181,75528.0,72061,147589.0,28592.0,16.23,-0.01,Medium Risk
U972,2024,10,528585.0,Stable Salary & Stable Fixed Expenses,176181,75528.0,74686,150214.0,25967.0,14.74,-0.01,High Risk
U972,2024,11,554552.0,Stable Salary & Stable Fixed Expenses,176181,75528.0,66407,141935.0,34246.0,19.44,0.02,Medium Risk
U972,2024,12,588798.0,Stable Salary & Stable Fixed Expenses,176181,75528.0,65975,141503.0,34678.0,19.68,0.02,Medium Risk
U973,2024,1,239880.0,Stable Salary & Stable Fixed Expenses,216835,66236.0,93666,159902.0,56933.0,26.26,-0.05,Low Risk
U973,2024,2,296813.0,Stable Salary & Stable Fixed Expenses,216835,66236.0,86946,153182.0,63653.0,29.36,-0.04,Low Risk
U973,2024,3,360466.0,Stable Salary & Stable Fixed Expenses,216835,66236.0,136168,202404.0,14431.0,6.66,0.03,High Risk
U973,2024,4,374897.0,Stable Salary & Stable Fixed Expenses,216835,66236.0,122418,188654.0,28181.0,13.0,-0.03,High Risk
U973,2024,5,403078.0,Stable Salary & Stable Fixed Expenses,216835,66236.0,100420,166656.0,50179.0,23.14,0.01,Medium Risk
U973,2024,6,453257.0,Stable Salary & Stable Fixed Expenses,216835,66236.0,95161,161397.0,55438.0,25.57,-0.04,Low Risk
U973,2024,7,508695.0,Stable Salary & Stable Fixed Expenses,216835,66236.0,125831,192067.0,24768.0,11.42,0.0,High Risk
U973,2024,8,533463.0,Stable Salary & Stable Fixed Expenses,216835,66236.0,116606,182842.0,33993.0,15.68,0.03,Medium Risk
U973,2024,9,567456.0,Stable Salary & Stable Fixed Expenses,216835,66236.0,121371,187607.0,29228.0,13.48,0.02,High Risk
U973,2024,10,596684.0,Stable Salary & Stable Fixed Expenses,216835,66236.0,138849,205085.0,11750.0,5.42,-0.03,High Risk
U973,2024,11,608434.0,Stable Salary & Stable Fixed Expenses,216835,66236.0,87093,153329.0,63506.0,29.29,0.04,Low Risk
U973,2024,12,671940.0,Stable Salary & Stable Fixed Expenses,216835,66236.0,112317,178553.0,38282.0,17.65,0.0,Medium Risk
U974,2024,1,214567.0,Salary Increases & Fixed Expenses Remain Stable,216231,68929.0,74803,143732.0,72499.0,33.53,-0.01,Low Risk
U974,2024,2,287066.0,Salary Increases & Fixed Expenses Remain Stable,216231,68929.0,74173,143102.0,73129.0,33.82,-0.02,Low Risk
U974,2024,3,360195.0,Salary Increases & Fixed Expenses Remain Stable,216231,68929.0,85625,154554.0,61677.0,28.52,0.05,Low Risk
U974,2024,4,421872.0,Salary Increases & Fixed Expenses Remain Stable,245990,68929.0,92999,161928.0,84062.0,34.17,0.03,Low Risk
U974,2024,5,505934.0,Salary Increases & Fixed Expenses Remain Stable,245990,68929.0,85069,153998.0,91992.0,37.4,-0.03,Low Risk
U974,2024,6,597926.0,Salary Increases & Fixed Expenses Remain Stable,245990,68929.0,93077,162006.0,83984.0,34.14,-0.04,Low Risk
U974,2024,7,681910.0,Salary Increases & Fixed Expenses Remain Stable,245990,68929.0,84788,153717.0,92273.0,37.51,0.04,Low Risk
U974,2024,8,774183.0,Salary Increases & Fixed Expenses Remain Stable,245990,68929.0,91523,160452.0,85538.0,34.77,-0.02,Low Risk
U974,2024,9,859721.0,Salary Increases & Fixed Expenses Remain Stable,245990,68929.0,73988,142917.0,103073.0,41.9,-0.04,Low Risk
U974,2024,10,962794.0,Salary Increases & Fixed Expenses Remain Stable,245990,68929.0,82060,150989.0,95001.0,38.62,0.03,Low Risk
U974,2024,11,1057795.0,Salary Increases & Fixed Expenses Remain Stable,245990,68929.0,91190,160119.0,85871.0,34.91,0.0,Low Risk
U974,2024,12,1143666.0,Salary Increases & Fixed Expenses Remain Stable,245990,68929.0,94745,163674.0,82316.0,33.46,-0.0,Low Risk
U975,2024,1,211129.0,Salary Increases & Fixed Expenses Increase,233023,101657.0,83924,185581.0,47442.0,20.36,-0.04,Medium Risk
U975,2024,2,258571.0,Salary Increases & Fixed Expenses Increase,233023,101657.0,93085,194742.0,38281.0,16.43,0.03,Medium Risk
U975,2024,3,296852.0,Salary Increases & Fixed Expenses Increase,238299,101657.0,84302,185959.0,52340.0,21.96,0.04,Medium Risk
U975,2024,4,349192.0,Salary Increases & Fixed Expenses Increase,238299,101657.0,92203,193860.0,44439.0,18.65,-0.0,Medium Risk
U975,2024,5,393631.0,Salary Increases & Fixed Expenses Increase,238299,101657.0,75443,177100.0,61199.0,25.68,-0.03,Low Risk
U975,2024,6,454830.0,Salary Increases & Fixed Expenses Increase,238299,103134.0,94665,197799.0,40500.0,17.0,0.01,Medium Risk
U975,2024,7,495330.0,Salary Increases & Fixed Expenses Increase,238299,103661.0,88998,192659.0,45640.0,19.15,0.03,Medium Risk
U975,2024,8,540970.0,Salary Increases & Fixed Expenses Increase,238299,103661.0,93628,197289.0,41010.0,17.21,-0.02,Medium Risk
U975,2024,9,581980.0,Salary Increases & Fixed Expenses Increase,238299,103661.0,81078,184739.0,53560.0,22.48,-0.04,Medium Risk
U975,2024,10,635540.0,Salary Increases & Fixed Expenses Increase,238299,105372.0,114867,220239.0,18060.0,7.58,0.04,High Risk
U975,2024,11,653600.0,Salary Increases & Fixed Expenses Increase,238299,105372.0,79406,184778.0,53521.0,22.46,-0.02,Medium Risk
U975,2024,12,707121.0,Salary Increases & Fixed Expenses Increase,238299,105372.0,80882,186254.0,52045.0,21.84,0.01,Medium Risk
U976,2024,1,228811.0,Salary Increases & Fixed Expenses Remain Stable,106370,62104.0,46949,109053.0,-2683.0,-2.52,0.04,High Risk
U976,2024,2,226128.0,Salary Increases & Fixed Expenses Remain Stable,106370,62104.0,43302,105406.0,964.0,0.91,-0.05,High Risk
U976,2024,3,227092.0,Salary Increases & Fixed Expenses Remain Stable,106370,62104.0,68177,130281.0,-23911.0,-22.48,-0.01,High Risk
U976,2024,4,203181.0,Salary Increases & Fixed Expenses Remain Stable,106370,62104.0,54565,116669.0,-10299.0,-9.68,-0.0,High Risk
U976,2024,5,192882.0,Salary Increases & Fixed Expenses Remain Stable,106370,62104.0,61437,123541.0,-17171.0,-16.14,0.01,High Risk
U976,2024,6,175711.0,Salary Increases & Fixed Expenses Remain Stable,106370,62104.0,52023,114127.0,-7757.0,-7.29,0.05,High Risk
U976,2024,7,167954.0,Salary Increases & Fixed Expenses Remain Stable,106370,62104.0,47283,109387.0,-3017.0,-2.84,-0.05,High Risk
U976,2024,8,164937.0,Salary Increases & Fixed Expenses Remain Stable,131185,62104.0,77895,139999.0,-8814.0,-6.72,0.0,High Risk
U976,2024,9,156123.0,Salary Increases & Fixed Expenses Remain Stable,131185,62104.0,72726,134830.0,-3645.0,-2.78,-0.04,High Risk
U976,2024,10,152478.0,Salary Increases & Fixed Expenses Remain Stable,131185,62104.0,85930,148034.0,-16849.0,-12.84,-0.02,High Risk
U976,2024,11,135629.0,Salary Increases & Fixed Expenses Remain Stable,131185,62104.0,68527,130631.0,554.0,0.42,0.01,High Risk
U976,2024,12,136183.0,Salary Increases & Fixed Expenses Remain Stable,131185,62104.0,59854,121958.0,9227.0,7.03,0.02,High Risk
U977,2024,1,217560.0,Stable Salary & Stable Fixed Expenses,200075,102992.0,143902,246894.0,-46819.0,-23.4,-0.04,High Risk
U977,2024,2,170741.0,Stable Salary & Stable Fixed Expenses,200075,102992.0,127947,230939.0,-30864.0,-15.43,0.03,High Risk
U977,2024,3,139877.0,Stable Salary & Stable Fixed Expenses,200075,102992.0,151495,254487.0,-54412.0,-27.2,-0.0,High Risk
U977,2024,4,85465.0,Stable Salary & Stable Fixed Expenses,200075,102992.0,123575,226567.0,-26492.0,-13.24,0.0,High Risk
U977,2024,5,58973.0,Stable Salary & Stable Fixed Expenses,200075,102992.0,141097,244089.0,-44014.0,-22.0,0.0,High Risk
U977,2024,6,14959.0,Stable Salary & Stable Fixed Expenses,200075,102992.0,123839,226831.0,-26756.0,-13.37,-0.02,High Risk
U977,2024,7,-11797.0,Stable Salary & Stable Fixed Expenses,200075,102992.0,134336,237328.0,-37253.0,-18.62,-0.01,High Risk
U977,2024,8,-49050.0,Stable Salary & Stable Fixed Expenses,200075,102992.0,145947,248939.0,-48864.0,-24.42,-0.04,High Risk
U977,2024,9,-97914.0,Stable Salary & Stable Fixed Expenses,200075,102992.0,125879,228871.0,-28796.0,-14.39,0.03,High Risk
U977,2024,10,-126710.0,Stable Salary & Stable Fixed Expenses,200075,102992.0,150772,253764.0,-53689.0,-26.83,-0.05,High Risk
U977,2024,11,-180399.0,Stable Salary & Stable Fixed Expenses,200075,102992.0,126513,229505.0,-29430.0,-14.71,0.05,High Risk
U977,2024,12,-209829.0,Stable Salary & Stable Fixed Expenses,200075,102992.0,140644,243636.0,-43561.0,-21.77,0.03,High Risk
U978,2024,1,234557.0,Salary Increases & Fixed Expenses Remain Stable,74922,27966.0,40998,68964.0,5958.0,7.95,-0.0,High Risk
U978,2024,2,240515.0,Salary Increases & Fixed Expenses Remain Stable,74922,27966.0,32239,60205.0,14717.0,19.64,-0.05,Medium Risk
U978,2024,3,255232.0,Salary Increases & Fixed Expenses Remain Stable,74922,27966.0,39246,67212.0,7710.0,10.29,-0.02,High Risk
U978,2024,4,262942.0,Salary Increases & Fixed Expenses Remain Stable,104289,27966.0,57208,85174.0,19115.0,18.33,0.03,Medium Risk
U978,2024,5,282057.0,Salary Increases & Fixed Expenses Remain Stable,104289,27966.0,48804,76770.0,27519.0,26.39,0.02,Low Risk
U978,2024,6,309576.0,Salary Increases & Fixed Expenses Remain Stable,104289,27966.0,59502,87468.0,16821.0,16.13,0.04,Medium Risk
U978,2024,7,326397.0,Salary Increases & Fixed Expenses Remain Stable,104289,27966.0,43948,71914.0,32375.0,31.04,-0.01,Low Risk
U978,2024,8,358772.0,Salary Increases & Fixed Expenses Remain Stable,104289,27966.0,44623,72589.0,31700.0,30.4,-0.03,Low Risk
U978,2024,9,390472.0,Salary Increases & Fixed Expenses Remain Stable,104289,27966.0,53983,81949.0,22340.0,21.42,-0.01,Medium Risk
U978,2024,10,412812.0,Salary Increases & Fixed Expenses Remain Stable,104289,27966.0,56284,84250.0,20039.0,19.21,0.0,Medium Risk
U978,2024,11,432851.0,Salary Increases & Fixed Expenses Remain Stable,104289,27966.0,56621,84587.0,19702.0,18.89,0.01,Medium Risk
U978,2024,12,452553.0,Salary Increases & Fixed Expenses Remain Stable,104289,27966.0,60433,88399.0,15890.0,15.24,0.02,Medium Risk
U979,2024,1,244968.0,Stable Salary & Stable Fixed Expenses,281383,81128.0,198182,279310.0,2073.0,0.74,-0.05,High Risk
U979,2024,2,247041.0,Stable Salary & Stable Fixed Expenses,281383,81128.0,173643,254771.0,26612.0,9.46,-0.01,High Risk
U979,2024,3,273653.0,Stable Salary & Stable Fixed Expenses,281383,81128.0,233125,314253.0,-32870.0,-11.68,0.02,High Risk
U979,2024,4,240783.0,Stable Salary & Stable Fixed Expenses,281383,81128.0,218861,299989.0,-18606.0,-6.61,0.0,High Risk
U979,2024,5,222177.0,Stable Salary & Stable Fixed Expenses,281383,81128.0,194155,275283.0,6100.0,2.17,-0.02,High Risk
U979,2024,6,228277.0,Stable Salary & Stable Fixed Expenses,281383,81128.0,206861,287989.0,-6606.0,-2.35,0.01,High Risk
U979,2024,7,221671.0,Stable Salary & Stable Fixed Expenses,281383,81128.0,207088,288216.0,-6833.0,-2.43,0.0,High Risk
U979,2024,8,214838.0,Stable Salary & Stable Fixed Expenses,281383,81128.0,204196,285324.0,-3941.0,-1.4,-0.01,High Risk
U979,2024,9,210897.0,Stable Salary & Stable Fixed Expenses,281383,81128.0,210634,291762.0,-10379.0,-3.69,-0.0,High Risk
U979,2024,10,200518.0,Stable Salary & Stable Fixed Expenses,281383,81128.0,240575,321703.0,-40320.0,-14.33,0.01,High Risk
U979,2024,11,160198.0,Stable Salary & Stable Fixed Expenses,281383,81128.0,207635,288763.0,-7380.0,-2.62,0.02,High Risk
U979,2024,12,152818.0,Stable Salary & Stable Fixed Expenses,281383,81128.0,172304,253432.0,27951.0,9.93,0.01,High Risk
U980,2024,1,219109.0,Salary Increases & Fixed Expenses Increase,58529,23538.0,39809,63347.0,-4818.0,-8.23,-0.02,High Risk
U980,2024,2,214291.0,Salary Increases & Fixed Expenses Increase,58529,23538.0,36957,60495.0,-1966.0,-3.36,0.04,High Risk
U980,2024,3,212325.0,Salary Increases & Fixed Expenses Increase,58529,23538.0,43996,67534.0,-9005.0,-15.39,0.02,High Risk
U980,2024,4,203320.0,Salary Increases & Fixed Expenses Increase,58529,23538.0,41277,64815.0,-6286.0,-10.74,0.05,High Risk
U980,2024,5,197034.0,Salary Increases & Fixed Expenses Increase,58529,23538.0,41931,65469.0,-6940.0,-11.86,0.02,High Risk
U980,2024,6,190094.0,Salary Increases & Fixed Expenses Increase,63713,23538.0,48723,72261.0,-8548.0,-13.42,0.02,High Risk
U980,2024,7,181546.0,Salary Increases & Fixed Expenses Increase,63713,23538.0,38505,62043.0,1670.0,2.62,-0.03,High Risk
U980,2024,8,183216.0,Salary Increases & Fixed Expenses Increase,63713,23538.0,40426,63964.0,-251.0,-0.39,-0.05,High Risk
U980,2024,9,182965.0,Salary Increases & Fixed Expenses Increase,63713,23538.0,43189,66727.0,-3014.0,-4.73,0.01,High Risk
U980,2024,10,179951.0,Salary Increases & Fixed Expenses Increase,63713,23538.0,48214,71752.0,-8039.0,-12.62,-0.02,High Risk
U980,2024,11,171912.0,Salary Increases & Fixed Expenses Increase,63713,23538.0,48789,72327.0,-8614.0,-13.52,0.02,High Risk
U980,2024,12,163298.0,Salary Increases & Fixed Expenses Increase,63713,23538.0,48224,71762.0,-8049.0,-12.63,0.02,High Risk
U981,2024,1,239861.0,Stable Salary & Stable Fixed Expenses,34066,22547.0,16296,38843.0,-4777.0,-14.02,0.0,High Risk
U981,2024,2,235084.0,Stable Salary & Stable Fixed Expenses,34066,22547.0,19388,41935.0,-7869.0,-23.1,0.05,High Risk
U981,2024,3,227215.0,Stable Salary & Stable Fixed Expenses,34066,22547.0,22407,44954.0,-10888.0,-31.96,0.04,High Risk
U981,2024,4,216327.0,Stable Salary & Stable Fixed Expenses,34066,22547.0,14448,36995.0,-2929.0,-8.6,0.02,High Risk
U981,2024,5,213398.0,Stable Salary & Stable Fixed Expenses,34066,22547.0,15349,37896.0,-3830.0,-11.24,-0.03,High Risk
U981,2024,6,209568.0,Stable Salary & Stable Fixed Expenses,34066,22547.0,15939,38486.0,-4420.0,-12.97,0.02,High Risk
U981,2024,7,205148.0,Stable Salary & Stable Fixed Expenses,34066,22547.0,17329,39876.0,-5810.0,-17.06,-0.03,High Risk
U981,2024,8,199338.0,Stable Salary & Stable Fixed Expenses,34066,22547.0,14319,36866.0,-2800.0,-8.22,0.04,High Risk
U981,2024,9,196538.0,Stable Salary & Stable Fixed Expenses,34066,22547.0,18447,40994.0,-6928.0,-20.34,0.03,High Risk
U981,2024,10,189610.0,Stable Salary & Stable Fixed Expenses,34066,22547.0,23994,46541.0,-12475.0,-36.62,-0.02,High Risk
U981,2024,11,177135.0,Stable Salary & Stable Fixed Expenses,34066,22547.0,20269,42816.0,-8750.0,-25.69,-0.05,High Risk
U981,2024,12,168385.0,Stable Salary & Stable Fixed Expenses,34066,22547.0,22403,44950.0,-10884.0,-31.95,-0.04,High Risk
U982,2024,1,223487.0,Stable Salary & Stable Fixed Expenses,162459,53913.0,105011,158924.0,3535.0,2.18,-0.04,High Risk
U982,2024,2,227022.0,Stable Salary & Stable Fixed Expenses,162459,53913.0,125037,178950.0,-16491.0,-10.15,0.04,High Risk
U982,2024,3,210531.0,Stable Salary & Stable Fixed Expenses,162459,53913.0,139255,193168.0,-30709.0,-18.9,0.03,High Risk
U982,2024,4,179822.0,Stable Salary & Stable Fixed Expenses,162459,53913.0,101831,155744.0,6715.0,4.13,0.05,High Risk
U982,2024,5,186537.0,Stable Salary & Stable Fixed Expenses,162459,53913.0,102951,156864.0,5595.0,3.44,-0.03,High Risk
U982,2024,6,192132.0,Stable Salary & Stable Fixed Expenses,162459,53913.0,103764,157677.0,4782.0,2.94,0.04,High Risk
U982,2024,7,196914.0,Stable Salary & Stable Fixed Expenses,162459,53913.0,108350,162263.0,196.0,0.12,0.01,High Risk
U982,2024,8,197110.0,Stable Salary & Stable Fixed Expenses,162459,53913.0,114477,168390.0,-5931.0,-3.65,-0.02,High Risk
U982,2024,9,191179.0,Stable Salary & Stable Fixed Expenses,162459,53913.0,108045,161958.0,501.0,0.31,-0.02,High Risk
U982,2024,10,191680.0,Stable Salary & Stable Fixed Expenses,162459,53913.0,148207,202120.0,-39661.0,-24.41,0.04,High Risk
U982,2024,11,152019.0,Stable Salary & Stable Fixed Expenses,162459,53913.0,117285,171198.0,-8739.0,-5.38,0.02,High Risk
U982,2024,12,143280.0,Stable Salary & Stable Fixed Expenses,162459,53913.0,112383,166296.0,-3837.0,-2.36,0.02,High Risk
U983,2024,1,236954.0,Stable Salary & Stable Fixed Expenses,235561,116691.0,174361,291052.0,-55491.0,-23.56,-0.03,High Risk
U983,2024,2,181463.0,Stable Salary & Stable Fixed Expenses,235561,116691.0,162780,279471.0,-43910.0,-18.64,-0.01,High Risk
U983,2024,3,137553.0,Stable Salary & Stable Fixed Expenses,235561,116691.0,168310,285001.0,-49440.0,-20.99,-0.01,High Risk
U983,2024,4,88113.0,Stable Salary & Stable Fixed Expenses,235561,116691.0,162971,279662.0,-44101.0,-18.72,-0.03,High Risk
U983,2024,5,44012.0,Stable Salary & Stable Fixed Expenses,235561,116691.0,182025,298716.0,-63155.0,-26.81,0.01,High Risk
U983,2024,6,-19143.0,Stable Salary & Stable Fixed Expenses,235561,116691.0,182792,299483.0,-63922.0,-27.14,-0.02,High Risk
U983,2024,7,-83065.0,Stable Salary & Stable Fixed Expenses,235561,116691.0,178248,294939.0,-59378.0,-25.21,0.04,High Risk
U983,2024,8,-142443.0,Stable Salary & Stable Fixed Expenses,235561,116691.0,157309,274000.0,-38439.0,-16.32,-0.01,High Risk
U983,2024,9,-180882.0,Stable Salary & Stable Fixed Expenses,235561,116691.0,207336,324027.0,-88466.0,-37.56,-0.03,High Risk
U983,2024,10,-269348.0,Stable Salary & Stable Fixed Expenses,235561,116691.0,211137,327828.0,-92267.0,-39.17,-0.04,High Risk
U983,2024,11,-361615.0,Stable Salary & Stable Fixed Expenses,235561,116691.0,198653,315344.0,-79783.0,-33.87,0.01,High Risk
U983,2024,12,-441398.0,Stable Salary & Stable Fixed Expenses,235561,116691.0,196342,313033.0,-77472.0,-32.89,-0.01,High Risk
U984,2024,1,206672.0,Salary Increases & Fixed Expenses Decrease,64621,25801.0,32879,58680.0,5941.0,9.19,0.05,High Risk
U984,2024,2,212613.0,Salary Increases & Fixed Expenses Decrease,64621,25801.0,31834,57635.0,6986.0,10.81,-0.02,High Risk
U984,2024,3,219599.0,Salary Increases & Fixed Expenses Decrease,89807,25801.0,43857,69658.0,20149.0,22.44,-0.02,Medium Risk
U984,2024,4,239748.0,Salary Increases & Fixed Expenses Decrease,89807,25801.0,51137,76938.0,12869.0,14.33,-0.04,High Risk
U984,2024,5,252617.0,Salary Increases & Fixed Expenses Decrease,89807,25801.0,39546,65347.0,24460.0,27.24,0.03,Low Risk
U984,2024,6,277077.0,Salary Increases & Fixed Expenses Decrease,89807,25801.0,43574,69375.0,20432.0,22.75,0.02,Medium Risk
U984,2024,7,297509.0,Salary Increases & Fixed Expenses Decrease,89807,25801.0,44522,70323.0,19484.0,21.7,0.04,Medium Risk
U984,2024,8,316993.0,Salary Increases & Fixed Expenses Decrease,89807,25801.0,38825,64626.0,25181.0,28.04,0.02,Low Risk
U984,2024,9,342174.0,Salary Increases & Fixed Expenses Decrease,89807,25801.0,47700,73501.0,16306.0,18.16,0.02,Medium Risk
U984,2024,10,358480.0,Salary Increases & Fixed Expenses Decrease,89807,25801.0,58397,84198.0,5609.0,6.25,-0.01,High Risk
U984,2024,11,364089.0,Salary Increases & Fixed Expenses Decrease,89807,25801.0,44555,70356.0,19451.0,21.66,-0.02,Medium Risk
U984,2024,12,383540.0,Salary Increases & Fixed Expenses Decrease,89807,25801.0,41611,67412.0,22395.0,24.94,-0.02,Medium Risk
U985,2024,1,215649.0,Stable Salary & Stable Fixed Expenses,227845,88927.0,82672,171599.0,56246.0,24.69,-0.03,Medium Risk
U985,2024,2,271895.0,Stable Salary & Stable Fixed Expenses,227845,88927.0,89119,178046.0,49799.0,21.86,-0.04,Medium Risk
U985,2024,3,321694.0,Stable Salary & Stable Fixed Expenses,227845,88927.0,85743,174670.0,53175.0,23.34,-0.02,Medium Risk
U985,2024,4,374869.0,Stable Salary & Stable Fixed Expenses,227845,88927.0,83801,172728.0,55117.0,24.19,0.01,Medium Risk
U985,2024,5,429986.0,Stable Salary & Stable Fixed Expenses,227845,88927.0,69539,158466.0,69379.0,30.45,0.02,Low Risk
U985,2024,6,499365.0,Stable Salary & Stable Fixed Expenses,227845,88927.0,80343,169270.0,58575.0,25.71,-0.05,Low Risk
U985,2024,7,557940.0,Stable Salary & Stable Fixed Expenses,227845,88927.0,80026,168953.0,58892.0,25.85,-0.01,Low Risk
U985,2024,8,616832.0,Stable Salary & Stable Fixed Expenses,227845,88927.0,79969,168896.0,58949.0,25.87,-0.02,Low Risk
U985,2024,9,675781.0,Stable Salary & Stable Fixed Expenses,227845,88927.0,84245,173172.0,54673.0,24.0,0.04,Medium Risk
U985,2024,10,730454.0,Stable Salary & Stable Fixed Expenses,227845,88927.0,94931,183858.0,43987.0,19.31,0.02,Medium Risk
U985,2024,11,774441.0,Stable Salary & Stable Fixed Expenses,227845,88927.0,84226,173153.0,54692.0,24.0,-0.01,Medium Risk
U985,2024,12,829133.0,Stable Salary & Stable Fixed Expenses,227845,88927.0,87972,176899.0,50946.0,22.36,-0.01,Medium Risk
U986,2024,1,207480.0,Salary Increases & Fixed Expenses Increase,231133,108779.0,118328,227107.0,4026.0,1.74,0.0,High Risk
U986,2024,2,211506.0,Salary Increases & Fixed Expenses Increase,231133,108779.0,121426,230205.0,928.0,0.4,0.05,High Risk
U986,2024,3,212434.0,Salary Increases & Fixed Expenses Increase,231133,108779.0,93710,202489.0,28644.0,12.39,-0.02,High Risk
U986,2024,4,241078.0,Salary Increases & Fixed Expenses Increase,231133,108779.0,101389,210168.0,20965.0,9.07,0.02,High Risk
U986,2024,5,262043.0,Salary Increases & Fixed Expenses Increase,231133,108779.0,106767,215546.0,15587.0,6.74,0.0,High Risk
U986,2024,6,277630.0,Salary Increases & Fixed Expenses Increase,231133,108779.0,124022,232801.0,-1668.0,-0.72,0.05,High Risk
U986,2024,7,275962.0,Salary Increases & Fixed Expenses Increase,231133,108779.0,102682,211461.0,19672.0,8.51,0.01,High Risk
U986,2024,8,295634.0,Salary Increases & Fixed Expenses Increase,256854,108779.0,137311,246090.0,10764.0,4.19,0.05,High Risk
U986,2024,9,306398.0,Salary Increases & Fixed Expenses Increase,256854,108779.0,138304,247083.0,9771.0,3.8,0.02,High Risk
U986,2024,10,316169.0,Salary Increases & Fixed Expenses Increase,256854,108779.0,109424,218203.0,38651.0,15.05,0.01,Medium Risk
U986,2024,11,354820.0,Salary Increases & Fixed Expenses Increase,256854,108779.0,128793,237572.0,19282.0,7.51,0.03,High Risk
U986,2024,12,374102.0,Salary Increases & Fixed Expenses Increase,256854,108779.0,149103,257882.0,-1028.0,-0.4,-0.03,High Risk
U987,2024,1,211007.0,Salary Increases & Fixed Expenses Increase,239422,119172.0,143893,263065.0,-23643.0,-9.88,0.01,High Risk
U987,2024,2,187364.0,Salary Increases & Fixed Expenses Increase,239422,119172.0,167501,286673.0,-47251.0,-19.74,-0.02,High Risk
U987,2024,3,140113.0,Salary Increases & Fixed Expenses Increase,268126,119172.0,202143,321315.0,-53189.0,-19.84,0.03,High Risk
U987,2024,4,86924.0,Salary Increases & Fixed Expenses Increase,268126,119172.0,165528,284700.0,-16574.0,-6.18,0.03,High Risk
U987,2024,5,70350.0,Salary Increases & Fixed Expenses Increase,268126,119172.0,196324,315496.0,-47370.0,-17.67,0.04,High Risk
U987,2024,6,22980.0,Salary Increases & Fixed Expenses Increase,268126,119172.0,199573,318745.0,-50619.0,-18.88,0.02,High Risk
U987,2024,7,-27639.0,Salary Increases & Fixed Expenses Increase,268126,120730.0,197731,318461.0,-50335.0,-18.77,-0.04,High Risk
U987,2024,8,-77974.0,Salary Increases & Fixed Expenses Increase,268126,120730.0,173175,293905.0,-25779.0,-9.61,-0.03,High Risk
U987,2024,9,-103753.0,Salary Increases & Fixed Expenses Increase,268126,120730.0,229398,350128.0,-82002.0,-30.58,0.02,High Risk
U987,2024,10,-185755.0,Salary Increases & Fixed Expenses Increase,268126,120730.0,218355,339085.0,-70959.0,-26.46,0.02,High Risk
U987,2024,11,-256714.0,Salary Increases & Fixed Expenses Increase,268126,120730.0,193297,314027.0,-45901.0,-17.12,0.04,High Risk
U987,2024,12,-302615.0,Salary Increases & Fixed Expenses Increase,268126,122167.0,217349,339516.0,-71390.0,-26.63,-0.01,High Risk
U988,2024,1,231647.0,Stable Salary & Stable Fixed Expenses,179253,54639.0,77346,131985.0,47268.0,26.37,-0.0,Low Risk
U988,2024,2,278915.0,Stable Salary & Stable Fixed Expenses,179253,54639.0,86460,141099.0,38154.0,21.28,0.04,Medium Risk
U988,2024,3,317069.0,Stable Salary & Stable Fixed Expenses,179253,54639.0,105166,159805.0,19448.0,10.85,-0.05,High Risk
U988,2024,4,336517.0,Stable Salary & Stable Fixed Expenses,179253,54639.0,74952,129591.0,49662.0,27.7,0.0,Low Risk
U988,2024,5,386179.0,Stable Salary & Stable Fixed Expenses,179253,54639.0,86535,141174.0,38079.0,21.24,-0.01,Medium Risk
U988,2024,6,424258.0,Stable Salary & Stable Fixed Expenses,179253,54639.0,85455,140094.0,39159.0,21.85,-0.05,Medium Risk
U988,2024,7,463417.0,Stable Salary & Stable Fixed Expenses,179253,54639.0,79307,133946.0,45307.0,25.28,0.04,Low Risk
U988,2024,8,508724.0,Stable Salary & Stable Fixed Expenses,179253,54639.0,74669,129308.0,49945.0,27.86,-0.05,Low Risk
U988,2024,9,558669.0,Stable Salary & Stable Fixed Expenses,179253,54639.0,101961,156600.0,22653.0,12.64,-0.04,High Risk
U988,2024,10,581322.0,Stable Salary & Stable Fixed Expenses,179253,54639.0,72203,126842.0,52411.0,29.24,-0.04,Low Risk
U988,2024,11,633733.0,Stable Salary & Stable Fixed Expenses,179253,54639.0,77245,131884.0,47369.0,26.43,0.03,Low Risk
U988,2024,12,681102.0,Stable Salary & Stable Fixed Expenses,179253,54639.0,80094,134733.0,44520.0,24.84,0.02,Medium Risk
U989,2024,1,235067.0,Stable Salary & Increasing Fixed Expenses,45314,18993.0,22340,41333.0,3981.0,8.79,0.0,High Risk
U989,2024,2,239048.0,Stable Salary & Increasing Fixed Expenses,45314,19540.0,26677,46217.0,-903.0,-1.99,-0.01,High Risk
U989,2024,3,238145.0,Stable Salary & Increasing Fixed Expenses,45314,19540.0,29890,49430.0,-4116.0,-9.08,0.01,High Risk
U989,2024,4,234029.0,Stable Salary & Increasing Fixed Expenses,45314,19540.0,25159,44699.0,615.0,1.36,-0.0,High Risk
U989,2024,5,234644.0,Stable Salary & Increasing Fixed Expenses,45314,20265.0,18602,38867.0,6447.0,14.23,-0.01,High Risk
U989,2024,6,241091.0,Stable Salary & Increasing Fixed Expenses,45314,20265.0,19193,39458.0,5856.0,12.92,-0.01,High Risk
U989,2024,7,246947.0,Stable Salary & Increasing Fixed Expenses,45314,20265.0,20488,40753.0,4561.0,10.07,0.04,High Risk
U989,2024,8,251508.0,Stable Salary & Increasing Fixed Expenses,45314,21737.0,18154,39891.0,5423.0,11.97,0.03,High Risk
U989,2024,9,256931.0,Stable Salary & Increasing Fixed Expenses,45314,21737.0,21214,42951.0,2363.0,5.21,-0.01,High Risk
U989,2024,10,259294.0,Stable Salary & Increasing Fixed Expenses,45314,21737.0,25906,47643.0,-2329.0,-5.14,-0.01,High Risk
U989,2024,11,256965.0,Stable Salary & Increasing Fixed Expenses,45314,21737.0,26303,48040.0,-2726.0,-6.02,-0.0,High Risk
U989,2024,12,254239.0,Stable Salary & Increasing Fixed Expenses,45314,21737.0,25225,46962.0,-1648.0,-3.64,0.02,High Risk
U990,2024,1,204976.0,Salary Increases & Fixed Expenses Remain Stable,155012,78760.0,47894,126654.0,28358.0,18.29,0.03,Medium Risk
U990,2024,2,233334.0,Salary Increases & Fixed Expenses Remain Stable,155012,78760.0,60161,138921.0,16091.0,10.38,0.01,High Risk
U990,2024,3,249425.0,Salary Increases & Fixed Expenses Remain Stable,155012,78760.0,60960,139720.0,15292.0,9.87,0.02,High Risk
U990,2024,4,264717.0,Salary Increases & Fixed Expenses Remain Stable,155012,78760.0,58103,136863.0,18149.0,11.71,-0.03,High Risk
U990,2024,5,282866.0,Salary Increases & Fixed Expenses Remain Stable,177076,78760.0,59697,138457.0,38619.0,21.81,-0.01,Medium Risk
U990,2024,6,321485.0,Salary Increases & Fixed Expenses Remain Stable,177076,78760.0,65655,144415.0,32661.0,18.44,0.03,Medium Risk
U990,2024,7,354146.0,Salary Increases & Fixed Expenses Remain Stable,177076,78760.0,66002,144762.0,32314.0,18.25,-0.02,Medium Risk
U990,2024,8,386460.0,Salary Increases & Fixed Expenses Remain Stable,177076,78760.0,68219,146979.0,30097.0,17.0,0.03,Medium Risk
U990,2024,9,416557.0,Salary Increases & Fixed Expenses Remain Stable,177076,78760.0,53293,132053.0,45023.0,25.43,0.04,Low Risk
U990,2024,10,461580.0,Salary Increases & Fixed Expenses Remain Stable,177076,78760.0,70273,149033.0,28043.0,15.84,0.02,Medium Risk
U990,2024,11,489623.0,Salary Increases & Fixed Expenses Remain Stable,177076,78760.0,70319,149079.0,27997.0,15.81,0.01,Medium Risk
U990,2024,12,517620.0,Salary Increases & Fixed Expenses Remain Stable,177076,78760.0,64864,143624.0,33452.0,18.89,-0.01,Medium Risk
U991,2024,1,209496.0,Stable Salary & Increasing Fixed Expenses,249464,62999.0,115570,178569.0,70895.0,28.42,0.02,Low Risk
U991,2024,2,280391.0,Stable Salary & Increasing Fixed Expenses,249464,62999.0,114344,177343.0,72121.0,28.91,-0.04,Low Risk
U991,2024,3,352512.0,Stable Salary & Increasing Fixed Expenses,249464,62999.0,136743,199742.0,49722.0,19.93,-0.03,Medium Risk
U991,2024,4,402234.0,Stable Salary & Increasing Fixed Expenses,249464,62999.0,105108,168107.0,81357.0,32.61,0.02,Low Risk
U991,2024,5,483591.0,Stable Salary & Increasing Fixed Expenses,249464,62999.0,127455,190454.0,59010.0,23.65,0.02,Medium Risk
U991,2024,6,542601.0,Stable Salary & Increasing Fixed Expenses,249464,62999.0,136737,199736.0,49728.0,19.93,0.03,Medium Risk
U991,2024,7,592329.0,Stable Salary & Increasing Fixed Expenses,249464,62999.0,141798,204797.0,44667.0,17.91,-0.03,Medium Risk
U991,2024,8,636996.0,Stable Salary & Increasing Fixed Expenses,249464,62999.0,119278,182277.0,67187.0,26.93,-0.02,Low Risk
U991,2024,9,704183.0,Stable Salary & Increasing Fixed Expenses,249464,62999.0,105818,168817.0,80647.0,32.33,0.0,Low Risk
U991,2024,10,784830.0,Stable Salary & Increasing Fixed Expenses,249464,64013.0,111290,175303.0,74161.0,29.73,0.01,Low Risk
U991,2024,11,858991.0,Stable Salary & Increasing Fixed Expenses,249464,64013.0,121410,185423.0,64041.0,25.67,0.01,Low Risk
U991,2024,12,923032.0,Stable Salary & Increasing Fixed Expenses,249464,64013.0,119534,183547.0,65917.0,26.42,0.03,Low Risk
U992,2024,1,207435.0,Salary Increases & Fixed Expenses Increase,203905,68201.0,158508,226709.0,-22804.0,-11.18,0.03,High Risk
U992,2024,2,184631.0,Salary Increases & Fixed Expenses Increase,203905,68201.0,141364,209565.0,-5660.0,-2.78,-0.04,High Risk
U992,2024,3,178971.0,Salary Increases & Fixed Expenses Increase,203905,68201.0,141757,209958.0,-6053.0,-2.97,-0.02,High Risk
U992,2024,4,172918.0,Salary Increases & Fixed Expenses Increase,203905,68201.0,155814,224015.0,-20110.0,-9.86,-0.04,High Risk
U992,2024,5,152808.0,Salary Increases & Fixed Expenses Increase,203905,69966.0,140768,210734.0,-6829.0,-3.35,0.03,High Risk
U992,2024,6,145979.0,Salary Increases & Fixed Expenses Increase,203905,71254.0,149053,220307.0,-16402.0,-8.04,0.04,High Risk
U992,2024,7,129577.0,Salary Increases & Fixed Expenses Increase,203905,71254.0,128922,200176.0,3729.0,1.83,-0.01,High Risk
U992,2024,8,133306.0,Salary Increases & Fixed Expenses Increase,218282,71254.0,165715,236969.0,-18687.0,-8.56,0.01,High Risk
U992,2024,9,114619.0,Salary Increases & Fixed Expenses Increase,218282,71254.0,153014,224268.0,-5986.0,-2.74,0.03,High Risk
U992,2024,10,108633.0,Salary Increases & Fixed Expenses Increase,218282,71254.0,143104,214358.0,3924.0,1.8,0.01,High Risk
U992,2024,11,112557.0,Salary Increases & Fixed Expenses Increase,218282,71254.0,139691,210945.0,7337.0,3.36,0.04,High Risk
U992,2024,12,119894.0,Salary Increases & Fixed Expenses Increase,218282,71254.0,157123,228377.0,-10095.0,-4.62,0.0,High Risk
U993,2024,1,213337.0,Salary Increases & Fixed Expenses Remain Stable,202791,104546.0,103768,208314.0,-5523.0,-2.72,0.03,High Risk
U993,2024,2,207814.0,Salary Increases & Fixed Expenses Remain Stable,202791,104546.0,111518,216064.0,-13273.0,-6.55,-0.04,High Risk
U993,2024,3,194541.0,Salary Increases & Fixed Expenses Remain Stable,202791,104546.0,103444,207990.0,-5199.0,-2.56,-0.02,High Risk
U993,2024,4,189342.0,Salary Increases & Fixed Expenses Remain Stable,202791,104546.0,86993,191539.0,11252.0,5.55,0.02,High Risk
U993,2024,5,200594.0,Salary Increases & Fixed Expenses Remain Stable,202791,104546.0,84551,189097.0,13694.0,6.75,0.02,High Risk
U993,2024,6,214288.0,Salary Increases & Fixed Expenses Remain Stable,202791,104546.0,121525,226071.0,-23280.0,-11.48,0.02,High Risk
U993,2024,7,191008.0,Salary Increases & Fixed Expenses Remain Stable,227314,104546.0,127674,232220.0,-4906.0,-2.16,0.03,High Risk
U993,2024,8,186102.0,Salary Increases & Fixed Expenses Remain Stable,227314,104546.0,95514,200060.0,27254.0,11.99,-0.02,High Risk
U993,2024,9,213356.0,Salary Increases & Fixed Expenses Remain Stable,227314,104546.0,96632,201178.0,26136.0,11.5,-0.04,High Risk
U993,2024,10,239492.0,Salary Increases & Fixed Expenses Remain Stable,227314,104546.0,151326,255872.0,-28558.0,-12.56,0.03,High Risk
U993,2024,11,210934.0,Salary Increases & Fixed Expenses Remain Stable,227314,104546.0,130820,235366.0,-8052.0,-3.54,0.0,High Risk
U993,2024,12,202882.0,Salary Increases & Fixed Expenses Remain Stable,227314,104546.0,124305,228851.0,-1537.0,-0.68,-0.02,High Risk
U994,2024,1,227528.0,Salary Increases & Fixed Expenses Increase,288453,77000.0,129898,206898.0,81555.0,28.27,-0.03,Low Risk
U994,2024,2,309083.0,Salary Increases & Fixed Expenses Increase,288453,77000.0,145760,222760.0,65693.0,22.77,-0.03,Medium Risk
U994,2024,3,374776.0,Salary Increases & Fixed Expenses Increase,288453,77000.0,201319,278319.0,10134.0,3.51,-0.04,High Risk
U994,2024,4,384910.0,Salary Increases & Fixed Expenses Increase,288453,78296.0,146196,224492.0,63961.0,22.17,0.05,Medium Risk
U994,2024,5,448871.0,Salary Increases & Fixed Expenses Increase,288453,78296.0,127705,206001.0,82452.0,28.58,-0.05,Low Risk
U994,2024,6,531323.0,Salary Increases & Fixed Expenses Increase,288453,78296.0,115913,194209.0,94244.0,32.67,-0.0,Low Risk
U994,2024,7,625567.0,Salary Increases & Fixed Expenses Increase,304972,79325.0,153041,232366.0,72606.0,23.81,0.03,Medium Risk
U994,2024,8,698173.0,Salary Increases & Fixed Expenses Increase,304972,79931.0,150593,230524.0,74448.0,24.41,0.01,Medium Risk
U994,2024,9,772621.0,Salary Increases & Fixed Expenses Increase,304972,79931.0,143511,223442.0,81530.0,26.73,0.03,Low Risk
U994,2024,10,854151.0,Salary Increases & Fixed Expenses Increase,304972,79931.0,214525,294456.0,10516.0,3.45,-0.03,High Risk
U994,2024,11,864667.0,Salary Increases & Fixed Expenses Increase,304972,79931.0,137763,217694.0,87278.0,28.62,0.01,Low Risk
U994,2024,12,951945.0,Salary Increases & Fixed Expenses Increase,304972,81322.0,168083,249405.0,55567.0,18.22,0.02,Medium Risk
U995,2024,1,228235.0,Salary Increases & Fixed Expenses Remain Stable,127327,60814.0,63667,124481.0,2846.0,2.24,-0.03,High Risk
U995,2024,2,231081.0,Salary Increases & Fixed Expenses Remain Stable,127327,60814.0,66426,127240.0,87.0,0.07,-0.0,High Risk
U995,2024,3,231168.0,Salary Increases & Fixed Expenses Remain Stable,127327,60814.0,82510,143324.0,-15997.0,-12.56,0.05,High Risk
U995,2024,4,215171.0,Salary Increases & Fixed Expenses Remain Stable,127327,60814.0,58411,119225.0,8102.0,6.36,0.04,High Risk
U995,2024,5,223273.0,Salary Increases & Fixed Expenses Remain Stable,127327,60814.0,66278,127092.0,235.0,0.18,-0.01,High Risk
U995,2024,6,223508.0,Salary Increases & Fixed Expenses Remain Stable,141254,60814.0,73017,133831.0,7423.0,5.26,0.01,High Risk
U995,2024,7,230931.0,Salary Increases & Fixed Expenses Remain Stable,141254,60814.0,73214,134028.0,7226.0,5.12,0.02,High Risk
U995,2024,8,238157.0,Salary Increases & Fixed Expenses Remain Stable,141254,60814.0,70389,131203.0,10051.0,7.12,-0.0,High Risk
U995,2024,9,248208.0,Salary Increases & Fixed Expenses Remain Stable,141254,60814.0,82259,143073.0,-1819.0,-1.29,0.03,High Risk
U995,2024,10,246389.0,Salary Increases & Fixed Expenses Remain Stable,141254,60814.0,86895,147709.0,-6455.0,-4.57,0.04,High Risk
U995,2024,11,239934.0,Salary Increases & Fixed Expenses Remain Stable,141254,60814.0,61771,122585.0,18669.0,13.22,-0.02,High Risk
U995,2024,12,258603.0,Salary Increases & Fixed Expenses Remain Stable,141254,60814.0,68455,129269.0,11985.0,8.48,0.02,High Risk
U996,2024,1,243094.0,Salary Increases & Fixed Expenses Remain Stable,162623,40909.0,80101,121010.0,41613.0,25.59,-0.0,Low Risk
U996,2024,2,284707.0,Salary Increases & Fixed Expenses Remain Stable,162623,40909.0,76139,117048.0,45575.0,28.02,-0.04,Low Risk
U996,2024,3,330282.0,Salary Increases & Fixed Expenses Remain Stable,162623,40909.0,92782,133691.0,28932.0,17.79,0.02,Medium Risk
U996,2024,4,359214.0,Salary Increases & Fixed Expenses Remain Stable,162623,40909.0,86496,127405.0,35218.0,21.66,-0.01,Medium Risk
U996,2024,5,394432.0,Salary Increases & Fixed Expenses Remain Stable,162623,40909.0,92940,133849.0,28774.0,17.69,0.03,Medium Risk
U996,2024,6,423206.0,Salary Increases & Fixed Expenses Remain Stable,162623,40909.0,66721,107630.0,54993.0,33.82,0.02,Low Risk
U996,2024,7,478199.0,Salary Increases & Fixed Expenses Remain Stable,162623,40909.0,91598,132507.0,30116.0,18.52,-0.0,Medium Risk
U996,2024,8,508315.0,Salary Increases & Fixed Expenses Remain Stable,181353,40909.0,81508,122417.0,58936.0,32.5,0.02,Low Risk
U996,2024,9,567251.0,Salary Increases & Fixed Expenses Remain Stable,181353,40909.0,91049,131958.0,49395.0,27.24,-0.0,Low Risk
U996,2024,10,616646.0,Salary Increases & Fixed Expenses Remain Stable,181353,40909.0,87465,128374.0,52979.0,29.21,0.03,Low Risk
U996,2024,11,669625.0,Salary Increases & Fixed Expenses Remain Stable,181353,40909.0,102016,142925.0,38428.0,21.19,0.03,Medium Risk
U996,2024,12,708053.0,Salary Increases & Fixed Expenses Remain Stable,181353,40909.0,86262,127171.0,54182.0,29.88,-0.01,Low Risk
U997,2024,1,212601.0,Stable Salary & Stable Fixed Expenses,77579,32855.0,51548,84403.0,-6824.0,-8.8,-0.02,High Risk
U997,2024,2,205777.0,Stable Salary & Stable Fixed Expenses,77579,32855.0,48020,80875.0,-3296.0,-4.25,0.04,High Risk
U997,2024,3,202481.0,Stable Salary & Stable Fixed Expenses,77579,32855.0,76501,109356.0,-31777.0,-40.96,-0.04,High Risk
U997,2024,4,170704.0,Stable Salary & Stable Fixed Expenses,77579,32855.0,58730,91585.0,-14006.0,-18.05,-0.05,High Risk
U997,2024,5,156698.0,Stable Salary & Stable Fixed Expenses,77579,32855.0,51967,84822.0,-7243.0,-9.34,-0.01,High Risk
U997,2024,6,149455.0,Stable Salary & Stable Fixed Expenses,77579,32855.0,49259,82114.0,-4535.0,-5.85,-0.01,High Risk
U997,2024,7,144920.0,Stable Salary & Stable Fixed Expenses,77579,32855.0,58321,91176.0,-13597.0,-17.53,0.01,High Risk
U997,2024,8,131323.0,Stable Salary & Stable Fixed Expenses,77579,32855.0,50955,83810.0,-6231.0,-8.03,-0.03,High Risk
U997,2024,9,125092.0,Stable Salary & Stable Fixed Expenses,77579,32855.0,52310,85165.0,-7586.0,-9.78,-0.03,High Risk
U997,2024,10,117506.0,Stable Salary & Stable Fixed Expenses,77579,32855.0,64745,97600.0,-20021.0,-25.81,0.02,High Risk
U997,2024,11,97485.0,Stable Salary & Stable Fixed Expenses,77579,32855.0,58962,91817.0,-14238.0,-18.35,0.03,High Risk
U997,2024,12,83247.0,Stable Salary & Stable Fixed Expenses,77579,32855.0,56600,89455.0,-11876.0,-15.31,0.03,High Risk
U998,2024,1,235978.0,Salary Increases & Fixed Expenses Increase,35576,10017.0,10809,20826.0,14750.0,41.46,-0.04,Low Risk
U998,2024,2,250728.0,Salary Increases & Fixed Expenses Increase,35576,10017.0,12353,22370.0,13206.0,37.12,0.04,Low Risk
U998,2024,3,263934.0,Salary Increases & Fixed Expenses Increase,35576,11872.0,16222,28094.0,7482.0,21.03,0.0,Medium Risk
U998,2024,4,271416.0,Salary Increases & Fixed Expenses Increase,35576,13418.0,13570,26988.0,8588.0,24.14,0.02,Medium Risk
U998,2024,5,280004.0,Salary Increases & Fixed Expenses Increase,35576,13418.0,11273,24691.0,10885.0,30.6,0.05,Low Risk
U998,2024,6,290889.0,Salary Increases & Fixed Expenses Increase,65491,13418.0,21020,34438.0,31053.0,47.42,0.05,Low Risk
U998,2024,7,321942.0,Salary Increases & Fixed Expenses Increase,65491,14408.0,21788,36196.0,29295.0,44.73,-0.0,Low Risk
U998,2024,8,351237.0,Salary Increases & Fixed Expenses Increase,65491,14408.0,20666,35074.0,30417.0,46.44,-0.02,Low Risk
U998,2024,9,381654.0,Salary Increases & Fixed Expenses Increase,65491,14408.0,24067,38475.0,27016.0,41.25,0.04,Low Risk
U998,2024,10,408670.0,Salary Increases & Fixed Expenses Increase,65491,14408.0,27980,42388.0,23103.0,35.28,0.03,Low Risk
U998,2024,11,431773.0,Salary Increases & Fixed Expenses Increase,65491,14408.0,24373,38781.0,26710.0,40.78,-0.01,Low Risk
U998,2024,12,458483.0,Salary Increases & Fixed Expenses Increase,65491,14408.0,30821,45229.0,20262.0,30.94,-0.0,Low Risk
U999,2024,1,231264.0,Stable Salary & Increasing Fixed Expenses,94305,32007.0,38897,70904.0,23401.0,24.81,0.01,Medium Risk
U999,2024,2,254665.0,Stable Salary & Increasing Fixed Expenses,94305,32007.0,44686,76693.0,17612.0,18.68,0.0,Medium Risk
U999,2024,3,272277.0,Stable Salary & Increasing Fixed Expenses,94305,32007.0,50813,82820.0,11485.0,12.18,0.01,High Risk
U999,2024,4,283762.0,Stable Salary & Increasing Fixed Expenses,94305,32007.0,54518,86525.0,7780.0,8.25,-0.04,High Risk
U999,2024,5,291542.0,Stable Salary & Increasing Fixed Expenses,94305,32007.0,50916,82923.0,11382.0,12.07,-0.05,High Risk
U999,2024,6,302924.0,Stable Salary & Increasing Fixed Expenses,94305,32007.0,55192,87199.0,7106.0,7.54,-0.04,High Risk
U999,2024,7,310030.0,Stable Salary & Increasing Fixed Expenses,94305,32604.0,51110,83714.0,10591.0,11.23,0.0,High Risk
U999,2024,8,320621.0,Stable Salary & Increasing Fixed Expenses,94305,32604.0,47656,80260.0,14045.0,14.89,-0.04,High Risk
U999,2024,9,334666.0,Stable Salary & Increasing Fixed Expenses,94305,33366.0,61336,94702.0,-397.0,-0.42,-0.03,High Risk
U999,2024,10,334269.0,Stable Salary & Increasing Fixed Expenses,94305,33366.0,66028,99394.0,-5089.0,-5.4,0.01,High Risk
U999,2024,11,329180.0,Stable Salary & Increasing Fixed Expenses,94305,33366.0,50410,83776.0,10529.0,11.16,0.04,High Risk
U999,2024,12,339709.0,Stable Salary & Increasing Fixed Expenses,94305,34198.0,53718,87916.0,6389.0,6.77,-0.03,High Risk
U1000,2024,1,243809.0,Salary Increases & Fixed Expenses Decrease,234764,76404.0,114126,190530.0,44234.0,18.84,-0.03,Medium Risk
U1000,2024,2,288043.0,Salary Increases & Fixed Expenses Decrease,234764,76404.0,100074,176478.0,58286.0,24.83,-0.05,Medium Risk
U1000,2024,3,346329.0,Salary Increases & Fixed Expenses Decrease,234764,76404.0,157518,233922.0,842.0,0.36,0.04,High Risk
U1000,2024,4,347171.0,Salary Increases & Fixed Expenses Decrease,234764,76404.0,101007,177411.0,57353.0,24.43,0.04,Medium Risk
U1000,2024,5,404524.0,Salary Increases & Fixed Expenses Decrease,234764,76404.0,140174,216578.0,18186.0,7.75,-0.04,High Risk
U1000,2024,6,422710.0,Salary Increases & Fixed Expenses Decrease,234764,76404.0,138003,214407.0,20357.0,8.67,0.0,High Risk
U1000,2024,7,443067.0,Salary Increases & Fixed Expenses Decrease,234764,76404.0,95779,172183.0,62581.0,26.66,0.01,Low Risk
U1000,2024,8,505648.0,Salary Increases & Fixed Expenses Decrease,259758,76404.0,139355,215759.0,43999.0,16.94,0.03,Medium Risk
U1000,2024,9,549647.0,Salary Increases & Fixed Expenses Decrease,259758,76404.0,146963,223367.0,36391.0,14.01,0.04,High Risk
U1000,2024,10,586038.0,Salary Increases & Fixed Expenses Decrease,259758,76404.0,157145,233549.0,26209.0,10.09,0.05,High Risk
U1000,2024,11,612247.0,Salary Increases & Fixed Expenses Decrease,259758,76404.0,138356,214760.0,44998.0,17.32,-0.0,Medium Risk
U1000,2024,12,657245.0,Salary Increases & Fixed Expenses Decrease,259758,76404.0,112008,188412.0,71346.0,27.47,0.02,Low Risk
