User_ID,Year,Month,Balance,Scenario,Salary,Fixed_Expenses,Variable_Expenses,Total_Expenses,Savings,Savings_Rate,Expense_Fluctuation,Risk_Category
U001,2024,1,171143.0,Stable Salary & Decreasing Fixed Expenses,52603,27058.0,12541,39599.0,13004.0,24.72,0.04,Medium Risk
U001,2024,2,184147.0,Stable Salary & Decreasing Fixed Expenses,52603,27058.0,12324,39382.0,13221.0,25.13,-0.0,Low Risk
U001,2024,3,197368.0,Stable Salary & Decreasing Fixed Expenses,52603,27058.0,13269,40327.0,12276.0,23.34,-0.02,Medium Risk
U001,2024,4,209644.0,Stable Salary & Decreasing Fixed Expenses,52603,25644.0,14310,39954.0,12649.0,24.05,-0.01,Medium Risk
U001,2024,5,222293.0,Stable Salary & Decreasing Fixed Expenses,52603,25644.0,12515,38159.0,14444.0,27.46,0.03,Low Risk
U001,2024,6,236737.0,Stable Salary & Decreasing Fixed Expenses,52603,25644.0,10971,36615.0,15988.0,30.39,0.01,Low Risk
U001,2024,7,252725.0,Stable Salary & Decreasing Fixed Expenses,52603,25644.0,12553,38197.0,14406.0,27.39,-0.02,Low Risk
U001,2024,8,267131.0,Stable Salary & Decreasing Fixed Expenses,52603,25644.0,12394,38038.0,14565.0,27.69,-0.01,Low Risk
U001,2024,9,281696.0,Stable Salary & Decreasing Fixed Expenses,52603,25644.0,11689,37333.0,15270.0,29.03,0.02,Low Risk
U001,2024,10,296966.0,Stable Salary & Decreasing Fixed Expenses,52603,25644.0,11260,36904.0,15699.0,29.84,-0.01,Low Risk
U001,2024,11,312665.0,Stable Salary & Decreasing Fixed Expenses,52603,25644.0,13692,39336.0,13267.0,25.22,-0.04,Low Risk
U001,2024,12,325932.0,Stable Salary & Decreasing Fixed Expenses,52603,25644.0,14416,40060.0,12543.0,23.84,0.05,Medium Risk
U002,2024,1,164112.0,Salary Increases & Fixed Expenses Remain Stable,111308,42280.0,35073,77353.0,33955.0,30.51,-0.02,Low Risk
U002,2024,2,198067.0,Salary Increases & Fixed Expenses Remain Stable,111308,42280.0,45756,88036.0,23272.0,20.91,0.02,Medium Risk
U002,2024,3,221339.0,Salary Increases & Fixed Expenses Remain Stable,111308,42280.0,42306,84586.0,26722.0,24.01,-0.04,Medium Risk
U002,2024,4,248061.0,Salary Increases & Fixed Expenses Remain Stable,111308,42280.0,45808,88088.0,23220.0,20.86,0.01,Medium Risk
U002,2024,5,271281.0,Salary Increases & Fixed Expenses Remain Stable,129312,42280.0,63088,105368.0,23944.0,18.52,-0.01,Medium Risk
U002,2024,6,295225.0,Salary Increases & Fixed Expenses Remain Stable,129312,42280.0,57924,100204.0,29108.0,22.51,0.01,Medium Risk
U002,2024,7,324333.0,Salary Increases & Fixed Expenses Remain Stable,129312,42280.0,41446,83726.0,45586.0,35.25,0.05,Low Risk
U002,2024,8,369919.0,Salary Increases & Fixed Expenses Remain Stable,129312,42280.0,63137,105417.0,23895.0,18.48,0.04,Medium Risk
U002,2024,9,393814.0,Salary Increases & Fixed Expenses Remain Stable,129312,42280.0,50662,92942.0,36370.0,28.13,-0.03,Low Risk
U002,2024,10,430184.0,Salary Increases & Fixed Expenses Remain Stable,129312,42280.0,59740,102020.0,27292.0,21.11,0.03,Medium Risk
U002,2024,11,457476.0,Salary Increases & Fixed Expenses Remain Stable,129312,42280.0,54436,96716.0,32596.0,25.21,-0.01,Low Risk
U002,2024,12,490072.0,Salary Increases & Fixed Expenses Remain Stable,129312,42280.0,51930,94210.0,35102.0,27.15,0.04,Low Risk
U003,2024,1,115668.0,Salary Increases & Fixed Expenses Increase,72617,25036.0,26374,51410.0,21207.0,29.2,-0.05,Low Risk
U003,2024,2,136875.0,Salary Increases & Fixed Expenses Increase,72617,25036.0,35864,60900.0,11717.0,16.14,-0.04,Medium Risk
U003,2024,3,148592.0,Salary Increases & Fixed Expenses Increase,72617,25036.0,23285,48321.0,24296.0,33.46,0.04,Low Risk
U003,2024,4,172888.0,Salary Increases & Fixed Expenses Increase,83802,25036.0,30140,55176.0,28626.0,34.16,0.01,Low Risk
U003,2024,5,201514.0,Salary Increases & Fixed Expenses Increase,83802,25036.0,25653,50689.0,33113.0,39.51,-0.02,Low Risk
U003,2024,6,234627.0,Salary Increases & Fixed Expenses Increase,83802,25036.0,25188,50224.0,33578.0,40.07,0.03,Low Risk
U003,2024,7,268205.0,Salary Increases & Fixed Expenses Increase,83802,25036.0,35984,61020.0,22782.0,27.19,0.03,Low Risk
U003,2024,8,290987.0,Salary Increases & Fixed Expenses Increase,83802,25036.0,37174,62210.0,21592.0,25.77,-0.02,Low Risk
U003,2024,9,312579.0,Salary Increases & Fixed Expenses Increase,83802,25036.0,29410,54446.0,29356.0,35.03,0.03,Low Risk
U003,2024,10,341935.0,Salary Increases & Fixed Expenses Increase,83802,25036.0,32027,57063.0,26739.0,31.91,-0.02,Low Risk
U003,2024,11,368674.0,Salary Increases & Fixed Expenses Increase,83802,26949.0,43881,70830.0,12972.0,15.48,0.05,Medium Risk
U003,2024,12,381646.0,Salary Increases & Fixed Expenses Increase,83802,26949.0,26293,53242.0,30560.0,36.47,0.04,Low Risk
U004,2024,1,187122.0,Stable Salary & Increasing Fixed Expenses,150841,49976.0,63946,113922.0,36919.0,24.48,0.04,Medium Risk
U004,2024,2,224041.0,Stable Salary & Increasing Fixed Expenses,150841,49976.0,48834,98810.0,52031.0,34.49,-0.05,Low Risk
U004,2024,3,276072.0,Stable Salary & Increasing Fixed Expenses,150841,49976.0,70747,120723.0,30118.0,19.97,0.02,Medium Risk
U004,2024,4,306190.0,Stable Salary & Increasing Fixed Expenses,150841,49976.0,53230,103206.0,47635.0,31.58,-0.01,Low Risk
U004,2024,5,353825.0,Stable Salary & Increasing Fixed Expenses,150841,49976.0,51670,101646.0,49195.0,32.61,-0.03,Low Risk
U004,2024,6,403020.0,Stable Salary & Increasing Fixed Expenses,150841,49976.0,58193,108169.0,42672.0,28.29,0.05,Low Risk
U004,2024,7,445692.0,Stable Salary & Increasing Fixed Expenses,150841,49976.0,73594,123570.0,27271.0,18.08,-0.01,Medium Risk
U004,2024,8,472963.0,Stable Salary & Increasing Fixed Expenses,150841,49976.0,69504,119480.0,31361.0,20.79,0.02,Medium Risk
U004,2024,9,504324.0,Stable Salary & Increasing Fixed Expenses,150841,49976.0,77395,127371.0,23470.0,15.56,0.03,Medium Risk
U004,2024,10,527794.0,Stable Salary & Increasing Fixed Expenses,150841,49976.0,54356,104332.0,46509.0,30.83,-0.0,Low Risk
U004,2024,11,574303.0,Stable Salary & Increasing Fixed Expenses,150841,49976.0,57001,106977.0,43864.0,29.08,0.02,Low Risk
U004,2024,12,618167.0,Stable Salary & Increasing Fixed Expenses,150841,49976.0,55332,105308.0,45533.0,30.19,-0.01,Low Risk
U005,2024,1,204442.0,Stable Salary & Stable Fixed Expenses,159373,49986.0,44628,94614.0,64759.0,40.63,-0.03,Low Risk
U005,2024,2,269201.0,Stable Salary & Stable Fixed Expenses,159373,49986.0,33626,83612.0,75761.0,47.54,-0.03,Low Risk
U005,2024,3,344962.0,Stable Salary & Stable Fixed Expenses,159373,49986.0,35184,85170.0,74203.0,46.56,0.04,Low Risk
U005,2024,4,419165.0,Stable Salary & Stable Fixed Expenses,159373,49986.0,33487,83473.0,75900.0,47.62,0.03,Low Risk
U005,2024,5,495065.0,Stable Salary & Stable Fixed Expenses,159373,49986.0,40637,90623.0,68750.0,43.14,-0.0,Low Risk
U005,2024,6,563815.0,Stable Salary & Stable Fixed Expenses,159373,49986.0,33453,83439.0,75934.0,47.65,0.02,Low Risk
U005,2024,7,639749.0,Stable Salary & Stable Fixed Expenses,159373,49986.0,44361,94347.0,65026.0,40.8,0.03,Low Risk
U005,2024,8,704775.0,Stable Salary & Stable Fixed Expenses,159373,49986.0,42093,92079.0,67294.0,42.22,-0.05,Low Risk
U005,2024,9,772069.0,Stable Salary & Stable Fixed Expenses,159373,49986.0,42128,92114.0,67259.0,42.2,-0.0,Low Risk
U005,2024,10,839328.0,Stable Salary & Stable Fixed Expenses,159373,49986.0,33047,83033.0,76340.0,47.9,-0.03,Low Risk
U005,2024,11,915668.0,Stable Salary & Stable Fixed Expenses,159373,49986.0,49760,99746.0,59627.0,37.41,0.04,Low Risk
U005,2024,12,975295.0,Stable Salary & Stable Fixed Expenses,159373,49986.0,33135,83121.0,76252.0,47.84,0.03,Low Risk
U006,2024,1,149620.0,Salary Increases & Fixed Expenses Increase,72250,37165.0,27798,64963.0,7287.0,10.09,-0.02,High Risk
U006,2024,2,156907.0,Salary Increases & Fixed Expenses Increase,72250,37165.0,25392,62557.0,9693.0,13.42,-0.01,High Risk
U006,2024,3,166600.0,Salary Increases & Fixed Expenses Increase,72250,37165.0,29523,66688.0,5562.0,7.7,-0.02,High Risk
U006,2024,4,172162.0,Salary Increases & Fixed Expenses Increase,72250,37165.0,27587,64752.0,7498.0,10.38,-0.05,High Risk
U006,2024,5,179660.0,Salary Increases & Fixed Expenses Increase,100229,37165.0,40211,77376.0,22853.0,22.8,0.03,Medium Risk
U006,2024,6,202513.0,Salary Increases & Fixed Expenses Increase,100229,37165.0,49504,86669.0,13560.0,13.53,-0.05,High Risk
U006,2024,7,216073.0,Salary Increases & Fixed Expenses Increase,100229,37165.0,42347,79512.0,20717.0,20.67,0.04,Medium Risk
U006,2024,8,236790.0,Salary Increases & Fixed Expenses Increase,100229,37165.0,32553,69718.0,30511.0,30.44,0.05,Low Risk
U006,2024,9,267301.0,Salary Increases & Fixed Expenses Increase,100229,37165.0,42159,79324.0,20905.0,20.86,-0.03,Medium Risk
U006,2024,10,288206.0,Salary Increases & Fixed Expenses Increase,100229,37165.0,33445,70610.0,29619.0,29.55,-0.05,Low Risk
U006,2024,11,317825.0,Salary Increases & Fixed Expenses Increase,100229,37165.0,45971,83136.0,17093.0,17.05,0.0,Medium Risk
U006,2024,12,334918.0,Salary Increases & Fixed Expenses Increase,100229,37165.0,47578,84743.0,15486.0,15.45,0.01,Medium Risk
U007,2024,1,231639.0,Salary Increases & Fixed Expenses Increase,116659,44978.0,32400,77378.0,39281.0,33.67,-0.01,Low Risk
U007,2024,2,270920.0,Salary Increases & Fixed Expenses Increase,116659,46844.0,34126,80970.0,35689.0,30.59,0.01,Low Risk
U007,2024,3,306609.0,Salary Increases & Fixed Expenses Increase,116659,46844.0,39865,86709.0,29950.0,25.67,0.05,Low Risk
U007,2024,4,336559.0,Salary Increases & Fixed Expenses Increase,116659,46844.0,26741,73585.0,43074.0,36.92,0.01,Low Risk
U007,2024,5,379633.0,Salary Increases & Fixed Expenses Increase,116659,46844.0,25138,71982.0,44677.0,38.3,0.01,Low Risk
U007,2024,6,424310.0,Salary Increases & Fixed Expenses Increase,116659,48751.0,34022,82773.0,33886.0,29.05,-0.02,Low Risk
U007,2024,7,458196.0,Salary Increases & Fixed Expenses Increase,124426,49487.0,34328,83815.0,40611.0,32.64,0.05,Low Risk
U007,2024,8,498807.0,Salary Increases & Fixed Expenses Increase,124426,49487.0,26258,75745.0,48681.0,39.12,-0.05,Low Risk
U007,2024,9,547488.0,Salary Increases & Fixed Expenses Increase,124426,49487.0,33662,83149.0,41277.0,33.17,-0.04,Low Risk
U007,2024,10,588765.0,Salary Increases & Fixed Expenses Increase,124426,49487.0,43782,93269.0,31157.0,25.04,0.01,Low Risk
U007,2024,11,619922.0,Salary Increases & Fixed Expenses Increase,124426,49487.0,36615,86102.0,38324.0,30.8,0.04,Low Risk
U007,2024,12,658246.0,Salary Increases & Fixed Expenses Increase,124426,49487.0,37926,87413.0,37013.0,29.75,0.01,Low Risk
U008,2024,1,230879.0,Stable Salary & Increasing Fixed Expenses,127349,70046.0,47301,117347.0,10002.0,7.85,-0.03,High Risk
U008,2024,2,240881.0,Stable Salary & Increasing Fixed Expenses,127349,70046.0,62904,132950.0,-5601.0,-4.4,0.02,High Risk
U008,2024,3,235280.0,Stable Salary & Increasing Fixed Expenses,127349,70046.0,49561,119607.0,7742.0,6.08,0.03,High Risk
U008,2024,4,243022.0,Stable Salary & Increasing Fixed Expenses,127349,71990.0,45511,117501.0,9848.0,7.73,0.04,High Risk
U008,2024,5,252870.0,Stable Salary & Increasing Fixed Expenses,127349,71990.0,62915,134905.0,-7556.0,-5.93,0.03,High Risk
U008,2024,6,245314.0,Stable Salary & Increasing Fixed Expenses,127349,71990.0,51133,123123.0,4226.0,3.32,-0.04,High Risk
U008,2024,7,249540.0,Stable Salary & Increasing Fixed Expenses,127349,71990.0,41449,113439.0,13910.0,10.92,-0.05,High Risk
U008,2024,8,263450.0,Stable Salary & Increasing Fixed Expenses,127349,71990.0,61491,133481.0,-6132.0,-4.82,-0.03,High Risk
U008,2024,9,257318.0,Stable Salary & Increasing Fixed Expenses,127349,71990.0,52265,124255.0,3094.0,2.43,0.04,High Risk
U008,2024,10,260412.0,Stable Salary & Increasing Fixed Expenses,127349,71990.0,55092,127082.0,267.0,0.21,0.04,High Risk
U008,2024,11,260679.0,Stable Salary & Increasing Fixed Expenses,127349,71990.0,56702,128692.0,-1343.0,-1.05,0.01,High Risk
U008,2024,12,259336.0,Stable Salary & Increasing Fixed Expenses,127349,71990.0,48220,120210.0,7139.0,5.61,0.02,High Risk
U009,2024,1,192822.0,Stable Salary & Stable Fixed Expenses,71493,27578.0,34992,62570.0,8923.0,12.48,-0.05,High Risk
U009,2024,2,201745.0,Stable Salary & Stable Fixed Expenses,71493,27578.0,29690,57268.0,14225.0,19.9,0.04,Medium Risk
U009,2024,3,215970.0,Stable Salary & Stable Fixed Expenses,71493,27578.0,24087,51665.0,19828.0,27.73,0.04,Low Risk
U009,2024,4,235798.0,Stable Salary & Stable Fixed Expenses,71493,27578.0,26736,54314.0,17179.0,24.03,0.02,Medium Risk
U009,2024,5,252977.0,Stable Salary & Stable Fixed Expenses,71493,27578.0,30999,58577.0,12916.0,18.07,0.01,Medium Risk
U009,2024,6,265893.0,Stable Salary & Stable Fixed Expenses,71493,27578.0,32727,60305.0,11188.0,15.65,-0.03,Medium Risk
U009,2024,7,277081.0,Stable Salary & Stable Fixed Expenses,71493,27578.0,25814,53392.0,18101.0,25.32,0.02,Low Risk
U009,2024,8,295182.0,Stable Salary & Stable Fixed Expenses,71493,27578.0,29258,56836.0,14657.0,20.5,0.01,Medium Risk
U009,2024,9,309839.0,Stable Salary & Stable Fixed Expenses,71493,27578.0,28724,56302.0,15191.0,21.25,-0.01,Medium Risk
U009,2024,10,325030.0,Stable Salary & Stable Fixed Expenses,71493,27578.0,29473,57051.0,14442.0,20.2,0.0,Medium Risk
U009,2024,11,339472.0,Stable Salary & Stable Fixed Expenses,71493,27578.0,33529,61107.0,10386.0,14.53,0.04,High Risk
U009,2024,12,349858.0,Stable Salary & Stable Fixed Expenses,71493,27578.0,30789,58367.0,13126.0,18.36,0.05,Medium Risk
U010,2024,1,250000.0,Stable Salary & Stable Fixed Expenses,275920,67357.0,95113,162470.0,113450.0,41.12,0.05,Low Risk
U010,2024,2,363450.0,Stable Salary & Stable Fixed Expenses,275920,67357.0,100498,167855.0,108065.0,39.17,0.02,Low Risk
U010,2024,3,471515.0,Stable Salary & Stable Fixed Expenses,275920,67357.0,122132,189489.0,86431.0,31.32,-0.01,Low Risk
U010,2024,4,557946.0,Stable Salary & Stable Fixed Expenses,275920,67357.0,98770,166127.0,109793.0,39.79,-0.03,Low Risk
U010,2024,5,667739.0,Stable Salary & Stable Fixed Expenses,275920,67357.0,134452,201809.0,74111.0,26.86,-0.05,Low Risk
U010,2024,6,741850.0,Stable Salary & Stable Fixed Expenses,275920,67357.0,124487,191844.0,84076.0,30.47,-0.04,Low Risk
U010,2024,7,825926.0,Stable Salary & Stable Fixed Expenses,275920,67357.0,90194,157551.0,118369.0,42.9,-0.01,Low Risk
U010,2024,8,944295.0,Stable Salary & Stable Fixed Expenses,275920,67357.0,108115,175472.0,100448.0,36.4,-0.0,Low Risk
U010,2024,9,1044743.0,Stable Salary & Stable Fixed Expenses,275920,67357.0,101829,169186.0,106734.0,38.68,0.03,Low Risk
U010,2024,10,1151477.0,Stable Salary & Stable Fixed Expenses,275920,67357.0,145987,213344.0,62576.0,22.68,-0.03,Medium Risk
U010,2024,11,1214053.0,Stable Salary & Stable Fixed Expenses,275920,67357.0,131133,198490.0,77430.0,28.06,0.04,Low Risk
U010,2024,12,1291483.0,Stable Salary & Stable Fixed Expenses,275920,67357.0,167230,234587.0,41333.0,14.98,-0.05,High Risk
U011,2024,1,250000.0,Stable Salary & Stable Fixed Expenses,291173,113093.0,61649,174742.0,116431.0,39.99,-0.03,Low Risk
U011,2024,2,366431.0,Stable Salary & Stable Fixed Expenses,291173,113093.0,61883,174976.0,116197.0,39.91,0.05,Low Risk
U011,2024,3,482628.0,Stable Salary & Stable Fixed Expenses,291173,113093.0,84088,197181.0,93992.0,32.28,0.03,Low Risk
U011,2024,4,576620.0,Stable Salary & Stable Fixed Expenses,291173,113093.0,79749,192842.0,98331.0,33.77,-0.01,Low Risk
U011,2024,5,674951.0,Stable Salary & Stable Fixed Expenses,291173,113093.0,69024,182117.0,109056.0,37.45,-0.02,Low Risk
U011,2024,6,784007.0,Stable Salary & Stable Fixed Expenses,291173,113093.0,86115,199208.0,91965.0,31.58,-0.03,Low Risk
U011,2024,7,875972.0,Stable Salary & Stable Fixed Expenses,291173,113093.0,67291,180384.0,110789.0,38.05,-0.02,Low Risk
U011,2024,8,986761.0,Stable Salary & Stable Fixed Expenses,291173,113093.0,67956,181049.0,110124.0,37.82,0.03,Low Risk
U011,2024,9,1096885.0,Stable Salary & Stable Fixed Expenses,291173,113093.0,70414,183507.0,107666.0,36.98,-0.04,Low Risk
U011,2024,10,1204551.0,Stable Salary & Stable Fixed Expenses,291173,113093.0,86898,199991.0,91182.0,31.32,-0.01,Low Risk
U011,2024,11,1295733.0,Stable Salary & Stable Fixed Expenses,291173,113093.0,93718,206811.0,84362.0,28.97,-0.0,Low Risk
U011,2024,12,1380095.0,Stable Salary & Stable Fixed Expenses,291173,113093.0,66414,179507.0,111666.0,38.35,0.0,Low Risk
U012,2024,1,169888.0,Stable Salary & Increasing Fixed Expenses,148799,44052.0,39041,83093.0,65706.0,44.16,-0.03,Low Risk
U012,2024,2,235594.0,Stable Salary & Increasing Fixed Expenses,148799,44052.0,37738,81790.0,67009.0,45.03,0.04,Low Risk
U012,2024,3,302603.0,Stable Salary & Increasing Fixed Expenses,148799,44052.0,50772,94824.0,53975.0,36.27,0.0,Low Risk
U012,2024,4,356578.0,Stable Salary & Increasing Fixed Expenses,148799,44843.0,37254,82097.0,66702.0,44.83,-0.02,Low Risk
U012,2024,5,423280.0,Stable Salary & Increasing Fixed Expenses,148799,44843.0,33013,77856.0,70943.0,47.68,0.03,Low Risk
U012,2024,6,494223.0,Stable Salary & Increasing Fixed Expenses,148799,46532.0,39109,85641.0,63158.0,42.45,-0.04,Low Risk
U012,2024,7,557381.0,Stable Salary & Increasing Fixed Expenses,148799,46532.0,43672,90204.0,58595.0,39.38,-0.03,Low Risk
U012,2024,8,615976.0,Stable Salary & Increasing Fixed Expenses,148799,48465.0,43466,91931.0,56868.0,38.22,0.04,Low Risk
U012,2024,9,672844.0,Stable Salary & Increasing Fixed Expenses,148799,50085.0,42210,92295.0,56504.0,37.97,-0.01,Low Risk
U012,2024,10,729348.0,Stable Salary & Increasing Fixed Expenses,148799,50085.0,38369,88454.0,60345.0,40.55,-0.03,Low Risk
U012,2024,11,789693.0,Stable Salary & Increasing Fixed Expenses,148799,50085.0,40112,90197.0,58602.0,39.38,0.04,Low Risk
U012,2024,12,848295.0,Stable Salary & Increasing Fixed Expenses,148799,50085.0,41611,91696.0,57103.0,38.38,-0.04,Low Risk
U013,2024,1,177415.0,Salary Increases & Fixed Expenses Decrease,171468,56123.0,59504,115627.0,55841.0,32.57,-0.05,Low Risk
U013,2024,2,233256.0,Salary Increases & Fixed Expenses Decrease,171468,56123.0,58776,114899.0,56569.0,32.99,-0.02,Low Risk
U013,2024,3,289825.0,Salary Increases & Fixed Expenses Decrease,179925,56123.0,61026,117149.0,62776.0,34.89,0.02,Low Risk
U013,2024,4,352601.0,Salary Increases & Fixed Expenses Decrease,179925,56123.0,63834,119957.0,59968.0,33.33,0.05,Low Risk
U013,2024,5,412569.0,Salary Increases & Fixed Expenses Decrease,179925,56123.0,66865,122988.0,56937.0,31.64,-0.04,Low Risk
U013,2024,6,469506.0,Salary Increases & Fixed Expenses Decrease,179925,56123.0,67609,123732.0,56193.0,31.23,-0.01,Low Risk
U013,2024,7,525699.0,Salary Increases & Fixed Expenses Decrease,179925,56123.0,79296,135419.0,44506.0,24.74,-0.0,Medium Risk
U013,2024,8,570205.0,Salary Increases & Fixed Expenses Decrease,179925,56123.0,69932,126055.0,53870.0,29.94,-0.03,Low Risk
U013,2024,9,624075.0,Salary Increases & Fixed Expenses Decrease,179925,56123.0,62486,118609.0,61316.0,34.08,0.03,Low Risk
U013,2024,10,685391.0,Salary Increases & Fixed Expenses Decrease,179925,56123.0,84956,141079.0,38846.0,21.59,-0.0,Medium Risk
U013,2024,11,724237.0,Salary Increases & Fixed Expenses Decrease,179925,56123.0,89345,145468.0,34457.0,19.15,-0.05,Medium Risk
U013,2024,12,758694.0,Salary Increases & Fixed Expenses Decrease,179925,56123.0,81754,137877.0,42048.0,23.37,-0.05,Medium Risk
U014,2024,1,240462.0,Salary Increases & Fixed Expenses Remain Stable,118821,77501.0,27035,104536.0,14285.0,12.02,0.03,High Risk
U014,2024,2,254747.0,Salary Increases & Fixed Expenses Remain Stable,118821,77501.0,34906,112407.0,6414.0,5.4,-0.05,High Risk
U014,2024,3,261161.0,Salary Increases & Fixed Expenses Remain Stable,118821,77501.0,31642,109143.0,9678.0,8.15,-0.04,High Risk
U014,2024,4,270839.0,Salary Increases & Fixed Expenses Remain Stable,118821,77501.0,31827,109328.0,9493.0,7.99,-0.01,High Risk
U014,2024,5,280332.0,Salary Increases & Fixed Expenses Remain Stable,118821,77501.0,32782,110283.0,8538.0,7.19,0.05,High Risk
U014,2024,6,288870.0,Salary Increases & Fixed Expenses Remain Stable,118821,77501.0,24993,102494.0,16327.0,13.74,-0.04,High Risk
U014,2024,7,305197.0,Salary Increases & Fixed Expenses Remain Stable,118821,77501.0,26558,104059.0,14762.0,12.42,0.03,High Risk
U014,2024,8,319959.0,Salary Increases & Fixed Expenses Remain Stable,130665,77501.0,30439,107940.0,22725.0,17.39,0.0,Medium Risk
U014,2024,9,342684.0,Salary Increases & Fixed Expenses Remain Stable,130665,77501.0,33283,110784.0,19881.0,15.22,-0.02,Medium Risk
U014,2024,10,362565.0,Salary Increases & Fixed Expenses Remain Stable,130665,77501.0,38499,116000.0,14665.0,11.22,0.03,High Risk
U014,2024,11,377230.0,Salary Increases & Fixed Expenses Remain Stable,130665,77501.0,33148,110649.0,20016.0,15.32,-0.01,Medium Risk
U014,2024,12,397246.0,Salary Increases & Fixed Expenses Remain Stable,130665,77501.0,32587,110088.0,20577.0,15.75,0.01,Medium Risk
U015,2024,1,241868.0,Stable Salary & Decreasing Fixed Expenses,205583,65916.0,46341,112257.0,93326.0,45.4,-0.01,Low Risk
U015,2024,2,335194.0,Stable Salary & Decreasing Fixed Expenses,205583,65916.0,59796,125712.0,79871.0,38.85,-0.01,Low Risk
U015,2024,3,415065.0,Stable Salary & Decreasing Fixed Expenses,205583,65916.0,74951,140867.0,64716.0,31.48,0.03,Low Risk
U015,2024,4,479781.0,Stable Salary & Decreasing Fixed Expenses,205583,65916.0,50736,116652.0,88931.0,43.26,0.02,Low Risk
U015,2024,5,568712.0,Stable Salary & Decreasing Fixed Expenses,205583,65916.0,45781,111697.0,93886.0,45.67,-0.0,Low Risk
U015,2024,6,662598.0,Stable Salary & Decreasing Fixed Expenses,205583,65916.0,49623,115539.0,90044.0,43.8,0.05,Low Risk
U015,2024,7,752642.0,Stable Salary & Decreasing Fixed Expenses,205583,65916.0,52799,118715.0,86868.0,42.25,-0.03,Low Risk
U015,2024,8,839510.0,Stable Salary & Decreasing Fixed Expenses,205583,65916.0,51642,117558.0,88025.0,42.82,-0.02,Low Risk
U015,2024,9,927535.0,Stable Salary & Decreasing Fixed Expenses,205583,65916.0,61049,126965.0,78618.0,38.24,0.02,Low Risk
U015,2024,10,1006153.0,Stable Salary & Decreasing Fixed Expenses,205583,65916.0,57169,123085.0,82498.0,40.13,-0.04,Low Risk
U015,2024,11,1088651.0,Stable Salary & Decreasing Fixed Expenses,205583,65916.0,58057,123973.0,81610.0,39.7,0.01,Low Risk
U015,2024,12,1170261.0,Stable Salary & Decreasing Fixed Expenses,205583,65916.0,68042,133958.0,71625.0,34.84,-0.03,Low Risk
U016,2024,1,114749.0,Salary Increases & Fixed Expenses Increase,45876,18075.0,17022,35097.0,10779.0,23.5,0.02,Medium Risk
U016,2024,2,125528.0,Salary Increases & Fixed Expenses Increase,45876,19837.0,15908,35745.0,10131.0,22.08,0.03,Medium Risk
U016,2024,3,135659.0,Salary Increases & Fixed Expenses Increase,45876,19837.0,17549,37386.0,8490.0,18.51,-0.03,Medium Risk
U016,2024,4,144149.0,Salary Increases & Fixed Expenses Increase,54137,19837.0,24677,44514.0,9623.0,17.78,0.04,Medium Risk
U016,2024,5,153772.0,Salary Increases & Fixed Expenses Increase,54137,19837.0,22691,42528.0,11609.0,21.44,0.03,Medium Risk
U016,2024,6,165381.0,Salary Increases & Fixed Expenses Increase,54137,19837.0,19350,39187.0,14950.0,27.62,0.04,Low Risk
U016,2024,7,180331.0,Salary Increases & Fixed Expenses Increase,54137,19837.0,23053,42890.0,11247.0,20.78,0.04,Medium Risk
U016,2024,8,191578.0,Salary Increases & Fixed Expenses Increase,54137,19837.0,24527,44364.0,9773.0,18.05,0.0,Medium Risk
U016,2024,9,201351.0,Salary Increases & Fixed Expenses Increase,54137,19837.0,23331,43168.0,10969.0,20.26,0.05,Medium Risk
U016,2024,10,212320.0,Salary Increases & Fixed Expenses Increase,54137,19837.0,21686,41523.0,12614.0,23.3,-0.04,Medium Risk
U016,2024,11,224934.0,Salary Increases & Fixed Expenses Increase,54137,19837.0,25185,45022.0,9115.0,16.84,-0.03,Medium Risk
U016,2024,12,234049.0,Salary Increases & Fixed Expenses Increase,54137,19837.0,19984,39821.0,14316.0,26.44,-0.04,Low Risk
U017,2024,1,248117.0,Stable Salary & Increasing Fixed Expenses,196221,76413.0,52889,129302.0,66919.0,34.1,0.01,Low Risk
U017,2024,2,315036.0,Stable Salary & Increasing Fixed Expenses,196221,76413.0,48187,124600.0,71621.0,36.5,-0.02,Low Risk
U017,2024,3,386657.0,Stable Salary & Increasing Fixed Expenses,196221,78304.0,52605,130909.0,65312.0,33.28,-0.01,Low Risk
U017,2024,4,451969.0,Stable Salary & Increasing Fixed Expenses,196221,80207.0,57206,137413.0,58808.0,29.97,-0.02,Low Risk
U017,2024,5,510777.0,Stable Salary & Increasing Fixed Expenses,196221,80207.0,55141,135348.0,60873.0,31.02,0.01,Low Risk
U017,2024,6,571650.0,Stable Salary & Increasing Fixed Expenses,196221,80207.0,49078,129285.0,66936.0,34.11,-0.02,Low Risk
U017,2024,7,638586.0,Stable Salary & Increasing Fixed Expenses,196221,80207.0,51953,132160.0,64061.0,32.65,-0.05,Low Risk
U017,2024,8,702647.0,Stable Salary & Increasing Fixed Expenses,196221,80207.0,55775,135982.0,60239.0,30.7,0.04,Low Risk
U017,2024,9,762886.0,Stable Salary & Increasing Fixed Expenses,196221,80207.0,53397,133604.0,62617.0,31.91,0.03,Low Risk
U017,2024,10,825503.0,Stable Salary & Increasing Fixed Expenses,196221,80207.0,43558,123765.0,72456.0,36.93,0.04,Low Risk
U017,2024,11,897959.0,Stable Salary & Increasing Fixed Expenses,196221,80207.0,56624,136831.0,59390.0,30.27,0.02,Low Risk
U017,2024,12,957349.0,Stable Salary & Increasing Fixed Expenses,196221,80207.0,41293,121500.0,74721.0,38.08,-0.01,Low Risk
U018,2024,1,247098.0,Salary Increases & Fixed Expenses Decrease,154154,44150.0,62416,106566.0,47588.0,30.87,0.02,Low Risk
U018,2024,2,294686.0,Salary Increases & Fixed Expenses Decrease,154154,44150.0,58559,102709.0,51445.0,33.37,0.01,Low Risk
U018,2024,3,346131.0,Salary Increases & Fixed Expenses Decrease,154154,44150.0,89366,133516.0,20638.0,13.39,-0.01,High Risk
U018,2024,4,366769.0,Salary Increases & Fixed Expenses Decrease,154154,44150.0,60353,104503.0,49651.0,32.21,0.02,Low Risk
U018,2024,5,416420.0,Salary Increases & Fixed Expenses Decrease,154154,43003.0,62526,105529.0,48625.0,31.54,0.01,Low Risk
U018,2024,6,465045.0,Salary Increases & Fixed Expenses Decrease,154154,43003.0,46764,89767.0,64387.0,41.77,0.03,Low Risk
U018,2024,7,529432.0,Salary Increases & Fixed Expenses Decrease,165741,43003.0,63078,106081.0,59660.0,36.0,-0.01,Low Risk
U018,2024,8,589092.0,Salary Increases & Fixed Expenses Decrease,165741,43003.0,79947,122950.0,42791.0,25.82,-0.01,Low Risk
U018,2024,9,631883.0,Salary Increases & Fixed Expenses Decrease,165741,43003.0,69579,112582.0,53159.0,32.07,0.05,Low Risk
U018,2024,10,685042.0,Salary Increases & Fixed Expenses Decrease,165741,43003.0,76354,119357.0,46384.0,27.99,-0.01,Low Risk
U018,2024,11,731426.0,Salary Increases & Fixed Expenses Decrease,165741,43003.0,75228,118231.0,47510.0,28.67,-0.0,Low Risk
U018,2024,12,778936.0,Salary Increases & Fixed Expenses Decrease,165741,43003.0,78556,121559.0,44182.0,26.66,0.04,Low Risk
U019,2024,1,162597.0,Stable Salary & Increasing Fixed Expenses,74434,30927.0,38682,69609.0,4825.0,6.48,0.01,High Risk
U019,2024,2,167422.0,Stable Salary & Increasing Fixed Expenses,74434,31430.0,47056,78486.0,-4052.0,-5.44,0.02,High Risk
U019,2024,3,163370.0,Stable Salary & Increasing Fixed Expenses,74434,31430.0,49946,81376.0,-6942.0,-9.33,-0.0,High Risk
U019,2024,4,156428.0,Stable Salary & Increasing Fixed Expenses,74434,31430.0,41358,72788.0,1646.0,2.21,-0.02,High Risk
U019,2024,5,158074.0,Stable Salary & Increasing Fixed Expenses,74434,31430.0,51601,83031.0,-8597.0,-11.55,-0.04,High Risk
U019,2024,6,149477.0,Stable Salary & Increasing Fixed Expenses,74434,31430.0,50069,81499.0,-7065.0,-9.49,-0.01,High Risk
U019,2024,7,142412.0,Stable Salary & Increasing Fixed Expenses,74434,31430.0,42500,73930.0,504.0,0.68,-0.02,High Risk
U019,2024,8,142916.0,Stable Salary & Increasing Fixed Expenses,74434,31430.0,44885,76315.0,-1881.0,-2.53,-0.02,High Risk
U019,2024,9,141035.0,Stable Salary & Increasing Fixed Expenses,74434,31430.0,41564,72994.0,1440.0,1.93,-0.03,High Risk
U019,2024,10,142475.0,Stable Salary & Increasing Fixed Expenses,74434,32944.0,39371,72315.0,2119.0,2.85,-0.01,High Risk
U019,2024,11,144594.0,Stable Salary & Increasing Fixed Expenses,74434,32944.0,46241,79185.0,-4751.0,-6.38,0.02,High Risk
U019,2024,12,139843.0,Stable Salary & Increasing Fixed Expenses,74434,32944.0,44077,77021.0,-2587.0,-3.48,0.05,High Risk
U020,2024,1,237003.0,Stable Salary & Stable Fixed Expenses,40659,14139.0,18388,32527.0,8132.0,20.0,-0.01,Medium Risk
U020,2024,2,245135.0,Stable Salary & Stable Fixed Expenses,40659,14139.0,13181,27320.0,13339.0,32.81,-0.05,Low Risk
U020,2024,3,258474.0,Stable Salary & Stable Fixed Expenses,40659,14139.0,14211,28350.0,12309.0,30.27,-0.0,Low Risk
U020,2024,4,270783.0,Stable Salary & Stable Fixed Expenses,40659,14139.0,16225,30364.0,10295.0,25.32,0.0,Low Risk
U020,2024,5,281078.0,Stable Salary & Stable Fixed Expenses,40659,14139.0,18004,32143.0,8516.0,20.94,0.01,Medium Risk
U020,2024,6,289594.0,Stable Salary & Stable Fixed Expenses,40659,14139.0,13331,27470.0,13189.0,32.44,0.03,Low Risk
U020,2024,7,302783.0,Stable Salary & Stable Fixed Expenses,40659,14139.0,14236,28375.0,12284.0,30.21,-0.04,Low Risk
U020,2024,8,315067.0,Stable Salary & Stable Fixed Expenses,40659,14139.0,19206,33345.0,7314.0,17.99,-0.01,Medium Risk
U020,2024,9,322381.0,Stable Salary & Stable Fixed Expenses,40659,14139.0,16881,31020.0,9639.0,23.71,-0.05,Medium Risk
U020,2024,10,332020.0,Stable Salary & Stable Fixed Expenses,40659,14139.0,19779,33918.0,6741.0,16.58,-0.05,Medium Risk
U020,2024,11,338761.0,Stable Salary & Stable Fixed Expenses,40659,14139.0,15147,29286.0,11373.0,27.97,0.04,Low Risk
U020,2024,12,350134.0,Stable Salary & Stable Fixed Expenses,40659,14139.0,12864,27003.0,13656.0,33.59,-0.02,Low Risk
U021,2024,1,250000.0,Salary Increases & Fixed Expenses Increase,266179,91209.0,77983,169192.0,96987.0,36.44,-0.01,Low Risk
U021,2024,2,346987.0,Salary Increases & Fixed Expenses Increase,266179,92620.0,76666,169286.0,96893.0,36.4,-0.01,Low Risk
U021,2024,3,443880.0,Salary Increases & Fixed Expenses Increase,266179,92620.0,56830,149450.0,116729.0,43.85,0.02,Low Risk
U021,2024,4,560609.0,Salary Increases & Fixed Expenses Increase,275135,92620.0,65110,157730.0,117405.0,42.67,0.03,Low Risk
U021,2024,5,678014.0,Salary Increases & Fixed Expenses Increase,275135,93983.0,58930,152913.0,122222.0,44.42,-0.04,Low Risk
U021,2024,6,800236.0,Salary Increases & Fixed Expenses Increase,275135,95414.0,77955,173369.0,101766.0,36.99,-0.03,Low Risk
U021,2024,7,902002.0,Salary Increases & Fixed Expenses Increase,275135,95414.0,75752,171166.0,103969.0,37.79,0.03,Low Risk
U021,2024,8,1005971.0,Salary Increases & Fixed Expenses Increase,275135,95414.0,81625,177039.0,98096.0,35.65,-0.03,Low Risk
U021,2024,9,1104067.0,Salary Increases & Fixed Expenses Increase,275135,95414.0,62392,157806.0,117329.0,42.64,-0.04,Low Risk
U021,2024,10,1221396.0,Salary Increases & Fixed Expenses Increase,275135,95414.0,68434,163848.0,111287.0,40.45,-0.03,Low Risk
U021,2024,11,1332683.0,Salary Increases & Fixed Expenses Increase,275135,95414.0,68688,164102.0,111033.0,40.36,-0.02,Low Risk
U021,2024,12,1443716.0,Salary Increases & Fixed Expenses Increase,275135,95414.0,76339,171753.0,103382.0,37.58,-0.03,Low Risk
U022,2024,1,234035.0,Salary Increases & Fixed Expenses Remain Stable,230699,69447.0,47577,117024.0,113675.0,49.27,-0.03,Low Risk
U022,2024,2,347710.0,Salary Increases & Fixed Expenses Remain Stable,230699,69447.0,62661,132108.0,98591.0,42.74,-0.03,Low Risk
U022,2024,3,446301.0,Salary Increases & Fixed Expenses Remain Stable,230699,69447.0,49640,119087.0,111612.0,48.38,0.01,Low Risk
U022,2024,4,557913.0,Salary Increases & Fixed Expenses Remain Stable,230699,69447.0,66904,136351.0,94348.0,40.9,-0.03,Low Risk
U022,2024,5,652261.0,Salary Increases & Fixed Expenses Remain Stable,243259,69447.0,58104,127551.0,115708.0,47.57,0.05,Low Risk
U022,2024,6,767969.0,Salary Increases & Fixed Expenses Remain Stable,243259,69447.0,49439,118886.0,124373.0,51.13,-0.04,Low Risk
U022,2024,7,892342.0,Salary Increases & Fixed Expenses Remain Stable,243259,69447.0,51994,121441.0,121818.0,50.08,0.02,Low Risk
U022,2024,8,1014160.0,Salary Increases & Fixed Expenses Remain Stable,243259,69447.0,56821,126268.0,116991.0,48.09,0.02,Low Risk
U022,2024,9,1131151.0,Salary Increases & Fixed Expenses Remain Stable,243259,69447.0,69999,139446.0,103813.0,42.68,-0.03,Low Risk
U022,2024,10,1234964.0,Salary Increases & Fixed Expenses Remain Stable,243259,69447.0,69102,138549.0,104710.0,43.04,-0.0,Low Risk
U022,2024,11,1339674.0,Salary Increases & Fixed Expenses Remain Stable,243259,69447.0,48743,118190.0,125069.0,51.41,0.01,Low Risk
U022,2024,12,1464743.0,Salary Increases & Fixed Expenses Remain Stable,243259,69447.0,52916,122363.0,120896.0,49.7,-0.02,Low Risk
U023,2024,1,250000.0,Salary Increases & Fixed Expenses Increase,270534,72596.0,86110,158706.0,111828.0,41.34,0.01,Low Risk
U023,2024,2,361828.0,Salary Increases & Fixed Expenses Increase,270534,72596.0,135089,207685.0,62849.0,23.23,0.02,Medium Risk
U023,2024,3,424677.0,Salary Increases & Fixed Expenses Increase,284899,74507.0,98769,173276.0,111623.0,39.18,0.02,Low Risk
U023,2024,4,536300.0,Salary Increases & Fixed Expenses Increase,284899,74507.0,111597,186104.0,98795.0,34.68,-0.04,Low Risk
U023,2024,5,635095.0,Salary Increases & Fixed Expenses Increase,284899,74507.0,137317,211824.0,73075.0,25.65,0.04,Low Risk
U023,2024,6,708170.0,Salary Increases & Fixed Expenses Increase,284899,74507.0,114237,188744.0,96155.0,33.75,0.04,Low Risk
U023,2024,7,804325.0,Salary Increases & Fixed Expenses Increase,284899,74507.0,100968,175475.0,109424.0,38.41,-0.04,Low Risk
U023,2024,8,913749.0,Salary Increases & Fixed Expenses Increase,284899,74507.0,118999,193506.0,91393.0,32.08,0.03,Low Risk
U023,2024,9,1005142.0,Salary Increases & Fixed Expenses Increase,284899,74507.0,135780,210287.0,74612.0,26.19,0.0,Low Risk
U023,2024,10,1079754.0,Salary Increases & Fixed Expenses Increase,284899,74507.0,97567,172074.0,112825.0,39.6,0.03,Low Risk
U023,2024,11,1192579.0,Salary Increases & Fixed Expenses Increase,284899,74507.0,117705,192212.0,92687.0,32.53,-0.05,Low Risk
U023,2024,12,1285266.0,Salary Increases & Fixed Expenses Increase,284899,76207.0,92600,168807.0,116092.0,40.75,0.01,Low Risk
U024,2024,1,234131.0,Salary Increases & Fixed Expenses Increase,83942,33302.0,23175,56477.0,27465.0,32.72,0.03,Low Risk
U024,2024,2,261596.0,Salary Increases & Fixed Expenses Increase,83942,33302.0,24947,58249.0,25693.0,30.61,-0.04,Low Risk
U024,2024,3,287289.0,Salary Increases & Fixed Expenses Increase,83942,33302.0,29063,62365.0,21577.0,25.7,-0.02,Low Risk
U024,2024,4,308866.0,Salary Increases & Fixed Expenses Increase,83942,33302.0,17093,50395.0,33547.0,39.96,-0.04,Low Risk
U024,2024,5,342413.0,Salary Increases & Fixed Expenses Increase,83942,33302.0,18516,51818.0,32124.0,38.27,-0.01,Low Risk
U024,2024,6,374537.0,Salary Increases & Fixed Expenses Increase,103938,33302.0,26516,59818.0,44120.0,42.45,0.04,Low Risk
U024,2024,7,418657.0,Salary Increases & Fixed Expenses Increase,103938,33302.0,27144,60446.0,43492.0,41.84,-0.01,Low Risk
U024,2024,8,462149.0,Salary Increases & Fixed Expenses Increase,103938,33302.0,28025,61327.0,42611.0,41.0,0.04,Low Risk
U024,2024,9,504760.0,Salary Increases & Fixed Expenses Increase,103938,33302.0,27415,60717.0,43221.0,41.58,-0.02,Low Risk
U024,2024,10,547981.0,Salary Increases & Fixed Expenses Increase,103938,33302.0,27798,61100.0,42838.0,41.21,0.04,Low Risk
U024,2024,11,590819.0,Salary Increases & Fixed Expenses Increase,103938,33302.0,28779,62081.0,41857.0,40.27,-0.01,Low Risk
U024,2024,12,632676.0,Salary Increases & Fixed Expenses Increase,103938,33302.0,37439,70741.0,33197.0,31.94,-0.04,Low Risk
U025,2024,1,247263.0,Salary Increases & Fixed Expenses Increase,246864,65262.0,101452,166714.0,80150.0,32.47,0.03,Low Risk
U025,2024,2,327413.0,Salary Increases & Fixed Expenses Increase,246864,65262.0,82948,148210.0,98654.0,39.96,0.01,Low Risk
U025,2024,3,426067.0,Salary Increases & Fixed Expenses Increase,267154,65262.0,97518,162780.0,104374.0,39.07,0.05,Low Risk
U025,2024,4,530441.0,Salary Increases & Fixed Expenses Increase,267154,65262.0,91774,157036.0,110118.0,41.22,0.04,Low Risk
U025,2024,5,640559.0,Salary Increases & Fixed Expenses Increase,267154,66713.0,91836,158549.0,108605.0,40.65,-0.01,Low Risk
U025,2024,6,749164.0,Salary Increases & Fixed Expenses Increase,267154,68332.0,130865,199197.0,67957.0,25.44,0.0,Low Risk
U025,2024,7,817121.0,Salary Increases & Fixed Expenses Increase,267154,68332.0,92505,160837.0,106317.0,39.8,0.0,Low Risk
U025,2024,8,923438.0,Salary Increases & Fixed Expenses Increase,267154,68332.0,109648,177980.0,89174.0,33.38,0.04,Low Risk
U025,2024,9,1012612.0,Salary Increases & Fixed Expenses Increase,267154,68332.0,111660,179992.0,87162.0,32.63,0.04,Low Risk
U025,2024,10,1099774.0,Salary Increases & Fixed Expenses Increase,267154,68332.0,160115,228447.0,38707.0,14.49,-0.01,High Risk
U025,2024,11,1138481.0,Salary Increases & Fixed Expenses Increase,267154,68332.0,137895,206227.0,60927.0,22.81,-0.04,Medium Risk
U025,2024,12,1199408.0,Salary Increases & Fixed Expenses Increase,267154,68332.0,152113,220445.0,46709.0,17.48,-0.02,Medium Risk
U026,2024,1,250000.0,Salary Increases & Fixed Expenses Increase,283624,89252.0,68203,157455.0,126169.0,44.48,0.05,Low Risk
U026,2024,2,376169.0,Salary Increases & Fixed Expenses Increase,283624,89252.0,74244,163496.0,120128.0,42.35,-0.04,Low Risk
U026,2024,3,496297.0,Salary Increases & Fixed Expenses Increase,299828,89252.0,76632,165884.0,133944.0,44.67,-0.04,Low Risk
U026,2024,4,630241.0,Salary Increases & Fixed Expenses Increase,299828,90554.0,81817,172371.0,127457.0,42.51,-0.01,Low Risk
U026,2024,5,757698.0,Salary Increases & Fixed Expenses Increase,299828,92371.0,85780,178151.0,121677.0,40.58,0.02,Low Risk
U026,2024,6,879375.0,Salary Increases & Fixed Expenses Increase,299828,92371.0,60375,152746.0,147082.0,49.06,0.03,Low Risk
U026,2024,7,1026457.0,Salary Increases & Fixed Expenses Increase,299828,92371.0,65084,157455.0,142373.0,47.48,0.02,Low Risk
U026,2024,8,1168830.0,Salary Increases & Fixed Expenses Increase,299828,92371.0,78296,170667.0,129161.0,43.08,0.05,Low Risk
U026,2024,9,1297991.0,Salary Increases & Fixed Expenses Increase,299828,92371.0,68130,160501.0,139327.0,46.47,-0.04,Low Risk
U026,2024,10,1437318.0,Salary Increases & Fixed Expenses Increase,299828,92371.0,78528,170899.0,128929.0,43.0,-0.05,Low Risk
U026,2024,11,1566247.0,Salary Increases & Fixed Expenses Increase,299828,92371.0,83755,176126.0,123702.0,41.26,0.02,Low Risk
U026,2024,12,1689949.0,Salary Increases & Fixed Expenses Increase,299828,93655.0,60651,154306.0,145522.0,48.54,-0.02,Low Risk
U027,2024,1,219261.0,Salary Increases & Fixed Expenses Remain Stable,78613,32148.0,18458,50606.0,28007.0,35.63,-0.0,Low Risk
U027,2024,2,247268.0,Salary Increases & Fixed Expenses Remain Stable,78613,32148.0,21518,53666.0,24947.0,31.73,-0.03,Low Risk
U027,2024,3,272215.0,Salary Increases & Fixed Expenses Remain Stable,103519,32148.0,28714,60862.0,42657.0,41.21,0.0,Low Risk
U027,2024,4,314872.0,Salary Increases & Fixed Expenses Remain Stable,103519,32148.0,24671,56819.0,46700.0,45.11,-0.0,Low Risk
U027,2024,5,361572.0,Salary Increases & Fixed Expenses Remain Stable,103519,32148.0,23649,55797.0,47722.0,46.1,-0.03,Low Risk
U027,2024,6,409294.0,Salary Increases & Fixed Expenses Remain Stable,103519,32148.0,24023,56171.0,47348.0,45.74,-0.01,Low Risk
U027,2024,7,456642.0,Salary Increases & Fixed Expenses Remain Stable,103519,32148.0,25059,57207.0,46312.0,44.74,0.03,Low Risk
U027,2024,8,502954.0,Salary Increases & Fixed Expenses Remain Stable,103519,32148.0,27569,59717.0,43802.0,42.31,-0.0,Low Risk
U027,2024,9,546756.0,Salary Increases & Fixed Expenses Remain Stable,103519,32148.0,26976,59124.0,44395.0,42.89,0.01,Low Risk
U027,2024,10,591151.0,Salary Increases & Fixed Expenses Remain Stable,103519,32148.0,22659,54807.0,48712.0,47.06,0.05,Low Risk
U027,2024,11,639863.0,Salary Increases & Fixed Expenses Remain Stable,103519,32148.0,30432,62580.0,40939.0,39.55,-0.02,Low Risk
U027,2024,12,680802.0,Salary Increases & Fixed Expenses Remain Stable,103519,32148.0,20941,53089.0,50430.0,48.72,0.04,Low Risk
U028,2024,1,249458.0,Salary Increases & Fixed Expenses Increase,221449,84206.0,60924,145130.0,76319.0,34.46,-0.02,Low Risk
U028,2024,2,325777.0,Salary Increases & Fixed Expenses Increase,221449,84206.0,64526,148732.0,72717.0,32.84,-0.05,Low Risk
U028,2024,3,398494.0,Salary Increases & Fixed Expenses Increase,221449,84206.0,60843,145049.0,76400.0,34.5,-0.03,Low Risk
U028,2024,4,474894.0,Salary Increases & Fixed Expenses Increase,221449,84206.0,61797,146003.0,75446.0,34.07,0.05,Low Risk
U028,2024,5,550340.0,Salary Increases & Fixed Expenses Increase,227840,84206.0,59467,143673.0,84167.0,36.94,0.02,Low Risk
U028,2024,6,634507.0,Salary Increases & Fixed Expenses Increase,227840,84887.0,57329,142216.0,85624.0,37.58,-0.03,Low Risk
U028,2024,7,720131.0,Salary Increases & Fixed Expenses Increase,227840,84887.0,67809,152696.0,75144.0,32.98,0.02,Low Risk
U028,2024,8,795275.0,Salary Increases & Fixed Expenses Increase,227840,84887.0,65244,150131.0,77709.0,34.11,-0.05,Low Risk
U028,2024,9,872984.0,Salary Increases & Fixed Expenses Increase,227840,84887.0,54861,139748.0,88092.0,38.66,0.03,Low Risk
U028,2024,10,961076.0,Salary Increases & Fixed Expenses Increase,227840,84887.0,73498,158385.0,69455.0,30.48,0.02,Low Risk
U028,2024,11,1030531.0,Salary Increases & Fixed Expenses Increase,227840,84887.0,53878,138765.0,89075.0,39.1,0.02,Low Risk
U028,2024,12,1119606.0,Salary Increases & Fixed Expenses Increase,227840,84887.0,63937,148824.0,79016.0,34.68,-0.05,Low Risk
U029,2024,1,250000.0,Salary Increases & Fixed Expenses Increase,298369,84764.0,69661,154425.0,143944.0,48.24,0.05,Low Risk
U029,2024,2,393944.0,Salary Increases & Fixed Expenses Increase,298369,84764.0,59766,144530.0,153839.0,51.56,-0.01,Low Risk
U029,2024,3,547783.0,Salary Increases & Fixed Expenses Increase,298369,84764.0,85924,170688.0,127681.0,42.79,0.01,Low Risk
U029,2024,4,675464.0,Salary Increases & Fixed Expenses Increase,308863,84764.0,62841,147605.0,161258.0,52.21,0.03,Low Risk
U029,2024,5,836722.0,Salary Increases & Fixed Expenses Increase,308863,84764.0,87452,172216.0,136647.0,44.24,-0.05,Low Risk
U029,2024,6,973369.0,Salary Increases & Fixed Expenses Increase,308863,84764.0,64390,149154.0,159709.0,51.71,-0.04,Low Risk
U029,2024,7,1133078.0,Salary Increases & Fixed Expenses Increase,308863,84764.0,67034,151798.0,157065.0,50.85,0.05,Low Risk
U029,2024,8,1290143.0,Salary Increases & Fixed Expenses Increase,308863,85731.0,86287,172018.0,136845.0,44.31,0.03,Low Risk
U029,2024,9,1426988.0,Salary Increases & Fixed Expenses Increase,308863,87498.0,84953,172451.0,136412.0,44.17,-0.03,Low Risk
U029,2024,10,1563400.0,Salary Increases & Fixed Expenses Increase,308863,87498.0,82033,169531.0,139332.0,45.11,0.01,Low Risk
U029,2024,11,1702732.0,Salary Increases & Fixed Expenses Increase,308863,87498.0,95657,183155.0,125708.0,40.7,0.01,Low Risk
U029,2024,12,1828440.0,Salary Increases & Fixed Expenses Increase,308863,88388.0,93327,181715.0,127148.0,41.17,-0.03,Low Risk
U030,2024,1,250000.0,Salary Increases & Fixed Expenses Remain Stable,291415,75344.0,68986,144330.0,147085.0,50.47,-0.01,Low Risk
U030,2024,2,397085.0,Salary Increases & Fixed Expenses Remain Stable,291415,75344.0,84146,159490.0,131925.0,45.27,0.02,Low Risk
U030,2024,3,529010.0,Salary Increases & Fixed Expenses Remain Stable,291415,75344.0,70306,145650.0,145765.0,50.02,0.03,Low Risk
U030,2024,4,674775.0,Salary Increases & Fixed Expenses Remain Stable,291415,75344.0,82809,158153.0,133262.0,45.73,0.02,Low Risk
U030,2024,5,808037.0,Salary Increases & Fixed Expenses Remain Stable,291415,75344.0,81093,156437.0,134978.0,46.32,0.02,Low Risk
U030,2024,6,943015.0,Salary Increases & Fixed Expenses Remain Stable,303777,75344.0,80235,155579.0,148198.0,48.79,-0.01,Low Risk
U030,2024,7,1091213.0,Salary Increases & Fixed Expenses Remain Stable,303777,75344.0,84836,160180.0,143597.0,47.27,-0.04,Low Risk
U030,2024,8,1234810.0,Salary Increases & Fixed Expenses Remain Stable,303777,75344.0,85435,160779.0,142998.0,47.07,0.02,Low Risk
U030,2024,9,1377808.0,Salary Increases & Fixed Expenses Remain Stable,303777,75344.0,68820,144164.0,159613.0,52.54,-0.03,Low Risk
U030,2024,10,1537421.0,Salary Increases & Fixed Expenses Remain Stable,303777,75344.0,71181,146525.0,157252.0,51.77,0.04,Low Risk
U030,2024,11,1694673.0,Salary Increases & Fixed Expenses Remain Stable,303777,75344.0,68539,143883.0,159894.0,52.64,0.04,Low Risk
U030,2024,12,1854567.0,Salary Increases & Fixed Expenses Remain Stable,303777,75344.0,77300,152644.0,151133.0,49.75,-0.04,Low Risk
U031,2024,1,223121.0,Salary Increases & Fixed Expenses Remain Stable,83397,31692.0,26078,57770.0,25627.0,30.73,0.03,Low Risk
U031,2024,2,248748.0,Salary Increases & Fixed Expenses Remain Stable,83397,31692.0,39928,71620.0,11777.0,14.12,0.03,High Risk
U031,2024,3,260525.0,Salary Increases & Fixed Expenses Remain Stable,83397,31692.0,31589,63281.0,20116.0,24.12,-0.03,Medium Risk
U031,2024,4,280641.0,Salary Increases & Fixed Expenses Remain Stable,83397,31692.0,36895,68587.0,14810.0,17.76,0.0,Medium Risk
U031,2024,5,295451.0,Salary Increases & Fixed Expenses Remain Stable,112681,31692.0,46044,77736.0,34945.0,31.01,-0.03,Low Risk
U031,2024,6,330396.0,Salary Increases & Fixed Expenses Remain Stable,112681,31692.0,47754,79446.0,33235.0,29.49,-0.0,Low Risk
U031,2024,7,363631.0,Salary Increases & Fixed Expenses Remain Stable,112681,31692.0,46853,78545.0,34136.0,30.29,0.02,Low Risk
U031,2024,8,397767.0,Salary Increases & Fixed Expenses Remain Stable,112681,31692.0,41592,73284.0,39397.0,34.96,0.01,Low Risk
U031,2024,9,437164.0,Salary Increases & Fixed Expenses Remain Stable,112681,31692.0,46382,78074.0,34607.0,30.71,0.01,Low Risk
U031,2024,10,471771.0,Salary Increases & Fixed Expenses Remain Stable,112681,31692.0,41827,73519.0,39162.0,34.75,0.04,Low Risk
U031,2024,11,510933.0,Salary Increases & Fixed Expenses Remain Stable,112681,31692.0,39724,71416.0,41265.0,36.62,0.03,Low Risk
U031,2024,12,552198.0,Salary Increases & Fixed Expenses Remain Stable,112681,31692.0,53228,84920.0,27761.0,24.64,0.0,Medium Risk
U032,2024,1,60084.0,Salary Increases & Fixed Expenses Increase,39802,13755.0,10629,24384.0,15418.0,38.74,0.04,Low Risk
U032,2024,2,75502.0,Salary Increases & Fixed Expenses Increase,39802,13755.0,11557,25312.0,14490.0,36.41,-0.05,Low Risk
U032,2024,3,89992.0,Salary Increases & Fixed Expenses Increase,39802,14387.0,11382,25769.0,14033.0,35.26,-0.04,Low Risk
U032,2024,4,104025.0,Salary Increases & Fixed Expenses Increase,46243,14387.0,10062,24449.0,21794.0,47.13,0.0,Low Risk
U032,2024,5,125819.0,Salary Increases & Fixed Expenses Increase,46243,14387.0,13834,28221.0,18022.0,38.97,0.01,Low Risk
U032,2024,6,143841.0,Salary Increases & Fixed Expenses Increase,46243,14387.0,13563,27950.0,18293.0,39.56,-0.01,Low Risk
U032,2024,7,162134.0,Salary Increases & Fixed Expenses Increase,46243,15952.0,10309,26261.0,19982.0,43.21,0.03,Low Risk
U032,2024,8,182116.0,Salary Increases & Fixed Expenses Increase,46243,15952.0,10797,26749.0,19494.0,42.16,-0.01,Low Risk
U032,2024,9,201610.0,Salary Increases & Fixed Expenses Increase,46243,15952.0,13189,29141.0,17102.0,36.98,0.05,Low Risk
U032,2024,10,218712.0,Salary Increases & Fixed Expenses Increase,46243,16962.0,12630,29592.0,16651.0,36.01,0.01,Low Risk
U032,2024,11,235363.0,Salary Increases & Fixed Expenses Increase,46243,16962.0,15024,31986.0,14257.0,30.83,0.05,Low Risk
U032,2024,12,249620.0,Salary Increases & Fixed Expenses Increase,46243,16962.0,10535,27497.0,18746.0,40.54,0.0,Low Risk
U033,2024,1,236355.0,Salary Increases & Fixed Expenses Increase,229358,102890.0,110121,213011.0,16347.0,7.13,0.04,High Risk
U033,2024,2,252702.0,Salary Increases & Fixed Expenses Increase,229358,102890.0,94468,197358.0,32000.0,13.95,-0.02,High Risk
U033,2024,3,284702.0,Salary Increases & Fixed Expenses Increase,229358,104621.0,111436,216057.0,13301.0,5.8,-0.03,High Risk
U033,2024,4,298003.0,Salary Increases & Fixed Expenses Increase,229358,106580.0,100709,207289.0,22069.0,9.62,0.03,High Risk
U033,2024,5,320072.0,Salary Increases & Fixed Expenses Increase,258775,107666.0,100988,208654.0,50121.0,19.37,0.0,Medium Risk
U033,2024,6,370193.0,Salary Increases & Fixed Expenses Increase,258775,107666.0,86210,193876.0,64899.0,25.08,-0.03,Low Risk
U033,2024,7,435092.0,Salary Increases & Fixed Expenses Increase,258775,107666.0,92660,200326.0,58449.0,22.59,0.01,Medium Risk
U033,2024,8,493541.0,Salary Increases & Fixed Expenses Increase,258775,107666.0,105615,213281.0,45494.0,17.58,0.03,Medium Risk
U033,2024,9,539035.0,Salary Increases & Fixed Expenses Increase,258775,107666.0,107911,215577.0,43198.0,16.69,0.03,Medium Risk
U033,2024,10,582233.0,Salary Increases & Fixed Expenses Increase,258775,107666.0,145986,253652.0,5123.0,1.98,-0.02,High Risk
U033,2024,11,587356.0,Salary Increases & Fixed Expenses Increase,258775,107666.0,93834,201500.0,57275.0,22.13,0.01,Medium Risk
U033,2024,12,644631.0,Salary Increases & Fixed Expenses Increase,258775,107666.0,120408,228074.0,30701.0,11.86,0.03,High Risk
U034,2024,1,244242.0,Salary Increases & Fixed Expenses Increase,235880,85551.0,136713,222264.0,13616.0,5.77,-0.01,High Risk
U034,2024,2,257858.0,Salary Increases & Fixed Expenses Increase,235880,85551.0,155707,241258.0,-5378.0,-2.28,0.04,High Risk
U034,2024,3,252480.0,Salary Increases & Fixed Expenses Increase,235880,85551.0,178111,263662.0,-27782.0,-11.78,0.02,High Risk
U034,2024,4,224698.0,Salary Increases & Fixed Expenses Increase,260085,85551.0,158866,244417.0,15668.0,6.02,0.02,High Risk
U034,2024,5,240366.0,Salary Increases & Fixed Expenses Increase,260085,86088.0,181206,267294.0,-7209.0,-2.77,-0.04,High Risk
U034,2024,6,233157.0,Salary Increases & Fixed Expenses Increase,260085,86088.0,181135,267223.0,-7138.0,-2.74,0.03,High Risk
U034,2024,7,226019.0,Salary Increases & Fixed Expenses Increase,260085,86088.0,156109,242197.0,17888.0,6.88,-0.02,High Risk
U034,2024,8,243907.0,Salary Increases & Fixed Expenses Increase,260085,86088.0,156554,242642.0,17443.0,6.71,-0.03,High Risk
U034,2024,9,261350.0,Salary Increases & Fixed Expenses Increase,260085,86088.0,177672,263760.0,-3675.0,-1.41,0.04,High Risk
U034,2024,10,257675.0,Salary Increases & Fixed Expenses Increase,260085,86088.0,173048,259136.0,949.0,0.36,0.04,High Risk
U034,2024,11,258624.0,Salary Increases & Fixed Expenses Increase,260085,86088.0,168084,254172.0,5913.0,2.27,0.04,High Risk
U034,2024,12,264537.0,Salary Increases & Fixed Expenses Increase,260085,87825.0,213352,301177.0,-41092.0,-15.8,-0.0,High Risk
U035,2024,1,121133.0,Stable Salary & Stable Fixed Expenses,119759,72472.0,39515,111987.0,7772.0,6.49,-0.02,High Risk
U035,2024,2,128905.0,Stable Salary & Stable Fixed Expenses,119759,72472.0,36102,108574.0,11185.0,9.34,0.05,High Risk
U035,2024,3,140090.0,Stable Salary & Stable Fixed Expenses,119759,72472.0,57245,129717.0,-9958.0,-8.32,-0.02,High Risk
U035,2024,4,130132.0,Stable Salary & Stable Fixed Expenses,119759,72472.0,50369,122841.0,-3082.0,-2.57,-0.03,High Risk
U035,2024,5,127050.0,Stable Salary & Stable Fixed Expenses,119759,72472.0,57441,129913.0,-10154.0,-8.48,-0.01,High Risk
U035,2024,6,116896.0,Stable Salary & Stable Fixed Expenses,119759,72472.0,36177,108649.0,11110.0,9.28,-0.0,High Risk
U035,2024,7,128006.0,Stable Salary & Stable Fixed Expenses,119759,72472.0,38119,110591.0,9168.0,7.66,0.02,High Risk
U035,2024,8,137174.0,Stable Salary & Stable Fixed Expenses,119759,72472.0,54317,126789.0,-7030.0,-5.87,0.01,High Risk
U035,2024,9,130144.0,Stable Salary & Stable Fixed Expenses,119759,72472.0,43473,115945.0,3814.0,3.18,0.01,High Risk
U035,2024,10,133958.0,Stable Salary & Stable Fixed Expenses,119759,72472.0,70946,143418.0,-23659.0,-19.76,0.02,High Risk
U035,2024,11,110299.0,Stable Salary & Stable Fixed Expenses,119759,72472.0,49866,122338.0,-2579.0,-2.15,-0.02,High Risk
U035,2024,12,107720.0,Stable Salary & Stable Fixed Expenses,119759,72472.0,56493,128965.0,-9206.0,-7.69,0.02,High Risk
U036,2024,1,237917.0,Stable Salary & Stable Fixed Expenses,138634,71326.0,83252,154578.0,-15944.0,-11.5,0.01,High Risk
U036,2024,2,221973.0,Stable Salary & Stable Fixed Expenses,138634,71326.0,72190,143516.0,-4882.0,-3.52,-0.01,High Risk
U036,2024,3,217091.0,Stable Salary & Stable Fixed Expenses,138634,71326.0,90819,162145.0,-23511.0,-16.96,-0.02,High Risk
U036,2024,4,193580.0,Stable Salary & Stable Fixed Expenses,138634,71326.0,86064,157390.0,-18756.0,-13.53,0.05,High Risk
U036,2024,5,174824.0,Stable Salary & Stable Fixed Expenses,138634,71326.0,78665,149991.0,-11357.0,-8.19,-0.05,High Risk
U036,2024,6,163467.0,Stable Salary & Stable Fixed Expenses,138634,71326.0,84836,156162.0,-17528.0,-12.64,-0.03,High Risk
U036,2024,7,145939.0,Stable Salary & Stable Fixed Expenses,138634,71326.0,69348,140674.0,-2040.0,-1.47,-0.04,High Risk
U036,2024,8,143899.0,Stable Salary & Stable Fixed Expenses,138634,71326.0,77710,149036.0,-10402.0,-7.5,0.02,High Risk
U036,2024,9,133497.0,Stable Salary & Stable Fixed Expenses,138634,71326.0,83321,154647.0,-16013.0,-11.55,0.04,High Risk
U036,2024,10,117484.0,Stable Salary & Stable Fixed Expenses,138634,71326.0,91887,163213.0,-24579.0,-17.73,0.01,High Risk
U036,2024,11,92905.0,Stable Salary & Stable Fixed Expenses,138634,71326.0,73702,145028.0,-6394.0,-4.61,0.04,High Risk
U036,2024,12,86511.0,Stable Salary & Stable Fixed Expenses,138634,71326.0,96138,167464.0,-28830.0,-20.8,-0.03,High Risk
U037,2024,1,224695.0,Salary Increases & Fixed Expenses Remain Stable,139223,70760.0,31485,102245.0,36978.0,26.56,0.04,Low Risk
U037,2024,2,261673.0,Salary Increases & Fixed Expenses Remain Stable,139223,70760.0,33837,104597.0,34626.0,24.87,0.02,Medium Risk
U037,2024,3,296299.0,Salary Increases & Fixed Expenses Remain Stable,139223,70760.0,28456,99216.0,40007.0,28.74,0.02,Low Risk
U037,2024,4,336306.0,Salary Increases & Fixed Expenses Remain Stable,139223,70760.0,32455,103215.0,36008.0,25.86,0.01,Low Risk
U037,2024,5,372314.0,Salary Increases & Fixed Expenses Remain Stable,139223,70760.0,34336,105096.0,34127.0,24.51,0.0,Medium Risk
U037,2024,6,406441.0,Salary Increases & Fixed Expenses Remain Stable,156088,70760.0,32356,103116.0,52972.0,33.94,-0.0,Low Risk
U037,2024,7,459413.0,Salary Increases & Fixed Expenses Remain Stable,156088,70760.0,33939,104699.0,51389.0,32.92,0.04,Low Risk
U037,2024,8,510802.0,Salary Increases & Fixed Expenses Remain Stable,156088,70760.0,31435,102195.0,53893.0,34.53,0.0,Low Risk
U037,2024,9,564695.0,Salary Increases & Fixed Expenses Remain Stable,156088,70760.0,38742,109502.0,46586.0,29.85,0.05,Low Risk
U037,2024,10,611281.0,Salary Increases & Fixed Expenses Remain Stable,156088,70760.0,34387,105147.0,50941.0,32.64,0.02,Low Risk
U037,2024,11,662222.0,Salary Increases & Fixed Expenses Remain Stable,156088,70760.0,48021,118781.0,37307.0,23.9,-0.01,Medium Risk
U037,2024,12,699529.0,Salary Increases & Fixed Expenses Remain Stable,156088,70760.0,37385,108145.0,47943.0,30.72,0.02,Low Risk
U038,2024,1,248683.0,Salary Increases & Fixed Expenses Remain Stable,248520,69213.0,64442,133655.0,114865.0,46.22,0.03,Low Risk
U038,2024,2,363548.0,Salary Increases & Fixed Expenses Remain Stable,248520,69213.0,50585,119798.0,128722.0,51.8,-0.01,Low Risk
U038,2024,3,492270.0,Salary Increases & Fixed Expenses Remain Stable,248520,69213.0,65854,135067.0,113453.0,45.65,0.0,Low Risk
U038,2024,4,605723.0,Salary Increases & Fixed Expenses Remain Stable,248520,69213.0,71700,140913.0,107607.0,43.3,-0.04,Low Risk
U038,2024,5,713330.0,Salary Increases & Fixed Expenses Remain Stable,248520,69213.0,72720,141933.0,106587.0,42.89,0.02,Low Risk
U038,2024,6,819917.0,Salary Increases & Fixed Expenses Remain Stable,248520,69213.0,55702,124915.0,123605.0,49.74,0.01,Low Risk
U038,2024,7,943522.0,Salary Increases & Fixed Expenses Remain Stable,248520,69213.0,71532,140745.0,107775.0,43.37,-0.02,Low Risk
U038,2024,8,1051297.0,Salary Increases & Fixed Expenses Remain Stable,265915,69213.0,68668,137881.0,128034.0,48.15,-0.03,Low Risk
U038,2024,9,1179331.0,Salary Increases & Fixed Expenses Remain Stable,265915,69213.0,71575,140788.0,125127.0,47.06,-0.04,Low Risk
U038,2024,10,1304458.0,Salary Increases & Fixed Expenses Remain Stable,265915,69213.0,61132,130345.0,135570.0,50.98,-0.03,Low Risk
U038,2024,11,1440028.0,Salary Increases & Fixed Expenses Remain Stable,265915,69213.0,60314,129527.0,136388.0,51.29,-0.02,Low Risk
U038,2024,12,1576416.0,Salary Increases & Fixed Expenses Remain Stable,265915,69213.0,57351,126564.0,139351.0,52.4,0.04,Low Risk
U039,2024,1,119804.0,Stable Salary & Increasing Fixed Expenses,119791,68984.0,39945,108929.0,10862.0,9.07,0.02,High Risk
U039,2024,2,130666.0,Stable Salary & Increasing Fixed Expenses,119791,70456.0,42362,112818.0,6973.0,5.82,0.04,High Risk
U039,2024,3,137639.0,Stable Salary & Increasing Fixed Expenses,119791,70456.0,47610,118066.0,1725.0,1.44,0.04,High Risk
U039,2024,4,139364.0,Stable Salary & Increasing Fixed Expenses,119791,70456.0,41879,112335.0,7456.0,6.22,0.01,High Risk
U039,2024,5,146820.0,Stable Salary & Increasing Fixed Expenses,119791,70456.0,42881,113337.0,6454.0,5.39,0.02,High Risk
U039,2024,6,153274.0,Stable Salary & Increasing Fixed Expenses,119791,70456.0,46012,116468.0,3323.0,2.77,0.03,High Risk
U039,2024,7,156597.0,Stable Salary & Increasing Fixed Expenses,119791,70456.0,49664,120120.0,-329.0,-0.27,-0.03,High Risk
U039,2024,8,156268.0,Stable Salary & Increasing Fixed Expenses,119791,70456.0,41980,112436.0,7355.0,6.14,-0.02,High Risk
U039,2024,9,163623.0,Stable Salary & Increasing Fixed Expenses,119791,70456.0,51171,121627.0,-1836.0,-1.53,0.0,High Risk
U039,2024,10,161787.0,Stable Salary & Increasing Fixed Expenses,119791,70456.0,53905,124361.0,-4570.0,-3.81,0.01,High Risk
U039,2024,11,157217.0,Stable Salary & Increasing Fixed Expenses,119791,70456.0,48119,118575.0,1216.0,1.02,0.04,High Risk
U039,2024,12,158433.0,Stable Salary & Increasing Fixed Expenses,119791,70456.0,57122,127578.0,-7787.0,-6.5,-0.04,High Risk
U040,2024,1,135982.0,Stable Salary & Stable Fixed Expenses,82953,34877.0,41884,76761.0,6192.0,7.46,0.01,High Risk
U040,2024,2,142174.0,Stable Salary & Stable Fixed Expenses,82953,34877.0,48797,83674.0,-721.0,-0.87,-0.03,High Risk
U040,2024,3,141453.0,Stable Salary & Stable Fixed Expenses,82953,34877.0,62360,97237.0,-14284.0,-17.22,0.02,High Risk
U040,2024,4,127169.0,Stable Salary & Stable Fixed Expenses,82953,34877.0,49895,84772.0,-1819.0,-2.19,0.01,High Risk
U040,2024,5,125350.0,Stable Salary & Stable Fixed Expenses,82953,34877.0,44858,79735.0,3218.0,3.88,0.0,High Risk
U040,2024,6,128568.0,Stable Salary & Stable Fixed Expenses,82953,34877.0,53890,88767.0,-5814.0,-7.01,-0.04,High Risk
U040,2024,7,122754.0,Stable Salary & Stable Fixed Expenses,82953,34877.0,43085,77962.0,4991.0,6.02,-0.04,High Risk
U040,2024,8,127745.0,Stable Salary & Stable Fixed Expenses,82953,34877.0,45627,80504.0,2449.0,2.95,-0.01,High Risk
U040,2024,9,130194.0,Stable Salary & Stable Fixed Expenses,82953,34877.0,52147,87024.0,-4071.0,-4.91,0.01,High Risk
U040,2024,10,126123.0,Stable Salary & Stable Fixed Expenses,82953,34877.0,55194,90071.0,-7118.0,-8.58,0.01,High Risk
U040,2024,11,119005.0,Stable Salary & Stable Fixed Expenses,82953,34877.0,47510,82387.0,566.0,0.68,0.02,High Risk
U040,2024,12,119571.0,Stable Salary & Stable Fixed Expenses,82953,34877.0,67379,102256.0,-19303.0,-23.27,0.01,High Risk
U041,2024,1,237061.0,Stable Salary & Stable Fixed Expenses,122566,70275.0,79629,149904.0,-27338.0,-22.3,-0.02,High Risk
U041,2024,2,209723.0,Stable Salary & Stable Fixed Expenses,122566,70275.0,66434,136709.0,-14143.0,-11.54,0.02,High Risk
U041,2024,3,195580.0,Stable Salary & Stable Fixed Expenses,122566,70275.0,70178,140453.0,-17887.0,-14.59,0.03,High Risk
U041,2024,4,177693.0,Stable Salary & Stable Fixed Expenses,122566,70275.0,83177,153452.0,-30886.0,-25.2,0.01,High Risk
U041,2024,5,146807.0,Stable Salary & Stable Fixed Expenses,122566,70275.0,76806,147081.0,-24515.0,-20.0,0.03,High Risk
U041,2024,6,122292.0,Stable Salary & Stable Fixed Expenses,122566,70275.0,80346,150621.0,-28055.0,-22.89,-0.02,High Risk
U041,2024,7,94237.0,Stable Salary & Stable Fixed Expenses,122566,70275.0,70572,140847.0,-18281.0,-14.92,0.01,High Risk
U041,2024,8,75956.0,Stable Salary & Stable Fixed Expenses,122566,70275.0,63452,133727.0,-11161.0,-9.11,0.01,High Risk
U041,2024,9,64795.0,Stable Salary & Stable Fixed Expenses,122566,70275.0,79224,149499.0,-26933.0,-21.97,-0.04,High Risk
U041,2024,10,37862.0,Stable Salary & Stable Fixed Expenses,122566,70275.0,83170,153445.0,-30879.0,-25.19,-0.03,High Risk
U041,2024,11,6983.0,Stable Salary & Stable Fixed Expenses,122566,70275.0,83590,153865.0,-31299.0,-25.54,-0.02,High Risk
U041,2024,12,-24316.0,Stable Salary & Stable Fixed Expenses,122566,70275.0,83550,153825.0,-31259.0,-25.5,0.03,High Risk
U042,2024,1,146545.0,Stable Salary & Stable Fixed Expenses,65962,29959.0,34356,64315.0,1647.0,2.5,0.01,High Risk
U042,2024,2,148192.0,Stable Salary & Stable Fixed Expenses,65962,29959.0,35736,65695.0,267.0,0.4,-0.02,High Risk
U042,2024,3,148459.0,Stable Salary & Stable Fixed Expenses,65962,29959.0,53327,83286.0,-17324.0,-26.26,-0.05,High Risk
U042,2024,4,131135.0,Stable Salary & Stable Fixed Expenses,65962,29959.0,45745,75704.0,-9742.0,-14.77,0.04,High Risk
U042,2024,5,121393.0,Stable Salary & Stable Fixed Expenses,65962,29959.0,38619,68578.0,-2616.0,-3.97,0.03,High Risk
U042,2024,6,118777.0,Stable Salary & Stable Fixed Expenses,65962,29959.0,33301,63260.0,2702.0,4.1,-0.05,High Risk
U042,2024,7,121479.0,Stable Salary & Stable Fixed Expenses,65962,29959.0,42348,72307.0,-6345.0,-9.62,-0.02,High Risk
U042,2024,8,115134.0,Stable Salary & Stable Fixed Expenses,65962,29959.0,44890,74849.0,-8887.0,-13.47,-0.03,High Risk
U042,2024,9,106247.0,Stable Salary & Stable Fixed Expenses,65962,29959.0,40780,70739.0,-4777.0,-7.24,-0.03,High Risk
U042,2024,10,101470.0,Stable Salary & Stable Fixed Expenses,65962,29959.0,54599,84558.0,-18596.0,-28.19,0.01,High Risk
U042,2024,11,82874.0,Stable Salary & Stable Fixed Expenses,65962,29959.0,45199,75158.0,-9196.0,-13.94,0.03,High Risk
U042,2024,12,73678.0,Stable Salary & Stable Fixed Expenses,65962,29959.0,45104,75063.0,-9101.0,-13.8,-0.04,High Risk
U043,2024,1,248332.0,Stable Salary & Increasing Fixed Expenses,239058,105544.0,54236,159780.0,79278.0,33.16,-0.02,Low Risk
U043,2024,2,327610.0,Stable Salary & Increasing Fixed Expenses,239058,105544.0,63339,168883.0,70175.0,29.35,-0.01,Low Risk
U043,2024,3,397785.0,Stable Salary & Increasing Fixed Expenses,239058,105544.0,49000,154544.0,84514.0,35.35,0.02,Low Risk
U043,2024,4,482299.0,Stable Salary & Increasing Fixed Expenses,239058,107146.0,70168,177314.0,61744.0,25.83,0.05,Low Risk
U043,2024,5,544043.0,Stable Salary & Increasing Fixed Expenses,239058,107146.0,67113,174259.0,64799.0,27.11,-0.04,Low Risk
U043,2024,6,608842.0,Stable Salary & Increasing Fixed Expenses,239058,107146.0,64583,171729.0,67329.0,28.16,0.01,Low Risk
U043,2024,7,676171.0,Stable Salary & Increasing Fixed Expenses,239058,107146.0,59410,166556.0,72502.0,30.33,-0.01,Low Risk
U043,2024,8,748673.0,Stable Salary & Increasing Fixed Expenses,239058,107146.0,71011,178157.0,60901.0,25.48,0.02,Low Risk
U043,2024,9,809574.0,Stable Salary & Increasing Fixed Expenses,239058,107146.0,57467,164613.0,74445.0,31.14,0.04,Low Risk
U043,2024,10,884019.0,Stable Salary & Increasing Fixed Expenses,239058,107146.0,57655,164801.0,74257.0,31.06,0.01,Low Risk
U043,2024,11,958276.0,Stable Salary & Increasing Fixed Expenses,239058,107146.0,80980,188126.0,50932.0,21.31,0.03,Medium Risk
U043,2024,12,1009208.0,Stable Salary & Increasing Fixed Expenses,239058,107146.0,60120,167266.0,71792.0,30.03,-0.03,Low Risk
U044,2024,1,250000.0,Stable Salary & Stable Fixed Expenses,250889,97781.0,64230,162011.0,88878.0,35.43,0.02,Low Risk
U044,2024,2,338878.0,Stable Salary & Stable Fixed Expenses,250889,97781.0,50266,148047.0,102842.0,40.99,-0.05,Low Risk
U044,2024,3,441720.0,Stable Salary & Stable Fixed Expenses,250889,97781.0,69969,167750.0,83139.0,33.14,0.03,Low Risk
U044,2024,4,524859.0,Stable Salary & Stable Fixed Expenses,250889,97781.0,71632,169413.0,81476.0,32.47,-0.01,Low Risk
U044,2024,5,606335.0,Stable Salary & Stable Fixed Expenses,250889,97781.0,61406,159187.0,91702.0,36.55,-0.02,Low Risk
U044,2024,6,698037.0,Stable Salary & Stable Fixed Expenses,250889,97781.0,70922,168703.0,82186.0,32.76,0.03,Low Risk
U044,2024,7,780223.0,Stable Salary & Stable Fixed Expenses,250889,97781.0,67707,165488.0,85401.0,34.04,0.03,Low Risk
U044,2024,8,865624.0,Stable Salary & Stable Fixed Expenses,250889,97781.0,69288,167069.0,83820.0,33.41,-0.05,Low Risk
U044,2024,9,949444.0,Stable Salary & Stable Fixed Expenses,250889,97781.0,73314,171095.0,79794.0,31.8,-0.03,Low Risk
U044,2024,10,1029238.0,Stable Salary & Stable Fixed Expenses,250889,97781.0,64381,162162.0,88727.0,35.37,-0.02,Low Risk
U044,2024,11,1117965.0,Stable Salary & Stable Fixed Expenses,250889,97781.0,70741,168522.0,82367.0,32.83,0.02,Low Risk
U044,2024,12,1200332.0,Stable Salary & Stable Fixed Expenses,250889,97781.0,51246,149027.0,101862.0,40.6,0.03,Low Risk
U045,2024,1,141139.0,Salary Increases & Fixed Expenses Increase,77191,39396.0,30300,69696.0,7495.0,9.71,-0.03,High Risk
U045,2024,2,148634.0,Salary Increases & Fixed Expenses Increase,77191,39396.0,35710,75106.0,2085.0,2.7,0.02,High Risk
U045,2024,3,150719.0,Salary Increases & Fixed Expenses Increase,77191,39396.0,26817,66213.0,10978.0,14.22,-0.02,High Risk
U045,2024,4,161697.0,Salary Increases & Fixed Expenses Increase,77191,39396.0,38577,77973.0,-782.0,-1.01,-0.01,High Risk
U045,2024,5,160915.0,Salary Increases & Fixed Expenses Increase,77191,41375.0,26183,67558.0,9633.0,12.48,0.05,High Risk
U045,2024,6,170548.0,Salary Increases & Fixed Expenses Increase,77191,41375.0,29364,70739.0,6452.0,8.36,-0.03,High Risk
U045,2024,7,177000.0,Salary Increases & Fixed Expenses Increase,95083,41375.0,41473,82848.0,12235.0,12.87,0.02,High Risk
U045,2024,8,189235.0,Salary Increases & Fixed Expenses Increase,95083,42172.0,43740,85912.0,9171.0,9.65,0.05,High Risk
U045,2024,9,198406.0,Salary Increases & Fixed Expenses Increase,95083,42172.0,45485,87657.0,7426.0,7.81,-0.01,High Risk
U045,2024,10,205832.0,Salary Increases & Fixed Expenses Increase,95083,42172.0,41242,83414.0,11669.0,12.27,0.04,High Risk
U045,2024,11,217501.0,Salary Increases & Fixed Expenses Increase,95083,42172.0,38997,81169.0,13914.0,14.63,-0.02,High Risk
U045,2024,12,231415.0,Salary Increases & Fixed Expenses Increase,95083,42172.0,35334,77506.0,17577.0,18.49,-0.02,Medium Risk
U046,2024,1,242653.0,Stable Salary & Stable Fixed Expenses,69031,38660.0,20407,59067.0,9964.0,14.43,-0.04,High Risk
U046,2024,2,252617.0,Stable Salary & Stable Fixed Expenses,69031,38660.0,16653,55313.0,13718.0,19.87,0.02,Medium Risk
U046,2024,3,266335.0,Stable Salary & Stable Fixed Expenses,69031,38660.0,17699,56359.0,12672.0,18.36,-0.03,Medium Risk
U046,2024,4,279007.0,Stable Salary & Stable Fixed Expenses,69031,38660.0,18367,57027.0,12004.0,17.39,0.01,Medium Risk
U046,2024,5,291011.0,Stable Salary & Stable Fixed Expenses,69031,38660.0,18350,57010.0,12021.0,17.41,0.02,Medium Risk
U046,2024,6,303032.0,Stable Salary & Stable Fixed Expenses,69031,38660.0,17047,55707.0,13324.0,19.3,-0.05,Medium Risk
U046,2024,7,316356.0,Stable Salary & Stable Fixed Expenses,69031,38660.0,18083,56743.0,12288.0,17.8,0.03,Medium Risk
U046,2024,8,328644.0,Stable Salary & Stable Fixed Expenses,69031,38660.0,17855,56515.0,12516.0,18.13,0.02,Medium Risk
U046,2024,9,341160.0,Stable Salary & Stable Fixed Expenses,69031,38660.0,19493,58153.0,10878.0,15.76,0.02,Medium Risk
U046,2024,10,352038.0,Stable Salary & Stable Fixed Expenses,69031,38660.0,14409,53069.0,15962.0,23.12,0.02,Medium Risk
U046,2024,11,368000.0,Stable Salary & Stable Fixed Expenses,69031,38660.0,21038,59698.0,9333.0,13.52,-0.04,High Risk
U046,2024,12,377333.0,Stable Salary & Stable Fixed Expenses,69031,38660.0,14567,53227.0,15804.0,22.89,0.02,Medium Risk
U047,2024,1,250000.0,Salary Increases & Fixed Expenses Increase,263044,102445.0,113816,216261.0,46783.0,17.79,0.03,Medium Risk
U047,2024,2,296783.0,Salary Increases & Fixed Expenses Increase,263044,102445.0,120895,223340.0,39704.0,15.09,-0.01,Medium Risk
U047,2024,3,336487.0,Salary Increases & Fixed Expenses Increase,263044,104206.0,142333,246539.0,16505.0,6.27,-0.04,High Risk
U047,2024,4,352992.0,Salary Increases & Fixed Expenses Increase,263044,104206.0,92680,196886.0,66158.0,25.15,-0.04,Low Risk
U047,2024,5,419150.0,Salary Increases & Fixed Expenses Increase,283021,104206.0,114692,218898.0,64123.0,22.66,0.0,Medium Risk
U047,2024,6,483273.0,Salary Increases & Fixed Expenses Increase,283021,104206.0,89976,194182.0,88839.0,31.39,0.01,Low Risk
U047,2024,7,572112.0,Salary Increases & Fixed Expenses Increase,283021,104206.0,109322,213528.0,69493.0,24.55,-0.03,Medium Risk
U047,2024,8,641605.0,Salary Increases & Fixed Expenses Increase,283021,104206.0,117775,221981.0,61040.0,21.57,0.01,Medium Risk
U047,2024,9,702645.0,Salary Increases & Fixed Expenses Increase,283021,105459.0,101765,207224.0,75797.0,26.78,-0.0,Low Risk
U047,2024,10,778442.0,Salary Increases & Fixed Expenses Increase,283021,105459.0,108508,213967.0,69054.0,24.4,-0.0,Medium Risk
U047,2024,11,847496.0,Salary Increases & Fixed Expenses Increase,283021,106949.0,92181,199130.0,83891.0,29.64,-0.01,Low Risk
U047,2024,12,931387.0,Salary Increases & Fixed Expenses Increase,283021,106949.0,133803,240752.0,42269.0,14.93,0.03,High Risk
U048,2024,1,98479.0,Salary Increases & Fixed Expenses Increase,44595,10438.0,19375,29813.0,14782.0,33.15,0.02,Low Risk
U048,2024,2,113261.0,Salary Increases & Fixed Expenses Increase,44595,10438.0,16106,26544.0,18051.0,40.48,0.03,Low Risk
U048,2024,3,131312.0,Salary Increases & Fixed Expenses Increase,55947,10438.0,31611,42049.0,13898.0,24.84,-0.03,Medium Risk
U048,2024,4,145210.0,Salary Increases & Fixed Expenses Increase,55947,10438.0,25667,36105.0,19842.0,35.47,-0.01,Low Risk
U048,2024,5,165052.0,Salary Increases & Fixed Expenses Increase,55947,10438.0,27838,38276.0,17671.0,31.59,0.03,Low Risk
U048,2024,6,182723.0,Salary Increases & Fixed Expenses Increase,55947,10438.0,19539,29977.0,25970.0,46.42,-0.01,Low Risk
U048,2024,7,208693.0,Salary Increases & Fixed Expenses Increase,55947,10438.0,22857,33295.0,22652.0,40.49,0.03,Low Risk
U048,2024,8,231345.0,Salary Increases & Fixed Expenses Increase,55947,10438.0,24690,35128.0,20819.0,37.21,0.03,Low Risk
U048,2024,9,252164.0,Salary Increases & Fixed Expenses Increase,55947,11191.0,19835,31026.0,24921.0,44.54,0.01,Low Risk
U048,2024,10,277085.0,Salary Increases & Fixed Expenses Increase,55947,11191.0,27137,38328.0,17619.0,31.49,-0.03,Low Risk
U048,2024,11,294704.0,Salary Increases & Fixed Expenses Increase,55947,11191.0,19905,31096.0,24851.0,44.42,0.03,Low Risk
U048,2024,12,319555.0,Salary Increases & Fixed Expenses Increase,55947,11191.0,25154,36345.0,19602.0,35.04,0.04,Low Risk
U049,2024,1,168470.0,Salary Increases & Fixed Expenses Decrease,129662,53576.0,51001,104577.0,25085.0,19.35,-0.05,Medium Risk
U049,2024,2,193555.0,Salary Increases & Fixed Expenses Decrease,129662,53576.0,55565,109141.0,20521.0,15.83,0.01,Medium Risk
U049,2024,3,214076.0,Salary Increases & Fixed Expenses Decrease,129662,53576.0,42853,96429.0,33233.0,25.63,-0.04,Low Risk
U049,2024,4,247309.0,Salary Increases & Fixed Expenses Decrease,129662,53576.0,51291,104867.0,24795.0,19.12,0.03,Medium Risk
U049,2024,5,272104.0,Salary Increases & Fixed Expenses Decrease,154827,53576.0,54677,108253.0,46574.0,30.08,-0.04,Low Risk
U049,2024,6,318678.0,Salary Increases & Fixed Expenses Decrease,154827,53576.0,64434,118010.0,36817.0,23.78,0.01,Medium Risk
U049,2024,7,355495.0,Salary Increases & Fixed Expenses Decrease,154827,53576.0,69005,122581.0,32246.0,20.83,0.0,Medium Risk
U049,2024,8,387741.0,Salary Increases & Fixed Expenses Decrease,154827,53576.0,67854,121430.0,33397.0,21.57,0.02,Medium Risk
U049,2024,9,421138.0,Salary Increases & Fixed Expenses Decrease,154827,53576.0,76773,130349.0,24478.0,15.81,-0.04,Medium Risk
U049,2024,10,445616.0,Salary Increases & Fixed Expenses Decrease,154827,53576.0,47352,100928.0,53899.0,34.81,-0.03,Low Risk
U049,2024,11,499515.0,Salary Increases & Fixed Expenses Decrease,154827,53576.0,51011,104587.0,50240.0,32.45,0.01,Low Risk
U049,2024,12,549755.0,Salary Increases & Fixed Expenses Decrease,154827,53576.0,67124,120700.0,34127.0,22.04,0.03,Medium Risk
U050,2024,1,190502.0,Salary Increases & Fixed Expenses Remain Stable,169595,54158.0,66979,121137.0,48458.0,28.57,0.02,Low Risk
U050,2024,2,238960.0,Salary Increases & Fixed Expenses Remain Stable,169595,54158.0,76272,130430.0,39165.0,23.09,-0.04,Medium Risk
U050,2024,3,278125.0,Salary Increases & Fixed Expenses Remain Stable,169595,54158.0,76998,131156.0,38439.0,22.67,-0.02,Medium Risk
U050,2024,4,316564.0,Salary Increases & Fixed Expenses Remain Stable,169595,54158.0,64655,118813.0,50782.0,29.94,0.01,Low Risk
U050,2024,5,367346.0,Salary Increases & Fixed Expenses Remain Stable,169595,54158.0,75932,130090.0,39505.0,23.29,-0.02,Medium Risk
U050,2024,6,406851.0,Salary Increases & Fixed Expenses Remain Stable,169595,54158.0,63107,117265.0,52330.0,30.86,0.03,Low Risk
U050,2024,7,459181.0,Salary Increases & Fixed Expenses Remain Stable,169595,54158.0,56463,110621.0,58974.0,34.77,-0.02,Low Risk
U050,2024,8,518155.0,Salary Increases & Fixed Expenses Remain Stable,182275,54158.0,83532,137690.0,44585.0,24.46,-0.05,Medium Risk
U050,2024,9,562740.0,Salary Increases & Fixed Expenses Remain Stable,182275,54158.0,96139,150297.0,31978.0,17.54,0.04,Medium Risk
U050,2024,10,594718.0,Salary Increases & Fixed Expenses Remain Stable,182275,54158.0,66598,120756.0,61519.0,33.75,-0.02,Low Risk
U050,2024,11,656237.0,Salary Increases & Fixed Expenses Remain Stable,182275,54158.0,65394,119552.0,62723.0,34.41,-0.01,Low Risk
U050,2024,12,718960.0,Salary Increases & Fixed Expenses Remain Stable,182275,54158.0,115653,169811.0,12464.0,6.84,0.03,High Risk
U051,2024,1,157519.0,Salary Increases & Fixed Expenses Increase,107169,73044.0,24326,97370.0,9799.0,9.14,0.0,High Risk
U051,2024,2,167318.0,Salary Increases & Fixed Expenses Increase,107169,73044.0,22332,95376.0,11793.0,11.0,-0.05,High Risk
U051,2024,3,179111.0,Salary Increases & Fixed Expenses Increase,107169,73044.0,36237,109281.0,-2112.0,-1.97,-0.02,High Risk
U051,2024,4,176999.0,Salary Increases & Fixed Expenses Increase,107169,73044.0,31602,104646.0,2523.0,2.35,-0.02,High Risk
U051,2024,5,179522.0,Salary Increases & Fixed Expenses Increase,130854,73044.0,30978,104022.0,26832.0,20.51,0.05,Medium Risk
U051,2024,6,206354.0,Salary Increases & Fixed Expenses Increase,130854,74260.0,31963,106223.0,24631.0,18.82,-0.02,Medium Risk
U051,2024,7,230985.0,Salary Increases & Fixed Expenses Increase,130854,74260.0,33755,108015.0,22839.0,17.45,-0.03,Medium Risk
U051,2024,8,253824.0,Salary Increases & Fixed Expenses Increase,130854,75343.0,33559,108902.0,21952.0,16.78,-0.04,Medium Risk
U051,2024,9,275776.0,Salary Increases & Fixed Expenses Increase,130854,75343.0,33778,109121.0,21733.0,16.61,-0.0,Medium Risk
U051,2024,10,297509.0,Salary Increases & Fixed Expenses Increase,130854,75343.0,50204,125547.0,5307.0,4.06,-0.02,High Risk
U051,2024,11,302816.0,Salary Increases & Fixed Expenses Increase,130854,75343.0,34465,109808.0,21046.0,16.08,0.04,Medium Risk
U051,2024,12,323862.0,Salary Increases & Fixed Expenses Increase,130854,75343.0,36695,112038.0,18816.0,14.38,-0.04,High Risk
U052,2024,1,216720.0,Salary Increases & Fixed Expenses Increase,102877,47005.0,55196,102201.0,676.0,0.66,-0.05,High Risk
U052,2024,2,217396.0,Salary Increases & Fixed Expenses Increase,102877,47005.0,70658,117663.0,-14786.0,-14.37,-0.05,High Risk
U052,2024,3,202610.0,Salary Increases & Fixed Expenses Increase,102877,47005.0,60185,107190.0,-4313.0,-4.19,-0.02,High Risk
U052,2024,4,198297.0,Salary Increases & Fixed Expenses Increase,102877,47005.0,60344,107349.0,-4472.0,-4.35,-0.01,High Risk
U052,2024,5,193825.0,Salary Increases & Fixed Expenses Increase,124142,47005.0,71100,118105.0,6037.0,4.86,0.05,High Risk
U052,2024,6,199862.0,Salary Increases & Fixed Expenses Increase,124142,47005.0,84757,131762.0,-7620.0,-6.14,-0.05,High Risk
U052,2024,7,192242.0,Salary Increases & Fixed Expenses Increase,124142,47005.0,62697,109702.0,14440.0,11.63,0.01,High Risk
U052,2024,8,206682.0,Salary Increases & Fixed Expenses Increase,124142,47005.0,82026,129031.0,-4889.0,-3.94,-0.02,High Risk
U052,2024,9,201793.0,Salary Increases & Fixed Expenses Increase,124142,47005.0,81496,128501.0,-4359.0,-3.51,-0.04,High Risk
U052,2024,10,197434.0,Salary Increases & Fixed Expenses Increase,124142,47005.0,75700,122705.0,1437.0,1.16,-0.04,High Risk
U052,2024,11,198871.0,Salary Increases & Fixed Expenses Increase,124142,47987.0,78203,126190.0,-2048.0,-1.65,0.01,High Risk
U052,2024,12,196823.0,Salary Increases & Fixed Expenses Increase,124142,47987.0,82220,130207.0,-6065.0,-4.89,0.03,High Risk
U053,2024,1,201080.0,Salary Increases & Fixed Expenses Remain Stable,106263,72374.0,44352,116726.0,-10463.0,-9.85,0.01,High Risk
U053,2024,2,190617.0,Salary Increases & Fixed Expenses Remain Stable,106263,72374.0,40504,112878.0,-6615.0,-6.23,0.02,High Risk
U053,2024,3,184002.0,Salary Increases & Fixed Expenses Remain Stable,106263,72374.0,51738,124112.0,-17849.0,-16.8,-0.02,High Risk
U053,2024,4,166153.0,Salary Increases & Fixed Expenses Remain Stable,106263,72374.0,46625,118999.0,-12736.0,-11.99,0.05,High Risk
U053,2024,5,153417.0,Salary Increases & Fixed Expenses Remain Stable,106263,72374.0,46712,119086.0,-12823.0,-12.07,-0.04,High Risk
U053,2024,6,140594.0,Salary Increases & Fixed Expenses Remain Stable,128570,72374.0,39547,111921.0,16649.0,12.95,0.05,High Risk
U053,2024,7,157243.0,Salary Increases & Fixed Expenses Remain Stable,128570,72374.0,52088,124462.0,4108.0,3.2,0.01,High Risk
U053,2024,8,161351.0,Salary Increases & Fixed Expenses Remain Stable,128570,72374.0,39465,111839.0,16731.0,13.01,0.01,High Risk
U053,2024,9,178082.0,Salary Increases & Fixed Expenses Remain Stable,128570,72374.0,57836,130210.0,-1640.0,-1.28,0.0,High Risk
U053,2024,10,176442.0,Salary Increases & Fixed Expenses Remain Stable,128570,72374.0,54411,126785.0,1785.0,1.39,-0.04,High Risk
U053,2024,11,178227.0,Salary Increases & Fixed Expenses Remain Stable,128570,72374.0,46227,118601.0,9969.0,7.75,0.05,High Risk
U053,2024,12,188196.0,Salary Increases & Fixed Expenses Remain Stable,128570,72374.0,39763,112137.0,16433.0,12.78,-0.01,High Risk
U054,2024,1,208146.0,Salary Increases & Fixed Expenses Remain Stable,160638,69181.0,70313,139494.0,21144.0,13.16,0.01,High Risk
U054,2024,2,229290.0,Salary Increases & Fixed Expenses Remain Stable,160638,69181.0,48732,117913.0,42725.0,26.6,0.02,Low Risk
U054,2024,3,272015.0,Salary Increases & Fixed Expenses Remain Stable,180803,69181.0,83360,152541.0,28262.0,15.63,-0.04,Medium Risk
U054,2024,4,300277.0,Salary Increases & Fixed Expenses Remain Stable,180803,69181.0,71459,140640.0,40163.0,22.21,0.03,Medium Risk
U054,2024,5,340440.0,Salary Increases & Fixed Expenses Remain Stable,180803,69181.0,67146,136327.0,44476.0,24.6,-0.04,Medium Risk
U054,2024,6,384916.0,Salary Increases & Fixed Expenses Remain Stable,180803,69181.0,56770,125951.0,54852.0,30.34,0.03,Low Risk
U054,2024,7,439768.0,Salary Increases & Fixed Expenses Remain Stable,180803,69181.0,72537,141718.0,39085.0,21.62,0.03,Medium Risk
U054,2024,8,478853.0,Salary Increases & Fixed Expenses Remain Stable,180803,69181.0,84542,153723.0,27080.0,14.98,0.01,High Risk
U054,2024,9,505933.0,Salary Increases & Fixed Expenses Remain Stable,180803,69181.0,83146,152327.0,28476.0,15.75,-0.05,Medium Risk
U054,2024,10,534409.0,Salary Increases & Fixed Expenses Remain Stable,180803,69181.0,77582,146763.0,34040.0,18.83,-0.04,Medium Risk
U054,2024,11,568449.0,Salary Increases & Fixed Expenses Remain Stable,180803,69181.0,87599,156780.0,24023.0,13.29,-0.03,High Risk
U054,2024,12,592472.0,Salary Increases & Fixed Expenses Remain Stable,180803,69181.0,73423,142604.0,38199.0,21.13,-0.0,Medium Risk
U055,2024,1,249479.0,Stable Salary & Stable Fixed Expenses,240017,72101.0,109295,181396.0,58621.0,24.42,-0.0,Medium Risk
U055,2024,2,308100.0,Stable Salary & Stable Fixed Expenses,240017,72101.0,116562,188663.0,51354.0,21.4,-0.05,Medium Risk
U055,2024,3,359454.0,Stable Salary & Stable Fixed Expenses,240017,72101.0,97203,169304.0,70713.0,29.46,0.03,Low Risk
U055,2024,4,430167.0,Stable Salary & Stable Fixed Expenses,240017,72101.0,95516,167617.0,72400.0,30.16,-0.02,Low Risk
U055,2024,5,502567.0,Stable Salary & Stable Fixed Expenses,240017,72101.0,92314,164415.0,75602.0,31.5,-0.04,Low Risk
U055,2024,6,578169.0,Stable Salary & Stable Fixed Expenses,240017,72101.0,113295,185396.0,54621.0,22.76,0.03,Medium Risk
U055,2024,7,632790.0,Stable Salary & Stable Fixed Expenses,240017,72101.0,119849,191950.0,48067.0,20.03,-0.01,Medium Risk
U055,2024,8,680857.0,Stable Salary & Stable Fixed Expenses,240017,72101.0,111216,183317.0,56700.0,23.62,-0.03,Medium Risk
U055,2024,9,737557.0,Stable Salary & Stable Fixed Expenses,240017,72101.0,114592,186693.0,53324.0,22.22,0.05,Medium Risk
U055,2024,10,790881.0,Stable Salary & Stable Fixed Expenses,240017,72101.0,92304,164405.0,75612.0,31.5,-0.04,Low Risk
U055,2024,11,866493.0,Stable Salary & Stable Fixed Expenses,240017,72101.0,93088,165189.0,74828.0,31.18,0.02,Low Risk
U055,2024,12,941321.0,Stable Salary & Stable Fixed Expenses,240017,72101.0,111920,184021.0,55996.0,23.33,0.01,Medium Risk
U056,2024,1,140954.0,Stable Salary & Decreasing Fixed Expenses,137719,41223.0,39802,81025.0,56694.0,41.17,-0.02,Low Risk
U056,2024,2,197648.0,Stable Salary & Decreasing Fixed Expenses,137719,41223.0,28484,69707.0,68012.0,49.38,0.04,Low Risk
U056,2024,3,265660.0,Stable Salary & Decreasing Fixed Expenses,137719,39573.0,38978,78551.0,59168.0,42.96,0.02,Low Risk
U056,2024,4,324828.0,Stable Salary & Decreasing Fixed Expenses,137719,39573.0,29037,68610.0,69109.0,50.18,-0.0,Low Risk
U056,2024,5,393937.0,Stable Salary & Decreasing Fixed Expenses,137719,39573.0,29043,68616.0,69103.0,50.18,0.01,Low Risk
U056,2024,6,463040.0,Stable Salary & Decreasing Fixed Expenses,137719,39573.0,32208,71781.0,65938.0,47.88,0.01,Low Risk
U056,2024,7,528978.0,Stable Salary & Decreasing Fixed Expenses,137719,39573.0,36541,76114.0,61605.0,44.73,-0.01,Low Risk
U056,2024,8,590583.0,Stable Salary & Decreasing Fixed Expenses,137719,39573.0,37448,77021.0,60698.0,44.07,-0.03,Low Risk
U056,2024,9,651281.0,Stable Salary & Decreasing Fixed Expenses,137719,39573.0,46126,85699.0,52020.0,37.77,0.03,Low Risk
U056,2024,10,703301.0,Stable Salary & Decreasing Fixed Expenses,137719,39573.0,31371,70944.0,66775.0,48.49,-0.02,Low Risk
U056,2024,11,770076.0,Stable Salary & Decreasing Fixed Expenses,137719,39573.0,37491,77064.0,60655.0,44.04,-0.03,Low Risk
U056,2024,12,830731.0,Stable Salary & Decreasing Fixed Expenses,137719,39573.0,34060,73633.0,64086.0,46.53,-0.01,Low Risk
U057,2024,1,246226.0,Salary Increases & Fixed Expenses Remain Stable,228383,66834.0,97972,164806.0,63577.0,27.84,0.03,Low Risk
U057,2024,2,309803.0,Salary Increases & Fixed Expenses Remain Stable,228383,66834.0,80118,146952.0,81431.0,35.66,0.01,Low Risk
U057,2024,3,391234.0,Salary Increases & Fixed Expenses Remain Stable,228383,66834.0,106606,173440.0,54943.0,24.06,-0.01,Medium Risk
U057,2024,4,446177.0,Salary Increases & Fixed Expenses Remain Stable,228383,66834.0,106906,173740.0,54643.0,23.93,-0.04,Medium Risk
U057,2024,5,500820.0,Salary Increases & Fixed Expenses Remain Stable,253561,66834.0,104308,171142.0,82419.0,32.5,-0.0,Low Risk
U057,2024,6,583239.0,Salary Increases & Fixed Expenses Remain Stable,253561,66834.0,115947,182781.0,70780.0,27.91,0.02,Low Risk
U057,2024,7,654019.0,Salary Increases & Fixed Expenses Remain Stable,253561,66834.0,103296,170130.0,83431.0,32.9,-0.03,Low Risk
U057,2024,8,737450.0,Salary Increases & Fixed Expenses Remain Stable,253561,66834.0,121984,188818.0,64743.0,25.53,-0.04,Low Risk
U057,2024,9,802193.0,Salary Increases & Fixed Expenses Remain Stable,253561,66834.0,90596,157430.0,96131.0,37.91,0.05,Low Risk
U057,2024,10,898324.0,Salary Increases & Fixed Expenses Remain Stable,253561,66834.0,108859,175693.0,77868.0,30.71,-0.03,Low Risk
U057,2024,11,976192.0,Salary Increases & Fixed Expenses Remain Stable,253561,66834.0,104763,171597.0,81964.0,32.33,-0.02,Low Risk
U057,2024,12,1058156.0,Salary Increases & Fixed Expenses Remain Stable,253561,66834.0,121453,188287.0,65274.0,25.74,-0.0,Low Risk
U058,2024,1,250000.0,Stable Salary & Stable Fixed Expenses,259475,83112.0,55317,138429.0,121046.0,46.65,0.02,Low Risk
U058,2024,2,371046.0,Stable Salary & Stable Fixed Expenses,259475,83112.0,69063,152175.0,107300.0,41.35,-0.02,Low Risk
U058,2024,3,478346.0,Stable Salary & Stable Fixed Expenses,259475,83112.0,73692,156804.0,102671.0,39.57,-0.01,Low Risk
U058,2024,4,581017.0,Stable Salary & Stable Fixed Expenses,259475,83112.0,56811,139923.0,119552.0,46.07,0.0,Low Risk
U058,2024,5,700569.0,Stable Salary & Stable Fixed Expenses,259475,83112.0,52733,135845.0,123630.0,47.65,0.02,Low Risk
U058,2024,6,824199.0,Stable Salary & Stable Fixed Expenses,259475,83112.0,52647,135759.0,123716.0,47.68,0.01,Low Risk
U058,2024,7,947915.0,Stable Salary & Stable Fixed Expenses,259475,83112.0,57430,140542.0,118933.0,45.84,0.04,Low Risk
U058,2024,8,1066848.0,Stable Salary & Stable Fixed Expenses,259475,83112.0,66162,149274.0,110201.0,42.47,0.05,Low Risk
U058,2024,9,1177049.0,Stable Salary & Stable Fixed Expenses,259475,83112.0,67416,150528.0,108947.0,41.99,0.02,Low Risk
U058,2024,10,1285996.0,Stable Salary & Stable Fixed Expenses,259475,83112.0,54953,138065.0,121410.0,46.79,0.03,Low Risk
U058,2024,11,1407406.0,Stable Salary & Stable Fixed Expenses,259475,83112.0,56803,139915.0,119560.0,46.08,0.05,Low Risk
U058,2024,12,1526966.0,Stable Salary & Stable Fixed Expenses,259475,83112.0,58222,141334.0,118141.0,45.53,-0.02,Low Risk
U059,2024,1,250000.0,Salary Increases & Fixed Expenses Increase,252990,98032.0,116449,214481.0,38509.0,15.22,0.02,Medium Risk
U059,2024,2,288509.0,Salary Increases & Fixed Expenses Increase,252990,98032.0,96519,194551.0,58439.0,23.1,0.04,Medium Risk
U059,2024,3,346948.0,Salary Increases & Fixed Expenses Increase,252990,98032.0,82121,180153.0,72837.0,28.79,0.02,Low Risk
U059,2024,4,419785.0,Salary Increases & Fixed Expenses Increase,252990,99177.0,116563,215740.0,37250.0,14.72,-0.0,High Risk
U059,2024,5,457035.0,Salary Increases & Fixed Expenses Increase,252990,99177.0,112487,211664.0,41326.0,16.34,0.03,Medium Risk
U059,2024,6,498361.0,Salary Increases & Fixed Expenses Increase,252990,99177.0,105676,204853.0,48137.0,19.03,-0.03,Medium Risk
U059,2024,7,546498.0,Salary Increases & Fixed Expenses Increase,271255,100337.0,89917,190254.0,81001.0,29.86,-0.02,Low Risk
U059,2024,8,627499.0,Salary Increases & Fixed Expenses Increase,271255,100337.0,97299,197636.0,73619.0,27.14,0.01,Low Risk
U059,2024,9,701118.0,Salary Increases & Fixed Expenses Increase,271255,100337.0,82412,182749.0,88506.0,32.63,-0.04,Low Risk
U059,2024,10,789624.0,Salary Increases & Fixed Expenses Increase,271255,100337.0,82450,182787.0,88468.0,32.61,-0.04,Low Risk
U059,2024,11,878092.0,Salary Increases & Fixed Expenses Increase,271255,100337.0,86919,187256.0,83999.0,30.97,-0.04,Low Risk
U059,2024,12,962091.0,Salary Increases & Fixed Expenses Increase,271255,102250.0,127438,229688.0,41567.0,15.32,-0.03,Medium Risk
U060,2024,1,206226.0,Stable Salary & Stable Fixed Expenses,84679,31687.0,40846,72533.0,12146.0,14.34,-0.03,High Risk
U060,2024,2,218372.0,Stable Salary & Stable Fixed Expenses,84679,31687.0,34952,66639.0,18040.0,21.3,-0.03,Medium Risk
U060,2024,3,236412.0,Stable Salary & Stable Fixed Expenses,84679,31687.0,47004,78691.0,5988.0,7.07,0.05,High Risk
U060,2024,4,242400.0,Stable Salary & Stable Fixed Expenses,84679,31687.0,30234,61921.0,22758.0,26.88,-0.03,Low Risk
U060,2024,5,265158.0,Stable Salary & Stable Fixed Expenses,84679,31687.0,38347,70034.0,14645.0,17.29,0.04,Medium Risk
U060,2024,6,279803.0,Stable Salary & Stable Fixed Expenses,84679,31687.0,40561,72248.0,12431.0,14.68,0.01,High Risk
U060,2024,7,292234.0,Stable Salary & Stable Fixed Expenses,84679,31687.0,37974,69661.0,15018.0,17.74,0.02,Medium Risk
U060,2024,8,307252.0,Stable Salary & Stable Fixed Expenses,84679,31687.0,27606,59293.0,25386.0,29.98,0.02,Low Risk
U060,2024,9,332638.0,Stable Salary & Stable Fixed Expenses,84679,31687.0,32498,64185.0,20494.0,24.2,-0.02,Medium Risk
U060,2024,10,353132.0,Stable Salary & Stable Fixed Expenses,84679,31687.0,40831,72518.0,12161.0,14.36,0.04,High Risk
U060,2024,11,365293.0,Stable Salary & Stable Fixed Expenses,84679,31687.0,28267,59954.0,24725.0,29.2,0.01,Low Risk
U060,2024,12,390018.0,Stable Salary & Stable Fixed Expenses,84679,31687.0,46378,78065.0,6614.0,7.81,0.0,High Risk
U061,2024,1,232767.0,Salary Increases & Fixed Expenses Increase,209751,63416.0,70539,133955.0,75796.0,36.14,0.01,Low Risk
U061,2024,2,308563.0,Salary Increases & Fixed Expenses Increase,209751,63416.0,67096,130512.0,79239.0,37.78,0.03,Low Risk
U061,2024,3,387802.0,Salary Increases & Fixed Expenses Increase,209751,63416.0,78841,142257.0,67494.0,32.18,0.01,Low Risk
U061,2024,4,455296.0,Salary Increases & Fixed Expenses Increase,236530,63416.0,81187,144603.0,91927.0,38.86,-0.05,Low Risk
U061,2024,5,547223.0,Salary Increases & Fixed Expenses Increase,236530,63416.0,93751,157167.0,79363.0,33.55,-0.01,Low Risk
U061,2024,6,626586.0,Salary Increases & Fixed Expenses Increase,236530,63416.0,71196,134612.0,101918.0,43.09,0.03,Low Risk
U061,2024,7,728504.0,Salary Increases & Fixed Expenses Increase,236530,63416.0,116773,180189.0,56341.0,23.82,-0.05,Medium Risk
U061,2024,8,784845.0,Salary Increases & Fixed Expenses Increase,236530,63416.0,103286,166702.0,69828.0,29.52,0.01,Low Risk
U061,2024,9,854673.0,Salary Increases & Fixed Expenses Increase,236530,63416.0,109746,173162.0,63368.0,26.79,0.02,Low Risk
U061,2024,10,918041.0,Salary Increases & Fixed Expenses Increase,236530,64678.0,89248,153926.0,82604.0,34.92,0.03,Low Risk
U061,2024,11,1000645.0,Salary Increases & Fixed Expenses Increase,236530,66369.0,109003,175372.0,61158.0,25.86,0.01,Low Risk
U061,2024,12,1061803.0,Salary Increases & Fixed Expenses Increase,236530,66369.0,96152,162521.0,74009.0,31.29,0.02,Low Risk
U062,2024,1,248169.0,Salary Increases & Fixed Expenses Remain Stable,245145,94506.0,62288,156794.0,88351.0,36.04,-0.02,Low Risk
U062,2024,2,336520.0,Salary Increases & Fixed Expenses Remain Stable,245145,94506.0,56109,150615.0,94530.0,38.56,0.02,Low Risk
U062,2024,3,431050.0,Salary Increases & Fixed Expenses Remain Stable,245145,94506.0,82102,176608.0,68537.0,27.96,0.02,Low Risk
U062,2024,4,499587.0,Salary Increases & Fixed Expenses Remain Stable,245145,94506.0,55005,149511.0,95634.0,39.01,-0.02,Low Risk
U062,2024,5,595221.0,Salary Increases & Fixed Expenses Remain Stable,245145,94506.0,56274,150780.0,94365.0,38.49,0.02,Low Risk
U062,2024,6,689586.0,Salary Increases & Fixed Expenses Remain Stable,267212,94506.0,66155,160661.0,106551.0,39.88,-0.01,Low Risk
U062,2024,7,796137.0,Salary Increases & Fixed Expenses Remain Stable,267212,94506.0,79514,174020.0,93192.0,34.88,0.02,Low Risk
U062,2024,8,889329.0,Salary Increases & Fixed Expenses Remain Stable,267212,94506.0,70586,165092.0,102120.0,38.22,0.02,Low Risk
U062,2024,9,991449.0,Salary Increases & Fixed Expenses Remain Stable,267212,94506.0,82948,177454.0,89758.0,33.59,-0.05,Low Risk
U062,2024,10,1081207.0,Salary Increases & Fixed Expenses Remain Stable,267212,94506.0,65231,159737.0,107475.0,40.22,0.03,Low Risk
U062,2024,11,1188682.0,Salary Increases & Fixed Expenses Remain Stable,267212,94506.0,70013,164519.0,102693.0,38.43,-0.02,Low Risk
U062,2024,12,1291375.0,Salary Increases & Fixed Expenses Remain Stable,267212,94506.0,79199,173705.0,93507.0,34.99,-0.02,Low Risk
U063,2024,1,178553.0,Salary Increases & Fixed Expenses Remain Stable,145277,77430.0,37055,114485.0,30792.0,21.2,-0.05,Medium Risk
U063,2024,2,209345.0,Salary Increases & Fixed Expenses Remain Stable,145277,77430.0,37830,115260.0,30017.0,20.66,-0.02,Medium Risk
U063,2024,3,239362.0,Salary Increases & Fixed Expenses Remain Stable,145277,77430.0,42545,119975.0,25302.0,17.42,-0.01,Medium Risk
U063,2024,4,264664.0,Salary Increases & Fixed Expenses Remain Stable,145277,77430.0,36830,114260.0,31017.0,21.35,0.02,Medium Risk
U063,2024,5,295681.0,Salary Increases & Fixed Expenses Remain Stable,145277,77430.0,35872,113302.0,31975.0,22.01,-0.02,Medium Risk
U063,2024,6,327656.0,Salary Increases & Fixed Expenses Remain Stable,145277,77430.0,35012,112442.0,32835.0,22.6,0.05,Medium Risk
U063,2024,7,360491.0,Salary Increases & Fixed Expenses Remain Stable,153557,77430.0,31156,108586.0,44971.0,29.29,0.03,Low Risk
U063,2024,8,405462.0,Salary Increases & Fixed Expenses Remain Stable,153557,77430.0,46052,123482.0,30075.0,19.59,-0.04,Medium Risk
U063,2024,9,435537.0,Salary Increases & Fixed Expenses Remain Stable,153557,77430.0,40181,117611.0,35946.0,23.41,0.03,Medium Risk
U063,2024,10,471483.0,Salary Increases & Fixed Expenses Remain Stable,153557,77430.0,41164,118594.0,34963.0,22.77,-0.0,Medium Risk
U063,2024,11,506446.0,Salary Increases & Fixed Expenses Remain Stable,153557,77430.0,37266,114696.0,38861.0,25.31,0.0,Low Risk
U063,2024,12,545307.0,Salary Increases & Fixed Expenses Remain Stable,153557,77430.0,54536,131966.0,21591.0,14.06,0.04,High Risk
U064,2024,1,244073.0,Salary Increases & Fixed Expenses Increase,201899,86278.0,87304,173582.0,28317.0,14.03,0.02,High Risk
U064,2024,2,272390.0,Salary Increases & Fixed Expenses Increase,201899,86278.0,71949,158227.0,43672.0,21.63,0.05,Medium Risk
U064,2024,3,316062.0,Salary Increases & Fixed Expenses Increase,207822,86278.0,71246,157524.0,50298.0,24.2,0.05,Medium Risk
U064,2024,4,366360.0,Salary Increases & Fixed Expenses Increase,207822,86278.0,96336,182614.0,25208.0,12.13,0.05,High Risk
U064,2024,5,391568.0,Salary Increases & Fixed Expenses Increase,207822,86278.0,67667,153945.0,53877.0,25.92,-0.04,Low Risk
U064,2024,6,445445.0,Salary Increases & Fixed Expenses Increase,207822,86278.0,82903,169181.0,38641.0,18.59,-0.04,Medium Risk
U064,2024,7,484086.0,Salary Increases & Fixed Expenses Increase,207822,86278.0,89145,175423.0,32399.0,15.59,0.01,Medium Risk
U064,2024,8,516485.0,Salary Increases & Fixed Expenses Increase,207822,86278.0,78418,164696.0,43126.0,20.75,-0.03,Medium Risk
U064,2024,9,559611.0,Salary Increases & Fixed Expenses Increase,207822,87022.0,101213,188235.0,19587.0,9.42,0.0,High Risk
U064,2024,10,579198.0,Salary Increases & Fixed Expenses Increase,207822,87625.0,94608,182233.0,25589.0,12.31,-0.03,High Risk
U064,2024,11,604787.0,Salary Increases & Fixed Expenses Increase,207822,87625.0,97213,184838.0,22984.0,11.06,0.04,High Risk
U064,2024,12,627771.0,Salary Increases & Fixed Expenses Increase,207822,87625.0,80243,167868.0,39954.0,19.23,0.03,Medium Risk
U065,2024,1,217386.0,Stable Salary & Stable Fixed Expenses,193792,74788.0,86956,161744.0,32048.0,16.54,-0.04,Medium Risk
U065,2024,2,249434.0,Stable Salary & Stable Fixed Expenses,193792,74788.0,76075,150863.0,42929.0,22.15,-0.05,Medium Risk
U065,2024,3,292363.0,Stable Salary & Stable Fixed Expenses,193792,74788.0,66552,141340.0,52452.0,27.07,0.03,Low Risk
U065,2024,4,344815.0,Stable Salary & Stable Fixed Expenses,193792,74788.0,91020,165808.0,27984.0,14.44,-0.04,High Risk
U065,2024,5,372799.0,Stable Salary & Stable Fixed Expenses,193792,74788.0,60287,135075.0,58717.0,30.3,-0.04,Low Risk
U065,2024,6,431516.0,Stable Salary & Stable Fixed Expenses,193792,74788.0,61129,135917.0,57875.0,29.86,0.01,Low Risk
U065,2024,7,489391.0,Stable Salary & Stable Fixed Expenses,193792,74788.0,73506,148294.0,45498.0,23.48,0.04,Medium Risk
U065,2024,8,534889.0,Stable Salary & Stable Fixed Expenses,193792,74788.0,75276,150064.0,43728.0,22.56,-0.04,Medium Risk
U065,2024,9,578617.0,Stable Salary & Stable Fixed Expenses,193792,74788.0,85232,160020.0,33772.0,17.43,0.04,Medium Risk
U065,2024,10,612389.0,Stable Salary & Stable Fixed Expenses,193792,74788.0,74731,149519.0,44273.0,22.85,-0.03,Medium Risk
U065,2024,11,656662.0,Stable Salary & Stable Fixed Expenses,193792,74788.0,82561,157349.0,36443.0,18.81,-0.02,Medium Risk
U065,2024,12,693105.0,Stable Salary & Stable Fixed Expenses,193792,74788.0,74278,149066.0,44726.0,23.08,-0.03,Medium Risk
U066,2024,1,73691.0,Stable Salary & Decreasing Fixed Expenses,58697,35164.0,21046,56210.0,2487.0,4.24,0.04,High Risk
U066,2024,2,76178.0,Stable Salary & Decreasing Fixed Expenses,58697,35164.0,21647,56811.0,1886.0,3.21,-0.03,High Risk
U066,2024,3,78064.0,Stable Salary & Decreasing Fixed Expenses,58697,35164.0,24630,59794.0,-1097.0,-1.87,0.02,High Risk
U066,2024,4,76967.0,Stable Salary & Decreasing Fixed Expenses,58697,35164.0,26965,62129.0,-3432.0,-5.85,0.0,High Risk
U066,2024,5,73535.0,Stable Salary & Decreasing Fixed Expenses,58697,35164.0,28330,63494.0,-4797.0,-8.17,0.01,High Risk
U066,2024,6,68738.0,Stable Salary & Decreasing Fixed Expenses,58697,35164.0,23780,58944.0,-247.0,-0.42,-0.04,High Risk
U066,2024,7,68491.0,Stable Salary & Decreasing Fixed Expenses,58697,35164.0,21458,56622.0,2075.0,3.54,0.03,High Risk
U066,2024,8,70566.0,Stable Salary & Decreasing Fixed Expenses,58697,35164.0,20384,55548.0,3149.0,5.36,-0.03,High Risk
U066,2024,9,73715.0,Stable Salary & Decreasing Fixed Expenses,58697,35164.0,28359,63523.0,-4826.0,-8.22,0.05,High Risk
U066,2024,10,68889.0,Stable Salary & Decreasing Fixed Expenses,58697,35164.0,28664,63828.0,-5131.0,-8.74,-0.02,High Risk
U066,2024,11,63758.0,Stable Salary & Decreasing Fixed Expenses,58697,35164.0,20224,55388.0,3309.0,5.64,0.05,High Risk
U066,2024,12,67067.0,Stable Salary & Decreasing Fixed Expenses,58697,35164.0,21044,56208.0,2489.0,4.24,0.05,High Risk
U067,2024,1,221750.0,Stable Salary & Increasing Fixed Expenses,87052,36142.0,23572,59714.0,27338.0,31.4,0.01,Low Risk
U067,2024,2,249088.0,Stable Salary & Increasing Fixed Expenses,87052,36142.0,21292,57434.0,29618.0,34.02,0.0,Low Risk
U067,2024,3,278706.0,Stable Salary & Increasing Fixed Expenses,87052,36142.0,22878,59020.0,28032.0,32.2,0.01,Low Risk
U067,2024,4,306738.0,Stable Salary & Increasing Fixed Expenses,87052,36142.0,19152,55294.0,31758.0,36.48,-0.02,Low Risk
U067,2024,5,338496.0,Stable Salary & Increasing Fixed Expenses,87052,36142.0,24121,60263.0,26789.0,30.77,-0.04,Low Risk
U067,2024,6,365285.0,Stable Salary & Increasing Fixed Expenses,87052,36142.0,22586,58728.0,28324.0,32.54,-0.03,Low Risk
U067,2024,7,393609.0,Stable Salary & Increasing Fixed Expenses,87052,36142.0,19946,56088.0,30964.0,35.57,0.05,Low Risk
U067,2024,8,424573.0,Stable Salary & Increasing Fixed Expenses,87052,36142.0,25090,61232.0,25820.0,29.66,0.03,Low Risk
U067,2024,9,450393.0,Stable Salary & Increasing Fixed Expenses,87052,36142.0,20867,57009.0,30043.0,34.51,0.03,Low Risk
U067,2024,10,480436.0,Stable Salary & Increasing Fixed Expenses,87052,36824.0,24232,61056.0,25996.0,29.86,0.03,Low Risk
U067,2024,11,506432.0,Stable Salary & Increasing Fixed Expenses,87052,36824.0,19800,56624.0,30428.0,34.95,0.04,Low Risk
U067,2024,12,536860.0,Stable Salary & Increasing Fixed Expenses,87052,38577.0,20285,58862.0,28190.0,32.38,-0.05,Low Risk
U068,2024,1,239725.0,Salary Increases & Fixed Expenses Remain Stable,234706,77618.0,99761,177379.0,57327.0,24.43,0.02,Medium Risk
U068,2024,2,297052.0,Salary Increases & Fixed Expenses Remain Stable,234706,77618.0,115111,192729.0,41977.0,17.88,-0.04,Medium Risk
U068,2024,3,339029.0,Salary Increases & Fixed Expenses Remain Stable,234706,77618.0,84080,161698.0,73008.0,31.11,0.01,Low Risk
U068,2024,4,412037.0,Salary Increases & Fixed Expenses Remain Stable,234706,77618.0,80991,158609.0,76097.0,32.42,-0.04,Low Risk
U068,2024,5,488134.0,Salary Increases & Fixed Expenses Remain Stable,234706,77618.0,90607,168225.0,66481.0,28.33,-0.02,Low Risk
U068,2024,6,554615.0,Salary Increases & Fixed Expenses Remain Stable,234706,77618.0,93086,170704.0,64002.0,27.27,0.04,Low Risk
U068,2024,7,618617.0,Salary Increases & Fixed Expenses Remain Stable,256587,77618.0,98558,176176.0,80411.0,31.34,0.04,Low Risk
U068,2024,8,699028.0,Salary Increases & Fixed Expenses Remain Stable,256587,77618.0,122438,200056.0,56531.0,22.03,-0.01,Medium Risk
U068,2024,9,755559.0,Salary Increases & Fixed Expenses Remain Stable,256587,77618.0,88301,165919.0,90668.0,35.34,0.03,Low Risk
U068,2024,10,846227.0,Salary Increases & Fixed Expenses Remain Stable,256587,77618.0,102286,179904.0,76683.0,29.89,0.0,Low Risk
U068,2024,11,922910.0,Salary Increases & Fixed Expenses Remain Stable,256587,77618.0,101079,178697.0,77890.0,30.36,-0.02,Low Risk
U068,2024,12,1000800.0,Salary Increases & Fixed Expenses Remain Stable,256587,77618.0,102379,179997.0,76590.0,29.85,0.03,Low Risk
U069,2024,1,227240.0,Stable Salary & Stable Fixed Expenses,71915,32699.0,22979,55678.0,16237.0,22.58,0.01,Medium Risk
U069,2024,2,243477.0,Stable Salary & Stable Fixed Expenses,71915,32699.0,32712,65411.0,6504.0,9.04,-0.03,High Risk
U069,2024,3,249981.0,Stable Salary & Stable Fixed Expenses,71915,32699.0,31831,64530.0,7385.0,10.27,0.03,High Risk
U069,2024,4,257366.0,Stable Salary & Stable Fixed Expenses,71915,32699.0,30147,62846.0,9069.0,12.61,-0.04,High Risk
U069,2024,5,266435.0,Stable Salary & Stable Fixed Expenses,71915,32699.0,30391,63090.0,8825.0,12.27,-0.02,High Risk
U069,2024,6,275260.0,Stable Salary & Stable Fixed Expenses,71915,32699.0,25434,58133.0,13782.0,19.16,-0.04,Medium Risk
U069,2024,7,289042.0,Stable Salary & Stable Fixed Expenses,71915,32699.0,24947,57646.0,14269.0,19.84,-0.05,Medium Risk
U069,2024,8,303311.0,Stable Salary & Stable Fixed Expenses,71915,32699.0,35286,67985.0,3930.0,5.46,0.05,High Risk
U069,2024,9,307241.0,Stable Salary & Stable Fixed Expenses,71915,32699.0,38936,71635.0,280.0,0.39,0.0,High Risk
U069,2024,10,307521.0,Stable Salary & Stable Fixed Expenses,71915,32699.0,32199,64898.0,7017.0,9.76,0.01,High Risk
U069,2024,11,314538.0,Stable Salary & Stable Fixed Expenses,71915,32699.0,34431,67130.0,4785.0,6.65,-0.01,High Risk
U069,2024,12,319323.0,Stable Salary & Stable Fixed Expenses,71915,32699.0,40709,73408.0,-1493.0,-2.08,-0.04,High Risk
U070,2024,1,249435.0,Stable Salary & Increasing Fixed Expenses,200423,91118.0,42609,133727.0,66696.0,33.28,-0.03,Low Risk
U070,2024,2,316131.0,Stable Salary & Increasing Fixed Expenses,200423,91118.0,55374,146492.0,53931.0,26.91,-0.03,Low Risk
U070,2024,3,370062.0,Stable Salary & Increasing Fixed Expenses,200423,91118.0,53082,144200.0,56223.0,28.05,-0.05,Low Risk
U070,2024,4,426285.0,Stable Salary & Increasing Fixed Expenses,200423,91118.0,44475,135593.0,64830.0,32.35,-0.03,Low Risk
U070,2024,5,491115.0,Stable Salary & Increasing Fixed Expenses,200423,91118.0,45495,136613.0,63810.0,31.84,-0.0,Low Risk
U070,2024,6,554925.0,Stable Salary & Increasing Fixed Expenses,200423,91118.0,52194,143312.0,57111.0,28.5,0.02,Low Risk
U070,2024,7,612036.0,Stable Salary & Increasing Fixed Expenses,200423,91118.0,59228,150346.0,50077.0,24.99,-0.01,Medium Risk
U070,2024,8,662113.0,Stable Salary & Increasing Fixed Expenses,200423,91118.0,54780,145898.0,54525.0,27.2,-0.01,Low Risk
U070,2024,9,716638.0,Stable Salary & Increasing Fixed Expenses,200423,91118.0,51359,142477.0,57946.0,28.91,-0.01,Low Risk
U070,2024,10,774584.0,Stable Salary & Increasing Fixed Expenses,200423,91118.0,60584,151702.0,48721.0,24.31,0.02,Medium Risk
U070,2024,11,823305.0,Stable Salary & Increasing Fixed Expenses,200423,91911.0,53101,145012.0,55411.0,27.65,-0.0,Low Risk
U070,2024,12,878716.0,Stable Salary & Increasing Fixed Expenses,200423,91911.0,58499,150410.0,50013.0,24.95,0.04,Medium Risk
U071,2024,1,204068.0,Salary Increases & Fixed Expenses Increase,82482,33342.0,25704,59046.0,23436.0,28.41,-0.0,Low Risk
U071,2024,2,227504.0,Salary Increases & Fixed Expenses Increase,82482,33342.0,39985,73327.0,9155.0,11.1,-0.0,High Risk
U071,2024,3,236659.0,Salary Increases & Fixed Expenses Increase,82482,33342.0,25435,58777.0,23705.0,28.74,0.05,Low Risk
U071,2024,4,260364.0,Salary Increases & Fixed Expenses Increase,82482,33342.0,36878,70220.0,12262.0,14.87,-0.01,High Risk
U071,2024,5,272626.0,Salary Increases & Fixed Expenses Increase,103267,33342.0,50641,83983.0,19284.0,18.67,-0.04,Medium Risk
U071,2024,6,291910.0,Salary Increases & Fixed Expenses Increase,103267,34785.0,43465,78250.0,25017.0,24.23,-0.03,Medium Risk
U071,2024,7,316927.0,Salary Increases & Fixed Expenses Increase,103267,34785.0,51516,86301.0,16966.0,16.43,-0.04,Medium Risk
U071,2024,8,333893.0,Salary Increases & Fixed Expenses Increase,103267,34785.0,43394,78179.0,25088.0,24.29,0.03,Medium Risk
U071,2024,9,358981.0,Salary Increases & Fixed Expenses Increase,103267,36152.0,51360,87512.0,15755.0,15.26,0.03,Medium Risk
U071,2024,10,374736.0,Salary Increases & Fixed Expenses Increase,103267,36152.0,38598,74750.0,28517.0,27.61,0.05,Low Risk
U071,2024,11,403253.0,Salary Increases & Fixed Expenses Increase,103267,36152.0,31413,67565.0,35702.0,34.57,0.03,Low Risk
U071,2024,12,438955.0,Salary Increases & Fixed Expenses Increase,103267,36152.0,42933,79085.0,24182.0,23.42,-0.04,Medium Risk
U072,2024,1,186171.0,Stable Salary & Increasing Fixed Expenses,29923,20000.0,9508,29508.0,415.0,1.39,-0.02,High Risk
U072,2024,2,186586.0,Stable Salary & Increasing Fixed Expenses,29923,20000.0,10388,30388.0,-465.0,-1.55,-0.02,High Risk
U072,2024,3,186121.0,Stable Salary & Increasing Fixed Expenses,29923,20000.0,11101,31101.0,-1178.0,-3.94,-0.0,High Risk
U072,2024,4,184943.0,Stable Salary & Increasing Fixed Expenses,29923,20000.0,10656,30656.0,-733.0,-2.45,0.03,High Risk
U072,2024,5,184210.0,Stable Salary & Increasing Fixed Expenses,29923,20617.0,13112,33729.0,-3806.0,-12.72,0.01,High Risk
U072,2024,6,180404.0,Stable Salary & Increasing Fixed Expenses,29923,20617.0,9756,30373.0,-450.0,-1.5,0.05,High Risk
U072,2024,7,179954.0,Stable Salary & Increasing Fixed Expenses,29923,22500.0,12613,35113.0,-5190.0,-17.34,0.03,High Risk
U072,2024,8,174764.0,Stable Salary & Increasing Fixed Expenses,29923,22500.0,12143,34643.0,-4720.0,-15.77,0.03,High Risk
U072,2024,9,170044.0,Stable Salary & Increasing Fixed Expenses,29923,22500.0,14474,36974.0,-7051.0,-23.56,0.02,High Risk
U072,2024,10,162993.0,Stable Salary & Increasing Fixed Expenses,29923,22500.0,13920,36420.0,-6497.0,-21.71,0.03,High Risk
U072,2024,11,156496.0,Stable Salary & Increasing Fixed Expenses,29923,22500.0,10650,33150.0,-3227.0,-10.78,0.01,High Risk
U072,2024,12,153269.0,Stable Salary & Increasing Fixed Expenses,29923,22500.0,13067,35567.0,-5644.0,-18.86,-0.03,High Risk
U073,2024,1,248254.0,Salary Increases & Fixed Expenses Remain Stable,195931,50314.0,55138,105452.0,90479.0,46.18,0.02,Low Risk
U073,2024,2,338733.0,Salary Increases & Fixed Expenses Remain Stable,195931,50314.0,51868,102182.0,93749.0,47.85,-0.05,Low Risk
U073,2024,3,432482.0,Salary Increases & Fixed Expenses Remain Stable,195931,50314.0,54585,104899.0,91032.0,46.46,-0.04,Low Risk
U073,2024,4,523514.0,Salary Increases & Fixed Expenses Remain Stable,195931,50314.0,53781,104095.0,91836.0,46.87,-0.03,Low Risk
U073,2024,5,615350.0,Salary Increases & Fixed Expenses Remain Stable,195931,50314.0,46310,96624.0,99307.0,50.68,-0.0,Low Risk
U073,2024,6,714657.0,Salary Increases & Fixed Expenses Remain Stable,195931,50314.0,44885,95199.0,100732.0,51.41,-0.04,Low Risk
U073,2024,7,815389.0,Salary Increases & Fixed Expenses Remain Stable,195931,50314.0,45678,95992.0,99939.0,51.01,-0.03,Low Risk
U073,2024,8,915328.0,Salary Increases & Fixed Expenses Remain Stable,221812,50314.0,61179,111493.0,110319.0,49.74,-0.0,Low Risk
U073,2024,9,1025647.0,Salary Increases & Fixed Expenses Remain Stable,221812,50314.0,71169,121483.0,100329.0,45.23,-0.01,Low Risk
U073,2024,10,1125976.0,Salary Increases & Fixed Expenses Remain Stable,221812,50314.0,54105,104419.0,117393.0,52.92,0.02,Low Risk
U073,2024,11,1243369.0,Salary Increases & Fixed Expenses Remain Stable,221812,50314.0,59979,110293.0,111519.0,50.28,0.02,Low Risk
U073,2024,12,1354888.0,Salary Increases & Fixed Expenses Remain Stable,221812,50314.0,61273,111587.0,110225.0,49.69,-0.03,Low Risk
U074,2024,1,250000.0,Stable Salary & Stable Fixed Expenses,291251,106015.0,94632,200647.0,90604.0,31.11,0.03,Low Risk
U074,2024,2,340604.0,Stable Salary & Stable Fixed Expenses,291251,106015.0,138865,244880.0,46371.0,15.92,0.05,Medium Risk
U074,2024,3,386975.0,Stable Salary & Stable Fixed Expenses,291251,106015.0,97683,203698.0,87553.0,30.06,-0.03,Low Risk
U074,2024,4,474528.0,Stable Salary & Stable Fixed Expenses,291251,106015.0,120134,226149.0,65102.0,22.35,-0.04,Medium Risk
U074,2024,5,539630.0,Stable Salary & Stable Fixed Expenses,291251,106015.0,125182,231197.0,60054.0,20.62,0.02,Medium Risk
U074,2024,6,599684.0,Stable Salary & Stable Fixed Expenses,291251,106015.0,107444,213459.0,77792.0,26.71,0.04,Low Risk
U074,2024,7,677476.0,Stable Salary & Stable Fixed Expenses,291251,106015.0,88256,194271.0,96980.0,33.3,0.03,Low Risk
U074,2024,8,774456.0,Stable Salary & Stable Fixed Expenses,291251,106015.0,140462,246477.0,44774.0,15.37,0.04,Medium Risk
U074,2024,9,819230.0,Stable Salary & Stable Fixed Expenses,291251,106015.0,120615,226630.0,64621.0,22.19,-0.01,Medium Risk
U074,2024,10,883851.0,Stable Salary & Stable Fixed Expenses,291251,106015.0,103362,209377.0,81874.0,28.11,0.01,Low Risk
U074,2024,11,965725.0,Stable Salary & Stable Fixed Expenses,291251,106015.0,131095,237110.0,54141.0,18.59,0.02,Medium Risk
U074,2024,12,1019866.0,Stable Salary & Stable Fixed Expenses,291251,106015.0,94413,200428.0,90823.0,31.18,-0.05,Low Risk
U075,2024,1,123995.0,Stable Salary & Increasing Fixed Expenses,115959,71261.0,55763,127024.0,-11065.0,-9.54,-0.04,High Risk
U075,2024,2,112930.0,Stable Salary & Increasing Fixed Expenses,115959,71261.0,53786,125047.0,-9088.0,-7.84,0.04,High Risk
U075,2024,3,103842.0,Stable Salary & Increasing Fixed Expenses,115959,71261.0,55502,126763.0,-10804.0,-9.32,0.01,High Risk
U075,2024,4,93038.0,Stable Salary & Increasing Fixed Expenses,115959,72657.0,49265,121922.0,-5963.0,-5.14,0.03,High Risk
U075,2024,5,87075.0,Stable Salary & Increasing Fixed Expenses,115959,72657.0,35731,108388.0,7571.0,6.53,-0.04,High Risk
U075,2024,6,94646.0,Stable Salary & Increasing Fixed Expenses,115959,72657.0,45284,117941.0,-1982.0,-1.71,0.01,High Risk
U075,2024,7,92664.0,Stable Salary & Increasing Fixed Expenses,115959,72657.0,36514,109171.0,6788.0,5.85,-0.03,High Risk
U075,2024,8,99452.0,Stable Salary & Increasing Fixed Expenses,115959,72657.0,51195,123852.0,-7893.0,-6.81,0.01,High Risk
U075,2024,9,91559.0,Stable Salary & Increasing Fixed Expenses,115959,72657.0,61887,134544.0,-18585.0,-16.03,-0.0,High Risk
U075,2024,10,72974.0,Stable Salary & Increasing Fixed Expenses,115959,72657.0,46900,119557.0,-3598.0,-3.1,-0.04,High Risk
U075,2024,11,69376.0,Stable Salary & Increasing Fixed Expenses,115959,72657.0,59850,132507.0,-16548.0,-14.27,0.01,High Risk
U075,2024,12,52828.0,Stable Salary & Increasing Fixed Expenses,115959,72657.0,36909,109566.0,6393.0,5.51,0.02,High Risk
U076,2024,1,250000.0,Salary Increases & Fixed Expenses Decrease,287080,79819.0,196964,276783.0,10297.0,3.59,-0.03,High Risk
U076,2024,2,260297.0,Salary Increases & Fixed Expenses Decrease,287080,79819.0,200819,280638.0,6442.0,2.24,-0.01,High Risk
U076,2024,3,266739.0,Salary Increases & Fixed Expenses Decrease,287080,79819.0,214526,294345.0,-7265.0,-2.53,0.05,High Risk
U076,2024,4,259474.0,Salary Increases & Fixed Expenses Decrease,287080,79819.0,183784,263603.0,23477.0,8.18,0.05,High Risk
U076,2024,5,282951.0,Salary Increases & Fixed Expenses Decrease,299637,79819.0,193225,273044.0,26593.0,8.88,0.03,High Risk
U076,2024,6,309544.0,Salary Increases & Fixed Expenses Decrease,299637,79819.0,157940,237759.0,61878.0,20.65,-0.04,Medium Risk
U076,2024,7,371422.0,Salary Increases & Fixed Expenses Decrease,299637,79819.0,159299,239118.0,60519.0,20.2,-0.01,Medium Risk
U076,2024,8,431941.0,Salary Increases & Fixed Expenses Decrease,299637,79819.0,156382,236201.0,63436.0,21.17,0.03,Medium Risk
U076,2024,9,495377.0,Salary Increases & Fixed Expenses Decrease,299637,79819.0,219383,299202.0,435.0,0.15,0.01,High Risk
U076,2024,10,495812.0,Salary Increases & Fixed Expenses Decrease,299637,79819.0,184603,264422.0,35215.0,11.75,-0.04,High Risk
U076,2024,11,531027.0,Salary Increases & Fixed Expenses Decrease,299637,79819.0,167366,247185.0,52452.0,17.51,-0.02,Medium Risk
U076,2024,12,583479.0,Salary Increases & Fixed Expenses Decrease,299637,79819.0,200057,279876.0,19761.0,6.59,0.0,High Risk
U077,2024,1,249845.0,Stable Salary & Increasing Fixed Expenses,222017,68849.0,56096,124945.0,97072.0,43.72,-0.05,Low Risk
U077,2024,2,346917.0,Stable Salary & Increasing Fixed Expenses,222017,68849.0,58545,127394.0,94623.0,42.62,0.05,Low Risk
U077,2024,3,441540.0,Stable Salary & Increasing Fixed Expenses,222017,68849.0,75511,144360.0,77657.0,34.98,0.0,Low Risk
U077,2024,4,519197.0,Stable Salary & Increasing Fixed Expenses,222017,68849.0,54792,123641.0,98376.0,44.31,-0.01,Low Risk
U077,2024,5,617573.0,Stable Salary & Increasing Fixed Expenses,222017,68849.0,48547,117396.0,104621.0,47.12,-0.04,Low Risk
U077,2024,6,722194.0,Stable Salary & Increasing Fixed Expenses,222017,68849.0,48123,116972.0,105045.0,47.31,-0.04,Low Risk
U077,2024,7,827239.0,Stable Salary & Increasing Fixed Expenses,222017,68849.0,66556,135405.0,86612.0,39.01,-0.05,Low Risk
U077,2024,8,913851.0,Stable Salary & Increasing Fixed Expenses,222017,68849.0,66398,135247.0,86770.0,39.08,-0.0,Low Risk
U077,2024,9,1000621.0,Stable Salary & Increasing Fixed Expenses,222017,70537.0,65711,136248.0,85769.0,38.63,0.02,Low Risk
U077,2024,10,1086390.0,Stable Salary & Increasing Fixed Expenses,222017,71824.0,70021,141845.0,80172.0,36.11,0.02,Low Risk
U077,2024,11,1166562.0,Stable Salary & Increasing Fixed Expenses,222017,71824.0,68828,140652.0,81365.0,36.65,-0.04,Low Risk
U077,2024,12,1247927.0,Stable Salary & Increasing Fixed Expenses,222017,71824.0,61001,132825.0,89192.0,40.17,0.0,Low Risk
U078,2024,1,143045.0,Salary Increases & Fixed Expenses Increase,118103,66774.0,53994,120768.0,-2665.0,-2.26,-0.05,High Risk
U078,2024,2,140380.0,Salary Increases & Fixed Expenses Increase,118103,66774.0,37876,104650.0,13453.0,11.39,-0.01,High Risk
U078,2024,3,153833.0,Salary Increases & Fixed Expenses Increase,118103,66774.0,56059,122833.0,-4730.0,-4.0,-0.02,High Risk
U078,2024,4,149103.0,Salary Increases & Fixed Expenses Increase,118103,67466.0,38095,105561.0,12542.0,10.62,0.05,High Risk
U078,2024,5,161645.0,Salary Increases & Fixed Expenses Increase,118103,67466.0,55725,123191.0,-5088.0,-4.31,0.04,High Risk
U078,2024,6,156557.0,Salary Increases & Fixed Expenses Increase,125367,69108.0,57341,126449.0,-1082.0,-0.86,-0.0,High Risk
U078,2024,7,155475.0,Salary Increases & Fixed Expenses Increase,125367,69108.0,62213,131321.0,-5954.0,-4.75,-0.04,High Risk
U078,2024,8,149521.0,Salary Increases & Fixed Expenses Increase,125367,69108.0,41787,110895.0,14472.0,11.54,0.01,High Risk
U078,2024,9,163993.0,Salary Increases & Fixed Expenses Increase,125367,69108.0,44830,113938.0,11429.0,9.12,0.02,High Risk
U078,2024,10,175422.0,Salary Increases & Fixed Expenses Increase,125367,70574.0,49411,119985.0,5382.0,4.29,-0.0,High Risk
U078,2024,11,180804.0,Salary Increases & Fixed Expenses Increase,125367,70574.0,59525,130099.0,-4732.0,-3.77,0.02,High Risk
U078,2024,12,176072.0,Salary Increases & Fixed Expenses Increase,125367,70574.0,54133,124707.0,660.0,0.53,-0.02,High Risk
U079,2024,1,129675.0,Stable Salary & Increasing Fixed Expenses,106290,76728.0,42050,118778.0,-12488.0,-11.75,0.02,High Risk
U079,2024,2,117187.0,Stable Salary & Increasing Fixed Expenses,106290,76728.0,43934,120662.0,-14372.0,-13.52,0.01,High Risk
U079,2024,3,102815.0,Stable Salary & Increasing Fixed Expenses,106290,76728.0,38505,115233.0,-8943.0,-8.41,0.04,High Risk
U079,2024,4,93872.0,Stable Salary & Increasing Fixed Expenses,106290,78467.0,32450,110917.0,-4627.0,-4.35,0.01,High Risk
U079,2024,5,89245.0,Stable Salary & Increasing Fixed Expenses,106290,78467.0,43891,122358.0,-16068.0,-15.12,-0.01,High Risk
U079,2024,6,73177.0,Stable Salary & Increasing Fixed Expenses,106290,79635.0,35442,115077.0,-8787.0,-8.27,-0.05,High Risk
U079,2024,7,64390.0,Stable Salary & Increasing Fixed Expenses,106290,79635.0,33602,113237.0,-6947.0,-6.54,-0.03,High Risk
U079,2024,8,57443.0,Stable Salary & Increasing Fixed Expenses,106290,81026.0,38436,119462.0,-13172.0,-12.39,0.01,High Risk
U079,2024,9,44271.0,Stable Salary & Increasing Fixed Expenses,106290,81026.0,50027,131053.0,-24763.0,-23.3,0.01,High Risk
U079,2024,10,19508.0,Stable Salary & Increasing Fixed Expenses,106290,81026.0,50916,131942.0,-25652.0,-24.13,0.01,High Risk
U079,2024,11,-6144.0,Stable Salary & Increasing Fixed Expenses,106290,81026.0,44499,125525.0,-19235.0,-18.1,0.02,High Risk
U079,2024,12,-25379.0,Stable Salary & Increasing Fixed Expenses,106290,81026.0,35378,116404.0,-10114.0,-9.52,0.01,High Risk
U080,2024,1,221979.0,Stable Salary & Increasing Fixed Expenses,212560,97233.0,110768,208001.0,4559.0,2.14,-0.04,High Risk
U080,2024,2,226538.0,Stable Salary & Increasing Fixed Expenses,212560,97233.0,133345,230578.0,-18018.0,-8.48,0.02,High Risk
U080,2024,3,208520.0,Stable Salary & Increasing Fixed Expenses,212560,97233.0,136801,234034.0,-21474.0,-10.1,-0.01,High Risk
U080,2024,4,187046.0,Stable Salary & Increasing Fixed Expenses,212560,97233.0,136544,233777.0,-21217.0,-9.98,0.05,High Risk
U080,2024,5,165829.0,Stable Salary & Increasing Fixed Expenses,212560,97233.0,133192,230425.0,-17865.0,-8.4,-0.0,High Risk
U080,2024,6,147964.0,Stable Salary & Increasing Fixed Expenses,212560,97233.0,115663,212896.0,-336.0,-0.16,-0.04,High Risk
U080,2024,7,147628.0,Stable Salary & Increasing Fixed Expenses,212560,97233.0,139594,236827.0,-24267.0,-11.42,-0.02,High Risk
U080,2024,8,123361.0,Stable Salary & Increasing Fixed Expenses,212560,97233.0,111551,208784.0,3776.0,1.78,-0.03,High Risk
U080,2024,9,127137.0,Stable Salary & Increasing Fixed Expenses,212560,97233.0,122297,219530.0,-6970.0,-3.28,-0.02,High Risk
U080,2024,10,120167.0,Stable Salary & Increasing Fixed Expenses,212560,97233.0,169769,267002.0,-54442.0,-25.61,-0.03,High Risk
U080,2024,11,65725.0,Stable Salary & Increasing Fixed Expenses,212560,97233.0,140867,238100.0,-25540.0,-12.02,-0.01,High Risk
U080,2024,12,40185.0,Stable Salary & Increasing Fixed Expenses,212560,97233.0,153956,251189.0,-38629.0,-18.17,-0.04,High Risk
U081,2024,1,233025.0,Stable Salary & Stable Fixed Expenses,230283,109781.0,64029,173810.0,56473.0,24.52,-0.03,Medium Risk
U081,2024,2,289498.0,Stable Salary & Stable Fixed Expenses,230283,109781.0,48583,158364.0,71919.0,31.23,-0.04,Low Risk
U081,2024,3,361417.0,Stable Salary & Stable Fixed Expenses,230283,109781.0,64170,173951.0,56332.0,24.46,0.05,Medium Risk
U081,2024,4,417749.0,Stable Salary & Stable Fixed Expenses,230283,109781.0,60537,170318.0,59965.0,26.04,-0.02,Low Risk
U081,2024,5,477714.0,Stable Salary & Stable Fixed Expenses,230283,109781.0,53946,163727.0,66556.0,28.9,0.03,Low Risk
U081,2024,6,544270.0,Stable Salary & Stable Fixed Expenses,230283,109781.0,63846,173627.0,56656.0,24.6,-0.02,Medium Risk
U081,2024,7,600926.0,Stable Salary & Stable Fixed Expenses,230283,109781.0,51813,161594.0,68689.0,29.83,0.02,Low Risk
U081,2024,8,669615.0,Stable Salary & Stable Fixed Expenses,230283,109781.0,57164,166945.0,63338.0,27.5,0.01,Low Risk
U081,2024,9,732953.0,Stable Salary & Stable Fixed Expenses,230283,109781.0,47935,157716.0,72567.0,31.51,-0.03,Low Risk
U081,2024,10,805520.0,Stable Salary & Stable Fixed Expenses,230283,109781.0,68298,178079.0,52204.0,22.67,0.04,Medium Risk
U081,2024,11,857724.0,Stable Salary & Stable Fixed Expenses,230283,109781.0,51825,161606.0,68677.0,29.82,0.04,Low Risk
U081,2024,12,926401.0,Stable Salary & Stable Fixed Expenses,230283,109781.0,54870,164651.0,65632.0,28.5,-0.04,Low Risk
U082,2024,1,155303.0,Salary Increases & Fixed Expenses Remain Stable,74459,38014.0,28865,66879.0,7580.0,10.18,0.01,High Risk
U082,2024,2,162883.0,Salary Increases & Fixed Expenses Remain Stable,74459,38014.0,36023,74037.0,422.0,0.57,0.02,High Risk
U082,2024,3,163305.0,Salary Increases & Fixed Expenses Remain Stable,74459,38014.0,38939,76953.0,-2494.0,-3.35,-0.01,High Risk
U082,2024,4,160811.0,Salary Increases & Fixed Expenses Remain Stable,74459,38014.0,28058,66072.0,8387.0,11.26,-0.0,High Risk
U082,2024,5,169198.0,Salary Increases & Fixed Expenses Remain Stable,84440,38014.0,25733,63747.0,20693.0,24.51,0.04,Medium Risk
U082,2024,6,189891.0,Salary Increases & Fixed Expenses Remain Stable,84440,38014.0,40178,78192.0,6248.0,7.4,-0.04,High Risk
U082,2024,7,196139.0,Salary Increases & Fixed Expenses Remain Stable,84440,38014.0,40014,78028.0,6412.0,7.59,0.05,High Risk
U082,2024,8,202551.0,Salary Increases & Fixed Expenses Remain Stable,84440,38014.0,39023,77037.0,7403.0,8.77,0.02,High Risk
U082,2024,9,209954.0,Salary Increases & Fixed Expenses Remain Stable,84440,38014.0,33640,71654.0,12786.0,15.14,0.0,Medium Risk
U082,2024,10,222740.0,Salary Increases & Fixed Expenses Remain Stable,84440,38014.0,52544,90558.0,-6118.0,-7.25,0.02,High Risk
U082,2024,11,216622.0,Salary Increases & Fixed Expenses Remain Stable,84440,38014.0,45650,83664.0,776.0,0.92,-0.03,High Risk
U082,2024,12,217398.0,Salary Increases & Fixed Expenses Remain Stable,84440,38014.0,49667,87681.0,-3241.0,-3.84,-0.04,High Risk
U083,2024,1,231936.0,Stable Salary & Stable Fixed Expenses,210759,72041.0,93581,165622.0,45137.0,21.42,-0.05,Medium Risk
U083,2024,2,277073.0,Stable Salary & Stable Fixed Expenses,210759,72041.0,99514,171555.0,39204.0,18.6,0.01,Medium Risk
U083,2024,3,316277.0,Stable Salary & Stable Fixed Expenses,210759,72041.0,94993,167034.0,43725.0,20.75,-0.01,Medium Risk
U083,2024,4,360002.0,Stable Salary & Stable Fixed Expenses,210759,72041.0,65654,137695.0,73064.0,34.67,-0.04,Low Risk
U083,2024,5,433066.0,Stable Salary & Stable Fixed Expenses,210759,72041.0,99270,171311.0,39448.0,18.72,0.04,Medium Risk
U083,2024,6,472514.0,Stable Salary & Stable Fixed Expenses,210759,72041.0,68847,140888.0,69871.0,33.15,-0.03,Low Risk
U083,2024,7,542385.0,Stable Salary & Stable Fixed Expenses,210759,72041.0,99135,171176.0,39583.0,18.78,-0.04,Medium Risk
U083,2024,8,581968.0,Stable Salary & Stable Fixed Expenses,210759,72041.0,64742,136783.0,73976.0,35.1,-0.01,Low Risk
U083,2024,9,655944.0,Stable Salary & Stable Fixed Expenses,210759,72041.0,69039,141080.0,69679.0,33.06,-0.03,Low Risk
U083,2024,10,725623.0,Stable Salary & Stable Fixed Expenses,210759,72041.0,67636,139677.0,71082.0,33.73,0.02,Low Risk
U083,2024,11,796705.0,Stable Salary & Stable Fixed Expenses,210759,72041.0,101265,173306.0,37453.0,17.77,0.05,Medium Risk
U083,2024,12,834158.0,Stable Salary & Stable Fixed Expenses,210759,72041.0,96720,168761.0,41998.0,19.93,-0.01,Medium Risk
U084,2024,1,250000.0,Salary Increases & Fixed Expenses Remain Stable,250361,112176.0,88049,200225.0,50136.0,20.03,0.03,Medium Risk
U084,2024,2,300136.0,Salary Increases & Fixed Expenses Remain Stable,250361,112176.0,122178,234354.0,16007.0,6.39,0.03,High Risk
U084,2024,3,316143.0,Salary Increases & Fixed Expenses Remain Stable,264499,112176.0,93923,206099.0,58400.0,22.08,0.01,Medium Risk
U084,2024,4,374543.0,Salary Increases & Fixed Expenses Remain Stable,264499,112176.0,104553,216729.0,47770.0,18.06,-0.04,Medium Risk
U084,2024,5,422313.0,Salary Increases & Fixed Expenses Remain Stable,264499,112176.0,121235,233411.0,31088.0,11.75,-0.03,High Risk
U084,2024,6,453401.0,Salary Increases & Fixed Expenses Remain Stable,264499,112176.0,128439,240615.0,23884.0,9.03,0.02,High Risk
U084,2024,7,477285.0,Salary Increases & Fixed Expenses Remain Stable,264499,112176.0,80095,192271.0,72228.0,27.31,0.01,Low Risk
U084,2024,8,549513.0,Salary Increases & Fixed Expenses Remain Stable,264499,112176.0,119552,231728.0,32771.0,12.39,0.03,High Risk
U084,2024,9,582284.0,Salary Increases & Fixed Expenses Remain Stable,264499,112176.0,87802,199978.0,64521.0,24.39,-0.01,Medium Risk
U084,2024,10,646805.0,Salary Increases & Fixed Expenses Remain Stable,264499,112176.0,122582,234758.0,29741.0,11.24,0.02,High Risk
U084,2024,11,676546.0,Salary Increases & Fixed Expenses Remain Stable,264499,112176.0,129044,241220.0,23279.0,8.8,0.01,High Risk
U084,2024,12,699825.0,Salary Increases & Fixed Expenses Remain Stable,264499,112176.0,120100,232276.0,32223.0,12.18,0.0,High Risk
U085,2024,1,174751.0,Salary Increases & Fixed Expenses Remain Stable,98433,37933.0,21194,59127.0,39306.0,39.93,0.0,Low Risk
U085,2024,2,214057.0,Salary Increases & Fixed Expenses Remain Stable,98433,37933.0,29107,67040.0,31393.0,31.89,-0.0,Low Risk
U085,2024,3,245450.0,Salary Increases & Fixed Expenses Remain Stable,98433,37933.0,23282,61215.0,37218.0,37.81,-0.01,Low Risk
U085,2024,4,282668.0,Salary Increases & Fixed Expenses Remain Stable,98433,37933.0,22269,60202.0,38231.0,38.84,-0.04,Low Risk
U085,2024,5,320899.0,Salary Increases & Fixed Expenses Remain Stable,98433,37933.0,20248,58181.0,40252.0,40.89,0.02,Low Risk
U085,2024,6,361151.0,Salary Increases & Fixed Expenses Remain Stable,98433,37933.0,21894,59827.0,38606.0,39.22,-0.02,Low Risk
U085,2024,7,399757.0,Salary Increases & Fixed Expenses Remain Stable,98433,37933.0,19959,57892.0,40541.0,41.19,0.04,Low Risk
U085,2024,8,440298.0,Salary Increases & Fixed Expenses Remain Stable,115629,37933.0,26251,64184.0,51445.0,44.49,-0.03,Low Risk
U085,2024,9,491743.0,Salary Increases & Fixed Expenses Remain Stable,115629,37933.0,28822,66755.0,48874.0,42.27,-0.01,Low Risk
U085,2024,10,540617.0,Salary Increases & Fixed Expenses Remain Stable,115629,37933.0,29045,66978.0,48651.0,42.08,0.03,Low Risk
U085,2024,11,589268.0,Salary Increases & Fixed Expenses Remain Stable,115629,37933.0,29085,67018.0,48611.0,42.04,-0.05,Low Risk
U085,2024,12,637879.0,Salary Increases & Fixed Expenses Remain Stable,115629,37933.0,23606,61539.0,54090.0,46.78,-0.01,Low Risk
U086,2024,1,241549.0,Stable Salary & Stable Fixed Expenses,100414,50659.0,26955,77614.0,22800.0,22.71,-0.02,Medium Risk
U086,2024,2,264349.0,Stable Salary & Stable Fixed Expenses,100414,50659.0,25812,76471.0,23943.0,23.84,-0.02,Medium Risk
U086,2024,3,288292.0,Stable Salary & Stable Fixed Expenses,100414,50659.0,21590,72249.0,28165.0,28.05,-0.02,Low Risk
U086,2024,4,316457.0,Stable Salary & Stable Fixed Expenses,100414,50659.0,20657,71316.0,29098.0,28.98,-0.01,Low Risk
U086,2024,5,345555.0,Stable Salary & Stable Fixed Expenses,100414,50659.0,24459,75118.0,25296.0,25.19,0.01,Low Risk
U086,2024,6,370851.0,Stable Salary & Stable Fixed Expenses,100414,50659.0,24113,74772.0,25642.0,25.54,-0.03,Low Risk
U086,2024,7,396493.0,Stable Salary & Stable Fixed Expenses,100414,50659.0,29020,79679.0,20735.0,20.65,0.01,Medium Risk
U086,2024,8,417228.0,Stable Salary & Stable Fixed Expenses,100414,50659.0,21975,72634.0,27780.0,27.67,0.04,Low Risk
U086,2024,9,445008.0,Stable Salary & Stable Fixed Expenses,100414,50659.0,29460,80119.0,20295.0,20.21,0.02,Medium Risk
U086,2024,10,465303.0,Stable Salary & Stable Fixed Expenses,100414,50659.0,27961,78620.0,21794.0,21.7,0.05,Medium Risk
U086,2024,11,487097.0,Stable Salary & Stable Fixed Expenses,100414,50659.0,31750,82409.0,18005.0,17.93,-0.02,Medium Risk
U086,2024,12,505102.0,Stable Salary & Stable Fixed Expenses,100414,50659.0,23943,74602.0,25812.0,25.71,0.03,Low Risk
U087,2024,1,224299.0,Stable Salary & Stable Fixed Expenses,214021,107058.0,140988,248046.0,-34025.0,-15.9,-0.03,High Risk
U087,2024,2,190274.0,Stable Salary & Stable Fixed Expenses,214021,107058.0,132606,239664.0,-25643.0,-11.98,0.02,High Risk
U087,2024,3,164631.0,Stable Salary & Stable Fixed Expenses,214021,107058.0,129291,236349.0,-22328.0,-10.43,-0.04,High Risk
U087,2024,4,142303.0,Stable Salary & Stable Fixed Expenses,214021,107058.0,143609,250667.0,-36646.0,-17.12,0.03,High Risk
U087,2024,5,105657.0,Stable Salary & Stable Fixed Expenses,214021,107058.0,114308,221366.0,-7345.0,-3.43,-0.01,High Risk
U087,2024,6,98312.0,Stable Salary & Stable Fixed Expenses,214021,107058.0,107117,214175.0,-154.0,-0.07,-0.04,High Risk
U087,2024,7,98158.0,Stable Salary & Stable Fixed Expenses,214021,107058.0,125744,232802.0,-18781.0,-8.78,-0.03,High Risk
U087,2024,8,79377.0,Stable Salary & Stable Fixed Expenses,214021,107058.0,118357,225415.0,-11394.0,-5.32,-0.01,High Risk
U087,2024,9,67983.0,Stable Salary & Stable Fixed Expenses,214021,107058.0,149780,256838.0,-42817.0,-20.01,0.05,High Risk
U087,2024,10,25166.0,Stable Salary & Stable Fixed Expenses,214021,107058.0,121119,228177.0,-14156.0,-6.61,0.04,High Risk
U087,2024,11,11010.0,Stable Salary & Stable Fixed Expenses,214021,107058.0,139528,246586.0,-32565.0,-15.22,0.03,High Risk
U087,2024,12,-21555.0,Stable Salary & Stable Fixed Expenses,214021,107058.0,118514,225572.0,-11551.0,-5.4,-0.02,High Risk
U088,2024,1,222947.0,Stable Salary & Increasing Fixed Expenses,201643,64083.0,66662,130745.0,70898.0,35.16,0.03,Low Risk
U088,2024,2,293845.0,Stable Salary & Increasing Fixed Expenses,201643,64083.0,86345,150428.0,51215.0,25.4,-0.04,Low Risk
U088,2024,3,345060.0,Stable Salary & Increasing Fixed Expenses,201643,64083.0,94928,159011.0,42632.0,21.14,0.04,Medium Risk
U088,2024,4,387692.0,Stable Salary & Increasing Fixed Expenses,201643,64083.0,82733,146816.0,54827.0,27.19,-0.03,Low Risk
U088,2024,5,442519.0,Stable Salary & Increasing Fixed Expenses,201643,64083.0,80742,144825.0,56818.0,28.18,-0.04,Low Risk
U088,2024,6,499337.0,Stable Salary & Increasing Fixed Expenses,201643,64083.0,76166,140249.0,61394.0,30.45,-0.02,Low Risk
U088,2024,7,560731.0,Stable Salary & Increasing Fixed Expenses,201643,64083.0,70239,134322.0,67321.0,33.39,0.01,Low Risk
U088,2024,8,628052.0,Stable Salary & Increasing Fixed Expenses,201643,64083.0,82922,147005.0,54638.0,27.1,-0.04,Low Risk
U088,2024,9,682690.0,Stable Salary & Increasing Fixed Expenses,201643,64083.0,100488,164571.0,37072.0,18.38,0.04,Medium Risk
U088,2024,10,719762.0,Stable Salary & Increasing Fixed Expenses,201643,64083.0,123861,187944.0,13699.0,6.79,-0.0,High Risk
U088,2024,11,733461.0,Stable Salary & Increasing Fixed Expenses,201643,64083.0,105049,169132.0,32511.0,16.12,0.05,Medium Risk
U088,2024,12,765972.0,Stable Salary & Increasing Fixed Expenses,201643,64083.0,85246,149329.0,52314.0,25.94,-0.04,Low Risk
U089,2024,1,248960.0,Stable Salary & Stable Fixed Expenses,240492,70982.0,108879,179861.0,60631.0,25.21,0.03,Low Risk
U089,2024,2,309591.0,Stable Salary & Stable Fixed Expenses,240492,70982.0,100862,171844.0,68648.0,28.54,0.01,Low Risk
U089,2024,3,378239.0,Stable Salary & Stable Fixed Expenses,240492,70982.0,145300,216282.0,24210.0,10.07,0.04,High Risk
U089,2024,4,402449.0,Stable Salary & Stable Fixed Expenses,240492,70982.0,106228,177210.0,63282.0,26.31,-0.01,Low Risk
U089,2024,5,465731.0,Stable Salary & Stable Fixed Expenses,240492,70982.0,83205,154187.0,86305.0,35.89,-0.05,Low Risk
U089,2024,6,552036.0,Stable Salary & Stable Fixed Expenses,240492,70982.0,73257,144239.0,96253.0,40.02,-0.0,Low Risk
U089,2024,7,648289.0,Stable Salary & Stable Fixed Expenses,240492,70982.0,94053,165035.0,75457.0,31.38,0.01,Low Risk
U089,2024,8,723746.0,Stable Salary & Stable Fixed Expenses,240492,70982.0,92152,163134.0,77358.0,32.17,0.05,Low Risk
U089,2024,9,801104.0,Stable Salary & Stable Fixed Expenses,240492,70982.0,108369,179351.0,61141.0,25.42,-0.01,Low Risk
U089,2024,10,862245.0,Stable Salary & Stable Fixed Expenses,240492,70982.0,103849,174831.0,65661.0,27.3,-0.01,Low Risk
U089,2024,11,927906.0,Stable Salary & Stable Fixed Expenses,240492,70982.0,122112,193094.0,47398.0,19.71,-0.01,Medium Risk
U089,2024,12,975304.0,Stable Salary & Stable Fixed Expenses,240492,70982.0,93427,164409.0,76083.0,31.64,0.0,Low Risk
U090,2024,1,206331.0,Salary Increases & Fixed Expenses Increase,92558,36580.0,33176,69756.0,22802.0,24.64,0.01,Medium Risk
U090,2024,2,229133.0,Salary Increases & Fixed Expenses Increase,92558,36580.0,44113,80693.0,11865.0,12.82,-0.04,High Risk
U090,2024,3,240998.0,Salary Increases & Fixed Expenses Increase,92558,36580.0,50346,86926.0,5632.0,6.08,0.0,High Risk
U090,2024,4,246630.0,Salary Increases & Fixed Expenses Increase,92558,36580.0,31515,68095.0,24463.0,26.43,0.04,Low Risk
U090,2024,5,271093.0,Salary Increases & Fixed Expenses Increase,92558,38214.0,40175,78389.0,14169.0,15.31,-0.01,Medium Risk
U090,2024,6,285262.0,Salary Increases & Fixed Expenses Increase,92558,39805.0,37390,77195.0,15363.0,16.6,0.04,Medium Risk
U090,2024,7,300625.0,Salary Increases & Fixed Expenses Increase,118683,40555.0,47922,88477.0,30206.0,25.45,-0.04,Low Risk
U090,2024,8,330831.0,Salary Increases & Fixed Expenses Increase,118683,40555.0,51279,91834.0,26849.0,22.62,0.01,Medium Risk
U090,2024,9,357680.0,Salary Increases & Fixed Expenses Increase,118683,40555.0,49389,89944.0,28739.0,24.21,0.0,Medium Risk
U090,2024,10,386419.0,Salary Increases & Fixed Expenses Increase,118683,40555.0,43623,84178.0,34505.0,29.07,-0.02,Low Risk
U090,2024,11,420924.0,Salary Increases & Fixed Expenses Increase,118683,40555.0,55499,96054.0,22629.0,19.07,0.01,Medium Risk
U090,2024,12,443553.0,Salary Increases & Fixed Expenses Increase,118683,40555.0,58926,99481.0,19202.0,16.18,-0.01,Medium Risk
U091,2024,1,167783.0,Stable Salary & Stable Fixed Expenses,53348,26456.0,15157,41613.0,11735.0,22.0,-0.04,Medium Risk
U091,2024,2,179518.0,Stable Salary & Stable Fixed Expenses,53348,26456.0,11655,38111.0,15237.0,28.56,0.04,Low Risk
U091,2024,3,194755.0,Stable Salary & Stable Fixed Expenses,53348,26456.0,11500,37956.0,15392.0,28.85,-0.02,Low Risk
U091,2024,4,210147.0,Stable Salary & Stable Fixed Expenses,53348,26456.0,15881,42337.0,11011.0,20.64,0.04,Medium Risk
U091,2024,5,221158.0,Stable Salary & Stable Fixed Expenses,53348,26456.0,14576,41032.0,12316.0,23.09,-0.01,Medium Risk
U091,2024,6,233474.0,Stable Salary & Stable Fixed Expenses,53348,26456.0,14015,40471.0,12877.0,24.14,0.04,Medium Risk
U091,2024,7,246351.0,Stable Salary & Stable Fixed Expenses,53348,26456.0,15519,41975.0,11373.0,21.32,0.01,Medium Risk
U091,2024,8,257724.0,Stable Salary & Stable Fixed Expenses,53348,26456.0,12301,38757.0,14591.0,27.35,0.0,Low Risk
U091,2024,9,272315.0,Stable Salary & Stable Fixed Expenses,53348,26456.0,15568,42024.0,11324.0,21.23,0.01,Medium Risk
U091,2024,10,283639.0,Stable Salary & Stable Fixed Expenses,53348,26456.0,15700,42156.0,11192.0,20.98,-0.0,Medium Risk
U091,2024,11,294831.0,Stable Salary & Stable Fixed Expenses,53348,26456.0,14643,41099.0,12249.0,22.96,-0.01,Medium Risk
U091,2024,12,307080.0,Stable Salary & Stable Fixed Expenses,53348,26456.0,15863,42319.0,11029.0,20.67,0.02,Medium Risk
U092,2024,1,244075.0,Stable Salary & Increasing Fixed Expenses,186034,46152.0,42373,88525.0,97509.0,52.41,-0.05,Low Risk
U092,2024,2,341584.0,Stable Salary & Increasing Fixed Expenses,186034,46703.0,46489,93192.0,92842.0,49.91,0.03,Low Risk
U092,2024,3,434426.0,Stable Salary & Increasing Fixed Expenses,186034,46703.0,68118,114821.0,71213.0,38.28,-0.03,Low Risk
U092,2024,4,505639.0,Stable Salary & Increasing Fixed Expenses,186034,46703.0,45828,92531.0,93503.0,50.26,0.02,Low Risk
U092,2024,5,599142.0,Stable Salary & Increasing Fixed Expenses,186034,46703.0,51470,98173.0,87861.0,47.23,-0.01,Low Risk
U092,2024,6,687003.0,Stable Salary & Increasing Fixed Expenses,186034,46703.0,48406,95109.0,90925.0,48.88,0.0,Low Risk
U092,2024,7,777928.0,Stable Salary & Increasing Fixed Expenses,186034,47598.0,40246,87844.0,98190.0,52.78,0.02,Low Risk
U092,2024,8,876118.0,Stable Salary & Increasing Fixed Expenses,186034,47598.0,37912,85510.0,100524.0,54.04,0.01,Low Risk
U092,2024,9,976642.0,Stable Salary & Increasing Fixed Expenses,186034,47598.0,50895,98493.0,87541.0,47.06,-0.0,Low Risk
U092,2024,10,1064183.0,Stable Salary & Increasing Fixed Expenses,186034,47598.0,47688,95286.0,90748.0,48.78,-0.04,Low Risk
U092,2024,11,1154931.0,Stable Salary & Increasing Fixed Expenses,186034,47598.0,45729,93327.0,92707.0,49.83,0.04,Low Risk
U092,2024,12,1247638.0,Stable Salary & Increasing Fixed Expenses,186034,47598.0,61524,109122.0,76912.0,41.34,-0.01,Low Risk
U093,2024,1,222857.0,Stable Salary & Increasing Fixed Expenses,101945,41092.0,44614,85706.0,16239.0,15.93,-0.01,Medium Risk
U093,2024,2,239096.0,Stable Salary & Increasing Fixed Expenses,101945,41092.0,46101,87193.0,14752.0,14.47,0.01,High Risk
U093,2024,3,253848.0,Stable Salary & Increasing Fixed Expenses,101945,41092.0,45534,86626.0,15319.0,15.03,-0.02,Medium Risk
U093,2024,4,269167.0,Stable Salary & Increasing Fixed Expenses,101945,41092.0,45422,86514.0,15431.0,15.14,-0.05,Medium Risk
U093,2024,5,284598.0,Stable Salary & Increasing Fixed Expenses,101945,42197.0,42306,84503.0,17442.0,17.11,0.0,Medium Risk
U093,2024,6,302040.0,Stable Salary & Increasing Fixed Expenses,101945,42197.0,37659,79856.0,22089.0,21.67,-0.01,Medium Risk
U093,2024,7,324129.0,Stable Salary & Increasing Fixed Expenses,101945,42197.0,45904,88101.0,13844.0,13.58,-0.02,High Risk
U093,2024,8,337973.0,Stable Salary & Increasing Fixed Expenses,101945,42197.0,39669,81866.0,20079.0,19.7,-0.05,Medium Risk
U093,2024,9,358052.0,Stable Salary & Increasing Fixed Expenses,101945,42197.0,38595,80792.0,21153.0,20.75,0.0,Medium Risk
U093,2024,10,379205.0,Stable Salary & Increasing Fixed Expenses,101945,42197.0,47722,89919.0,12026.0,11.8,-0.03,High Risk
U093,2024,11,391231.0,Stable Salary & Increasing Fixed Expenses,101945,42197.0,36793,78990.0,22955.0,22.52,0.05,Medium Risk
U093,2024,12,414186.0,Stable Salary & Increasing Fixed Expenses,101945,42197.0,54222,96419.0,5526.0,5.42,0.05,High Risk
U094,2024,1,250000.0,Stable Salary & Decreasing Fixed Expenses,266345,77189.0,111452,188641.0,77704.0,29.17,-0.03,Low Risk
U094,2024,2,327704.0,Stable Salary & Decreasing Fixed Expenses,266345,77189.0,90491,167680.0,98665.0,37.04,0.04,Low Risk
U094,2024,3,426369.0,Stable Salary & Decreasing Fixed Expenses,266345,77189.0,118132,195321.0,71024.0,26.67,-0.02,Low Risk
U094,2024,4,497393.0,Stable Salary & Decreasing Fixed Expenses,266345,77189.0,119079,196268.0,70077.0,26.31,0.01,Low Risk
U094,2024,5,567470.0,Stable Salary & Decreasing Fixed Expenses,266345,77189.0,113197,190386.0,75959.0,28.52,0.01,Low Risk
U094,2024,6,643429.0,Stable Salary & Decreasing Fixed Expenses,266345,77189.0,94048,171237.0,95108.0,35.71,0.0,Low Risk
U094,2024,7,738537.0,Stable Salary & Decreasing Fixed Expenses,266345,76152.0,107873,184025.0,82320.0,30.91,-0.02,Low Risk
U094,2024,8,820857.0,Stable Salary & Decreasing Fixed Expenses,266345,76152.0,104202,180354.0,85991.0,32.29,0.02,Low Risk
U094,2024,9,906848.0,Stable Salary & Decreasing Fixed Expenses,266345,76152.0,143380,219532.0,46813.0,17.58,0.03,Medium Risk
U094,2024,10,953661.0,Stable Salary & Decreasing Fixed Expenses,266345,76152.0,92516,168668.0,97677.0,36.67,0.03,Low Risk
U094,2024,11,1051338.0,Stable Salary & Decreasing Fixed Expenses,266345,76152.0,133763,209915.0,56430.0,21.19,-0.02,Medium Risk
U094,2024,12,1107768.0,Stable Salary & Decreasing Fixed Expenses,266345,76152.0,100017,176169.0,90176.0,33.86,0.02,Low Risk
U095,2024,1,239177.0,Salary Increases & Fixed Expenses Decrease,79057,36899.0,46217,83116.0,-4059.0,-5.13,-0.03,High Risk
U095,2024,2,235118.0,Salary Increases & Fixed Expenses Decrease,79057,36899.0,55312,92211.0,-13154.0,-16.64,-0.04,High Risk
U095,2024,3,221964.0,Salary Increases & Fixed Expenses Decrease,79057,36899.0,48426,85325.0,-6268.0,-7.93,-0.03,High Risk
U095,2024,4,215696.0,Salary Increases & Fixed Expenses Decrease,79057,36899.0,52571,89470.0,-10413.0,-13.17,-0.0,High Risk
U095,2024,5,205283.0,Salary Increases & Fixed Expenses Decrease,79057,36197.0,53053,89250.0,-10193.0,-12.89,0.05,High Risk
U095,2024,6,195090.0,Salary Increases & Fixed Expenses Decrease,79057,36197.0,53788,89985.0,-10928.0,-13.82,-0.03,High Risk
U095,2024,7,184162.0,Salary Increases & Fixed Expenses Decrease,96240,36197.0,64124,100321.0,-4081.0,-4.24,-0.01,High Risk
U095,2024,8,180081.0,Salary Increases & Fixed Expenses Decrease,96240,36197.0,62741,98938.0,-2698.0,-2.8,0.03,High Risk
U095,2024,9,177383.0,Salary Increases & Fixed Expenses Decrease,96240,36197.0,65336,101533.0,-5293.0,-5.5,-0.01,High Risk
U095,2024,10,172090.0,Salary Increases & Fixed Expenses Decrease,96240,36197.0,51670,87867.0,8373.0,8.7,-0.02,High Risk
U095,2024,11,180463.0,Salary Increases & Fixed Expenses Decrease,96240,35019.0,55225,90244.0,5996.0,6.23,-0.03,High Risk
U095,2024,12,186459.0,Salary Increases & Fixed Expenses Decrease,96240,35019.0,50473,85492.0,10748.0,11.17,-0.01,High Risk
U096,2024,1,220907.0,Stable Salary & Increasing Fixed Expenses,45100,22103.0,29597,51700.0,-6600.0,-14.63,0.03,High Risk
U096,2024,2,214307.0,Stable Salary & Increasing Fixed Expenses,45100,22103.0,27226,49329.0,-4229.0,-9.38,-0.01,High Risk
U096,2024,3,210078.0,Stable Salary & Increasing Fixed Expenses,45100,22103.0,35535,57638.0,-12538.0,-27.8,-0.03,High Risk
U096,2024,4,197540.0,Stable Salary & Increasing Fixed Expenses,45100,22103.0,26126,48229.0,-3129.0,-6.94,-0.01,High Risk
U096,2024,5,194411.0,Stable Salary & Increasing Fixed Expenses,45100,22103.0,31352,53455.0,-8355.0,-18.53,0.03,High Risk
U096,2024,6,186056.0,Stable Salary & Increasing Fixed Expenses,45100,22103.0,30857,52960.0,-7860.0,-17.43,-0.01,High Risk
U096,2024,7,178196.0,Stable Salary & Increasing Fixed Expenses,45100,22103.0,28376,50479.0,-5379.0,-11.93,-0.02,High Risk
U096,2024,8,172817.0,Stable Salary & Increasing Fixed Expenses,45100,22103.0,28146,50249.0,-5149.0,-11.42,0.02,High Risk
U096,2024,9,167668.0,Stable Salary & Increasing Fixed Expenses,45100,22103.0,26238,48341.0,-3241.0,-7.19,-0.03,High Risk
U096,2024,10,164427.0,Stable Salary & Increasing Fixed Expenses,45100,22103.0,28621,50724.0,-5624.0,-12.47,0.03,High Risk
U096,2024,11,158803.0,Stable Salary & Increasing Fixed Expenses,45100,22103.0,27830,49933.0,-4833.0,-10.72,-0.04,High Risk
U096,2024,12,153970.0,Stable Salary & Increasing Fixed Expenses,45100,22103.0,25388,47491.0,-2391.0,-5.3,0.03,High Risk
U097,2024,1,236066.0,Stable Salary & Stable Fixed Expenses,205027,80603.0,120949,201552.0,3475.0,1.69,-0.04,High Risk
U097,2024,2,239541.0,Stable Salary & Stable Fixed Expenses,205027,80603.0,138019,218622.0,-13595.0,-6.63,0.01,High Risk
U097,2024,3,225946.0,Stable Salary & Stable Fixed Expenses,205027,80603.0,103339,183942.0,21085.0,10.28,0.0,High Risk
U097,2024,4,247031.0,Stable Salary & Stable Fixed Expenses,205027,80603.0,142878,223481.0,-18454.0,-9.0,0.04,High Risk
U097,2024,5,228577.0,Stable Salary & Stable Fixed Expenses,205027,80603.0,127515,208118.0,-3091.0,-1.51,-0.03,High Risk
U097,2024,6,225486.0,Stable Salary & Stable Fixed Expenses,205027,80603.0,104836,185439.0,19588.0,9.55,0.05,High Risk
U097,2024,7,245074.0,Stable Salary & Stable Fixed Expenses,205027,80603.0,118509,199112.0,5915.0,2.88,-0.02,High Risk
U097,2024,8,250989.0,Stable Salary & Stable Fixed Expenses,205027,80603.0,103106,183709.0,21318.0,10.4,-0.02,High Risk
U097,2024,9,272307.0,Stable Salary & Stable Fixed Expenses,205027,80603.0,133060,213663.0,-8636.0,-4.21,0.03,High Risk
U097,2024,10,263671.0,Stable Salary & Stable Fixed Expenses,205027,80603.0,105885,186488.0,18539.0,9.04,-0.01,High Risk
U097,2024,11,282210.0,Stable Salary & Stable Fixed Expenses,205027,80603.0,142321,222924.0,-17897.0,-8.73,-0.04,High Risk
U097,2024,12,264313.0,Stable Salary & Stable Fixed Expenses,205027,80603.0,111033,191636.0,13391.0,6.53,-0.05,High Risk
U098,2024,1,81914.0,Stable Salary & Stable Fixed Expenses,71965,24194.0,26755,50949.0,21016.0,29.2,0.03,Low Risk
U098,2024,2,102930.0,Stable Salary & Stable Fixed Expenses,71965,24194.0,32020,56214.0,15751.0,21.89,0.01,Medium Risk
U098,2024,3,118681.0,Stable Salary & Stable Fixed Expenses,71965,24194.0,34685,58879.0,13086.0,18.18,0.03,Medium Risk
U098,2024,4,131767.0,Stable Salary & Stable Fixed Expenses,71965,24194.0,21767,45961.0,26004.0,36.13,-0.03,Low Risk
U098,2024,5,157771.0,Stable Salary & Stable Fixed Expenses,71965,24194.0,33305,57499.0,14466.0,20.1,0.0,Medium Risk
U098,2024,6,172237.0,Stable Salary & Stable Fixed Expenses,71965,24194.0,32403,56597.0,15368.0,21.35,0.02,Medium Risk
U098,2024,7,187605.0,Stable Salary & Stable Fixed Expenses,71965,24194.0,21969,46163.0,25802.0,35.85,0.04,Low Risk
U098,2024,8,213407.0,Stable Salary & Stable Fixed Expenses,71965,24194.0,25377,49571.0,22394.0,31.12,0.02,Low Risk
U098,2024,9,235801.0,Stable Salary & Stable Fixed Expenses,71965,24194.0,31116,55310.0,16655.0,23.14,-0.04,Medium Risk
U098,2024,10,252456.0,Stable Salary & Stable Fixed Expenses,71965,24194.0,22014,46208.0,25757.0,35.79,0.01,Low Risk
U098,2024,11,278213.0,Stable Salary & Stable Fixed Expenses,71965,24194.0,29734,53928.0,18037.0,25.06,0.04,Low Risk
U098,2024,12,296250.0,Stable Salary & Stable Fixed Expenses,71965,24194.0,35637,59831.0,12134.0,16.86,-0.02,Medium Risk
U099,2024,1,250000.0,Stable Salary & Stable Fixed Expenses,291815,96082.0,157753,253835.0,37980.0,13.02,0.03,High Risk
U099,2024,2,287980.0,Stable Salary & Stable Fixed Expenses,291815,96082.0,184859,280941.0,10874.0,3.73,-0.02,High Risk
U099,2024,3,298854.0,Stable Salary & Stable Fixed Expenses,291815,96082.0,181644,277726.0,14089.0,4.83,0.0,High Risk
U099,2024,4,312943.0,Stable Salary & Stable Fixed Expenses,291815,96082.0,163570,259652.0,32163.0,11.02,0.04,High Risk
U099,2024,5,345106.0,Stable Salary & Stable Fixed Expenses,291815,96082.0,197234,293316.0,-1501.0,-0.51,0.05,High Risk
U099,2024,6,343605.0,Stable Salary & Stable Fixed Expenses,291815,96082.0,157169,253251.0,38564.0,13.22,0.02,High Risk
U099,2024,7,382169.0,Stable Salary & Stable Fixed Expenses,291815,96082.0,159265,255347.0,36468.0,12.5,0.01,High Risk
U099,2024,8,418637.0,Stable Salary & Stable Fixed Expenses,291815,96082.0,163665,259747.0,32068.0,10.99,0.02,High Risk
U099,2024,9,450705.0,Stable Salary & Stable Fixed Expenses,291815,96082.0,180511,276593.0,15222.0,5.22,-0.04,High Risk
U099,2024,10,465927.0,Stable Salary & Stable Fixed Expenses,291815,96082.0,212015,308097.0,-16282.0,-5.58,0.03,High Risk
U099,2024,11,449645.0,Stable Salary & Stable Fixed Expenses,291815,96082.0,200209,296291.0,-4476.0,-1.53,-0.0,High Risk
U099,2024,12,445169.0,Stable Salary & Stable Fixed Expenses,291815,96082.0,226126,322208.0,-30393.0,-10.42,0.04,High Risk
U100,2024,1,221368.0,Salary Increases & Fixed Expenses Remain Stable,146363,50633.0,32698,83331.0,63032.0,43.07,-0.03,Low Risk
U100,2024,2,284400.0,Salary Increases & Fixed Expenses Remain Stable,146363,50633.0,38434,89067.0,57296.0,39.15,-0.03,Low Risk
U100,2024,3,341696.0,Salary Increases & Fixed Expenses Remain Stable,146363,50633.0,34794,85427.0,60936.0,41.63,-0.03,Low Risk
U100,2024,4,402632.0,Salary Increases & Fixed Expenses Remain Stable,146363,50633.0,36790,87423.0,58940.0,40.27,-0.02,Low Risk
U100,2024,5,461572.0,Salary Increases & Fixed Expenses Remain Stable,158782,50633.0,46896,97529.0,61253.0,38.58,-0.01,Low Risk
U100,2024,6,522825.0,Salary Increases & Fixed Expenses Remain Stable,158782,50633.0,33177,83810.0,74972.0,47.22,-0.01,Low Risk
U100,2024,7,597797.0,Salary Increases & Fixed Expenses Remain Stable,158782,50633.0,33835,84468.0,74314.0,46.8,-0.0,Low Risk
U100,2024,8,672111.0,Salary Increases & Fixed Expenses Remain Stable,158782,50633.0,37476,88109.0,70673.0,44.51,0.01,Low Risk
U100,2024,9,742784.0,Salary Increases & Fixed Expenses Remain Stable,158782,50633.0,44456,95089.0,63693.0,40.11,-0.04,Low Risk
U100,2024,10,806477.0,Salary Increases & Fixed Expenses Remain Stable,158782,50633.0,45289,95922.0,62860.0,39.59,0.02,Low Risk
U100,2024,11,869337.0,Salary Increases & Fixed Expenses Remain Stable,158782,50633.0,39965,90598.0,68184.0,42.94,-0.03,Low Risk
U100,2024,12,937521.0,Salary Increases & Fixed Expenses Remain Stable,158782,50633.0,53294,103927.0,54855.0,34.55,-0.03,Low Risk
U101,2024,1,139346.0,Salary Increases & Fixed Expenses Increase,37181,17946.0,7878,25824.0,11357.0,30.55,-0.03,Low Risk
U101,2024,2,150703.0,Salary Increases & Fixed Expenses Increase,37181,19239.0,9938,29177.0,8004.0,21.53,0.02,Medium Risk
U101,2024,3,158707.0,Salary Increases & Fixed Expenses Increase,37181,19239.0,12204,31443.0,5738.0,15.43,-0.02,Medium Risk
U101,2024,4,164445.0,Salary Increases & Fixed Expenses Increase,37181,19239.0,7755,26994.0,10187.0,27.4,-0.03,Low Risk
U101,2024,5,174632.0,Salary Increases & Fixed Expenses Increase,37181,19239.0,8215,27454.0,9727.0,26.16,-0.02,Low Risk
U101,2024,6,184359.0,Salary Increases & Fixed Expenses Increase,37181,19239.0,8408,27647.0,9534.0,25.64,0.03,Low Risk
U101,2024,7,193893.0,Salary Increases & Fixed Expenses Increase,60298,19239.0,18077,37316.0,22982.0,38.11,-0.03,Low Risk
U101,2024,8,216875.0,Salary Increases & Fixed Expenses Increase,60298,19239.0,15161,34400.0,25898.0,42.95,0.01,Low Risk
U101,2024,9,242773.0,Salary Increases & Fixed Expenses Increase,60298,19239.0,14813,34052.0,26246.0,43.53,0.03,Low Risk
U101,2024,10,269019.0,Salary Increases & Fixed Expenses Increase,60298,19239.0,19567,38806.0,21492.0,35.64,0.02,Low Risk
U101,2024,11,290511.0,Salary Increases & Fixed Expenses Increase,60298,20388.0,17110,37498.0,22800.0,37.81,-0.04,Low Risk
U101,2024,12,313311.0,Salary Increases & Fixed Expenses Increase,60298,22006.0,16846,38852.0,21446.0,35.57,-0.04,Low Risk
U102,2024,1,234253.0,Salary Increases & Fixed Expenses Remain Stable,92488,37055.0,43262,80317.0,12171.0,13.16,-0.04,High Risk
U102,2024,2,246424.0,Salary Increases & Fixed Expenses Remain Stable,92488,37055.0,42512,79567.0,12921.0,13.97,0.01,High Risk
U102,2024,3,259345.0,Salary Increases & Fixed Expenses Remain Stable,92488,37055.0,43089,80144.0,12344.0,13.35,0.0,High Risk
U102,2024,4,271689.0,Salary Increases & Fixed Expenses Remain Stable,115778,37055.0,46525,83580.0,32198.0,27.81,-0.04,Low Risk
U102,2024,5,303887.0,Salary Increases & Fixed Expenses Remain Stable,115778,37055.0,40915,77970.0,37808.0,32.66,0.04,Low Risk
U102,2024,6,341695.0,Salary Increases & Fixed Expenses Remain Stable,115778,37055.0,52320,89375.0,26403.0,22.8,-0.01,Medium Risk
U102,2024,7,368098.0,Salary Increases & Fixed Expenses Remain Stable,115778,37055.0,57577,94632.0,21146.0,18.26,0.02,Medium Risk
U102,2024,8,389244.0,Salary Increases & Fixed Expenses Remain Stable,115778,37055.0,36295,73350.0,42428.0,36.65,-0.03,Low Risk
U102,2024,9,431672.0,Salary Increases & Fixed Expenses Remain Stable,115778,37055.0,35820,72875.0,42903.0,37.06,0.04,Low Risk
U102,2024,10,474575.0,Salary Increases & Fixed Expenses Remain Stable,115778,37055.0,36554,73609.0,42169.0,36.42,0.03,Low Risk
U102,2024,11,516744.0,Salary Increases & Fixed Expenses Remain Stable,115778,37055.0,54680,91735.0,24043.0,20.77,0.02,Medium Risk
U102,2024,12,540787.0,Salary Increases & Fixed Expenses Remain Stable,115778,37055.0,39291,76346.0,39432.0,34.06,0.03,Low Risk
U103,2024,1,235649.0,Salary Increases & Fixed Expenses Increase,230080,70309.0,64577,134886.0,95194.0,41.37,-0.01,Low Risk
U103,2024,2,330843.0,Salary Increases & Fixed Expenses Increase,230080,70309.0,53816,124125.0,105955.0,46.05,-0.0,Low Risk
U103,2024,3,436798.0,Salary Increases & Fixed Expenses Increase,230080,70309.0,64273,134582.0,95498.0,41.51,0.01,Low Risk
U103,2024,4,532296.0,Salary Increases & Fixed Expenses Increase,230080,70975.0,65735,136710.0,93370.0,40.58,-0.01,Low Risk
U103,2024,5,625666.0,Salary Increases & Fixed Expenses Increase,250918,72704.0,63271,135975.0,114943.0,45.81,0.02,Low Risk
U103,2024,6,740609.0,Salary Increases & Fixed Expenses Increase,250918,72704.0,71106,143810.0,107108.0,42.69,0.02,Low Risk
U103,2024,7,847717.0,Salary Increases & Fixed Expenses Increase,250918,72704.0,50517,123221.0,127697.0,50.89,0.04,Low Risk
U103,2024,8,975414.0,Salary Increases & Fixed Expenses Increase,250918,72704.0,62085,134789.0,116129.0,46.28,-0.02,Low Risk
U103,2024,9,1091543.0,Salary Increases & Fixed Expenses Increase,250918,74284.0,71920,146204.0,104714.0,41.73,-0.05,Low Risk
U103,2024,10,1196257.0,Salary Increases & Fixed Expenses Increase,250918,74284.0,85869,160153.0,90765.0,36.17,-0.01,Low Risk
U103,2024,11,1287022.0,Salary Increases & Fixed Expenses Increase,250918,74284.0,61347,135631.0,115287.0,45.95,-0.04,Low Risk
U103,2024,12,1402309.0,Salary Increases & Fixed Expenses Increase,250918,76050.0,70704,146754.0,104164.0,41.51,-0.03,Low Risk
U104,2024,1,213189.0,Stable Salary & Stable Fixed Expenses,186640,74006.0,62559,136565.0,50075.0,26.83,0.04,Low Risk
U104,2024,2,263264.0,Stable Salary & Stable Fixed Expenses,186640,74006.0,75984,149990.0,36650.0,19.64,0.0,Medium Risk
U104,2024,3,299914.0,Stable Salary & Stable Fixed Expenses,186640,74006.0,78034,152040.0,34600.0,18.54,0.03,Medium Risk
U104,2024,4,334514.0,Stable Salary & Stable Fixed Expenses,186640,74006.0,91489,165495.0,21145.0,11.33,-0.02,High Risk
U104,2024,5,355659.0,Stable Salary & Stable Fixed Expenses,186640,74006.0,63785,137791.0,48849.0,26.17,0.03,Low Risk
U104,2024,6,404508.0,Stable Salary & Stable Fixed Expenses,186640,74006.0,83994,158000.0,28640.0,15.35,-0.0,Medium Risk
U104,2024,7,433148.0,Stable Salary & Stable Fixed Expenses,186640,74006.0,68425,142431.0,44209.0,23.69,-0.01,Medium Risk
U104,2024,8,477357.0,Stable Salary & Stable Fixed Expenses,186640,74006.0,66759,140765.0,45875.0,24.58,-0.04,Medium Risk
U104,2024,9,523232.0,Stable Salary & Stable Fixed Expenses,186640,74006.0,83507,157513.0,29127.0,15.61,-0.02,Medium Risk
U104,2024,10,552359.0,Stable Salary & Stable Fixed Expenses,186640,74006.0,71915,145921.0,40719.0,21.82,0.0,Medium Risk
U104,2024,11,593078.0,Stable Salary & Stable Fixed Expenses,186640,74006.0,88062,162068.0,24572.0,13.17,-0.02,High Risk
U104,2024,12,617650.0,Stable Salary & Stable Fixed Expenses,186640,74006.0,78750,152756.0,33884.0,18.15,-0.03,Medium Risk
U105,2024,1,250000.0,Salary Increases & Fixed Expenses Remain Stable,263881,94333.0,117076,211409.0,52472.0,19.88,0.03,Medium Risk
U105,2024,2,302472.0,Salary Increases & Fixed Expenses Remain Stable,263881,94333.0,89189,183522.0,80359.0,30.45,-0.01,Low Risk
U105,2024,3,382831.0,Salary Increases & Fixed Expenses Remain Stable,263881,94333.0,131236,225569.0,38312.0,14.52,0.01,High Risk
U105,2024,4,421143.0,Salary Increases & Fixed Expenses Remain Stable,263881,94333.0,120976,215309.0,48572.0,18.41,0.0,Medium Risk
U105,2024,5,469715.0,Salary Increases & Fixed Expenses Remain Stable,263881,94333.0,102942,197275.0,66606.0,25.24,0.02,Low Risk
U105,2024,6,536321.0,Salary Increases & Fixed Expenses Remain Stable,289858,94333.0,104262,198595.0,91263.0,31.49,0.01,Low Risk
U105,2024,7,627584.0,Salary Increases & Fixed Expenses Remain Stable,289858,94333.0,97397,191730.0,98128.0,33.85,0.03,Low Risk
U105,2024,8,725712.0,Salary Increases & Fixed Expenses Remain Stable,289858,94333.0,118901,213234.0,76624.0,26.44,-0.04,Low Risk
U105,2024,9,802336.0,Salary Increases & Fixed Expenses Remain Stable,289858,94333.0,154357,248690.0,41168.0,14.2,0.01,High Risk
U105,2024,10,843504.0,Salary Increases & Fixed Expenses Remain Stable,289858,94333.0,112450,206783.0,83075.0,28.66,0.05,Low Risk
U105,2024,11,926579.0,Salary Increases & Fixed Expenses Remain Stable,289858,94333.0,137338,231671.0,58187.0,20.07,0.04,Medium Risk
U105,2024,12,984766.0,Salary Increases & Fixed Expenses Remain Stable,289858,94333.0,134128,228461.0,61397.0,21.18,0.01,Medium Risk
U106,2024,1,67749.0,Stable Salary & Decreasing Fixed Expenses,43799,19605.0,10994,30599.0,13200.0,30.14,-0.03,Low Risk
U106,2024,2,80949.0,Stable Salary & Decreasing Fixed Expenses,43799,19605.0,10492,30097.0,13702.0,31.28,-0.04,Low Risk
U106,2024,3,94651.0,Stable Salary & Decreasing Fixed Expenses,43799,19605.0,10185,29790.0,14009.0,31.98,0.02,Low Risk
U106,2024,4,108660.0,Stable Salary & Decreasing Fixed Expenses,43799,19605.0,9779,29384.0,14415.0,32.91,-0.04,Low Risk
U106,2024,5,123075.0,Stable Salary & Decreasing Fixed Expenses,43799,19605.0,10049,29654.0,14145.0,32.3,0.02,Low Risk
U106,2024,6,137220.0,Stable Salary & Decreasing Fixed Expenses,43799,19605.0,12593,32198.0,11601.0,26.49,0.04,Low Risk
U106,2024,7,148821.0,Stable Salary & Decreasing Fixed Expenses,43799,18627.0,12556,31183.0,12616.0,28.8,0.03,Low Risk
U106,2024,8,161437.0,Stable Salary & Decreasing Fixed Expenses,43799,18627.0,12816,31443.0,12356.0,28.21,0.04,Low Risk
U106,2024,9,173793.0,Stable Salary & Decreasing Fixed Expenses,43799,18627.0,10732,29359.0,14440.0,32.97,0.02,Low Risk
U106,2024,10,188233.0,Stable Salary & Decreasing Fixed Expenses,43799,18627.0,9920,28547.0,15252.0,34.82,0.01,Low Risk
U106,2024,11,203485.0,Stable Salary & Decreasing Fixed Expenses,43799,18627.0,9455,28082.0,15717.0,35.88,-0.0,Low Risk
U106,2024,12,219202.0,Stable Salary & Decreasing Fixed Expenses,43799,18627.0,11649,30276.0,13523.0,30.88,-0.02,Low Risk
U107,2024,1,239178.0,Salary Increases & Fixed Expenses Remain Stable,228358,77161.0,92280,169441.0,58917.0,25.8,-0.01,Low Risk
U107,2024,2,298095.0,Salary Increases & Fixed Expenses Remain Stable,228358,77161.0,83835,160996.0,67362.0,29.5,-0.02,Low Risk
U107,2024,3,365457.0,Salary Increases & Fixed Expenses Remain Stable,228358,77161.0,124573,201734.0,26624.0,11.66,-0.02,High Risk
U107,2024,4,392081.0,Salary Increases & Fixed Expenses Remain Stable,228358,77161.0,105483,182644.0,45714.0,20.02,-0.0,Medium Risk
U107,2024,5,437795.0,Salary Increases & Fixed Expenses Remain Stable,254162,77161.0,87070,164231.0,89931.0,35.38,-0.05,Low Risk
U107,2024,6,527726.0,Salary Increases & Fixed Expenses Remain Stable,254162,77161.0,120793,197954.0,56208.0,22.12,-0.04,Medium Risk
U107,2024,7,583934.0,Salary Increases & Fixed Expenses Remain Stable,254162,77161.0,109443,186604.0,67558.0,26.58,-0.02,Low Risk
U107,2024,8,651492.0,Salary Increases & Fixed Expenses Remain Stable,254162,77161.0,91123,168284.0,85878.0,33.79,-0.0,Low Risk
U107,2024,9,737370.0,Salary Increases & Fixed Expenses Remain Stable,254162,77161.0,124043,201204.0,52958.0,20.84,0.04,Medium Risk
U107,2024,10,790328.0,Salary Increases & Fixed Expenses Remain Stable,254162,77161.0,98918,176079.0,78083.0,30.72,0.04,Low Risk
U107,2024,11,868411.0,Salary Increases & Fixed Expenses Remain Stable,254162,77161.0,95822,172983.0,81179.0,31.94,-0.0,Low Risk
U107,2024,12,949590.0,Salary Increases & Fixed Expenses Remain Stable,254162,77161.0,150022,227183.0,26979.0,10.61,-0.0,High Risk
U108,2024,1,225136.0,Stable Salary & Stable Fixed Expenses,191480,60048.0,39878,99926.0,91554.0,47.81,-0.04,Low Risk
U108,2024,2,316690.0,Stable Salary & Stable Fixed Expenses,191480,60048.0,47209,107257.0,84223.0,43.99,-0.02,Low Risk
U108,2024,3,400913.0,Stable Salary & Stable Fixed Expenses,191480,60048.0,51504,111552.0,79928.0,41.74,0.01,Low Risk
U108,2024,4,480841.0,Stable Salary & Stable Fixed Expenses,191480,60048.0,49764,109812.0,81668.0,42.65,0.02,Low Risk
U108,2024,5,562509.0,Stable Salary & Stable Fixed Expenses,191480,60048.0,53039,113087.0,78393.0,40.94,-0.02,Low Risk
U108,2024,6,640902.0,Stable Salary & Stable Fixed Expenses,191480,60048.0,46389,106437.0,85043.0,44.41,-0.02,Low Risk
U108,2024,7,725945.0,Stable Salary & Stable Fixed Expenses,191480,60048.0,55398,115446.0,76034.0,39.71,-0.0,Low Risk
U108,2024,8,801979.0,Stable Salary & Stable Fixed Expenses,191480,60048.0,45895,105943.0,85537.0,44.67,-0.05,Low Risk
U108,2024,9,887516.0,Stable Salary & Stable Fixed Expenses,191480,60048.0,56015,116063.0,75417.0,39.39,0.05,Low Risk
U108,2024,10,962933.0,Stable Salary & Stable Fixed Expenses,191480,60048.0,48325,108373.0,83107.0,43.4,-0.03,Low Risk
U108,2024,11,1046040.0,Stable Salary & Stable Fixed Expenses,191480,60048.0,43475,103523.0,87957.0,45.94,-0.03,Low Risk
U108,2024,12,1133997.0,Stable Salary & Stable Fixed Expenses,191480,60048.0,43888,103936.0,87544.0,45.72,0.02,Low Risk
U109,2024,1,241570.0,Salary Increases & Fixed Expenses Remain Stable,27887,18225.0,10474,28699.0,-812.0,-2.91,-0.02,High Risk
U109,2024,2,240758.0,Salary Increases & Fixed Expenses Remain Stable,27887,18225.0,10891,29116.0,-1229.0,-4.41,0.01,High Risk
U109,2024,3,239529.0,Salary Increases & Fixed Expenses Remain Stable,27887,18225.0,10983,29208.0,-1321.0,-4.74,0.03,High Risk
U109,2024,4,238208.0,Salary Increases & Fixed Expenses Remain Stable,27887,18225.0,8970,27195.0,692.0,2.48,-0.03,High Risk
U109,2024,5,238900.0,Salary Increases & Fixed Expenses Remain Stable,27887,18225.0,9325,27550.0,337.0,1.21,0.01,High Risk
U109,2024,6,239237.0,Salary Increases & Fixed Expenses Remain Stable,41471,18225.0,12478,30703.0,10768.0,25.97,0.0,Low Risk
U109,2024,7,250005.0,Salary Increases & Fixed Expenses Remain Stable,41471,18225.0,20434,38659.0,2812.0,6.78,0.0,High Risk
U109,2024,8,252817.0,Salary Increases & Fixed Expenses Remain Stable,41471,18225.0,19940,38165.0,3306.0,7.97,-0.05,High Risk
U109,2024,9,256123.0,Salary Increases & Fixed Expenses Remain Stable,41471,18225.0,18375,36600.0,4871.0,11.75,-0.03,High Risk
U109,2024,10,260994.0,Salary Increases & Fixed Expenses Remain Stable,41471,18225.0,14128,32353.0,9118.0,21.99,0.01,Medium Risk
U109,2024,11,270112.0,Salary Increases & Fixed Expenses Remain Stable,41471,18225.0,17632,35857.0,5614.0,13.54,0.03,High Risk
U109,2024,12,275726.0,Salary Increases & Fixed Expenses Remain Stable,41471,18225.0,16276,34501.0,6970.0,16.81,-0.03,Medium Risk
U110,2024,1,250000.0,Salary Increases & Fixed Expenses Increase,261082,66922.0,116318,183240.0,77842.0,29.82,-0.03,Low Risk
U110,2024,2,327842.0,Salary Increases & Fixed Expenses Increase,261082,66922.0,112788,179710.0,81372.0,31.17,-0.05,Low Risk
U110,2024,3,409214.0,Salary Increases & Fixed Expenses Increase,261082,66922.0,154519,221441.0,39641.0,15.18,0.04,Medium Risk
U110,2024,4,448855.0,Salary Increases & Fixed Expenses Increase,282036,66922.0,135883,202805.0,79231.0,28.09,0.01,Low Risk
U110,2024,5,528086.0,Salary Increases & Fixed Expenses Increase,282036,66922.0,88180,155102.0,126934.0,45.01,-0.03,Low Risk
U110,2024,6,655020.0,Salary Increases & Fixed Expenses Increase,282036,66922.0,101271,168193.0,113843.0,40.36,-0.01,Low Risk
U110,2024,7,768863.0,Salary Increases & Fixed Expenses Increase,282036,66922.0,132501,199423.0,82613.0,29.29,-0.05,Low Risk
U110,2024,8,851476.0,Salary Increases & Fixed Expenses Increase,282036,66922.0,118213,185135.0,96901.0,34.36,0.02,Low Risk
U110,2024,9,948377.0,Salary Increases & Fixed Expenses Increase,282036,66922.0,100907,167829.0,114207.0,40.49,-0.01,Low Risk
U110,2024,10,1062584.0,Salary Increases & Fixed Expenses Increase,282036,66922.0,126066,192988.0,89048.0,31.57,0.01,Low Risk
U110,2024,11,1151632.0,Salary Increases & Fixed Expenses Increase,282036,66922.0,122163,189085.0,92951.0,32.96,0.04,Low Risk
U110,2024,12,1244583.0,Salary Increases & Fixed Expenses Increase,282036,66922.0,121500,188422.0,93614.0,33.19,-0.01,Low Risk
U111,2024,1,191583.0,Stable Salary & Decreasing Fixed Expenses,105545,76974.0,70480,147454.0,-41909.0,-39.71,-0.03,High Risk
U111,2024,2,149674.0,Stable Salary & Decreasing Fixed Expenses,105545,76974.0,63605,140579.0,-35034.0,-33.19,-0.03,High Risk
U111,2024,3,114640.0,Stable Salary & Decreasing Fixed Expenses,105545,76974.0,69019,145993.0,-40448.0,-38.32,-0.04,High Risk
U111,2024,4,74192.0,Stable Salary & Decreasing Fixed Expenses,105545,76974.0,64862,141836.0,-36291.0,-34.38,0.02,High Risk
U111,2024,5,37901.0,Stable Salary & Decreasing Fixed Expenses,105545,76974.0,70635,147609.0,-42064.0,-39.85,0.03,High Risk
U111,2024,6,-4163.0,Stable Salary & Decreasing Fixed Expenses,105545,76974.0,70996,147970.0,-42425.0,-40.2,-0.04,High Risk
U111,2024,7,-46588.0,Stable Salary & Decreasing Fixed Expenses,105545,76974.0,55959,132933.0,-27388.0,-25.95,-0.04,High Risk
U111,2024,8,-73976.0,Stable Salary & Decreasing Fixed Expenses,105545,76974.0,55310,132284.0,-26739.0,-25.33,0.02,High Risk
U111,2024,9,-100715.0,Stable Salary & Decreasing Fixed Expenses,105545,76974.0,80167,157141.0,-51596.0,-48.89,-0.03,High Risk
U111,2024,10,-152311.0,Stable Salary & Decreasing Fixed Expenses,105545,76974.0,66044,143018.0,-37473.0,-35.5,-0.02,High Risk
U111,2024,11,-189784.0,Stable Salary & Decreasing Fixed Expenses,105545,76974.0,64945,141919.0,-36374.0,-34.46,0.04,High Risk
U111,2024,12,-226158.0,Stable Salary & Decreasing Fixed Expenses,105545,76974.0,63253,140227.0,-34682.0,-32.86,0.03,High Risk
U112,2024,1,55827.0,Stable Salary & Increasing Fixed Expenses,55092,39230.0,14668,53898.0,1194.0,2.17,-0.04,High Risk
U112,2024,2,57021.0,Stable Salary & Increasing Fixed Expenses,55092,39230.0,11410,50640.0,4452.0,8.08,0.03,High Risk
U112,2024,3,61473.0,Stable Salary & Increasing Fixed Expenses,55092,39230.0,15816,55046.0,46.0,0.08,-0.01,High Risk
U112,2024,4,61519.0,Stable Salary & Increasing Fixed Expenses,55092,39230.0,12533,51763.0,3329.0,6.04,-0.01,High Risk
U112,2024,5,64848.0,Stable Salary & Increasing Fixed Expenses,55092,39230.0,16428,55658.0,-566.0,-1.03,0.04,High Risk
U112,2024,6,64282.0,Stable Salary & Increasing Fixed Expenses,55092,39230.0,16141,55371.0,-279.0,-0.51,-0.05,High Risk
U112,2024,7,64003.0,Stable Salary & Increasing Fixed Expenses,55092,39230.0,11238,50468.0,4624.0,8.39,-0.0,High Risk
U112,2024,8,68627.0,Stable Salary & Increasing Fixed Expenses,55092,39230.0,11288,50518.0,4574.0,8.3,0.03,High Risk
U112,2024,9,73201.0,Stable Salary & Increasing Fixed Expenses,55092,39230.0,16574,55804.0,-712.0,-1.29,0.05,High Risk
U112,2024,10,72489.0,Stable Salary & Increasing Fixed Expenses,55092,39230.0,13173,52403.0,2689.0,4.88,-0.01,High Risk
U112,2024,11,75178.0,Stable Salary & Increasing Fixed Expenses,55092,39230.0,16962,56192.0,-1100.0,-2.0,0.01,High Risk
U112,2024,12,74078.0,Stable Salary & Increasing Fixed Expenses,55092,39230.0,15357,54587.0,505.0,0.92,-0.0,High Risk
U113,2024,1,226692.0,Salary Increases & Fixed Expenses Increase,207650,85534.0,100022,185556.0,22094.0,10.64,-0.04,High Risk
U113,2024,2,248786.0,Salary Increases & Fixed Expenses Increase,207650,86226.0,65278,151504.0,56146.0,27.04,-0.03,Low Risk
U113,2024,3,304932.0,Salary Increases & Fixed Expenses Increase,207650,86226.0,109355,195581.0,12069.0,5.81,0.04,High Risk
U113,2024,4,317001.0,Salary Increases & Fixed Expenses Increase,207650,86226.0,97108,183334.0,24316.0,11.71,0.02,High Risk
U113,2024,5,341317.0,Salary Increases & Fixed Expenses Increase,231954,86226.0,102954,189180.0,42774.0,18.44,-0.04,Medium Risk
U113,2024,6,384091.0,Salary Increases & Fixed Expenses Increase,231954,86226.0,78727,164953.0,67001.0,28.89,-0.03,Low Risk
U113,2024,7,451092.0,Salary Increases & Fixed Expenses Increase,231954,87083.0,81365,168448.0,63506.0,27.38,0.04,Low Risk
U113,2024,8,514598.0,Salary Increases & Fixed Expenses Increase,231954,87083.0,100677,187760.0,44194.0,19.05,-0.03,Medium Risk
U113,2024,9,558792.0,Salary Increases & Fixed Expenses Increase,231954,87083.0,116957,204040.0,27914.0,12.03,0.01,High Risk
U113,2024,10,586706.0,Salary Increases & Fixed Expenses Increase,231954,88498.0,142441,230939.0,1015.0,0.44,-0.02,High Risk
U113,2024,11,587721.0,Salary Increases & Fixed Expenses Increase,231954,88498.0,95124,183622.0,48332.0,20.84,0.01,Medium Risk
U113,2024,12,636053.0,Salary Increases & Fixed Expenses Increase,231954,88498.0,94799,183297.0,48657.0,20.98,0.01,Medium Risk
U114,2024,1,196558.0,Salary Increases & Fixed Expenses Remain Stable,65099,36908.0,25736,62644.0,2455.0,3.77,0.01,High Risk
U114,2024,2,199013.0,Salary Increases & Fixed Expenses Remain Stable,65099,36908.0,20256,57164.0,7935.0,12.19,0.04,High Risk
U114,2024,3,206948.0,Salary Increases & Fixed Expenses Remain Stable,65099,36908.0,23466,60374.0,4725.0,7.26,-0.01,High Risk
U114,2024,4,211673.0,Salary Increases & Fixed Expenses Remain Stable,65099,36908.0,32538,69446.0,-4347.0,-6.68,-0.05,High Risk
U114,2024,5,207326.0,Salary Increases & Fixed Expenses Remain Stable,70574,36908.0,25564,62472.0,8102.0,11.48,0.04,High Risk
U114,2024,6,215428.0,Salary Increases & Fixed Expenses Remain Stable,70574,36908.0,25517,62425.0,8149.0,11.55,0.0,High Risk
U114,2024,7,223577.0,Salary Increases & Fixed Expenses Remain Stable,70574,36908.0,29226,66134.0,4440.0,6.29,0.05,High Risk
U114,2024,8,228017.0,Salary Increases & Fixed Expenses Remain Stable,70574,36908.0,22213,59121.0,11453.0,16.23,-0.03,Medium Risk
U114,2024,9,239470.0,Salary Increases & Fixed Expenses Remain Stable,70574,36908.0,33737,70645.0,-71.0,-0.1,-0.03,High Risk
U114,2024,10,239399.0,Salary Increases & Fixed Expenses Remain Stable,70574,36908.0,24406,61314.0,9260.0,13.12,-0.04,High Risk
U114,2024,11,248659.0,Salary Increases & Fixed Expenses Remain Stable,70574,36908.0,30886,67794.0,2780.0,3.94,-0.02,High Risk
U114,2024,12,251439.0,Salary Increases & Fixed Expenses Remain Stable,70574,36908.0,23880,60788.0,9786.0,13.87,0.02,High Risk
U115,2024,1,250000.0,Salary Increases & Fixed Expenses Increase,288378,105090.0,79616,184706.0,103672.0,35.95,-0.01,Low Risk
U115,2024,2,353672.0,Salary Increases & Fixed Expenses Increase,288378,105090.0,58540,163630.0,124748.0,43.26,0.03,Low Risk
U115,2024,3,478420.0,Salary Increases & Fixed Expenses Increase,301746,105090.0,95402,200492.0,101254.0,33.56,-0.03,Low Risk
U115,2024,4,579674.0,Salary Increases & Fixed Expenses Increase,301746,105090.0,65040,170130.0,131616.0,43.62,0.01,Low Risk
U115,2024,5,711290.0,Salary Increases & Fixed Expenses Increase,301746,105090.0,68184,173274.0,128472.0,42.58,-0.03,Low Risk
U115,2024,6,839762.0,Salary Increases & Fixed Expenses Increase,301746,105090.0,88680,193770.0,107976.0,35.78,-0.03,Low Risk
U115,2024,7,947738.0,Salary Increases & Fixed Expenses Increase,301746,106379.0,70649,177028.0,124718.0,41.33,-0.01,Low Risk
U115,2024,8,1072456.0,Salary Increases & Fixed Expenses Increase,301746,106916.0,89666,196582.0,105164.0,34.85,-0.0,Low Risk
U115,2024,9,1177620.0,Salary Increases & Fixed Expenses Increase,301746,108049.0,82010,190059.0,111687.0,37.01,0.03,Low Risk
U115,2024,10,1289307.0,Salary Increases & Fixed Expenses Increase,301746,108049.0,95839,203888.0,97858.0,32.43,0.05,Low Risk
U115,2024,11,1387165.0,Salary Increases & Fixed Expenses Increase,301746,108049.0,79051,187100.0,114646.0,37.99,0.04,Low Risk
U115,2024,12,1501811.0,Salary Increases & Fixed Expenses Increase,301746,108049.0,83594,191643.0,110103.0,36.49,-0.01,Low Risk
U116,2024,1,223596.0,Salary Increases & Fixed Expenses Increase,189990,48324.0,44787,93111.0,96879.0,50.99,-0.05,Low Risk
U116,2024,2,320475.0,Salary Increases & Fixed Expenses Increase,189990,48324.0,45623,93947.0,96043.0,50.55,-0.01,Low Risk
U116,2024,3,416518.0,Salary Increases & Fixed Expenses Increase,189990,49671.0,50324,99995.0,89995.0,47.37,-0.03,Low Risk
U116,2024,4,506513.0,Salary Increases & Fixed Expenses Increase,189990,50588.0,39423,90011.0,99979.0,52.62,-0.0,Low Risk
U116,2024,5,606492.0,Salary Increases & Fixed Expenses Increase,195637,50588.0,58041,108629.0,87008.0,44.47,-0.04,Low Risk
U116,2024,6,693500.0,Salary Increases & Fixed Expenses Increase,195637,50588.0,58233,108821.0,86816.0,44.38,-0.02,Low Risk
U116,2024,7,780316.0,Salary Increases & Fixed Expenses Increase,195637,50588.0,43448,94036.0,101601.0,51.93,0.05,Low Risk
U116,2024,8,881917.0,Salary Increases & Fixed Expenses Increase,195637,50588.0,48355,98943.0,96694.0,49.43,-0.04,Low Risk
U116,2024,9,978611.0,Salary Increases & Fixed Expenses Increase,195637,50588.0,54429,105017.0,90620.0,46.32,-0.02,Low Risk
U116,2024,10,1069231.0,Salary Increases & Fixed Expenses Increase,195637,50588.0,39945,90533.0,105104.0,53.72,-0.04,Low Risk
U116,2024,11,1174335.0,Salary Increases & Fixed Expenses Increase,195637,50588.0,41343,91931.0,103706.0,53.01,-0.02,Low Risk
U116,2024,12,1278041.0,Salary Increases & Fixed Expenses Increase,195637,52367.0,41088,93455.0,102182.0,52.23,-0.03,Low Risk
U117,2024,1,154272.0,Salary Increases & Fixed Expenses Remain Stable,77437,29635.0,26557,56192.0,21245.0,27.44,0.05,Low Risk
U117,2024,2,175517.0,Salary Increases & Fixed Expenses Remain Stable,77437,29635.0,29553,59188.0,18249.0,23.57,-0.04,Medium Risk
U117,2024,3,193766.0,Salary Increases & Fixed Expenses Remain Stable,77437,29635.0,35598,65233.0,12204.0,15.76,0.02,Medium Risk
U117,2024,4,205970.0,Salary Increases & Fixed Expenses Remain Stable,77437,29635.0,38379,68014.0,9423.0,12.17,0.03,High Risk
U117,2024,5,215393.0,Salary Increases & Fixed Expenses Remain Stable,77437,29635.0,28697,58332.0,19105.0,24.67,-0.04,Medium Risk
U117,2024,6,234498.0,Salary Increases & Fixed Expenses Remain Stable,102252,29635.0,46160,75795.0,26457.0,25.87,0.04,Low Risk
U117,2024,7,260955.0,Salary Increases & Fixed Expenses Remain Stable,102252,29635.0,42553,72188.0,30064.0,29.4,-0.05,Low Risk
U117,2024,8,291019.0,Salary Increases & Fixed Expenses Remain Stable,102252,29635.0,41895,71530.0,30722.0,30.05,0.04,Low Risk
U117,2024,9,321741.0,Salary Increases & Fixed Expenses Remain Stable,102252,29635.0,57139,86774.0,15478.0,15.14,0.02,Medium Risk
U117,2024,10,337219.0,Salary Increases & Fixed Expenses Remain Stable,102252,29635.0,33066,62701.0,39551.0,38.68,0.03,Low Risk
U117,2024,11,376770.0,Salary Increases & Fixed Expenses Remain Stable,102252,29635.0,53994,83629.0,18623.0,18.21,-0.01,Medium Risk
U117,2024,12,395393.0,Salary Increases & Fixed Expenses Remain Stable,102252,29635.0,44822,74457.0,27795.0,27.18,-0.04,Low Risk
U118,2024,1,216004.0,Salary Increases & Fixed Expenses Remain Stable,114966,53359.0,45481,98840.0,16126.0,14.03,-0.02,High Risk
U118,2024,2,232130.0,Salary Increases & Fixed Expenses Remain Stable,114966,53359.0,43357,96716.0,18250.0,15.87,0.04,Medium Risk
U118,2024,3,250380.0,Salary Increases & Fixed Expenses Remain Stable,114966,53359.0,49269,102628.0,12338.0,10.73,0.02,High Risk
U118,2024,4,262718.0,Salary Increases & Fixed Expenses Remain Stable,114966,53359.0,55347,108706.0,6260.0,5.45,0.04,High Risk
U118,2024,5,268978.0,Salary Increases & Fixed Expenses Remain Stable,134359,53359.0,50700,104059.0,30300.0,22.55,0.02,Medium Risk
U118,2024,6,299278.0,Salary Increases & Fixed Expenses Remain Stable,134359,53359.0,58048,111407.0,22952.0,17.08,-0.03,Medium Risk
U118,2024,7,322230.0,Salary Increases & Fixed Expenses Remain Stable,134359,53359.0,42331,95690.0,38669.0,28.78,0.04,Low Risk
U118,2024,8,360899.0,Salary Increases & Fixed Expenses Remain Stable,134359,53359.0,46264,99623.0,34736.0,25.85,0.03,Low Risk
U118,2024,9,395635.0,Salary Increases & Fixed Expenses Remain Stable,134359,53359.0,49616,102975.0,31384.0,23.36,0.01,Medium Risk
U118,2024,10,427019.0,Salary Increases & Fixed Expenses Remain Stable,134359,53359.0,59302,112661.0,21698.0,16.15,-0.0,Medium Risk
U118,2024,11,448717.0,Salary Increases & Fixed Expenses Remain Stable,134359,53359.0,54642,108001.0,26358.0,19.62,-0.05,Medium Risk
U118,2024,12,475075.0,Salary Increases & Fixed Expenses Remain Stable,134359,53359.0,65458,118817.0,15542.0,11.57,-0.04,High Risk
U119,2024,1,218818.0,Salary Increases & Fixed Expenses Remain Stable,170904,70812.0,36520,107332.0,63572.0,37.2,-0.01,Low Risk
U119,2024,2,282390.0,Salary Increases & Fixed Expenses Remain Stable,170904,70812.0,49026,119838.0,51066.0,29.88,0.03,Low Risk
U119,2024,3,333456.0,Salary Increases & Fixed Expenses Remain Stable,170904,70812.0,50508,121320.0,49584.0,29.01,0.01,Low Risk
U119,2024,4,383040.0,Salary Increases & Fixed Expenses Remain Stable,170904,70812.0,47126,117938.0,52966.0,30.99,0.02,Low Risk
U119,2024,5,436006.0,Salary Increases & Fixed Expenses Remain Stable,198534,70812.0,47121,117933.0,80601.0,40.6,0.0,Low Risk
U119,2024,6,516607.0,Salary Increases & Fixed Expenses Remain Stable,198534,70812.0,57388,128200.0,70334.0,35.43,-0.02,Low Risk
U119,2024,7,586941.0,Salary Increases & Fixed Expenses Remain Stable,198534,70812.0,53195,124007.0,74527.0,37.54,-0.01,Low Risk
U119,2024,8,661468.0,Salary Increases & Fixed Expenses Remain Stable,198534,70812.0,48059,118871.0,79663.0,40.13,-0.03,Low Risk
U119,2024,9,741131.0,Salary Increases & Fixed Expenses Remain Stable,198534,70812.0,51521,122333.0,76201.0,38.38,0.04,Low Risk
U119,2024,10,817332.0,Salary Increases & Fixed Expenses Remain Stable,198534,70812.0,64895,135707.0,62827.0,31.65,-0.01,Low Risk
U119,2024,11,880159.0,Salary Increases & Fixed Expenses Remain Stable,198534,70812.0,53603,124415.0,74119.0,37.33,-0.04,Low Risk
U119,2024,12,954278.0,Salary Increases & Fixed Expenses Remain Stable,198534,70812.0,53583,124395.0,74139.0,37.34,-0.01,Low Risk
U120,2024,1,175719.0,Salary Increases & Fixed Expenses Remain Stable,51021,28132.0,17352,45484.0,5537.0,10.85,0.03,High Risk
U120,2024,2,181256.0,Salary Increases & Fixed Expenses Remain Stable,51021,28132.0,23844,51976.0,-955.0,-1.87,0.05,High Risk
U120,2024,3,180301.0,Salary Increases & Fixed Expenses Remain Stable,51021,28132.0,24418,52550.0,-1529.0,-3.0,0.03,High Risk
U120,2024,4,178772.0,Salary Increases & Fixed Expenses Remain Stable,51021,28132.0,22754,50886.0,135.0,0.26,-0.01,High Risk
U120,2024,5,178907.0,Salary Increases & Fixed Expenses Remain Stable,51021,28132.0,18069,46201.0,4820.0,9.45,0.0,High Risk
U120,2024,6,183727.0,Salary Increases & Fixed Expenses Remain Stable,80634,28132.0,33218,61350.0,19284.0,23.92,0.04,Medium Risk
U120,2024,7,203011.0,Salary Increases & Fixed Expenses Remain Stable,80634,28132.0,36632,64764.0,15870.0,19.68,0.02,Medium Risk
U120,2024,8,218881.0,Salary Increases & Fixed Expenses Remain Stable,80634,28132.0,29310,57442.0,23192.0,28.76,0.01,Low Risk
U120,2024,9,242073.0,Salary Increases & Fixed Expenses Remain Stable,80634,28132.0,39611,67743.0,12891.0,15.99,-0.0,Medium Risk
U120,2024,10,254964.0,Salary Increases & Fixed Expenses Remain Stable,80634,28132.0,29709,57841.0,22793.0,28.27,-0.02,Low Risk
U120,2024,11,277757.0,Salary Increases & Fixed Expenses Remain Stable,80634,28132.0,40099,68231.0,12403.0,15.38,-0.01,Medium Risk
U120,2024,12,290160.0,Salary Increases & Fixed Expenses Remain Stable,80634,28132.0,37258,65390.0,15244.0,18.91,0.05,Medium Risk
U121,2024,1,250000.0,Salary Increases & Fixed Expenses Increase,268378,110568.0,86104,196672.0,71706.0,26.72,-0.05,Low Risk
U121,2024,2,321706.0,Salary Increases & Fixed Expenses Increase,268378,111467.0,100520,211987.0,56391.0,21.01,-0.04,Medium Risk
U121,2024,3,378097.0,Salary Increases & Fixed Expenses Increase,268378,111467.0,158080,269547.0,-1169.0,-0.44,-0.03,High Risk
U121,2024,4,376928.0,Salary Increases & Fixed Expenses Increase,282235,111467.0,88016,199483.0,82752.0,29.32,0.01,Low Risk
U121,2024,5,459680.0,Salary Increases & Fixed Expenses Increase,282235,111467.0,135680,247147.0,35088.0,12.43,-0.0,High Risk
U121,2024,6,494768.0,Salary Increases & Fixed Expenses Increase,282235,111467.0,89218,200685.0,81550.0,28.89,-0.01,Low Risk
U121,2024,7,576318.0,Salary Increases & Fixed Expenses Increase,282235,112773.0,100131,212904.0,69331.0,24.56,-0.01,Medium Risk
U121,2024,8,645649.0,Salary Increases & Fixed Expenses Increase,282235,113553.0,87507,201060.0,81175.0,28.76,0.01,Low Risk
U121,2024,9,726824.0,Salary Increases & Fixed Expenses Increase,282235,113553.0,127722,241275.0,40960.0,14.51,0.03,High Risk
U121,2024,10,767784.0,Salary Increases & Fixed Expenses Increase,282235,113553.0,136608,250161.0,32074.0,11.36,0.04,High Risk
U121,2024,11,799858.0,Salary Increases & Fixed Expenses Increase,282235,113553.0,102531,216084.0,66151.0,23.44,0.02,Medium Risk
U121,2024,12,866009.0,Salary Increases & Fixed Expenses Increase,282235,113553.0,157164,270717.0,11518.0,4.08,-0.02,High Risk
U122,2024,1,248630.0,Salary Increases & Fixed Expenses Remain Stable,178168,57473.0,76133,133606.0,44562.0,25.01,-0.02,Low Risk
U122,2024,2,293192.0,Salary Increases & Fixed Expenses Remain Stable,178168,57473.0,66706,124179.0,53989.0,30.3,0.04,Low Risk
U122,2024,3,347181.0,Salary Increases & Fixed Expenses Remain Stable,178168,57473.0,58196,115669.0,62499.0,35.08,0.02,Low Risk
U122,2024,4,409680.0,Salary Increases & Fixed Expenses Remain Stable,178168,57473.0,88743,146216.0,31952.0,17.93,-0.05,Medium Risk
U122,2024,5,441632.0,Salary Increases & Fixed Expenses Remain Stable,178168,57473.0,82582,140055.0,38113.0,21.39,0.0,Medium Risk
U122,2024,6,479745.0,Salary Increases & Fixed Expenses Remain Stable,201701,57473.0,90886,148359.0,53342.0,26.45,-0.0,Low Risk
U122,2024,7,533087.0,Salary Increases & Fixed Expenses Remain Stable,201701,57473.0,99435,156908.0,44793.0,22.21,-0.04,Medium Risk
U122,2024,8,577880.0,Salary Increases & Fixed Expenses Remain Stable,201701,57473.0,83226,140699.0,61002.0,30.24,-0.05,Low Risk
U122,2024,9,638882.0,Salary Increases & Fixed Expenses Remain Stable,201701,57473.0,91674,149147.0,52554.0,26.06,0.04,Low Risk
U122,2024,10,691436.0,Salary Increases & Fixed Expenses Remain Stable,201701,57473.0,93749,151222.0,50479.0,25.03,0.04,Low Risk
U122,2024,11,741915.0,Salary Increases & Fixed Expenses Remain Stable,201701,57473.0,66615,124088.0,77613.0,38.48,0.02,Low Risk
U122,2024,12,819528.0,Salary Increases & Fixed Expenses Remain Stable,201701,57473.0,97472,154945.0,46756.0,23.18,-0.03,Medium Risk
U123,2024,1,140652.0,Stable Salary & Decreasing Fixed Expenses,58002,35311.0,23097,58408.0,-406.0,-0.7,0.02,High Risk
U123,2024,2,140246.0,Stable Salary & Decreasing Fixed Expenses,58002,35311.0,22387,57698.0,304.0,0.52,0.01,High Risk
U123,2024,3,140550.0,Stable Salary & Decreasing Fixed Expenses,58002,35311.0,18826,54137.0,3865.0,6.66,0.02,High Risk
U123,2024,4,144415.0,Stable Salary & Decreasing Fixed Expenses,58002,35311.0,27171,62482.0,-4480.0,-7.72,0.01,High Risk
U123,2024,5,139935.0,Stable Salary & Decreasing Fixed Expenses,58002,35311.0,28047,63358.0,-5356.0,-9.23,0.03,High Risk
U123,2024,6,134579.0,Stable Salary & Decreasing Fixed Expenses,58002,35311.0,17966,53277.0,4725.0,8.15,-0.04,High Risk
U123,2024,7,139304.0,Stable Salary & Decreasing Fixed Expenses,58002,35311.0,18037,53348.0,4654.0,8.02,-0.02,High Risk
U123,2024,8,143958.0,Stable Salary & Decreasing Fixed Expenses,58002,35311.0,26247,61558.0,-3556.0,-6.13,-0.04,High Risk
U123,2024,9,140402.0,Stable Salary & Decreasing Fixed Expenses,58002,35311.0,19370,54681.0,3321.0,5.73,-0.02,High Risk
U123,2024,10,143723.0,Stable Salary & Decreasing Fixed Expenses,58002,35311.0,19398,54709.0,3293.0,5.68,-0.02,High Risk
U123,2024,11,147016.0,Stable Salary & Decreasing Fixed Expenses,58002,35311.0,31672,66983.0,-8981.0,-15.48,-0.02,High Risk
U123,2024,12,138035.0,Stable Salary & Decreasing Fixed Expenses,58002,35311.0,22827,58138.0,-136.0,-0.23,0.03,High Risk
U124,2024,1,73783.0,Salary Increases & Fixed Expenses Remain Stable,29839,12159.0,7096,19255.0,10584.0,35.47,0.05,Low Risk
U124,2024,2,84367.0,Salary Increases & Fixed Expenses Remain Stable,29839,12159.0,7154,19313.0,10526.0,35.28,0.0,Low Risk
U124,2024,3,94893.0,Salary Increases & Fixed Expenses Remain Stable,29839,12159.0,6204,18363.0,11476.0,38.46,-0.04,Low Risk
U124,2024,4,106369.0,Salary Increases & Fixed Expenses Remain Stable,29839,12159.0,7101,19260.0,10579.0,35.45,0.02,Low Risk
U124,2024,5,116948.0,Salary Increases & Fixed Expenses Remain Stable,41562,12159.0,9902,22061.0,19501.0,46.92,0.05,Low Risk
U124,2024,6,136449.0,Salary Increases & Fixed Expenses Remain Stable,41562,12159.0,11216,23375.0,18187.0,43.76,0.04,Low Risk
U124,2024,7,154636.0,Salary Increases & Fixed Expenses Remain Stable,41562,12159.0,10404,22563.0,18999.0,45.71,-0.04,Low Risk
U124,2024,8,173635.0,Salary Increases & Fixed Expenses Remain Stable,41562,12159.0,12007,24166.0,17396.0,41.86,-0.05,Low Risk
U124,2024,9,191031.0,Salary Increases & Fixed Expenses Remain Stable,41562,12159.0,12662,24821.0,16741.0,40.28,-0.04,Low Risk
U124,2024,10,207772.0,Salary Increases & Fixed Expenses Remain Stable,41562,12159.0,11216,23375.0,18187.0,43.76,0.0,Low Risk
U124,2024,11,225959.0,Salary Increases & Fixed Expenses Remain Stable,41562,12159.0,9733,21892.0,19670.0,47.33,0.05,Low Risk
U124,2024,12,245629.0,Salary Increases & Fixed Expenses Remain Stable,41562,12159.0,11721,23880.0,17682.0,42.54,0.05,Low Risk
U125,2024,1,243783.0,Stable Salary & Decreasing Fixed Expenses,240323,111118.0,83027,194145.0,46178.0,19.21,0.05,Medium Risk
U125,2024,2,289961.0,Stable Salary & Decreasing Fixed Expenses,240323,111118.0,109166,220284.0,20039.0,8.34,0.04,High Risk
U125,2024,3,310000.0,Stable Salary & Decreasing Fixed Expenses,240323,111118.0,102763,213881.0,26442.0,11.0,-0.02,High Risk
U125,2024,4,336442.0,Stable Salary & Decreasing Fixed Expenses,240323,111118.0,91143,202261.0,38062.0,15.84,-0.03,Medium Risk
U125,2024,5,374504.0,Stable Salary & Decreasing Fixed Expenses,240323,111118.0,114103,225221.0,15102.0,6.28,0.03,High Risk
U125,2024,6,389606.0,Stable Salary & Decreasing Fixed Expenses,240323,111118.0,83659,194777.0,45546.0,18.95,-0.05,Medium Risk
U125,2024,7,435152.0,Stable Salary & Decreasing Fixed Expenses,240323,111118.0,106074,217192.0,23131.0,9.62,0.04,High Risk
U125,2024,8,458283.0,Stable Salary & Decreasing Fixed Expenses,240323,111118.0,97347,208465.0,31858.0,13.26,-0.02,High Risk
U125,2024,9,490141.0,Stable Salary & Decreasing Fixed Expenses,240323,111118.0,126604,237722.0,2601.0,1.08,0.04,High Risk
U125,2024,10,492742.0,Stable Salary & Decreasing Fixed Expenses,240323,111118.0,101010,212128.0,28195.0,11.73,0.02,High Risk
U125,2024,11,520937.0,Stable Salary & Decreasing Fixed Expenses,240323,110252.0,99792,210044.0,30279.0,12.6,0.01,High Risk
U125,2024,12,551216.0,Stable Salary & Decreasing Fixed Expenses,240323,110252.0,102605,212857.0,27466.0,11.43,-0.0,High Risk
U126,2024,1,144315.0,Salary Increases & Fixed Expenses Increase,88987,28526.0,25259,53785.0,35202.0,39.56,-0.04,Low Risk
U126,2024,2,179517.0,Salary Increases & Fixed Expenses Increase,88987,29995.0,22410,52405.0,36582.0,41.11,0.04,Low Risk
U126,2024,3,216099.0,Salary Increases & Fixed Expenses Increase,88987,29995.0,25499,55494.0,33493.0,37.64,0.04,Low Risk
U126,2024,4,249592.0,Salary Increases & Fixed Expenses Increase,88987,29995.0,23247,53242.0,35745.0,40.17,0.04,Low Risk
U126,2024,5,285337.0,Salary Increases & Fixed Expenses Increase,88987,29995.0,18181,48176.0,40811.0,45.86,-0.04,Low Risk
U126,2024,6,326148.0,Salary Increases & Fixed Expenses Increase,88987,29995.0,23508,53503.0,35484.0,39.88,0.04,Low Risk
U126,2024,7,361632.0,Salary Increases & Fixed Expenses Increase,88987,29995.0,26650,56645.0,32342.0,36.34,-0.02,Low Risk
U126,2024,8,393974.0,Salary Increases & Fixed Expenses Increase,114356,29995.0,24974,54969.0,59387.0,51.93,-0.03,Low Risk
U126,2024,9,453361.0,Salary Increases & Fixed Expenses Increase,114356,29995.0,27299,57294.0,57062.0,49.9,0.02,Low Risk
U126,2024,10,510423.0,Salary Increases & Fixed Expenses Increase,114356,29995.0,28164,58159.0,56197.0,49.14,-0.03,Low Risk
U126,2024,11,566620.0,Salary Increases & Fixed Expenses Increase,114356,29995.0,30425,60420.0,53936.0,47.16,-0.01,Low Risk
U126,2024,12,620556.0,Salary Increases & Fixed Expenses Increase,114356,29995.0,25243,55238.0,59118.0,51.7,-0.04,Low Risk
U127,2024,1,233361.0,Salary Increases & Fixed Expenses Remain Stable,228795,99215.0,94695,193910.0,34885.0,15.25,0.02,Medium Risk
U127,2024,2,268246.0,Salary Increases & Fixed Expenses Remain Stable,228795,99215.0,99649,198864.0,29931.0,13.08,0.03,High Risk
U127,2024,3,298177.0,Salary Increases & Fixed Expenses Remain Stable,228795,99215.0,83116,182331.0,46464.0,20.31,0.05,Medium Risk
U127,2024,4,344641.0,Salary Increases & Fixed Expenses Remain Stable,228795,99215.0,99893,199108.0,29687.0,12.98,-0.05,High Risk
U127,2024,5,374328.0,Salary Increases & Fixed Expenses Remain Stable,228795,99215.0,85469,184684.0,44111.0,19.28,0.05,Medium Risk
U127,2024,6,418439.0,Salary Increases & Fixed Expenses Remain Stable,249519,99215.0,99916,199131.0,50388.0,20.19,0.02,Medium Risk
U127,2024,7,468827.0,Salary Increases & Fixed Expenses Remain Stable,249519,99215.0,123138,222353.0,27166.0,10.89,0.01,High Risk
U127,2024,8,495993.0,Salary Increases & Fixed Expenses Remain Stable,249519,99215.0,113884,213099.0,36420.0,14.6,0.0,High Risk
U127,2024,9,532413.0,Salary Increases & Fixed Expenses Remain Stable,249519,99215.0,127121,226336.0,23183.0,9.29,-0.01,High Risk
U127,2024,10,555596.0,Salary Increases & Fixed Expenses Remain Stable,249519,99215.0,105452,204667.0,44852.0,17.98,-0.04,Medium Risk
U127,2024,11,600448.0,Salary Increases & Fixed Expenses Remain Stable,249519,99215.0,101236,200451.0,49068.0,19.67,-0.0,Medium Risk
U127,2024,12,649516.0,Salary Increases & Fixed Expenses Remain Stable,249519,99215.0,76473,175688.0,73831.0,29.59,0.0,Low Risk
U128,2024,1,231677.0,Stable Salary & Stable Fixed Expenses,228433,94588.0,76435,171023.0,57410.0,25.13,-0.04,Low Risk
U128,2024,2,289087.0,Stable Salary & Stable Fixed Expenses,228433,94588.0,105980,200568.0,27865.0,12.2,0.03,High Risk
U128,2024,3,316952.0,Stable Salary & Stable Fixed Expenses,228433,94588.0,69012,163600.0,64833.0,28.38,-0.02,Low Risk
U128,2024,4,381785.0,Stable Salary & Stable Fixed Expenses,228433,94588.0,82600,177188.0,51245.0,22.43,-0.03,Medium Risk
U128,2024,5,433030.0,Stable Salary & Stable Fixed Expenses,228433,94588.0,104890,199478.0,28955.0,12.68,-0.03,High Risk
U128,2024,6,461985.0,Stable Salary & Stable Fixed Expenses,228433,94588.0,112030,206618.0,21815.0,9.55,-0.05,High Risk
U128,2024,7,483800.0,Stable Salary & Stable Fixed Expenses,228433,94588.0,106852,201440.0,26993.0,11.82,-0.03,High Risk
U128,2024,8,510793.0,Stable Salary & Stable Fixed Expenses,228433,94588.0,69417,164005.0,64428.0,28.2,-0.03,Low Risk
U128,2024,9,575221.0,Stable Salary & Stable Fixed Expenses,228433,94588.0,102227,196815.0,31618.0,13.84,-0.0,High Risk
U128,2024,10,606839.0,Stable Salary & Stable Fixed Expenses,228433,94588.0,90942,185530.0,42903.0,18.78,0.01,Medium Risk
U128,2024,11,649742.0,Stable Salary & Stable Fixed Expenses,228433,94588.0,75404,169992.0,58441.0,25.58,0.03,Low Risk
U128,2024,12,708183.0,Stable Salary & Stable Fixed Expenses,228433,94588.0,102646,197234.0,31199.0,13.66,-0.05,High Risk
U129,2024,1,250000.0,Salary Increases & Fixed Expenses Remain Stable,284177,96208.0,77296,173504.0,110673.0,38.95,-0.02,Low Risk
U129,2024,2,360673.0,Salary Increases & Fixed Expenses Remain Stable,284177,96208.0,78579,174787.0,109390.0,38.49,-0.0,Low Risk
U129,2024,3,470063.0,Salary Increases & Fixed Expenses Remain Stable,284177,96208.0,76400,172608.0,111569.0,39.26,0.02,Low Risk
U129,2024,4,581632.0,Salary Increases & Fixed Expenses Remain Stable,284177,96208.0,61551,157759.0,126418.0,44.49,0.01,Low Risk
U129,2024,5,708050.0,Salary Increases & Fixed Expenses Remain Stable,284177,96208.0,71309,167517.0,116660.0,41.05,0.03,Low Risk
U129,2024,6,824710.0,Salary Increases & Fixed Expenses Remain Stable,284177,96208.0,78719,174927.0,109250.0,38.44,0.03,Low Risk
U129,2024,7,933960.0,Salary Increases & Fixed Expenses Remain Stable,284177,96208.0,62403,158611.0,125566.0,44.19,0.04,Low Risk
U129,2024,8,1059526.0,Salary Increases & Fixed Expenses Remain Stable,309334,96208.0,77646,173854.0,135480.0,43.8,-0.03,Low Risk
U129,2024,9,1195006.0,Salary Increases & Fixed Expenses Remain Stable,309334,96208.0,78502,174710.0,134624.0,43.52,0.01,Low Risk
U129,2024,10,1329630.0,Salary Increases & Fixed Expenses Remain Stable,309334,96208.0,78767,174975.0,134359.0,43.43,0.01,Low Risk
U129,2024,11,1463989.0,Salary Increases & Fixed Expenses Remain Stable,309334,96208.0,91137,187345.0,121989.0,39.44,0.02,Low Risk
U129,2024,12,1585978.0,Salary Increases & Fixed Expenses Remain Stable,309334,96208.0,94490,190698.0,118636.0,38.35,0.0,Low Risk
U130,2024,1,245675.0,Salary Increases & Fixed Expenses Decrease,201053,77704.0,40279,117983.0,83070.0,41.32,0.02,Low Risk
U130,2024,2,328745.0,Salary Increases & Fixed Expenses Decrease,201053,77704.0,52501,130205.0,70848.0,35.24,0.02,Low Risk
U130,2024,3,399593.0,Salary Increases & Fixed Expenses Decrease,201053,77704.0,54351,132055.0,68998.0,34.32,-0.01,Low Risk
U130,2024,4,468591.0,Salary Increases & Fixed Expenses Decrease,201053,77704.0,53246,130950.0,70103.0,34.87,-0.01,Low Risk
U130,2024,5,538694.0,Salary Increases & Fixed Expenses Decrease,201053,77704.0,57453,135157.0,65896.0,32.78,0.02,Low Risk
U130,2024,6,604590.0,Salary Increases & Fixed Expenses Decrease,201053,77704.0,55298,133002.0,68051.0,33.85,0.0,Low Risk
U130,2024,7,672641.0,Salary Increases & Fixed Expenses Decrease,217618,77704.0,44620,122324.0,95294.0,43.79,0.02,Low Risk
U130,2024,8,767935.0,Salary Increases & Fixed Expenses Decrease,217618,77704.0,61798,139502.0,78116.0,35.9,0.0,Low Risk
U130,2024,9,846051.0,Salary Increases & Fixed Expenses Decrease,217618,77704.0,54957,132661.0,84957.0,39.04,0.04,Low Risk
U130,2024,10,931008.0,Salary Increases & Fixed Expenses Decrease,217618,77704.0,55408,133112.0,84506.0,38.83,0.02,Low Risk
U130,2024,11,1015514.0,Salary Increases & Fixed Expenses Decrease,217618,77704.0,59746,137450.0,80168.0,36.84,0.03,Low Risk
U130,2024,12,1095682.0,Salary Increases & Fixed Expenses Decrease,217618,77704.0,64034,141738.0,75880.0,34.87,0.0,Low Risk
U131,2024,1,127864.0,Salary Increases & Fixed Expenses Remain Stable,71257,35263.0,31528,66791.0,4466.0,6.27,-0.01,High Risk
U131,2024,2,132330.0,Salary Increases & Fixed Expenses Remain Stable,71257,35263.0,22014,57277.0,13980.0,19.62,0.01,Medium Risk
U131,2024,3,146310.0,Salary Increases & Fixed Expenses Remain Stable,71257,35263.0,31940,67203.0,4054.0,5.69,-0.01,High Risk
U131,2024,4,150364.0,Salary Increases & Fixed Expenses Remain Stable,71257,35263.0,22620,57883.0,13374.0,18.77,-0.01,Medium Risk
U131,2024,5,163738.0,Salary Increases & Fixed Expenses Remain Stable,71257,35263.0,25685,60948.0,10309.0,14.47,-0.04,High Risk
U131,2024,6,174047.0,Salary Increases & Fixed Expenses Remain Stable,71257,35263.0,26569,61832.0,9425.0,13.23,0.02,High Risk
U131,2024,7,183472.0,Salary Increases & Fixed Expenses Remain Stable,71257,35263.0,26405,61668.0,9589.0,13.46,0.03,High Risk
U131,2024,8,193061.0,Salary Increases & Fixed Expenses Remain Stable,97663,35263.0,41509,76772.0,20891.0,21.39,-0.02,Medium Risk
U131,2024,9,213952.0,Salary Increases & Fixed Expenses Remain Stable,97663,35263.0,35158,70421.0,27242.0,27.89,0.02,Low Risk
U131,2024,10,241194.0,Salary Increases & Fixed Expenses Remain Stable,97663,35263.0,48574,83837.0,13826.0,14.16,0.02,High Risk
U131,2024,11,255020.0,Salary Increases & Fixed Expenses Remain Stable,97663,35263.0,53659,88922.0,8741.0,8.95,-0.03,High Risk
U131,2024,12,263761.0,Salary Increases & Fixed Expenses Remain Stable,97663,35263.0,40362,75625.0,22038.0,22.57,-0.03,Medium Risk
U132,2024,1,197903.0,Salary Increases & Fixed Expenses Remain Stable,183303,41435.0,46836,88271.0,95032.0,51.84,-0.04,Low Risk
U132,2024,2,292935.0,Salary Increases & Fixed Expenses Remain Stable,183303,41435.0,53223,94658.0,88645.0,48.36,-0.01,Low Risk
U132,2024,3,381580.0,Salary Increases & Fixed Expenses Remain Stable,183303,41435.0,47569,89004.0,94299.0,51.44,-0.03,Low Risk
U132,2024,4,475879.0,Salary Increases & Fixed Expenses Remain Stable,183303,41435.0,48182,89617.0,93686.0,51.11,-0.01,Low Risk
U132,2024,5,569565.0,Salary Increases & Fixed Expenses Remain Stable,183303,41435.0,51455,92890.0,90413.0,49.32,-0.01,Low Risk
U132,2024,6,659978.0,Salary Increases & Fixed Expenses Remain Stable,183303,41435.0,51735,93170.0,90133.0,49.17,-0.03,Low Risk
U132,2024,7,750111.0,Salary Increases & Fixed Expenses Remain Stable,208706,41435.0,58935,100370.0,108336.0,51.91,-0.03,Low Risk
U132,2024,8,858447.0,Salary Increases & Fixed Expenses Remain Stable,208706,41435.0,45891,87326.0,121380.0,58.16,-0.01,Low Risk
U132,2024,9,979827.0,Salary Increases & Fixed Expenses Remain Stable,208706,41435.0,68506,109941.0,98765.0,47.32,0.04,Low Risk
U132,2024,10,1078592.0,Salary Increases & Fixed Expenses Remain Stable,208706,41435.0,47974,89409.0,119297.0,57.16,-0.01,Low Risk
U132,2024,11,1197889.0,Salary Increases & Fixed Expenses Remain Stable,208706,41435.0,58879,100314.0,108392.0,51.94,-0.04,Low Risk
U132,2024,12,1306281.0,Salary Increases & Fixed Expenses Remain Stable,208706,41435.0,58903,100338.0,108368.0,51.92,0.04,Low Risk
U133,2024,1,228744.0,Salary Increases & Fixed Expenses Remain Stable,44836,20082.0,19063,39145.0,5691.0,12.69,-0.01,High Risk
U133,2024,2,234435.0,Salary Increases & Fixed Expenses Remain Stable,44836,20082.0,17726,37808.0,7028.0,15.67,-0.01,Medium Risk
U133,2024,3,241463.0,Salary Increases & Fixed Expenses Remain Stable,44836,20082.0,17002,37084.0,7752.0,17.29,0.02,Medium Risk
U133,2024,4,249215.0,Salary Increases & Fixed Expenses Remain Stable,44836,20082.0,17771,37853.0,6983.0,15.57,-0.03,Medium Risk
U133,2024,5,256198.0,Salary Increases & Fixed Expenses Remain Stable,44836,20082.0,21552,41634.0,3202.0,7.14,-0.01,High Risk
U133,2024,6,259400.0,Salary Increases & Fixed Expenses Remain Stable,44836,20082.0,15918,36000.0,8836.0,19.71,0.03,Medium Risk
U133,2024,7,268236.0,Salary Increases & Fixed Expenses Remain Stable,61584,20082.0,25428,45510.0,16074.0,26.1,-0.02,Low Risk
U133,2024,8,284310.0,Salary Increases & Fixed Expenses Remain Stable,61584,20082.0,25024,45106.0,16478.0,26.76,-0.01,Low Risk
U133,2024,9,300788.0,Salary Increases & Fixed Expenses Remain Stable,61584,20082.0,20548,40630.0,20954.0,34.03,-0.04,Low Risk
U133,2024,10,321742.0,Salary Increases & Fixed Expenses Remain Stable,61584,20082.0,19427,39509.0,22075.0,35.85,-0.01,Low Risk
U133,2024,11,343817.0,Salary Increases & Fixed Expenses Remain Stable,61584,20082.0,28491,48573.0,13011.0,21.13,0.03,Medium Risk
U133,2024,12,356828.0,Salary Increases & Fixed Expenses Remain Stable,61584,20082.0,23466,43548.0,18036.0,29.29,0.05,Low Risk
U134,2024,1,231777.0,Salary Increases & Fixed Expenses Remain Stable,113652,67132.0,38048,105180.0,8472.0,7.45,-0.04,High Risk
U134,2024,2,240249.0,Salary Increases & Fixed Expenses Remain Stable,113652,67132.0,53849,120981.0,-7329.0,-6.45,-0.04,High Risk
U134,2024,3,232920.0,Salary Increases & Fixed Expenses Remain Stable,135841,67132.0,42886,110018.0,25823.0,19.01,0.02,Medium Risk
U134,2024,4,258743.0,Salary Increases & Fixed Expenses Remain Stable,135841,67132.0,41078,108210.0,27631.0,20.34,0.05,Medium Risk
U134,2024,5,286374.0,Salary Increases & Fixed Expenses Remain Stable,135841,67132.0,47396,114528.0,21313.0,15.69,-0.0,Medium Risk
U134,2024,6,307687.0,Salary Increases & Fixed Expenses Remain Stable,135841,67132.0,45348,112480.0,23361.0,17.2,-0.03,Medium Risk
U134,2024,7,331048.0,Salary Increases & Fixed Expenses Remain Stable,135841,67132.0,51187,118319.0,17522.0,12.9,0.01,High Risk
U134,2024,8,348570.0,Salary Increases & Fixed Expenses Remain Stable,135841,67132.0,50373,117505.0,18336.0,13.5,-0.05,High Risk
U134,2024,9,366906.0,Salary Increases & Fixed Expenses Remain Stable,135841,67132.0,53426,120558.0,15283.0,11.25,0.02,High Risk
U134,2024,10,382189.0,Salary Increases & Fixed Expenses Remain Stable,135841,67132.0,61394,128526.0,7315.0,5.38,0.03,High Risk
U134,2024,11,389504.0,Salary Increases & Fixed Expenses Remain Stable,135841,67132.0,56028,123160.0,12681.0,9.34,0.03,High Risk
U134,2024,12,402185.0,Salary Increases & Fixed Expenses Remain Stable,135841,67132.0,43614,110746.0,25095.0,18.47,-0.03,Medium Risk
U135,2024,1,232742.0,Salary Increases & Fixed Expenses Remain Stable,217954,77984.0,58140,136124.0,81830.0,37.54,0.02,Low Risk
U135,2024,2,314572.0,Salary Increases & Fixed Expenses Remain Stable,217954,77984.0,47370,125354.0,92600.0,42.49,0.02,Low Risk
U135,2024,3,407172.0,Salary Increases & Fixed Expenses Remain Stable,217954,77984.0,52647,130631.0,87323.0,40.06,0.03,Low Risk
U135,2024,4,494495.0,Salary Increases & Fixed Expenses Remain Stable,236866,77984.0,56917,134901.0,101965.0,43.05,-0.0,Low Risk
U135,2024,5,596460.0,Salary Increases & Fixed Expenses Remain Stable,236866,77984.0,54971,132955.0,103911.0,43.87,-0.0,Low Risk
U135,2024,6,700371.0,Salary Increases & Fixed Expenses Remain Stable,236866,77984.0,55363,133347.0,103519.0,43.7,0.01,Low Risk
U135,2024,7,803890.0,Salary Increases & Fixed Expenses Remain Stable,236866,77984.0,62607,140591.0,96275.0,40.65,-0.04,Low Risk
U135,2024,8,900165.0,Salary Increases & Fixed Expenses Remain Stable,236866,77984.0,48860,126844.0,110022.0,46.45,-0.02,Low Risk
U135,2024,9,1010187.0,Salary Increases & Fixed Expenses Remain Stable,236866,77984.0,52114,130098.0,106768.0,45.08,-0.0,Low Risk
U135,2024,10,1116955.0,Salary Increases & Fixed Expenses Remain Stable,236866,77984.0,48563,126547.0,110319.0,46.57,-0.04,Low Risk
U135,2024,11,1227274.0,Salary Increases & Fixed Expenses Remain Stable,236866,77984.0,49239,127223.0,109643.0,46.29,0.03,Low Risk
U135,2024,12,1336917.0,Salary Increases & Fixed Expenses Remain Stable,236866,77984.0,70160,148144.0,88722.0,37.46,-0.0,Low Risk
U136,2024,1,181912.0,Stable Salary & Increasing Fixed Expenses,42887,11500.0,10835,22335.0,20552.0,47.92,-0.02,Low Risk
U136,2024,2,202464.0,Stable Salary & Increasing Fixed Expenses,42887,11500.0,10835,22335.0,20552.0,47.92,0.03,Low Risk
U136,2024,3,223016.0,Stable Salary & Increasing Fixed Expenses,42887,11500.0,11047,22547.0,20340.0,47.43,-0.0,Low Risk
U136,2024,4,243356.0,Stable Salary & Increasing Fixed Expenses,42887,11500.0,9957,21457.0,21430.0,49.97,0.01,Low Risk
U136,2024,5,264786.0,Stable Salary & Increasing Fixed Expenses,42887,11500.0,9979,21479.0,21408.0,49.92,-0.01,Low Risk
U136,2024,6,286194.0,Stable Salary & Increasing Fixed Expenses,42887,11500.0,10570,22070.0,20817.0,48.54,0.04,Low Risk
U136,2024,7,307011.0,Stable Salary & Increasing Fixed Expenses,42887,11500.0,9036,20536.0,22351.0,52.12,-0.0,Low Risk
U136,2024,8,329362.0,Stable Salary & Increasing Fixed Expenses,42887,11500.0,10987,22487.0,20400.0,47.57,0.04,Low Risk
U136,2024,9,349762.0,Stable Salary & Increasing Fixed Expenses,42887,11500.0,10283,21783.0,21104.0,49.21,0.04,Low Risk
U136,2024,10,370866.0,Stable Salary & Increasing Fixed Expenses,42887,11500.0,14189,25689.0,17198.0,40.1,0.04,Low Risk
U136,2024,11,388064.0,Stable Salary & Increasing Fixed Expenses,42887,11500.0,12128,23628.0,19259.0,44.91,0.02,Low Risk
U136,2024,12,407323.0,Stable Salary & Increasing Fixed Expenses,42887,11500.0,12425,23925.0,18962.0,44.21,0.01,Low Risk
U137,2024,1,118704.0,Salary Increases & Fixed Expenses Increase,113559,61968.0,32441,94409.0,19150.0,16.86,0.04,Medium Risk
U137,2024,2,137854.0,Salary Increases & Fixed Expenses Increase,113559,63602.0,27022,90624.0,22935.0,20.2,-0.02,Medium Risk
U137,2024,3,160789.0,Salary Increases & Fixed Expenses Increase,113559,63602.0,28332,91934.0,21625.0,19.04,0.05,Medium Risk
U137,2024,4,182414.0,Salary Increases & Fixed Expenses Increase,113559,63602.0,29200,92802.0,20757.0,18.28,0.0,Medium Risk
U137,2024,5,203171.0,Salary Increases & Fixed Expenses Increase,142249,63602.0,32445,96047.0,46202.0,32.48,0.02,Low Risk
U137,2024,6,249373.0,Salary Increases & Fixed Expenses Increase,142249,63602.0,33520,97122.0,45127.0,31.72,0.04,Low Risk
U137,2024,7,294500.0,Salary Increases & Fixed Expenses Increase,142249,63602.0,34828,98430.0,43819.0,30.8,0.03,Low Risk
U137,2024,8,338319.0,Salary Increases & Fixed Expenses Increase,142249,63602.0,36121,99723.0,42526.0,29.9,0.0,Low Risk
U137,2024,9,380845.0,Salary Increases & Fixed Expenses Increase,142249,63602.0,30362,93964.0,48285.0,33.94,0.0,Low Risk
U137,2024,10,429130.0,Salary Increases & Fixed Expenses Increase,142249,63602.0,42487,106089.0,36160.0,25.42,0.04,Low Risk
U137,2024,11,465290.0,Salary Increases & Fixed Expenses Increase,142249,63602.0,42647,106249.0,36000.0,25.31,0.0,Low Risk
U137,2024,12,501290.0,Salary Increases & Fixed Expenses Increase,142249,63602.0,47778,111380.0,30869.0,21.7,0.02,Medium Risk
U138,2024,1,249510.0,Stable Salary & Increasing Fixed Expenses,26435,18290.0,6505,24795.0,1640.0,6.2,-0.04,High Risk
U138,2024,2,251150.0,Stable Salary & Increasing Fixed Expenses,26435,18290.0,5614,23904.0,2531.0,9.57,-0.01,High Risk
U138,2024,3,253681.0,Stable Salary & Increasing Fixed Expenses,26435,18290.0,6759,25049.0,1386.0,5.24,-0.03,High Risk
U138,2024,4,255067.0,Stable Salary & Increasing Fixed Expenses,26435,18290.0,7917,26207.0,228.0,0.86,-0.02,High Risk
U138,2024,5,255295.0,Stable Salary & Increasing Fixed Expenses,26435,18290.0,6100,24390.0,2045.0,7.74,-0.03,High Risk
U138,2024,6,257340.0,Stable Salary & Increasing Fixed Expenses,26435,18290.0,6710,25000.0,1435.0,5.43,-0.01,High Risk
U138,2024,7,258775.0,Stable Salary & Increasing Fixed Expenses,26435,18290.0,7670,25960.0,475.0,1.8,-0.01,High Risk
U138,2024,8,259250.0,Stable Salary & Increasing Fixed Expenses,26435,18290.0,7664,25954.0,481.0,1.82,-0.01,High Risk
U138,2024,9,259731.0,Stable Salary & Increasing Fixed Expenses,26435,18290.0,7373,25663.0,772.0,2.92,0.01,High Risk
U138,2024,10,260503.0,Stable Salary & Increasing Fixed Expenses,26435,18290.0,6475,24765.0,1670.0,6.32,0.04,High Risk
U138,2024,11,262173.0,Stable Salary & Increasing Fixed Expenses,26435,18290.0,5864,24154.0,2281.0,8.63,-0.01,High Risk
U138,2024,12,264454.0,Stable Salary & Increasing Fixed Expenses,26435,18290.0,5379,23669.0,2766.0,10.46,0.05,High Risk
U139,2024,1,59594.0,Salary Increases & Fixed Expenses Remain Stable,35924,19378.0,15891,35269.0,655.0,1.82,0.04,High Risk
U139,2024,2,60249.0,Salary Increases & Fixed Expenses Remain Stable,35924,19378.0,10904,30282.0,5642.0,15.71,0.0,Medium Risk
U139,2024,3,65891.0,Salary Increases & Fixed Expenses Remain Stable,35924,19378.0,14865,34243.0,1681.0,4.68,-0.01,High Risk
U139,2024,4,67572.0,Salary Increases & Fixed Expenses Remain Stable,35924,19378.0,14277,33655.0,2269.0,6.32,-0.04,High Risk
U139,2024,5,69841.0,Salary Increases & Fixed Expenses Remain Stable,35924,19378.0,14666,34044.0,1880.0,5.23,-0.01,High Risk
U139,2024,6,71721.0,Salary Increases & Fixed Expenses Remain Stable,35924,19378.0,14122,33500.0,2424.0,6.75,-0.03,High Risk
U139,2024,7,74145.0,Salary Increases & Fixed Expenses Remain Stable,52239,19378.0,17845,37223.0,15016.0,28.74,-0.0,Low Risk
U139,2024,8,89161.0,Salary Increases & Fixed Expenses Remain Stable,52239,19378.0,20829,40207.0,12032.0,23.03,0.01,Medium Risk
U139,2024,9,101193.0,Salary Increases & Fixed Expenses Remain Stable,52239,19378.0,27841,47219.0,5020.0,9.61,-0.0,High Risk
U139,2024,10,106213.0,Salary Increases & Fixed Expenses Remain Stable,52239,19378.0,18993,38371.0,13868.0,26.55,-0.03,Low Risk
U139,2024,11,120081.0,Salary Increases & Fixed Expenses Remain Stable,52239,19378.0,26123,45501.0,6738.0,12.9,-0.03,High Risk
U139,2024,12,126819.0,Salary Increases & Fixed Expenses Remain Stable,52239,19378.0,20501,39879.0,12360.0,23.66,0.01,Medium Risk
U140,2024,1,250000.0,Salary Increases & Fixed Expenses Remain Stable,272891,81216.0,94067,175283.0,97608.0,35.77,-0.03,Low Risk
U140,2024,2,347608.0,Salary Increases & Fixed Expenses Remain Stable,272891,81216.0,92742,173958.0,98933.0,36.25,0.02,Low Risk
U140,2024,3,446541.0,Salary Increases & Fixed Expenses Remain Stable,272891,81216.0,82321,163537.0,109354.0,40.07,-0.05,Low Risk
U140,2024,4,555895.0,Salary Increases & Fixed Expenses Remain Stable,272891,81216.0,123526,204742.0,68149.0,24.97,0.03,Medium Risk
U140,2024,5,624044.0,Salary Increases & Fixed Expenses Remain Stable,299142,81216.0,119338,200554.0,98588.0,32.96,-0.03,Low Risk
U140,2024,6,722632.0,Salary Increases & Fixed Expenses Remain Stable,299142,81216.0,107448,188664.0,110478.0,36.93,0.01,Low Risk
U140,2024,7,833110.0,Salary Increases & Fixed Expenses Remain Stable,299142,81216.0,137553,218769.0,80373.0,26.87,0.04,Low Risk
U140,2024,8,913483.0,Salary Increases & Fixed Expenses Remain Stable,299142,81216.0,142777,223993.0,75149.0,25.12,-0.03,Low Risk
U140,2024,9,988632.0,Salary Increases & Fixed Expenses Remain Stable,299142,81216.0,123077,204293.0,94849.0,31.71,0.02,Low Risk
U140,2024,10,1083481.0,Salary Increases & Fixed Expenses Remain Stable,299142,81216.0,97777,178993.0,120149.0,40.16,-0.03,Low Risk
U140,2024,11,1203630.0,Salary Increases & Fixed Expenses Remain Stable,299142,81216.0,138794,220010.0,79132.0,26.45,-0.01,Low Risk
U140,2024,12,1282762.0,Salary Increases & Fixed Expenses Remain Stable,299142,81216.0,94709,175925.0,123217.0,41.19,0.01,Low Risk
U141,2024,1,250000.0,Salary Increases & Fixed Expenses Increase,275356,86374.0,151817,238191.0,37165.0,13.5,0.04,High Risk
U141,2024,2,287165.0,Salary Increases & Fixed Expenses Increase,275356,87905.0,147125,235030.0,40326.0,14.65,0.01,High Risk
U141,2024,3,327491.0,Salary Increases & Fixed Expenses Increase,302326,87905.0,183134,271039.0,31287.0,10.35,0.02,High Risk
U141,2024,4,358778.0,Salary Increases & Fixed Expenses Increase,302326,87905.0,177472,265377.0,36949.0,12.22,-0.02,High Risk
U141,2024,5,395727.0,Salary Increases & Fixed Expenses Increase,302326,87905.0,166172,254077.0,48249.0,15.96,0.01,Medium Risk
U141,2024,6,443976.0,Salary Increases & Fixed Expenses Increase,302326,87905.0,164564,252469.0,49857.0,16.49,0.02,Medium Risk
U141,2024,7,493833.0,Salary Increases & Fixed Expenses Increase,302326,87905.0,211401,299306.0,3020.0,1.0,-0.03,High Risk
U141,2024,8,496853.0,Salary Increases & Fixed Expenses Increase,302326,87905.0,207251,295156.0,7170.0,2.37,0.02,High Risk
U141,2024,9,504023.0,Salary Increases & Fixed Expenses Increase,302326,87905.0,178477,266382.0,35944.0,11.89,-0.02,High Risk
U141,2024,10,539967.0,Salary Increases & Fixed Expenses Increase,302326,87905.0,194625,282530.0,19796.0,6.55,0.03,High Risk
U141,2024,11,559763.0,Salary Increases & Fixed Expenses Increase,302326,88623.0,170636,259259.0,43067.0,14.25,0.02,High Risk
U141,2024,12,602830.0,Salary Increases & Fixed Expenses Increase,302326,88623.0,182915,271538.0,30788.0,10.18,0.01,High Risk
U142,2024,1,200489.0,Stable Salary & Stable Fixed Expenses,162385,79639.0,86225,165864.0,-3479.0,-2.14,-0.04,High Risk
U142,2024,2,197010.0,Stable Salary & Stable Fixed Expenses,162385,79639.0,84504,164143.0,-1758.0,-1.08,0.04,High Risk
U142,2024,3,195252.0,Stable Salary & Stable Fixed Expenses,162385,79639.0,99612,179251.0,-16866.0,-10.39,-0.01,High Risk
U142,2024,4,178386.0,Stable Salary & Stable Fixed Expenses,162385,79639.0,108794,188433.0,-26048.0,-16.04,0.05,High Risk
U142,2024,5,152338.0,Stable Salary & Stable Fixed Expenses,162385,79639.0,90892,170531.0,-8146.0,-5.02,-0.02,High Risk
U142,2024,6,144192.0,Stable Salary & Stable Fixed Expenses,162385,79639.0,104667,184306.0,-21921.0,-13.5,-0.04,High Risk
U142,2024,7,122271.0,Stable Salary & Stable Fixed Expenses,162385,79639.0,104703,184342.0,-21957.0,-13.52,-0.0,High Risk
U142,2024,8,100314.0,Stable Salary & Stable Fixed Expenses,162385,79639.0,97218,176857.0,-14472.0,-8.91,-0.05,High Risk
U142,2024,9,85842.0,Stable Salary & Stable Fixed Expenses,162385,79639.0,99655,179294.0,-16909.0,-10.41,-0.0,High Risk
U142,2024,10,68933.0,Stable Salary & Stable Fixed Expenses,162385,79639.0,89941,169580.0,-7195.0,-4.43,-0.02,High Risk
U142,2024,11,61738.0,Stable Salary & Stable Fixed Expenses,162385,79639.0,98337,177976.0,-15591.0,-9.6,-0.02,High Risk
U142,2024,12,46147.0,Stable Salary & Stable Fixed Expenses,162385,79639.0,103375,183014.0,-20629.0,-12.7,-0.03,High Risk
U143,2024,1,243104.0,Salary Increases & Fixed Expenses Remain Stable,191772,48522.0,82746,131268.0,60504.0,31.55,-0.02,Low Risk
U143,2024,2,303608.0,Salary Increases & Fixed Expenses Remain Stable,191772,48522.0,70690,119212.0,72560.0,37.84,0.02,Low Risk
U143,2024,3,376168.0,Salary Increases & Fixed Expenses Remain Stable,191772,48522.0,63448,111970.0,79802.0,41.61,-0.01,Low Risk
U143,2024,4,455970.0,Salary Increases & Fixed Expenses Remain Stable,191772,48522.0,60047,108569.0,83203.0,43.39,0.0,Low Risk
U143,2024,5,539173.0,Salary Increases & Fixed Expenses Remain Stable,191772,48522.0,89199,137721.0,54051.0,28.19,-0.04,Low Risk
U143,2024,6,593224.0,Salary Increases & Fixed Expenses Remain Stable,191772,48522.0,72143,120665.0,71107.0,37.08,0.03,Low Risk
U143,2024,7,664331.0,Salary Increases & Fixed Expenses Remain Stable,213068,48522.0,93097,141619.0,71449.0,33.53,-0.02,Low Risk
U143,2024,8,735780.0,Salary Increases & Fixed Expenses Remain Stable,213068,48522.0,85011,133533.0,79535.0,37.33,-0.01,Low Risk
U143,2024,9,815315.0,Salary Increases & Fixed Expenses Remain Stable,213068,48522.0,111039,159561.0,53507.0,25.11,-0.04,Low Risk
U143,2024,10,868822.0,Salary Increases & Fixed Expenses Remain Stable,213068,48522.0,67155,115677.0,97391.0,45.71,-0.0,Low Risk
U143,2024,11,966213.0,Salary Increases & Fixed Expenses Remain Stable,213068,48522.0,89013,137535.0,75533.0,35.45,0.04,Low Risk
U143,2024,12,1041746.0,Salary Increases & Fixed Expenses Remain Stable,213068,48522.0,72239,120761.0,92307.0,43.32,-0.01,Low Risk
U144,2024,1,246848.0,Salary Increases & Fixed Expenses Increase,239271,66942.0,114020,180962.0,58309.0,24.37,-0.04,Medium Risk
U144,2024,2,305157.0,Salary Increases & Fixed Expenses Increase,239271,66942.0,78378,145320.0,93951.0,39.27,-0.02,Low Risk
U144,2024,3,399108.0,Salary Increases & Fixed Expenses Increase,239271,66942.0,81376,148318.0,90953.0,38.01,0.05,Low Risk
U144,2024,4,490061.0,Salary Increases & Fixed Expenses Increase,244342,67741.0,84737,152478.0,91864.0,37.6,-0.02,Low Risk
U144,2024,5,581925.0,Salary Increases & Fixed Expenses Increase,244342,67741.0,82746,150487.0,93855.0,38.41,-0.03,Low Risk
U144,2024,6,675780.0,Salary Increases & Fixed Expenses Increase,244342,67741.0,93535,161276.0,83066.0,34.0,-0.03,Low Risk
U144,2024,7,758846.0,Salary Increases & Fixed Expenses Increase,244342,67741.0,109011,176752.0,67590.0,27.66,0.03,Low Risk
U144,2024,8,826436.0,Salary Increases & Fixed Expenses Increase,244342,67741.0,96178,163919.0,80423.0,32.91,-0.03,Low Risk
U144,2024,9,906859.0,Salary Increases & Fixed Expenses Increase,244342,67741.0,109051,176792.0,67550.0,27.65,0.05,Low Risk
U144,2024,10,974409.0,Salary Increases & Fixed Expenses Increase,244342,67741.0,115830,183571.0,60771.0,24.87,-0.01,Medium Risk
U144,2024,11,1035180.0,Salary Increases & Fixed Expenses Increase,244342,67741.0,95085,162826.0,81516.0,33.36,0.05,Low Risk
U144,2024,12,1116696.0,Salary Increases & Fixed Expenses Increase,244342,67741.0,92564,160305.0,84037.0,34.39,0.03,Low Risk
U145,2024,1,184959.0,Salary Increases & Fixed Expenses Decrease,147071,66540.0,37648,104188.0,42883.0,29.16,-0.02,Low Risk
U145,2024,2,227842.0,Salary Increases & Fixed Expenses Decrease,147071,66540.0,34370,100910.0,46161.0,31.39,0.0,Low Risk
U145,2024,3,274003.0,Salary Increases & Fixed Expenses Decrease,147071,66540.0,46004,112544.0,34527.0,23.48,-0.01,Medium Risk
U145,2024,4,308530.0,Salary Increases & Fixed Expenses Decrease,147071,66540.0,30931,97471.0,49600.0,33.73,-0.03,Low Risk
U145,2024,5,358130.0,Salary Increases & Fixed Expenses Decrease,147071,66540.0,36279,102819.0,44252.0,30.09,0.03,Low Risk
U145,2024,6,402382.0,Salary Increases & Fixed Expenses Decrease,147071,66540.0,41389,107929.0,39142.0,26.61,-0.05,Low Risk
U145,2024,7,441524.0,Salary Increases & Fixed Expenses Decrease,167038,66540.0,44462,111002.0,56036.0,33.55,0.01,Low Risk
U145,2024,8,497560.0,Salary Increases & Fixed Expenses Decrease,167038,66540.0,48370,114910.0,52128.0,31.21,0.05,Low Risk
U145,2024,9,549688.0,Salary Increases & Fixed Expenses Decrease,167038,66540.0,35145,101685.0,65353.0,39.12,0.01,Low Risk
U145,2024,10,615041.0,Salary Increases & Fixed Expenses Decrease,167038,66540.0,46945,113485.0,53553.0,32.06,0.01,Low Risk
U145,2024,11,668594.0,Salary Increases & Fixed Expenses Decrease,167038,66540.0,44039,110579.0,56459.0,33.8,0.03,Low Risk
U145,2024,12,725053.0,Salary Increases & Fixed Expenses Decrease,167038,66540.0,55970,122510.0,44528.0,26.66,0.04,Low Risk
U146,2024,1,184873.0,Salary Increases & Fixed Expenses Increase,125776,61706.0,30144,91850.0,33926.0,26.97,0.03,Low Risk
U146,2024,2,218799.0,Salary Increases & Fixed Expenses Increase,125776,61706.0,37352,99058.0,26718.0,21.24,-0.04,Medium Risk
U146,2024,3,245517.0,Salary Increases & Fixed Expenses Increase,125776,61706.0,30071,91777.0,33999.0,27.03,-0.0,Low Risk
U146,2024,4,279516.0,Salary Increases & Fixed Expenses Increase,131324,61706.0,27517,89223.0,42101.0,32.06,-0.04,Low Risk
U146,2024,5,321617.0,Salary Increases & Fixed Expenses Increase,131324,62518.0,31525,94043.0,37281.0,28.39,0.03,Low Risk
U146,2024,6,358898.0,Salary Increases & Fixed Expenses Increase,131324,64402.0,31900,96302.0,35022.0,26.67,-0.02,Low Risk
U146,2024,7,393920.0,Salary Increases & Fixed Expenses Increase,131324,66081.0,37881,103962.0,27362.0,20.84,-0.04,Medium Risk
U146,2024,8,421282.0,Salary Increases & Fixed Expenses Increase,131324,66081.0,38917,104998.0,26326.0,20.05,0.03,Medium Risk
U146,2024,9,447608.0,Salary Increases & Fixed Expenses Increase,131324,66081.0,30799,96880.0,34444.0,26.23,-0.04,Low Risk
U146,2024,10,482052.0,Salary Increases & Fixed Expenses Increase,131324,66081.0,34041,100122.0,31202.0,23.76,0.03,Medium Risk
U146,2024,11,513254.0,Salary Increases & Fixed Expenses Increase,131324,66081.0,33766,99847.0,31477.0,23.97,-0.04,Medium Risk
U146,2024,12,544731.0,Salary Increases & Fixed Expenses Increase,131324,66081.0,28114,94195.0,37129.0,28.27,0.02,Low Risk
U147,2024,1,202766.0,Salary Increases & Fixed Expenses Increase,77778,36185.0,37653,73838.0,3940.0,5.07,0.03,High Risk
U147,2024,2,206706.0,Salary Increases & Fixed Expenses Increase,77778,36185.0,32253,68438.0,9340.0,12.01,-0.03,High Risk
U147,2024,3,216046.0,Salary Increases & Fixed Expenses Increase,77778,36185.0,46591,82776.0,-4998.0,-6.43,-0.03,High Risk
U147,2024,4,211048.0,Salary Increases & Fixed Expenses Increase,77778,36185.0,27108,63293.0,14485.0,18.62,0.01,Medium Risk
U147,2024,5,225533.0,Salary Increases & Fixed Expenses Increase,77778,36185.0,25797,61982.0,15796.0,20.31,-0.03,Medium Risk
U147,2024,6,241329.0,Salary Increases & Fixed Expenses Increase,88136,36185.0,37509,73694.0,14442.0,16.39,0.03,Medium Risk
U147,2024,7,255771.0,Salary Increases & Fixed Expenses Increase,88136,36185.0,31609,67794.0,20342.0,23.08,0.0,Medium Risk
U147,2024,8,276113.0,Salary Increases & Fixed Expenses Increase,88136,36185.0,34221,70406.0,17730.0,20.12,0.02,Medium Risk
U147,2024,9,293843.0,Salary Increases & Fixed Expenses Increase,88136,36185.0,40945,77130.0,11006.0,12.49,0.02,High Risk
U147,2024,10,304849.0,Salary Increases & Fixed Expenses Increase,88136,36185.0,53790,89975.0,-1839.0,-2.09,-0.0,High Risk
U147,2024,11,303010.0,Salary Increases & Fixed Expenses Increase,88136,36185.0,37419,73604.0,14532.0,16.49,-0.04,Medium Risk
U147,2024,12,317542.0,Salary Increases & Fixed Expenses Increase,88136,36185.0,50411,86596.0,1540.0,1.75,0.02,High Risk
U148,2024,1,223035.0,Salary Increases & Fixed Expenses Remain Stable,186940,60830.0,49666,110496.0,76444.0,40.89,-0.05,Low Risk
U148,2024,2,299479.0,Salary Increases & Fixed Expenses Remain Stable,186940,60830.0,37402,98232.0,88708.0,47.45,-0.04,Low Risk
U148,2024,3,388187.0,Salary Increases & Fixed Expenses Remain Stable,186940,60830.0,51736,112566.0,74374.0,39.78,-0.0,Low Risk
U148,2024,4,462561.0,Salary Increases & Fixed Expenses Remain Stable,186940,60830.0,40705,101535.0,85405.0,45.69,0.03,Low Risk
U148,2024,5,547966.0,Salary Increases & Fixed Expenses Remain Stable,186940,60830.0,55948,116778.0,70162.0,37.53,-0.0,Low Risk
U148,2024,6,618128.0,Salary Increases & Fixed Expenses Remain Stable,199078,60830.0,53896,114726.0,84352.0,42.37,-0.01,Low Risk
U148,2024,7,702480.0,Salary Increases & Fixed Expenses Remain Stable,199078,60830.0,40183,101013.0,98065.0,49.26,-0.05,Low Risk
U148,2024,8,800545.0,Salary Increases & Fixed Expenses Remain Stable,199078,60830.0,46685,107515.0,91563.0,45.99,-0.03,Low Risk
U148,2024,9,892108.0,Salary Increases & Fixed Expenses Remain Stable,199078,60830.0,40964,101794.0,97284.0,48.87,0.02,Low Risk
U148,2024,10,989392.0,Salary Increases & Fixed Expenses Remain Stable,199078,60830.0,55010,115840.0,83238.0,41.81,-0.04,Low Risk
U148,2024,11,1072630.0,Salary Increases & Fixed Expenses Remain Stable,199078,60830.0,55643,116473.0,82605.0,41.49,-0.02,Low Risk
U148,2024,12,1155235.0,Salary Increases & Fixed Expenses Remain Stable,199078,60830.0,43795,104625.0,94453.0,47.45,0.02,Low Risk
U149,2024,1,229906.0,Stable Salary & Stable Fixed Expenses,228799,84652.0,131502,216154.0,12645.0,5.53,0.03,High Risk
U149,2024,2,242551.0,Stable Salary & Stable Fixed Expenses,228799,84652.0,132672,217324.0,11475.0,5.02,-0.01,High Risk
U149,2024,3,254026.0,Stable Salary & Stable Fixed Expenses,228799,84652.0,132008,216660.0,12139.0,5.31,0.04,High Risk
U149,2024,4,266165.0,Stable Salary & Stable Fixed Expenses,228799,84652.0,152533,237185.0,-8386.0,-3.67,-0.01,High Risk
U149,2024,5,257779.0,Stable Salary & Stable Fixed Expenses,228799,84652.0,135711,220363.0,8436.0,3.69,-0.04,High Risk
U149,2024,6,266215.0,Stable Salary & Stable Fixed Expenses,228799,84652.0,141348,226000.0,2799.0,1.22,-0.01,High Risk
U149,2024,7,269014.0,Stable Salary & Stable Fixed Expenses,228799,84652.0,150354,235006.0,-6207.0,-2.71,-0.04,High Risk
U149,2024,8,262807.0,Stable Salary & Stable Fixed Expenses,228799,84652.0,150649,235301.0,-6502.0,-2.84,-0.03,High Risk
U149,2024,9,256305.0,Stable Salary & Stable Fixed Expenses,228799,84652.0,122465,207117.0,21682.0,9.48,0.04,High Risk
U149,2024,10,277987.0,Stable Salary & Stable Fixed Expenses,228799,84652.0,121785,206437.0,22362.0,9.77,0.04,High Risk
U149,2024,11,300349.0,Stable Salary & Stable Fixed Expenses,228799,84652.0,157368,242020.0,-13221.0,-5.78,0.05,High Risk
U149,2024,12,287128.0,Stable Salary & Stable Fixed Expenses,228799,84652.0,150922,235574.0,-6775.0,-2.96,0.01,High Risk
U150,2024,1,230861.0,Stable Salary & Increasing Fixed Expenses,193543,51036.0,76650,127686.0,65857.0,34.03,0.04,Low Risk
U150,2024,2,296718.0,Stable Salary & Increasing Fixed Expenses,193543,51036.0,61159,112195.0,81348.0,42.03,0.03,Low Risk
U150,2024,3,378066.0,Stable Salary & Increasing Fixed Expenses,193543,51036.0,80013,131049.0,62494.0,32.29,-0.03,Low Risk
U150,2024,4,440560.0,Stable Salary & Increasing Fixed Expenses,193543,51036.0,71543,122579.0,70964.0,36.67,-0.03,Low Risk
U150,2024,5,511524.0,Stable Salary & Increasing Fixed Expenses,193543,52192.0,94441,146633.0,46910.0,24.24,-0.03,Medium Risk
U150,2024,6,558434.0,Stable Salary & Increasing Fixed Expenses,193543,52192.0,63003,115195.0,78348.0,40.48,-0.02,Low Risk
U150,2024,7,636782.0,Stable Salary & Increasing Fixed Expenses,193543,52192.0,82823,135015.0,58528.0,30.24,-0.0,Low Risk
U150,2024,8,695310.0,Stable Salary & Increasing Fixed Expenses,193543,52192.0,72209,124401.0,69142.0,35.72,0.04,Low Risk
U150,2024,9,764452.0,Stable Salary & Increasing Fixed Expenses,193543,52192.0,103787,155979.0,37564.0,19.41,0.03,Medium Risk
U150,2024,10,802016.0,Stable Salary & Increasing Fixed Expenses,193543,52192.0,78297,130489.0,63054.0,32.58,0.03,Low Risk
U150,2024,11,865070.0,Stable Salary & Increasing Fixed Expenses,193543,52192.0,85926,138118.0,55425.0,28.64,0.02,Low Risk
U150,2024,12,920495.0,Stable Salary & Increasing Fixed Expenses,193543,52192.0,68645,120837.0,72706.0,37.57,-0.01,Low Risk
U151,2024,1,163919.0,Stable Salary & Increasing Fixed Expenses,30248,16154.0,6082,22236.0,8012.0,26.49,0.01,Low Risk
U151,2024,2,171931.0,Stable Salary & Increasing Fixed Expenses,30248,16154.0,8095,24249.0,5999.0,19.83,-0.03,Medium Risk
U151,2024,3,177930.0,Stable Salary & Increasing Fixed Expenses,30248,17549.0,10927,28476.0,1772.0,5.86,0.01,High Risk
U151,2024,4,179702.0,Stable Salary & Increasing Fixed Expenses,30248,17549.0,7602,25151.0,5097.0,16.85,-0.03,Medium Risk
U151,2024,5,184799.0,Stable Salary & Increasing Fixed Expenses,30248,17549.0,7347,24896.0,5352.0,17.69,-0.01,Medium Risk
U151,2024,6,190151.0,Stable Salary & Increasing Fixed Expenses,30248,17549.0,8404,25953.0,4295.0,14.2,-0.01,High Risk
U151,2024,7,194446.0,Stable Salary & Increasing Fixed Expenses,30248,17549.0,6322,23871.0,6377.0,21.08,-0.02,Medium Risk
U151,2024,8,200823.0,Stable Salary & Increasing Fixed Expenses,30248,17549.0,7856,25405.0,4843.0,16.01,0.04,Medium Risk
U151,2024,9,205666.0,Stable Salary & Increasing Fixed Expenses,30248,17549.0,7306,24855.0,5393.0,17.83,-0.03,Medium Risk
U151,2024,10,211059.0,Stable Salary & Increasing Fixed Expenses,30248,17549.0,7955,25504.0,4744.0,15.68,0.04,Medium Risk
U151,2024,11,215803.0,Stable Salary & Increasing Fixed Expenses,30248,17549.0,9622,27171.0,3077.0,10.17,0.03,High Risk
U151,2024,12,218880.0,Stable Salary & Increasing Fixed Expenses,30248,17549.0,10989,28538.0,1710.0,5.65,-0.01,High Risk
U152,2024,1,202850.0,Stable Salary & Stable Fixed Expenses,167606,60743.0,67863,128606.0,39000.0,23.27,0.01,Medium Risk
U152,2024,2,241850.0,Stable Salary & Stable Fixed Expenses,167606,60743.0,68961,129704.0,37902.0,22.61,0.03,Medium Risk
U152,2024,3,279752.0,Stable Salary & Stable Fixed Expenses,167606,60743.0,58364,119107.0,48499.0,28.94,0.03,Low Risk
U152,2024,4,328251.0,Stable Salary & Stable Fixed Expenses,167606,60743.0,82770,143513.0,24093.0,14.37,-0.05,High Risk
U152,2024,5,352344.0,Stable Salary & Stable Fixed Expenses,167606,60743.0,60526,121269.0,46337.0,27.65,-0.04,Low Risk
U152,2024,6,398681.0,Stable Salary & Stable Fixed Expenses,167606,60743.0,64404,125147.0,42459.0,25.33,-0.03,Low Risk
U152,2024,7,441140.0,Stable Salary & Stable Fixed Expenses,167606,60743.0,54790,115533.0,52073.0,31.07,-0.0,Low Risk
U152,2024,8,493213.0,Stable Salary & Stable Fixed Expenses,167606,60743.0,82937,143680.0,23926.0,14.28,-0.04,High Risk
U152,2024,9,517139.0,Stable Salary & Stable Fixed Expenses,167606,60743.0,69022,129765.0,37841.0,22.58,0.04,Medium Risk
U152,2024,10,554980.0,Stable Salary & Stable Fixed Expenses,167606,60743.0,60113,120856.0,46750.0,27.89,-0.04,Low Risk
U152,2024,11,601730.0,Stable Salary & Stable Fixed Expenses,167606,60743.0,58689,119432.0,48174.0,28.74,-0.0,Low Risk
U152,2024,12,649904.0,Stable Salary & Stable Fixed Expenses,167606,60743.0,79289,140032.0,27574.0,16.45,-0.03,Medium Risk
U153,2024,1,228453.0,Salary Increases & Fixed Expenses Remain Stable,221809,87414.0,69523,156937.0,64872.0,29.25,-0.02,Low Risk
U153,2024,2,293325.0,Salary Increases & Fixed Expenses Remain Stable,221809,87414.0,88760,176174.0,45635.0,20.57,-0.05,Medium Risk
U153,2024,3,338960.0,Salary Increases & Fixed Expenses Remain Stable,221809,87414.0,68861,156275.0,65534.0,29.55,-0.0,Low Risk
U153,2024,4,404494.0,Salary Increases & Fixed Expenses Remain Stable,221809,87414.0,94123,181537.0,40272.0,18.16,-0.01,Medium Risk
U153,2024,5,444766.0,Salary Increases & Fixed Expenses Remain Stable,221809,87414.0,99170,186584.0,35225.0,15.88,-0.01,Medium Risk
U153,2024,6,479991.0,Salary Increases & Fixed Expenses Remain Stable,221809,87414.0,73689,161103.0,60706.0,27.37,-0.04,Low Risk
U153,2024,7,540697.0,Salary Increases & Fixed Expenses Remain Stable,231230,87414.0,91426,178840.0,52390.0,22.66,0.01,Medium Risk
U153,2024,8,593087.0,Salary Increases & Fixed Expenses Remain Stable,231230,87414.0,76456,163870.0,67360.0,29.13,-0.0,Low Risk
U153,2024,9,660447.0,Salary Increases & Fixed Expenses Remain Stable,231230,87414.0,127430,214844.0,16386.0,7.09,0.01,High Risk
U153,2024,10,676833.0,Salary Increases & Fixed Expenses Remain Stable,231230,87414.0,92011,179425.0,51805.0,22.4,0.05,Medium Risk
U153,2024,11,728638.0,Salary Increases & Fixed Expenses Remain Stable,231230,87414.0,123772,211186.0,20044.0,8.67,-0.04,High Risk
U153,2024,12,748682.0,Salary Increases & Fixed Expenses Remain Stable,231230,87414.0,112265,199679.0,31551.0,13.64,-0.0,High Risk
U154,2024,1,205982.0,Stable Salary & Stable Fixed Expenses,119251,60852.0,34431,95283.0,23968.0,20.1,-0.05,Medium Risk
U154,2024,2,229950.0,Stable Salary & Stable Fixed Expenses,119251,60852.0,31830,92682.0,26569.0,22.28,0.04,Medium Risk
U154,2024,3,256519.0,Stable Salary & Stable Fixed Expenses,119251,60852.0,28255,89107.0,30144.0,25.28,-0.01,Low Risk
U154,2024,4,286663.0,Stable Salary & Stable Fixed Expenses,119251,60852.0,26545,87397.0,31854.0,26.71,0.01,Low Risk
U154,2024,5,318517.0,Stable Salary & Stable Fixed Expenses,119251,60852.0,30027,90879.0,28372.0,23.79,0.01,Medium Risk
U154,2024,6,346889.0,Stable Salary & Stable Fixed Expenses,119251,60852.0,27484,88336.0,30915.0,25.92,-0.01,Low Risk
U154,2024,7,377804.0,Stable Salary & Stable Fixed Expenses,119251,60852.0,33909,94761.0,24490.0,20.54,0.04,Medium Risk
U154,2024,8,402294.0,Stable Salary & Stable Fixed Expenses,119251,60852.0,25295,86147.0,33104.0,27.76,-0.04,Low Risk
U154,2024,9,435398.0,Stable Salary & Stable Fixed Expenses,119251,60852.0,36694,97546.0,21705.0,18.2,0.02,Medium Risk
U154,2024,10,457103.0,Stable Salary & Stable Fixed Expenses,119251,60852.0,25214,86066.0,33185.0,27.83,0.02,Low Risk
U154,2024,11,490288.0,Stable Salary & Stable Fixed Expenses,119251,60852.0,28771,89623.0,29628.0,24.85,0.02,Medium Risk
U154,2024,12,519916.0,Stable Salary & Stable Fixed Expenses,119251,60852.0,32786,93638.0,25613.0,21.48,0.03,Medium Risk
U155,2024,1,89973.0,Stable Salary & Increasing Fixed Expenses,43106,20284.0,10906,31190.0,11916.0,27.64,0.02,Low Risk
U155,2024,2,101889.0,Stable Salary & Increasing Fixed Expenses,43106,20284.0,10109,30393.0,12713.0,29.49,-0.02,Low Risk
U155,2024,3,114602.0,Stable Salary & Increasing Fixed Expenses,43106,21063.0,10718,31781.0,11325.0,26.27,-0.01,Low Risk
U155,2024,4,125927.0,Stable Salary & Increasing Fixed Expenses,43106,21063.0,8862,29925.0,13181.0,30.58,-0.0,Low Risk
U155,2024,5,139108.0,Stable Salary & Increasing Fixed Expenses,43106,21063.0,12044,33107.0,9999.0,23.2,0.0,Medium Risk
U155,2024,6,149107.0,Stable Salary & Increasing Fixed Expenses,43106,21063.0,10413,31476.0,11630.0,26.98,0.02,Low Risk
U155,2024,7,160737.0,Stable Salary & Increasing Fixed Expenses,43106,21063.0,11253,32316.0,10790.0,25.03,0.05,Low Risk
U155,2024,8,171527.0,Stable Salary & Increasing Fixed Expenses,43106,21063.0,10532,31595.0,11511.0,26.7,0.04,Low Risk
U155,2024,9,183038.0,Stable Salary & Increasing Fixed Expenses,43106,21063.0,9975,31038.0,12068.0,28.0,0.02,Low Risk
U155,2024,10,195106.0,Stable Salary & Increasing Fixed Expenses,43106,21063.0,11957,33020.0,10086.0,23.4,0.04,Medium Risk
U155,2024,11,205192.0,Stable Salary & Increasing Fixed Expenses,43106,21063.0,10428,31491.0,11615.0,26.95,0.02,Low Risk
U155,2024,12,216807.0,Stable Salary & Increasing Fixed Expenses,43106,21063.0,9308,30371.0,12735.0,29.54,0.02,Low Risk
U156,2024,1,140307.0,Stable Salary & Increasing Fixed Expenses,32531,14890.0,22631,37521.0,-4990.0,-15.34,0.01,High Risk
U156,2024,2,135317.0,Stable Salary & Increasing Fixed Expenses,32531,14890.0,19587,34477.0,-1946.0,-5.98,-0.04,High Risk
U156,2024,3,133371.0,Stable Salary & Increasing Fixed Expenses,32531,14890.0,20086,34976.0,-2445.0,-7.52,0.02,High Risk
U156,2024,4,130926.0,Stable Salary & Increasing Fixed Expenses,32531,14890.0,19462,34352.0,-1821.0,-5.6,0.02,High Risk
U156,2024,5,129105.0,Stable Salary & Increasing Fixed Expenses,32531,14890.0,16373,31263.0,1268.0,3.9,-0.05,High Risk
U156,2024,6,130373.0,Stable Salary & Increasing Fixed Expenses,32531,14890.0,20228,35118.0,-2587.0,-7.95,0.01,High Risk
U156,2024,7,127786.0,Stable Salary & Increasing Fixed Expenses,32531,14890.0,22129,37019.0,-4488.0,-13.8,0.0,High Risk
U156,2024,8,123298.0,Stable Salary & Increasing Fixed Expenses,32531,14890.0,21287,36177.0,-3646.0,-11.21,-0.0,High Risk
U156,2024,9,119652.0,Stable Salary & Increasing Fixed Expenses,32531,16273.0,17645,33918.0,-1387.0,-4.26,0.01,High Risk
U156,2024,10,118265.0,Stable Salary & Increasing Fixed Expenses,32531,16273.0,18831,35104.0,-2573.0,-7.91,0.01,High Risk
U156,2024,11,115692.0,Stable Salary & Increasing Fixed Expenses,32531,16273.0,20168,36441.0,-3910.0,-12.02,0.03,High Risk
U156,2024,12,111782.0,Stable Salary & Increasing Fixed Expenses,32531,16273.0,21320,37593.0,-5062.0,-15.56,-0.01,High Risk
U157,2024,1,250000.0,Salary Increases & Fixed Expenses Remain Stable,297304,67315.0,92286,159601.0,137703.0,46.32,-0.03,Low Risk
U157,2024,2,387703.0,Salary Increases & Fixed Expenses Remain Stable,297304,67315.0,107740,175055.0,122249.0,41.12,0.05,Low Risk
U157,2024,3,509952.0,Salary Increases & Fixed Expenses Remain Stable,314235,67315.0,154107,221422.0,92813.0,29.54,0.03,Low Risk
U157,2024,4,602765.0,Salary Increases & Fixed Expenses Remain Stable,314235,67315.0,133202,200517.0,113718.0,36.19,0.01,Low Risk
U157,2024,5,716483.0,Salary Increases & Fixed Expenses Remain Stable,314235,67315.0,152769,220084.0,94151.0,29.96,0.01,Low Risk
U157,2024,6,810634.0,Salary Increases & Fixed Expenses Remain Stable,314235,67315.0,140408,207723.0,106512.0,33.9,-0.03,Low Risk
U157,2024,7,917146.0,Salary Increases & Fixed Expenses Remain Stable,314235,67315.0,111672,178987.0,135248.0,43.04,-0.04,Low Risk
U157,2024,8,1052394.0,Salary Increases & Fixed Expenses Remain Stable,314235,67315.0,144497,211812.0,102423.0,32.59,0.03,Low Risk
U157,2024,9,1154817.0,Salary Increases & Fixed Expenses Remain Stable,314235,67315.0,106496,173811.0,140424.0,44.69,-0.01,Low Risk
U157,2024,10,1295241.0,Salary Increases & Fixed Expenses Remain Stable,314235,67315.0,119258,186573.0,127662.0,40.63,0.02,Low Risk
U157,2024,11,1422903.0,Salary Increases & Fixed Expenses Remain Stable,314235,67315.0,136593,203908.0,110327.0,35.11,0.01,Low Risk
U157,2024,12,1533230.0,Salary Increases & Fixed Expenses Remain Stable,314235,67315.0,110402,177717.0,136518.0,43.44,0.02,Low Risk
U158,2024,1,248637.0,Salary Increases & Fixed Expenses Remain Stable,236068,115532.0,63200,178732.0,57336.0,24.29,-0.01,Medium Risk
U158,2024,2,305973.0,Salary Increases & Fixed Expenses Remain Stable,236068,115532.0,52671,168203.0,67865.0,28.75,0.05,Low Risk
U158,2024,3,373838.0,Salary Increases & Fixed Expenses Remain Stable,236068,115532.0,65951,181483.0,54585.0,23.12,0.03,Medium Risk
U158,2024,4,428423.0,Salary Increases & Fixed Expenses Remain Stable,236068,115532.0,50538,166070.0,69998.0,29.65,0.01,Low Risk
U158,2024,5,498421.0,Salary Increases & Fixed Expenses Remain Stable,236068,115532.0,58740,174272.0,61796.0,26.18,0.02,Low Risk
U158,2024,6,560217.0,Salary Increases & Fixed Expenses Remain Stable,236068,115532.0,68233,183765.0,52303.0,22.16,0.02,Medium Risk
U158,2024,7,612520.0,Salary Increases & Fixed Expenses Remain Stable,236068,115532.0,68923,184455.0,51613.0,21.86,-0.05,Medium Risk
U158,2024,8,664133.0,Salary Increases & Fixed Expenses Remain Stable,250173,115532.0,68727,184259.0,65914.0,26.35,0.02,Low Risk
U158,2024,9,730047.0,Salary Increases & Fixed Expenses Remain Stable,250173,115532.0,58867,174399.0,75774.0,30.29,0.04,Low Risk
U158,2024,10,805821.0,Salary Increases & Fixed Expenses Remain Stable,250173,115532.0,67477,183009.0,67164.0,26.85,-0.02,Low Risk
U158,2024,11,872985.0,Salary Increases & Fixed Expenses Remain Stable,250173,115532.0,71221,186753.0,63420.0,25.35,-0.03,Low Risk
U158,2024,12,936405.0,Salary Increases & Fixed Expenses Remain Stable,250173,115532.0,55361,170893.0,79280.0,31.69,-0.01,Low Risk
U159,2024,1,250000.0,Stable Salary & Decreasing Fixed Expenses,273081,79159.0,103008,182167.0,90914.0,33.29,0.03,Low Risk
U159,2024,2,340914.0,Stable Salary & Decreasing Fixed Expenses,273081,79159.0,126019,205178.0,67903.0,24.87,0.04,Medium Risk
U159,2024,3,408817.0,Stable Salary & Decreasing Fixed Expenses,273081,79159.0,97078,176237.0,96844.0,35.46,0.02,Low Risk
U159,2024,4,505661.0,Stable Salary & Decreasing Fixed Expenses,273081,79159.0,98487,177646.0,95435.0,34.95,0.02,Low Risk
U159,2024,5,601096.0,Stable Salary & Decreasing Fixed Expenses,273081,79159.0,83820,162979.0,110102.0,40.32,0.03,Low Risk
U159,2024,6,711198.0,Stable Salary & Decreasing Fixed Expenses,273081,79159.0,111178,190337.0,82744.0,30.3,0.0,Low Risk
U159,2024,7,793942.0,Stable Salary & Decreasing Fixed Expenses,273081,79159.0,120478,199637.0,73444.0,26.89,-0.04,Low Risk
U159,2024,8,867386.0,Stable Salary & Decreasing Fixed Expenses,273081,79159.0,89203,168362.0,104719.0,38.35,0.0,Low Risk
U159,2024,9,972105.0,Stable Salary & Decreasing Fixed Expenses,273081,79159.0,146480,225639.0,47442.0,17.37,0.02,Medium Risk
U159,2024,10,1019547.0,Stable Salary & Decreasing Fixed Expenses,273081,79159.0,84165,163324.0,109757.0,40.19,0.03,Low Risk
U159,2024,11,1129304.0,Stable Salary & Decreasing Fixed Expenses,273081,79159.0,105988,185147.0,87934.0,32.2,0.0,Low Risk
U159,2024,12,1217238.0,Stable Salary & Decreasing Fixed Expenses,273081,79159.0,113466,192625.0,80456.0,29.46,0.03,Low Risk
U160,2024,1,250000.0,Salary Increases & Fixed Expenses Increase,271232,104018.0,80522,184540.0,86692.0,31.96,-0.01,Low Risk
U160,2024,2,336692.0,Salary Increases & Fixed Expenses Increase,271232,104679.0,67151,171830.0,99402.0,36.65,0.04,Low Risk
U160,2024,3,436094.0,Salary Increases & Fixed Expenses Increase,293819,104679.0,83177,187856.0,105963.0,36.06,-0.03,Low Risk
U160,2024,4,542057.0,Salary Increases & Fixed Expenses Increase,293819,104679.0,70031,174710.0,119109.0,40.54,-0.01,Low Risk
U160,2024,5,661166.0,Salary Increases & Fixed Expenses Increase,293819,105504.0,71576,177080.0,116739.0,39.73,0.02,Low Risk
U160,2024,6,777905.0,Salary Increases & Fixed Expenses Increase,293819,105504.0,83244,188748.0,105071.0,35.76,-0.03,Low Risk
U160,2024,7,882976.0,Salary Increases & Fixed Expenses Increase,293819,105504.0,68040,173544.0,120275.0,40.94,-0.02,Low Risk
U160,2024,8,1003251.0,Salary Increases & Fixed Expenses Increase,293819,105504.0,62069,167573.0,126246.0,42.97,0.01,Low Risk
U160,2024,9,1129497.0,Salary Increases & Fixed Expenses Increase,293819,105504.0,85598,191102.0,102717.0,34.96,-0.03,Low Risk
U160,2024,10,1232214.0,Salary Increases & Fixed Expenses Increase,293819,105504.0,74188,179692.0,114127.0,38.84,-0.04,Low Risk
U160,2024,11,1346341.0,Salary Increases & Fixed Expenses Increase,293819,105504.0,100425,205929.0,87890.0,29.91,-0.05,Low Risk
U160,2024,12,1434231.0,Salary Increases & Fixed Expenses Increase,293819,106310.0,110971,217281.0,76538.0,26.05,-0.05,Low Risk
U161,2024,1,234892.0,Stable Salary & Decreasing Fixed Expenses,58269,25020.0,19409,44429.0,13840.0,23.75,-0.03,Medium Risk
U161,2024,2,248732.0,Stable Salary & Decreasing Fixed Expenses,58269,25020.0,19629,44649.0,13620.0,23.37,-0.05,Medium Risk
U161,2024,3,262352.0,Stable Salary & Decreasing Fixed Expenses,58269,25020.0,17707,42727.0,15542.0,26.67,-0.04,Low Risk
U161,2024,4,277894.0,Stable Salary & Decreasing Fixed Expenses,58269,23913.0,24267,48180.0,10089.0,17.31,-0.04,Medium Risk
U161,2024,5,287983.0,Stable Salary & Decreasing Fixed Expenses,58269,23913.0,19013,42926.0,15343.0,26.33,-0.03,Low Risk
U161,2024,6,303326.0,Stable Salary & Decreasing Fixed Expenses,58269,23913.0,22071,45984.0,12285.0,21.08,0.04,Medium Risk
U161,2024,7,315611.0,Stable Salary & Decreasing Fixed Expenses,58269,23913.0,24592,48505.0,9764.0,16.76,0.01,Medium Risk
U161,2024,8,325375.0,Stable Salary & Decreasing Fixed Expenses,58269,23913.0,20162,44075.0,14194.0,24.36,0.0,Medium Risk
U161,2024,9,339569.0,Stable Salary & Decreasing Fixed Expenses,58269,23913.0,22592,46505.0,11764.0,20.19,0.01,Medium Risk
U161,2024,10,351333.0,Stable Salary & Decreasing Fixed Expenses,58269,23913.0,20724,44637.0,13632.0,23.39,0.03,Medium Risk
U161,2024,11,364965.0,Stable Salary & Decreasing Fixed Expenses,58269,23913.0,19796,43709.0,14560.0,24.99,-0.03,Medium Risk
U161,2024,12,379525.0,Stable Salary & Decreasing Fixed Expenses,58269,23913.0,23145,47058.0,11211.0,19.24,-0.04,Medium Risk
U162,2024,1,234496.0,Salary Increases & Fixed Expenses Increase,171638,74143.0,70005,144148.0,27490.0,16.02,-0.0,Medium Risk
U162,2024,2,261986.0,Salary Increases & Fixed Expenses Increase,171638,74643.0,63187,137830.0,33808.0,19.7,-0.01,Medium Risk
U162,2024,3,295794.0,Salary Increases & Fixed Expenses Increase,171638,74643.0,105479,180122.0,-8484.0,-4.94,-0.01,High Risk
U162,2024,4,287310.0,Salary Increases & Fixed Expenses Increase,171638,74643.0,63574,138217.0,33421.0,19.47,0.02,Medium Risk
U162,2024,5,320731.0,Salary Increases & Fixed Expenses Increase,171638,74643.0,61283,135926.0,35712.0,20.81,-0.03,Medium Risk
U162,2024,6,356443.0,Salary Increases & Fixed Expenses Increase,171638,74643.0,74442,149085.0,22553.0,13.14,0.03,High Risk
U162,2024,7,378996.0,Salary Increases & Fixed Expenses Increase,201421,74643.0,77276,151919.0,49502.0,24.58,-0.01,Medium Risk
U162,2024,8,428498.0,Salary Increases & Fixed Expenses Increase,201421,74643.0,92720,167363.0,34058.0,16.91,0.01,Medium Risk
U162,2024,9,462556.0,Salary Increases & Fixed Expenses Increase,201421,74643.0,77731,152374.0,49047.0,24.35,-0.0,Medium Risk
U162,2024,10,511603.0,Salary Increases & Fixed Expenses Increase,201421,74643.0,123331,197974.0,3447.0,1.71,-0.05,High Risk
U162,2024,11,515050.0,Salary Increases & Fixed Expenses Increase,201421,74643.0,87944,162587.0,38834.0,19.28,-0.03,Medium Risk
U162,2024,12,553884.0,Salary Increases & Fixed Expenses Increase,201421,74643.0,108863,183506.0,17915.0,8.89,-0.01,High Risk
U163,2024,1,204974.0,Stable Salary & Decreasing Fixed Expenses,127063,44814.0,58965,103779.0,23284.0,18.32,-0.03,Medium Risk
U163,2024,2,228258.0,Stable Salary & Decreasing Fixed Expenses,127063,44814.0,63242,108056.0,19007.0,14.96,-0.03,High Risk
U163,2024,3,247265.0,Stable Salary & Decreasing Fixed Expenses,127063,44814.0,48614,93428.0,33635.0,26.47,-0.04,Low Risk
U163,2024,4,280900.0,Stable Salary & Decreasing Fixed Expenses,127063,44814.0,63095,107909.0,19154.0,15.07,0.01,Medium Risk
U163,2024,5,300054.0,Stable Salary & Decreasing Fixed Expenses,127063,44814.0,51671,96485.0,30578.0,24.07,0.01,Medium Risk
U163,2024,6,330632.0,Stable Salary & Decreasing Fixed Expenses,127063,44814.0,46791,91605.0,35458.0,27.91,0.04,Low Risk
U163,2024,7,366090.0,Stable Salary & Decreasing Fixed Expenses,127063,44814.0,63155,107969.0,19094.0,15.03,-0.04,Medium Risk
U163,2024,8,385184.0,Stable Salary & Decreasing Fixed Expenses,127063,43091.0,61413,104504.0,22559.0,17.75,-0.04,Medium Risk
U163,2024,9,407743.0,Stable Salary & Decreasing Fixed Expenses,127063,43091.0,43898,86989.0,40074.0,31.54,0.01,Low Risk
U163,2024,10,447817.0,Stable Salary & Decreasing Fixed Expenses,127063,43091.0,52278,95369.0,31694.0,24.94,-0.02,Medium Risk
U163,2024,11,479511.0,Stable Salary & Decreasing Fixed Expenses,127063,43091.0,47716,90807.0,36256.0,28.53,-0.03,Low Risk
U163,2024,12,515767.0,Stable Salary & Decreasing Fixed Expenses,127063,43091.0,50888,93979.0,33084.0,26.04,0.03,Low Risk
U164,2024,1,106669.0,Salary Increases & Fixed Expenses Remain Stable,32179,11410.0,16395,27805.0,4374.0,13.59,-0.04,High Risk
U164,2024,2,111043.0,Salary Increases & Fixed Expenses Remain Stable,32179,11410.0,17554,28964.0,3215.0,9.99,-0.01,High Risk
U164,2024,3,114258.0,Salary Increases & Fixed Expenses Remain Stable,56233,11410.0,35807,47217.0,9016.0,16.03,0.03,Medium Risk
U164,2024,4,123274.0,Salary Increases & Fixed Expenses Remain Stable,56233,11410.0,28796,40206.0,16027.0,28.5,-0.04,Low Risk
U164,2024,5,139301.0,Salary Increases & Fixed Expenses Remain Stable,56233,11410.0,33987,45397.0,10836.0,19.27,-0.01,Medium Risk
U164,2024,6,150137.0,Salary Increases & Fixed Expenses Remain Stable,56233,11410.0,29844,41254.0,14979.0,26.64,0.02,Low Risk
U164,2024,7,165116.0,Salary Increases & Fixed Expenses Remain Stable,56233,11410.0,30363,41773.0,14460.0,25.71,-0.03,Low Risk
U164,2024,8,179576.0,Salary Increases & Fixed Expenses Remain Stable,56233,11410.0,35766,47176.0,9057.0,16.11,-0.01,Medium Risk
U164,2024,9,188633.0,Salary Increases & Fixed Expenses Remain Stable,56233,11410.0,35787,47197.0,9036.0,16.07,0.01,Medium Risk
U164,2024,10,197669.0,Salary Increases & Fixed Expenses Remain Stable,56233,11410.0,35091,46501.0,9732.0,17.31,0.04,Medium Risk
U164,2024,11,207401.0,Salary Increases & Fixed Expenses Remain Stable,56233,11410.0,33346,44756.0,11477.0,20.41,0.03,Medium Risk
U164,2024,12,218878.0,Salary Increases & Fixed Expenses Remain Stable,56233,11410.0,30278,41688.0,14545.0,25.87,-0.02,Low Risk
U165,2024,1,250000.0,Salary Increases & Fixed Expenses Increase,290304,101673.0,140287,241960.0,48344.0,16.65,-0.04,Medium Risk
U165,2024,2,298344.0,Salary Increases & Fixed Expenses Increase,290304,101673.0,124214,225887.0,64417.0,22.19,-0.02,Medium Risk
U165,2024,3,362761.0,Salary Increases & Fixed Expenses Increase,290304,101673.0,127517,229190.0,61114.0,21.05,-0.02,Medium Risk
U165,2024,4,423875.0,Salary Increases & Fixed Expenses Increase,290304,101673.0,95574,197247.0,93057.0,32.06,0.02,Low Risk
U165,2024,5,516932.0,Salary Increases & Fixed Expenses Increase,296311,101673.0,136240,237913.0,58398.0,19.71,-0.02,Medium Risk
U165,2024,6,575330.0,Salary Increases & Fixed Expenses Increase,296311,102196.0,140217,242413.0,53898.0,18.19,-0.01,Medium Risk
U165,2024,7,629228.0,Salary Increases & Fixed Expenses Increase,296311,102196.0,138576,240772.0,55539.0,18.74,0.02,Medium Risk
U165,2024,8,684767.0,Salary Increases & Fixed Expenses Increase,296311,104059.0,91786,195845.0,100466.0,33.91,-0.02,Low Risk
U165,2024,9,785233.0,Salary Increases & Fixed Expenses Increase,296311,104059.0,155876,259935.0,36376.0,12.28,0.0,High Risk
U165,2024,10,821609.0,Salary Increases & Fixed Expenses Increase,296311,104059.0,111788,215847.0,80464.0,27.16,0.0,Low Risk
U165,2024,11,902073.0,Salary Increases & Fixed Expenses Increase,296311,104059.0,130952,235011.0,61300.0,20.69,-0.02,Medium Risk
U165,2024,12,963373.0,Salary Increases & Fixed Expenses Increase,296311,104059.0,145968,250027.0,46284.0,15.62,-0.01,Medium Risk
U166,2024,1,222368.0,Salary Increases & Fixed Expenses Remain Stable,143578,51978.0,49688,101666.0,41912.0,29.19,0.04,Low Risk
U166,2024,2,264280.0,Salary Increases & Fixed Expenses Remain Stable,143578,51978.0,61556,113534.0,30044.0,20.93,0.02,Medium Risk
U166,2024,3,294324.0,Salary Increases & Fixed Expenses Remain Stable,143578,51978.0,43917,95895.0,47683.0,33.21,0.03,Low Risk
U166,2024,4,342007.0,Salary Increases & Fixed Expenses Remain Stable,143578,51978.0,60657,112635.0,30943.0,21.55,0.02,Medium Risk
U166,2024,5,372950.0,Salary Increases & Fixed Expenses Remain Stable,143578,51978.0,49542,101520.0,42058.0,29.29,-0.04,Low Risk
U166,2024,6,415008.0,Salary Increases & Fixed Expenses Remain Stable,143578,51978.0,48434,100412.0,43166.0,30.06,-0.02,Low Risk
U166,2024,7,458174.0,Salary Increases & Fixed Expenses Remain Stable,152940,51978.0,63193,115171.0,37769.0,24.7,0.01,Medium Risk
U166,2024,8,495943.0,Salary Increases & Fixed Expenses Remain Stable,152940,51978.0,62911,114889.0,38051.0,24.88,-0.02,Medium Risk
U166,2024,9,533994.0,Salary Increases & Fixed Expenses Remain Stable,152940,51978.0,68952,120930.0,32010.0,20.93,-0.03,Medium Risk
U166,2024,10,566004.0,Salary Increases & Fixed Expenses Remain Stable,152940,51978.0,68360,120338.0,32602.0,21.32,-0.0,Medium Risk
U166,2024,11,598606.0,Salary Increases & Fixed Expenses Remain Stable,152940,51978.0,78769,130747.0,22193.0,14.51,-0.01,High Risk
U166,2024,12,620799.0,Salary Increases & Fixed Expenses Remain Stable,152940,51978.0,59917,111895.0,41045.0,26.84,0.04,Low Risk
U167,2024,1,219497.0,Stable Salary & Stable Fixed Expenses,77940,37496.0,18024,55520.0,22420.0,28.77,-0.01,Low Risk
U167,2024,2,241917.0,Stable Salary & Stable Fixed Expenses,77940,37496.0,22120,59616.0,18324.0,23.51,-0.03,Medium Risk
U167,2024,3,260241.0,Stable Salary & Stable Fixed Expenses,77940,37496.0,17867,55363.0,22577.0,28.97,-0.01,Low Risk
U167,2024,4,282818.0,Stable Salary & Stable Fixed Expenses,77940,37496.0,20582,58078.0,19862.0,25.48,-0.01,Low Risk
U167,2024,5,302680.0,Stable Salary & Stable Fixed Expenses,77940,37496.0,20523,58019.0,19921.0,25.56,-0.02,Low Risk
U167,2024,6,322601.0,Stable Salary & Stable Fixed Expenses,77940,37496.0,22967,60463.0,17477.0,22.42,0.0,Medium Risk
U167,2024,7,340078.0,Stable Salary & Stable Fixed Expenses,77940,37496.0,18609,56105.0,21835.0,28.02,0.01,Low Risk
U167,2024,8,361913.0,Stable Salary & Stable Fixed Expenses,77940,37496.0,17308,54804.0,23136.0,29.68,-0.04,Low Risk
U167,2024,9,385049.0,Stable Salary & Stable Fixed Expenses,77940,37496.0,23991,61487.0,16453.0,21.11,-0.04,Medium Risk
U167,2024,10,401502.0,Stable Salary & Stable Fixed Expenses,77940,37496.0,21942,59438.0,18502.0,23.74,0.02,Medium Risk
U167,2024,11,420004.0,Stable Salary & Stable Fixed Expenses,77940,37496.0,24999,62495.0,15445.0,19.82,0.04,Medium Risk
U167,2024,12,435449.0,Stable Salary & Stable Fixed Expenses,77940,37496.0,18395,55891.0,22049.0,28.29,-0.05,Low Risk
U168,2024,1,199002.0,Salary Increases & Fixed Expenses Decrease,80768,25871.0,34198,60069.0,20699.0,25.63,0.02,Low Risk
U168,2024,2,219701.0,Salary Increases & Fixed Expenses Decrease,80768,25871.0,39115,64986.0,15782.0,19.54,-0.05,Medium Risk
U168,2024,3,235483.0,Salary Increases & Fixed Expenses Decrease,80768,25871.0,35090,60961.0,19807.0,24.52,-0.03,Medium Risk
U168,2024,4,255290.0,Salary Increases & Fixed Expenses Decrease,80768,25871.0,29214,55085.0,25683.0,31.8,0.03,Low Risk
U168,2024,5,280973.0,Salary Increases & Fixed Expenses Decrease,80768,25871.0,25038,50909.0,29859.0,36.97,-0.01,Low Risk
U168,2024,6,310832.0,Salary Increases & Fixed Expenses Decrease,87522,25871.0,26755,52626.0,34896.0,39.87,-0.04,Low Risk
U168,2024,7,345728.0,Salary Increases & Fixed Expenses Decrease,87522,25871.0,38970,64841.0,22681.0,25.91,-0.04,Low Risk
U168,2024,8,368409.0,Salary Increases & Fixed Expenses Decrease,87522,25871.0,43005,68876.0,18646.0,21.3,-0.0,Medium Risk
U168,2024,9,387055.0,Salary Increases & Fixed Expenses Decrease,87522,23961.0,43005,66966.0,20556.0,23.49,-0.04,Medium Risk
U168,2024,10,407611.0,Salary Increases & Fixed Expenses Decrease,87522,23961.0,32613,56574.0,30948.0,35.36,0.03,Low Risk
U168,2024,11,438559.0,Salary Increases & Fixed Expenses Decrease,87522,23961.0,44406,68367.0,19155.0,21.89,-0.04,Medium Risk
U168,2024,12,457714.0,Salary Increases & Fixed Expenses Decrease,87522,23961.0,26960,50921.0,36601.0,41.82,-0.04,Low Risk
U169,2024,1,250000.0,Salary Increases & Fixed Expenses Remain Stable,298174,77860.0,66089,143949.0,154225.0,51.72,-0.03,Low Risk
U169,2024,2,404225.0,Salary Increases & Fixed Expenses Remain Stable,298174,77860.0,86450,164310.0,133864.0,44.89,-0.01,Low Risk
U169,2024,3,538089.0,Salary Increases & Fixed Expenses Remain Stable,298174,77860.0,81647,159507.0,138667.0,46.51,-0.0,Low Risk
U169,2024,4,676756.0,Salary Increases & Fixed Expenses Remain Stable,298174,77860.0,84966,162826.0,135348.0,45.39,-0.03,Low Risk
U169,2024,5,812104.0,Salary Increases & Fixed Expenses Remain Stable,323410,77860.0,68913,146773.0,176637.0,54.62,-0.02,Low Risk
U169,2024,6,988741.0,Salary Increases & Fixed Expenses Remain Stable,323410,77860.0,91991,169851.0,153559.0,47.48,-0.03,Low Risk
U169,2024,7,1142300.0,Salary Increases & Fixed Expenses Remain Stable,323410,77860.0,95070,172930.0,150480.0,46.53,0.05,Low Risk
U169,2024,8,1292780.0,Salary Increases & Fixed Expenses Remain Stable,323410,77860.0,86470,164330.0,159080.0,49.19,0.02,Low Risk
U169,2024,9,1451860.0,Salary Increases & Fixed Expenses Remain Stable,323410,77860.0,103322,181182.0,142228.0,43.98,-0.03,Low Risk
U169,2024,10,1594088.0,Salary Increases & Fixed Expenses Remain Stable,323410,77860.0,108187,186047.0,137363.0,42.47,-0.0,Low Risk
U169,2024,11,1731451.0,Salary Increases & Fixed Expenses Remain Stable,323410,77860.0,77345,155205.0,168205.0,52.01,-0.01,Low Risk
U169,2024,12,1899656.0,Salary Increases & Fixed Expenses Remain Stable,323410,77860.0,103131,180991.0,142419.0,44.04,0.03,Low Risk
U170,2024,1,200535.0,Salary Increases & Fixed Expenses Remain Stable,198906,44829.0,131509,176338.0,22568.0,11.35,-0.02,High Risk
U170,2024,2,223103.0,Salary Increases & Fixed Expenses Remain Stable,198906,44829.0,126627,171456.0,27450.0,13.8,0.03,High Risk
U170,2024,3,250553.0,Salary Increases & Fixed Expenses Remain Stable,198906,44829.0,167842,212671.0,-13765.0,-6.92,0.04,High Risk
U170,2024,4,236788.0,Salary Increases & Fixed Expenses Remain Stable,198906,44829.0,112052,156881.0,42025.0,21.13,0.04,Medium Risk
U170,2024,5,278813.0,Salary Increases & Fixed Expenses Remain Stable,198906,44829.0,125872,170701.0,28205.0,14.18,-0.01,High Risk
U170,2024,6,307018.0,Salary Increases & Fixed Expenses Remain Stable,198906,44829.0,109502,154331.0,44575.0,22.41,0.0,Medium Risk
U170,2024,7,351593.0,Salary Increases & Fixed Expenses Remain Stable,211946,44829.0,131544,176373.0,35573.0,16.78,0.04,Medium Risk
U170,2024,8,387166.0,Salary Increases & Fixed Expenses Remain Stable,211946,44829.0,140192,185021.0,26925.0,12.7,0.04,High Risk
U170,2024,9,414091.0,Salary Increases & Fixed Expenses Remain Stable,211946,44829.0,116577,161406.0,50540.0,23.85,-0.01,Medium Risk
U170,2024,10,464631.0,Salary Increases & Fixed Expenses Remain Stable,211946,44829.0,165834,210663.0,1283.0,0.61,0.02,High Risk
U170,2024,11,465914.0,Salary Increases & Fixed Expenses Remain Stable,211946,44829.0,135664,180493.0,31453.0,14.84,-0.02,High Risk
U170,2024,12,497367.0,Salary Increases & Fixed Expenses Remain Stable,211946,44829.0,157593,202422.0,9524.0,4.49,0.0,High Risk
U171,2024,1,208593.0,Salary Increases & Fixed Expenses Increase,109059,73870.0,25923,99793.0,9266.0,8.5,0.03,High Risk
U171,2024,2,217859.0,Salary Increases & Fixed Expenses Increase,109059,73870.0,32635,106505.0,2554.0,2.34,-0.03,High Risk
U171,2024,3,220413.0,Salary Increases & Fixed Expenses Increase,109059,73870.0,28099,101969.0,7090.0,6.5,-0.04,High Risk
U171,2024,4,227503.0,Salary Increases & Fixed Expenses Increase,109059,73870.0,23214,97084.0,11975.0,10.98,0.0,High Risk
U171,2024,5,239478.0,Salary Increases & Fixed Expenses Increase,109059,75237.0,32434,107671.0,1388.0,1.27,0.03,High Risk
U171,2024,6,240866.0,Salary Increases & Fixed Expenses Increase,109059,75237.0,29530,104767.0,4292.0,3.94,0.05,High Risk
U171,2024,7,245158.0,Salary Increases & Fixed Expenses Increase,126174,76932.0,30059,106991.0,19183.0,15.2,0.03,Medium Risk
U171,2024,8,264341.0,Salary Increases & Fixed Expenses Increase,126174,76932.0,34639,111571.0,14603.0,11.57,0.01,High Risk
U171,2024,9,278944.0,Salary Increases & Fixed Expenses Increase,126174,76932.0,35720,112652.0,13522.0,10.72,0.04,High Risk
U171,2024,10,292466.0,Salary Increases & Fixed Expenses Increase,126174,76932.0,36441,113373.0,12801.0,10.15,-0.03,High Risk
U171,2024,11,305267.0,Salary Increases & Fixed Expenses Increase,126174,76932.0,32546,109478.0,16696.0,13.23,-0.01,High Risk
U171,2024,12,321963.0,Salary Increases & Fixed Expenses Increase,126174,76932.0,35391,112323.0,13851.0,10.98,-0.04,High Risk
U172,2024,1,234825.0,Salary Increases & Fixed Expenses Remain Stable,197610,49951.0,54793,104744.0,92866.0,46.99,0.02,Low Risk
U172,2024,2,327691.0,Salary Increases & Fixed Expenses Remain Stable,197610,49951.0,41840,91791.0,105819.0,53.55,-0.01,Low Risk
U172,2024,3,433510.0,Salary Increases & Fixed Expenses Remain Stable,197610,49951.0,49739,99690.0,97920.0,49.55,-0.05,Low Risk
U172,2024,4,531430.0,Salary Increases & Fixed Expenses Remain Stable,197610,49951.0,53474,103425.0,94185.0,47.66,-0.02,Low Risk
U172,2024,5,625615.0,Salary Increases & Fixed Expenses Remain Stable,197610,49951.0,56525,106476.0,91134.0,46.12,-0.05,Low Risk
U172,2024,6,716749.0,Salary Increases & Fixed Expenses Remain Stable,216372,49951.0,50882,100833.0,115539.0,53.4,0.05,Low Risk
U172,2024,7,832288.0,Salary Increases & Fixed Expenses Remain Stable,216372,49951.0,47912,97863.0,118509.0,54.77,-0.03,Low Risk
U172,2024,8,950797.0,Salary Increases & Fixed Expenses Remain Stable,216372,49951.0,52550,102501.0,113871.0,52.63,0.03,Low Risk
U172,2024,9,1064668.0,Salary Increases & Fixed Expenses Remain Stable,216372,49951.0,63820,113771.0,102601.0,47.42,0.01,Low Risk
U172,2024,10,1167269.0,Salary Increases & Fixed Expenses Remain Stable,216372,49951.0,74211,124162.0,92210.0,42.62,0.03,Low Risk
U172,2024,11,1259479.0,Salary Increases & Fixed Expenses Remain Stable,216372,49951.0,60406,110357.0,106015.0,49.0,-0.02,Low Risk
U172,2024,12,1365494.0,Salary Increases & Fixed Expenses Remain Stable,216372,49951.0,69660,119611.0,96761.0,44.72,0.0,Low Risk
U173,2024,1,221594.0,Stable Salary & Stable Fixed Expenses,166898,51266.0,63515,114781.0,52117.0,31.23,-0.02,Low Risk
U173,2024,2,273711.0,Stable Salary & Stable Fixed Expenses,166898,51266.0,58480,109746.0,57152.0,34.24,0.01,Low Risk
U173,2024,3,330863.0,Stable Salary & Stable Fixed Expenses,166898,51266.0,64239,115505.0,51393.0,30.79,0.01,Low Risk
U173,2024,4,382256.0,Stable Salary & Stable Fixed Expenses,166898,51266.0,61838,113104.0,53794.0,32.23,-0.04,Low Risk
U173,2024,5,436050.0,Stable Salary & Stable Fixed Expenses,166898,51266.0,59039,110305.0,56593.0,33.91,-0.05,Low Risk
U173,2024,6,492643.0,Stable Salary & Stable Fixed Expenses,166898,51266.0,59788,111054.0,55844.0,33.46,-0.03,Low Risk
U173,2024,7,548487.0,Stable Salary & Stable Fixed Expenses,166898,51266.0,64896,116162.0,50736.0,30.4,-0.05,Low Risk
U173,2024,8,599223.0,Stable Salary & Stable Fixed Expenses,166898,51266.0,70395,121661.0,45237.0,27.1,-0.0,Low Risk
U173,2024,9,644460.0,Stable Salary & Stable Fixed Expenses,166898,51266.0,90253,141519.0,25379.0,15.21,0.01,Medium Risk
U173,2024,10,669839.0,Stable Salary & Stable Fixed Expenses,166898,51266.0,63626,114892.0,52006.0,31.16,0.02,Low Risk
U173,2024,11,721845.0,Stable Salary & Stable Fixed Expenses,166898,51266.0,88732,139998.0,26900.0,16.12,-0.01,Medium Risk
U173,2024,12,748745.0,Stable Salary & Stable Fixed Expenses,166898,51266.0,55604,106870.0,60028.0,35.97,-0.05,Low Risk
U174,2024,1,228523.0,Stable Salary & Stable Fixed Expenses,213719,96617.0,113184,209801.0,3918.0,1.83,0.04,High Risk
U174,2024,2,232441.0,Stable Salary & Stable Fixed Expenses,213719,96617.0,122155,218772.0,-5053.0,-2.36,0.03,High Risk
U174,2024,3,227388.0,Stable Salary & Stable Fixed Expenses,213719,96617.0,142132,238749.0,-25030.0,-11.71,-0.04,High Risk
U174,2024,4,202358.0,Stable Salary & Stable Fixed Expenses,213719,96617.0,146808,243425.0,-29706.0,-13.9,-0.0,High Risk
U174,2024,5,172652.0,Stable Salary & Stable Fixed Expenses,213719,96617.0,144575,241192.0,-27473.0,-12.85,0.0,High Risk
U174,2024,6,145179.0,Stable Salary & Stable Fixed Expenses,213719,96617.0,125083,221700.0,-7981.0,-3.73,0.01,High Risk
U174,2024,7,137198.0,Stable Salary & Stable Fixed Expenses,213719,96617.0,145288,241905.0,-28186.0,-13.19,0.0,High Risk
U174,2024,8,109012.0,Stable Salary & Stable Fixed Expenses,213719,96617.0,147138,243755.0,-30036.0,-14.05,-0.01,High Risk
U174,2024,9,78976.0,Stable Salary & Stable Fixed Expenses,213719,96617.0,116389,213006.0,713.0,0.33,-0.02,High Risk
U174,2024,10,79689.0,Stable Salary & Stable Fixed Expenses,213719,96617.0,140555,237172.0,-23453.0,-10.97,0.04,High Risk
U174,2024,11,56236.0,Stable Salary & Stable Fixed Expenses,213719,96617.0,143719,240336.0,-26617.0,-12.45,0.04,High Risk
U174,2024,12,29619.0,Stable Salary & Stable Fixed Expenses,213719,96617.0,113243,209860.0,3859.0,1.81,-0.04,High Risk
U175,2024,1,250000.0,Salary Increases & Fixed Expenses Remain Stable,290677,101732.0,79389,181121.0,109556.0,37.69,0.03,Low Risk
U175,2024,2,359556.0,Salary Increases & Fixed Expenses Remain Stable,290677,101732.0,82845,184577.0,106100.0,36.5,-0.04,Low Risk
U175,2024,3,465656.0,Salary Increases & Fixed Expenses Remain Stable,290677,101732.0,77444,179176.0,111501.0,38.36,0.01,Low Risk
U175,2024,4,577157.0,Salary Increases & Fixed Expenses Remain Stable,290677,101732.0,59068,160800.0,129877.0,44.68,0.04,Low Risk
U175,2024,5,707034.0,Salary Increases & Fixed Expenses Remain Stable,290677,101732.0,58713,160445.0,130232.0,44.8,-0.05,Low Risk
U175,2024,6,837266.0,Salary Increases & Fixed Expenses Remain Stable,290677,101732.0,73439,175171.0,115506.0,39.74,-0.04,Low Risk
U175,2024,7,952772.0,Salary Increases & Fixed Expenses Remain Stable,290677,101732.0,60802,162534.0,128143.0,44.08,0.04,Low Risk
U175,2024,8,1080915.0,Salary Increases & Fixed Expenses Remain Stable,319630,101732.0,85052,186784.0,132846.0,41.56,0.01,Low Risk
U175,2024,9,1213761.0,Salary Increases & Fixed Expenses Remain Stable,319630,101732.0,87216,188948.0,130682.0,40.89,0.0,Low Risk
U175,2024,10,1344443.0,Salary Increases & Fixed Expenses Remain Stable,319630,101732.0,76577,178309.0,141321.0,44.21,0.04,Low Risk
U175,2024,11,1485764.0,Salary Increases & Fixed Expenses Remain Stable,319630,101732.0,77414,179146.0,140484.0,43.95,-0.03,Low Risk
U175,2024,12,1626248.0,Salary Increases & Fixed Expenses Remain Stable,319630,101732.0,70602,172334.0,147296.0,46.08,0.02,Low Risk
U176,2024,1,232969.0,Stable Salary & Decreasing Fixed Expenses,28689,15198.0,17109,32307.0,-3618.0,-12.61,0.02,High Risk
U176,2024,2,229351.0,Stable Salary & Decreasing Fixed Expenses,28689,15198.0,15722,30920.0,-2231.0,-7.78,0.05,High Risk
U176,2024,3,227120.0,Stable Salary & Decreasing Fixed Expenses,28689,15198.0,19809,35007.0,-6318.0,-22.02,0.04,High Risk
U176,2024,4,220802.0,Stable Salary & Decreasing Fixed Expenses,28689,15198.0,17844,33042.0,-4353.0,-15.17,-0.01,High Risk
U176,2024,5,216449.0,Stable Salary & Decreasing Fixed Expenses,28689,15198.0,15142,30340.0,-1651.0,-5.75,-0.02,High Risk
U176,2024,6,214798.0,Stable Salary & Decreasing Fixed Expenses,28689,15198.0,16429,31627.0,-2938.0,-10.24,0.01,High Risk
U176,2024,7,211860.0,Stable Salary & Decreasing Fixed Expenses,28689,15198.0,19806,35004.0,-6315.0,-22.01,0.01,High Risk
U176,2024,8,205545.0,Stable Salary & Decreasing Fixed Expenses,28689,15198.0,18634,33832.0,-5143.0,-17.93,-0.05,High Risk
U176,2024,9,200402.0,Stable Salary & Decreasing Fixed Expenses,28689,15198.0,17112,32310.0,-3621.0,-12.62,0.04,High Risk
U176,2024,10,196781.0,Stable Salary & Decreasing Fixed Expenses,28689,15198.0,17278,32476.0,-3787.0,-13.2,-0.0,High Risk
U176,2024,11,192994.0,Stable Salary & Decreasing Fixed Expenses,28689,15198.0,19182,34380.0,-5691.0,-19.84,-0.02,High Risk
U176,2024,12,187303.0,Stable Salary & Decreasing Fixed Expenses,28689,15198.0,18828,34026.0,-5337.0,-18.6,-0.04,High Risk
U177,2024,1,243350.0,Salary Increases & Fixed Expenses Increase,242879,90732.0,96687,187419.0,55460.0,22.83,-0.02,Medium Risk
U177,2024,2,298810.0,Salary Increases & Fixed Expenses Increase,242879,90732.0,76827,167559.0,75320.0,31.01,0.0,Low Risk
U177,2024,3,374130.0,Salary Increases & Fixed Expenses Increase,242879,92297.0,79000,171297.0,71582.0,29.47,-0.04,Low Risk
U177,2024,4,445712.0,Salary Increases & Fixed Expenses Increase,242879,93539.0,80479,174018.0,68861.0,28.35,0.02,Low Risk
U177,2024,5,514573.0,Salary Increases & Fixed Expenses Increase,242879,93539.0,95426,188965.0,53914.0,22.2,0.0,Medium Risk
U177,2024,6,568487.0,Salary Increases & Fixed Expenses Increase,242879,93539.0,99219,192758.0,50121.0,20.64,0.01,Medium Risk
U177,2024,7,618608.0,Salary Increases & Fixed Expenses Increase,264139,93539.0,131793,225332.0,38807.0,14.69,-0.03,High Risk
U177,2024,8,657415.0,Salary Increases & Fixed Expenses Increase,264139,93539.0,84540,178079.0,86060.0,32.58,-0.05,Low Risk
U177,2024,9,743475.0,Salary Increases & Fixed Expenses Increase,264139,93539.0,132507,226046.0,38093.0,14.42,0.03,High Risk
U177,2024,10,781568.0,Salary Increases & Fixed Expenses Increase,264139,93539.0,104952,198491.0,65648.0,24.85,0.01,Medium Risk
U177,2024,11,847216.0,Salary Increases & Fixed Expenses Increase,264139,93539.0,137160,230699.0,33440.0,12.66,-0.02,High Risk
U177,2024,12,880656.0,Salary Increases & Fixed Expenses Increase,264139,93539.0,90739,184278.0,79861.0,30.23,-0.05,Low Risk
U178,2024,1,247836.0,Salary Increases & Fixed Expenses Remain Stable,244464,60112.0,85748,145860.0,98604.0,40.33,-0.03,Low Risk
U178,2024,2,346440.0,Salary Increases & Fixed Expenses Remain Stable,244464,60112.0,105451,165563.0,78901.0,32.28,0.03,Low Risk
U178,2024,3,425341.0,Salary Increases & Fixed Expenses Remain Stable,244464,60112.0,73609,133721.0,110743.0,45.3,-0.02,Low Risk
U178,2024,4,536084.0,Salary Increases & Fixed Expenses Remain Stable,244464,60112.0,95671,155783.0,88681.0,36.28,-0.01,Low Risk
U178,2024,5,624765.0,Salary Increases & Fixed Expenses Remain Stable,244464,60112.0,79132,139244.0,105220.0,43.04,-0.01,Low Risk
U178,2024,6,729985.0,Salary Increases & Fixed Expenses Remain Stable,244464,60112.0,119911,180023.0,64441.0,26.36,-0.03,Low Risk
U178,2024,7,794426.0,Salary Increases & Fixed Expenses Remain Stable,244464,60112.0,90726,150838.0,93626.0,38.3,-0.02,Low Risk
U178,2024,8,888052.0,Salary Increases & Fixed Expenses Remain Stable,251221,60112.0,120284,180396.0,70825.0,28.19,-0.04,Low Risk
U178,2024,9,958877.0,Salary Increases & Fixed Expenses Remain Stable,251221,60112.0,115227,175339.0,75882.0,30.21,-0.03,Low Risk
U178,2024,10,1034759.0,Salary Increases & Fixed Expenses Remain Stable,251221,60112.0,97882,157994.0,93227.0,37.11,-0.04,Low Risk
U178,2024,11,1127986.0,Salary Increases & Fixed Expenses Remain Stable,251221,60112.0,82137,142249.0,108972.0,43.38,0.01,Low Risk
U178,2024,12,1236958.0,Salary Increases & Fixed Expenses Remain Stable,251221,60112.0,76389,136501.0,114720.0,45.66,-0.05,Low Risk
U179,2024,1,111111.0,Stable Salary & Stable Fixed Expenses,51384,38848.0,25292,64140.0,-12756.0,-24.82,-0.02,High Risk
U179,2024,2,98355.0,Stable Salary & Stable Fixed Expenses,51384,38848.0,17189,56037.0,-4653.0,-9.06,-0.04,High Risk
U179,2024,3,93702.0,Stable Salary & Stable Fixed Expenses,51384,38848.0,20476,59324.0,-7940.0,-15.45,-0.04,High Risk
U179,2024,4,85762.0,Stable Salary & Stable Fixed Expenses,51384,38848.0,19455,58303.0,-6919.0,-13.47,0.01,High Risk
U179,2024,5,78843.0,Stable Salary & Stable Fixed Expenses,51384,38848.0,24236,63084.0,-11700.0,-22.77,0.05,High Risk
U179,2024,6,67143.0,Stable Salary & Stable Fixed Expenses,51384,38848.0,17287,56135.0,-4751.0,-9.25,0.01,High Risk
U179,2024,7,62392.0,Stable Salary & Stable Fixed Expenses,51384,38848.0,25235,64083.0,-12699.0,-24.71,-0.0,High Risk
U179,2024,8,49693.0,Stable Salary & Stable Fixed Expenses,51384,38848.0,19624,58472.0,-7088.0,-13.79,-0.04,High Risk
U179,2024,9,42605.0,Stable Salary & Stable Fixed Expenses,51384,38848.0,18840,57688.0,-6304.0,-12.27,0.01,High Risk
U179,2024,10,36301.0,Stable Salary & Stable Fixed Expenses,51384,38848.0,23089,61937.0,-10553.0,-20.54,-0.01,High Risk
U179,2024,11,25748.0,Stable Salary & Stable Fixed Expenses,51384,38848.0,18259,57107.0,-5723.0,-11.14,0.02,High Risk
U179,2024,12,20025.0,Stable Salary & Stable Fixed Expenses,51384,38848.0,20239,59087.0,-7703.0,-14.99,-0.0,High Risk
U180,2024,1,244829.0,Salary Increases & Fixed Expenses Increase,226286,85344.0,52391,137735.0,88551.0,39.13,-0.04,Low Risk
U180,2024,2,333380.0,Salary Increases & Fixed Expenses Increase,226286,85344.0,54703,140047.0,86239.0,38.11,-0.02,Low Risk
U180,2024,3,419619.0,Salary Increases & Fixed Expenses Increase,226286,85344.0,54086,139430.0,86856.0,38.38,-0.02,Low Risk
U180,2024,4,506475.0,Salary Increases & Fixed Expenses Increase,236757,85344.0,63163,148507.0,88250.0,37.27,0.03,Low Risk
U180,2024,5,594725.0,Salary Increases & Fixed Expenses Increase,236757,85344.0,61217,146561.0,90196.0,38.1,-0.02,Low Risk
U180,2024,6,684921.0,Salary Increases & Fixed Expenses Increase,236757,85344.0,62418,147762.0,88995.0,37.59,-0.03,Low Risk
U180,2024,7,773916.0,Salary Increases & Fixed Expenses Increase,236757,85344.0,53659,139003.0,97754.0,41.29,-0.03,Low Risk
U180,2024,8,871670.0,Salary Increases & Fixed Expenses Increase,236757,85344.0,65262,150606.0,86151.0,36.39,0.04,Low Risk
U180,2024,9,957821.0,Salary Increases & Fixed Expenses Increase,236757,85344.0,64177,149521.0,87236.0,36.85,0.02,Low Risk
U180,2024,10,1045057.0,Salary Increases & Fixed Expenses Increase,236757,85344.0,50376,135720.0,101037.0,42.68,0.05,Low Risk
U180,2024,11,1146094.0,Salary Increases & Fixed Expenses Increase,236757,85344.0,55692,141036.0,95721.0,40.43,0.04,Low Risk
U180,2024,12,1241815.0,Salary Increases & Fixed Expenses Increase,236757,85344.0,69979,155323.0,81434.0,34.4,0.04,Low Risk
U181,2024,1,222182.0,Salary Increases & Fixed Expenses Increase,155369,62364.0,63126,125490.0,29879.0,19.23,0.04,Medium Risk
U181,2024,2,252061.0,Salary Increases & Fixed Expenses Increase,155369,62364.0,64028,126392.0,28977.0,18.65,-0.05,Medium Risk
U181,2024,3,281038.0,Salary Increases & Fixed Expenses Increase,155369,62364.0,51133,113497.0,41872.0,26.95,0.02,Low Risk
U181,2024,4,322910.0,Salary Increases & Fixed Expenses Increase,155369,63866.0,58809,122675.0,32694.0,21.04,-0.02,Medium Risk
U181,2024,5,355604.0,Salary Increases & Fixed Expenses Increase,155369,64817.0,73825,138642.0,16727.0,10.77,-0.03,High Risk
U181,2024,6,372331.0,Salary Increases & Fixed Expenses Increase,155369,64817.0,62274,127091.0,28278.0,18.2,-0.03,Medium Risk
U181,2024,7,400609.0,Salary Increases & Fixed Expenses Increase,155369,64817.0,47330,112147.0,43222.0,27.82,0.0,Low Risk
U181,2024,8,443831.0,Salary Increases & Fixed Expenses Increase,173383,66481.0,79229,145710.0,27673.0,15.96,-0.02,Medium Risk
U181,2024,9,471504.0,Salary Increases & Fixed Expenses Increase,173383,66481.0,71977,138458.0,34925.0,20.14,-0.03,Medium Risk
U181,2024,10,506429.0,Salary Increases & Fixed Expenses Increase,173383,66481.0,76616,143097.0,30286.0,17.47,0.04,Medium Risk
U181,2024,11,536715.0,Salary Increases & Fixed Expenses Increase,173383,66481.0,78550,145031.0,28352.0,16.35,-0.0,Medium Risk
U181,2024,12,565067.0,Salary Increases & Fixed Expenses Increase,173383,66481.0,67201,133682.0,39701.0,22.9,-0.03,Medium Risk
U182,2024,1,250000.0,Salary Increases & Fixed Expenses Increase,267613,112483.0,184852,297335.0,-29722.0,-11.11,0.03,High Risk
U182,2024,2,220278.0,Salary Increases & Fixed Expenses Increase,267613,112483.0,183719,296202.0,-28589.0,-10.68,0.03,High Risk
U182,2024,3,191689.0,Salary Increases & Fixed Expenses Increase,267613,112483.0,206645,319128.0,-51515.0,-19.25,-0.02,High Risk
U182,2024,4,140174.0,Salary Increases & Fixed Expenses Increase,267613,112483.0,137180,249663.0,17950.0,6.71,0.03,High Risk
U182,2024,5,158124.0,Salary Increases & Fixed Expenses Increase,267613,112483.0,175776,288259.0,-20646.0,-7.71,0.05,High Risk
U182,2024,6,137478.0,Salary Increases & Fixed Expenses Increase,282264,112483.0,153750,266233.0,16031.0,5.68,0.03,High Risk
U182,2024,7,153509.0,Salary Increases & Fixed Expenses Increase,282264,112483.0,153732,266215.0,16049.0,5.69,-0.03,High Risk
U182,2024,8,169558.0,Salary Increases & Fixed Expenses Increase,282264,112483.0,173235,285718.0,-3454.0,-1.22,-0.02,High Risk
U182,2024,9,166104.0,Salary Increases & Fixed Expenses Increase,282264,112483.0,166363,278846.0,3418.0,1.21,-0.05,High Risk
U182,2024,10,169522.0,Salary Increases & Fixed Expenses Increase,282264,112483.0,199980,312463.0,-30199.0,-10.7,0.01,High Risk
U182,2024,11,139323.0,Salary Increases & Fixed Expenses Increase,282264,112483.0,179926,292409.0,-10145.0,-3.59,0.05,High Risk
U182,2024,12,129178.0,Salary Increases & Fixed Expenses Increase,282264,112483.0,230042,342525.0,-60261.0,-21.35,-0.01,High Risk
U183,2024,1,135243.0,Stable Salary & Stable Fixed Expenses,88204,28667.0,27962,56629.0,31575.0,35.8,-0.01,Low Risk
U183,2024,2,166818.0,Stable Salary & Stable Fixed Expenses,88204,28667.0,31561,60228.0,27976.0,31.72,-0.03,Low Risk
U183,2024,3,194794.0,Stable Salary & Stable Fixed Expenses,88204,28667.0,27856,56523.0,31681.0,35.92,-0.0,Low Risk
U183,2024,4,226475.0,Stable Salary & Stable Fixed Expenses,88204,28667.0,30736,59403.0,28801.0,32.65,-0.04,Low Risk
U183,2024,5,255276.0,Stable Salary & Stable Fixed Expenses,88204,28667.0,30588,59255.0,28949.0,32.82,0.02,Low Risk
U183,2024,6,284225.0,Stable Salary & Stable Fixed Expenses,88204,28667.0,35857,64524.0,23680.0,26.85,0.04,Low Risk
U183,2024,7,307905.0,Stable Salary & Stable Fixed Expenses,88204,28667.0,41239,69906.0,18298.0,20.75,0.02,Medium Risk
U183,2024,8,326203.0,Stable Salary & Stable Fixed Expenses,88204,28667.0,43469,72136.0,16068.0,18.22,-0.04,Medium Risk
U183,2024,9,342271.0,Stable Salary & Stable Fixed Expenses,88204,28667.0,30893,59560.0,28644.0,32.47,-0.05,Low Risk
U183,2024,10,370915.0,Stable Salary & Stable Fixed Expenses,88204,28667.0,30084,58751.0,29453.0,33.39,0.03,Low Risk
U183,2024,11,400368.0,Stable Salary & Stable Fixed Expenses,88204,28667.0,28636,57303.0,30901.0,35.03,0.01,Low Risk
U183,2024,12,431269.0,Stable Salary & Stable Fixed Expenses,88204,28667.0,31551,60218.0,27986.0,31.73,-0.01,Low Risk
U184,2024,1,226237.0,Stable Salary & Increasing Fixed Expenses,131584,56422.0,34900,91322.0,40262.0,30.6,-0.01,Low Risk
U184,2024,2,266499.0,Stable Salary & Increasing Fixed Expenses,131584,56422.0,35302,91724.0,39860.0,30.29,-0.01,Low Risk
U184,2024,3,306359.0,Stable Salary & Increasing Fixed Expenses,131584,56422.0,26979,83401.0,48183.0,36.62,0.01,Low Risk
U184,2024,4,354542.0,Stable Salary & Increasing Fixed Expenses,131584,57884.0,36455,94339.0,37245.0,28.31,0.04,Low Risk
U184,2024,5,391787.0,Stable Salary & Increasing Fixed Expenses,131584,57884.0,26622,84506.0,47078.0,35.78,0.04,Low Risk
U184,2024,6,438865.0,Stable Salary & Increasing Fixed Expenses,131584,57884.0,30250,88134.0,43450.0,33.02,-0.04,Low Risk
U184,2024,7,482315.0,Stable Salary & Increasing Fixed Expenses,131584,57884.0,30036,87920.0,43664.0,33.18,-0.03,Low Risk
U184,2024,8,525979.0,Stable Salary & Increasing Fixed Expenses,131584,57884.0,29122,87006.0,44578.0,33.88,0.02,Low Risk
U184,2024,9,570557.0,Stable Salary & Increasing Fixed Expenses,131584,59655.0,35238,94893.0,36691.0,27.88,-0.04,Low Risk
U184,2024,10,607248.0,Stable Salary & Increasing Fixed Expenses,131584,59655.0,30911,90566.0,41018.0,31.17,-0.04,Low Risk
U184,2024,11,648266.0,Stable Salary & Increasing Fixed Expenses,131584,59655.0,28930,88585.0,42999.0,32.68,-0.04,Low Risk
U184,2024,12,691265.0,Stable Salary & Increasing Fixed Expenses,131584,59655.0,39362,99017.0,32567.0,24.75,-0.03,Medium Risk
U185,2024,1,237782.0,Salary Increases & Fixed Expenses Increase,233989,103545.0,91760,195305.0,38684.0,16.53,0.04,Medium Risk
U185,2024,2,276466.0,Salary Increases & Fixed Expenses Increase,233989,103545.0,116586,220131.0,13858.0,5.92,-0.05,High Risk
U185,2024,3,290324.0,Salary Increases & Fixed Expenses Increase,233989,103545.0,88959,192504.0,41485.0,17.73,-0.0,Medium Risk
U185,2024,4,331809.0,Salary Increases & Fixed Expenses Increase,233989,105155.0,78510,183665.0,50324.0,21.51,-0.01,Medium Risk
U185,2024,5,382133.0,Salary Increases & Fixed Expenses Increase,233989,105155.0,96307,201462.0,32527.0,13.9,0.03,High Risk
U185,2024,6,414660.0,Salary Increases & Fixed Expenses Increase,243411,105155.0,96681,201836.0,41575.0,17.08,0.0,Medium Risk
U185,2024,7,456235.0,Salary Increases & Fixed Expenses Increase,243411,105155.0,108224,213379.0,30032.0,12.34,0.03,High Risk
U185,2024,8,486267.0,Salary Increases & Fixed Expenses Increase,243411,105155.0,83047,188202.0,55209.0,22.68,0.02,Medium Risk
U185,2024,9,541476.0,Salary Increases & Fixed Expenses Increase,243411,105155.0,99354,204509.0,38902.0,15.98,0.02,Medium Risk
U185,2024,10,580378.0,Salary Increases & Fixed Expenses Increase,243411,106576.0,87146,193722.0,49689.0,20.41,-0.05,Medium Risk
U185,2024,11,630067.0,Salary Increases & Fixed Expenses Increase,243411,106576.0,86744,193320.0,50091.0,20.58,0.03,Medium Risk
U185,2024,12,680158.0,Salary Increases & Fixed Expenses Increase,243411,106576.0,92070,198646.0,44765.0,18.39,-0.0,Medium Risk
U186,2024,1,214854.0,Stable Salary & Stable Fixed Expenses,114571,70290.0,43643,113933.0,638.0,0.56,0.02,High Risk
U186,2024,2,215492.0,Stable Salary & Stable Fixed Expenses,114571,70290.0,43674,113964.0,607.0,0.53,-0.02,High Risk
U186,2024,3,216099.0,Stable Salary & Stable Fixed Expenses,114571,70290.0,45842,116132.0,-1561.0,-1.36,-0.01,High Risk
U186,2024,4,214538.0,Stable Salary & Stable Fixed Expenses,114571,70290.0,37807,108097.0,6474.0,5.65,0.01,High Risk
U186,2024,5,221012.0,Stable Salary & Stable Fixed Expenses,114571,70290.0,40639,110929.0,3642.0,3.18,-0.03,High Risk
U186,2024,6,224654.0,Stable Salary & Stable Fixed Expenses,114571,70290.0,48156,118446.0,-3875.0,-3.38,0.03,High Risk
U186,2024,7,220779.0,Stable Salary & Stable Fixed Expenses,114571,70290.0,51576,121866.0,-7295.0,-6.37,0.02,High Risk
U186,2024,8,213484.0,Stable Salary & Stable Fixed Expenses,114571,70290.0,41784,112074.0,2497.0,2.18,-0.04,High Risk
U186,2024,9,215981.0,Stable Salary & Stable Fixed Expenses,114571,70290.0,40520,110810.0,3761.0,3.28,0.04,High Risk
U186,2024,10,219742.0,Stable Salary & Stable Fixed Expenses,114571,70290.0,51629,121919.0,-7348.0,-6.41,-0.03,High Risk
U186,2024,11,212394.0,Stable Salary & Stable Fixed Expenses,114571,70290.0,55242,125532.0,-10961.0,-9.57,-0.03,High Risk
U186,2024,12,201433.0,Stable Salary & Stable Fixed Expenses,114571,70290.0,35715,106005.0,8566.0,7.48,-0.04,High Risk
U187,2024,1,163766.0,Stable Salary & Stable Fixed Expenses,152406,70220.0,56517,126737.0,25669.0,16.84,-0.04,Medium Risk
U187,2024,2,189435.0,Stable Salary & Stable Fixed Expenses,152406,70220.0,46673,116893.0,35513.0,23.3,0.01,Medium Risk
U187,2024,3,224948.0,Stable Salary & Stable Fixed Expenses,152406,70220.0,62454,132674.0,19732.0,12.95,0.04,High Risk
U187,2024,4,244680.0,Stable Salary & Stable Fixed Expenses,152406,70220.0,66358,136578.0,15828.0,10.39,-0.04,High Risk
U187,2024,5,260508.0,Stable Salary & Stable Fixed Expenses,152406,70220.0,68422,138642.0,13764.0,9.03,0.05,High Risk
U187,2024,6,274272.0,Stable Salary & Stable Fixed Expenses,152406,70220.0,64436,134656.0,17750.0,11.65,0.04,High Risk
U187,2024,7,292022.0,Stable Salary & Stable Fixed Expenses,152406,70220.0,58872,129092.0,23314.0,15.3,0.01,Medium Risk
U187,2024,8,315336.0,Stable Salary & Stable Fixed Expenses,152406,70220.0,65318,135538.0,16868.0,11.07,0.04,High Risk
U187,2024,9,332204.0,Stable Salary & Stable Fixed Expenses,152406,70220.0,46509,116729.0,35677.0,23.41,-0.04,Medium Risk
U187,2024,10,367881.0,Stable Salary & Stable Fixed Expenses,152406,70220.0,68823,139043.0,13363.0,8.77,-0.02,High Risk
U187,2024,11,381244.0,Stable Salary & Stable Fixed Expenses,152406,70220.0,71224,141444.0,10962.0,7.19,0.03,High Risk
U187,2024,12,392206.0,Stable Salary & Stable Fixed Expenses,152406,70220.0,55089,125309.0,27097.0,17.78,0.0,Medium Risk
U188,2024,1,218494.0,Stable Salary & Stable Fixed Expenses,207761,107648.0,102113,209761.0,-2000.0,-0.96,-0.01,High Risk
U188,2024,2,216494.0,Stable Salary & Stable Fixed Expenses,207761,107648.0,74470,182118.0,25643.0,12.34,0.0,High Risk
U188,2024,3,242137.0,Stable Salary & Stable Fixed Expenses,207761,107648.0,70567,178215.0,29546.0,14.22,0.05,High Risk
U188,2024,4,271683.0,Stable Salary & Stable Fixed Expenses,207761,107648.0,83602,191250.0,16511.0,7.95,-0.03,High Risk
U188,2024,5,288194.0,Stable Salary & Stable Fixed Expenses,207761,107648.0,63585,171233.0,36528.0,17.58,-0.02,Medium Risk
U188,2024,6,324722.0,Stable Salary & Stable Fixed Expenses,207761,107648.0,81290,188938.0,18823.0,9.06,0.04,High Risk
U188,2024,7,343545.0,Stable Salary & Stable Fixed Expenses,207761,107648.0,102356,210004.0,-2243.0,-1.08,-0.02,High Risk
U188,2024,8,341302.0,Stable Salary & Stable Fixed Expenses,207761,107648.0,84371,192019.0,15742.0,7.58,0.04,High Risk
U188,2024,9,357044.0,Stable Salary & Stable Fixed Expenses,207761,107648.0,83631,191279.0,16482.0,7.93,-0.04,High Risk
U188,2024,10,373526.0,Stable Salary & Stable Fixed Expenses,207761,107648.0,67493,175141.0,32620.0,15.7,-0.04,Medium Risk
U188,2024,11,406146.0,Stable Salary & Stable Fixed Expenses,207761,107648.0,70691,178339.0,29422.0,14.16,0.01,High Risk
U188,2024,12,435568.0,Stable Salary & Stable Fixed Expenses,207761,107648.0,103801,211449.0,-3688.0,-1.78,0.04,High Risk
U189,2024,1,247166.0,Salary Increases & Fixed Expenses Remain Stable,246146,98887.0,75187,174074.0,72072.0,29.28,0.03,Low Risk
U189,2024,2,319238.0,Salary Increases & Fixed Expenses Remain Stable,246146,98887.0,99469,198356.0,47790.0,19.42,-0.04,Medium Risk
U189,2024,3,367028.0,Salary Increases & Fixed Expenses Remain Stable,246146,98887.0,91906,190793.0,55353.0,22.49,-0.04,Medium Risk
U189,2024,4,422381.0,Salary Increases & Fixed Expenses Remain Stable,256310,98887.0,119918,218805.0,37505.0,14.63,-0.04,High Risk
U189,2024,5,459886.0,Salary Increases & Fixed Expenses Remain Stable,256310,98887.0,119767,218654.0,37656.0,14.69,0.0,High Risk
U189,2024,6,497542.0,Salary Increases & Fixed Expenses Remain Stable,256310,98887.0,99229,198116.0,58194.0,22.7,-0.04,Medium Risk
U189,2024,7,555736.0,Salary Increases & Fixed Expenses Remain Stable,256310,98887.0,90311,189198.0,67112.0,26.18,-0.0,Low Risk
U189,2024,8,622848.0,Salary Increases & Fixed Expenses Remain Stable,256310,98887.0,125056,223943.0,32367.0,12.63,0.03,High Risk
U189,2024,9,655215.0,Salary Increases & Fixed Expenses Remain Stable,256310,98887.0,122214,221101.0,35209.0,13.74,-0.02,High Risk
U189,2024,10,690424.0,Salary Increases & Fixed Expenses Remain Stable,256310,98887.0,135643,234530.0,21780.0,8.5,-0.02,High Risk
U189,2024,11,712204.0,Salary Increases & Fixed Expenses Remain Stable,256310,98887.0,93610,192497.0,63813.0,24.9,0.03,Medium Risk
U189,2024,12,776017.0,Salary Increases & Fixed Expenses Remain Stable,256310,98887.0,95693,194580.0,61730.0,24.08,0.04,Medium Risk
U190,2024,1,245865.0,Stable Salary & Stable Fixed Expenses,240311,61587.0,99568,161155.0,79156.0,32.94,-0.01,Low Risk
U190,2024,2,325021.0,Stable Salary & Stable Fixed Expenses,240311,61587.0,85379,146966.0,93345.0,38.84,0.05,Low Risk
U190,2024,3,418366.0,Stable Salary & Stable Fixed Expenses,240311,61587.0,130998,192585.0,47726.0,19.86,0.03,Medium Risk
U190,2024,4,466092.0,Stable Salary & Stable Fixed Expenses,240311,61587.0,114591,176178.0,64133.0,26.69,-0.01,Low Risk
U190,2024,5,530225.0,Stable Salary & Stable Fixed Expenses,240311,61587.0,99104,160691.0,79620.0,33.13,-0.03,Low Risk
U190,2024,6,609845.0,Stable Salary & Stable Fixed Expenses,240311,61587.0,118575,180162.0,60149.0,25.03,0.03,Low Risk
U190,2024,7,669994.0,Stable Salary & Stable Fixed Expenses,240311,61587.0,97884,159471.0,80840.0,33.64,-0.01,Low Risk
U190,2024,8,750834.0,Stable Salary & Stable Fixed Expenses,240311,61587.0,78372,139959.0,100352.0,41.76,-0.03,Low Risk
U190,2024,9,851186.0,Stable Salary & Stable Fixed Expenses,240311,61587.0,126236,187823.0,52488.0,21.84,0.02,Medium Risk
U190,2024,10,903674.0,Stable Salary & Stable Fixed Expenses,240311,61587.0,117963,179550.0,60761.0,25.28,-0.05,Low Risk
U190,2024,11,964435.0,Stable Salary & Stable Fixed Expenses,240311,61587.0,113048,174635.0,65676.0,27.33,-0.0,Low Risk
U190,2024,12,1030111.0,Stable Salary & Stable Fixed Expenses,240311,61587.0,105571,167158.0,73153.0,30.44,-0.02,Low Risk
U191,2024,1,247388.0,Salary Increases & Fixed Expenses Remain Stable,242176,70925.0,94589,165514.0,76662.0,31.66,-0.04,Low Risk
U191,2024,2,324050.0,Salary Increases & Fixed Expenses Remain Stable,242176,70925.0,89761,160686.0,81490.0,33.65,0.01,Low Risk
U191,2024,3,405540.0,Salary Increases & Fixed Expenses Remain Stable,242176,70925.0,108232,179157.0,63019.0,26.02,0.01,Low Risk
U191,2024,4,468559.0,Salary Increases & Fixed Expenses Remain Stable,242176,70925.0,114818,185743.0,56433.0,23.3,-0.01,Medium Risk
U191,2024,5,524992.0,Salary Increases & Fixed Expenses Remain Stable,242176,70925.0,101047,171972.0,70204.0,28.99,0.03,Low Risk
U191,2024,6,595196.0,Salary Increases & Fixed Expenses Remain Stable,268751,70925.0,80961,151886.0,116865.0,43.48,0.03,Low Risk
U191,2024,7,712061.0,Salary Increases & Fixed Expenses Remain Stable,268751,70925.0,104719,175644.0,93107.0,34.64,0.05,Low Risk
U191,2024,8,805168.0,Salary Increases & Fixed Expenses Remain Stable,268751,70925.0,119470,190395.0,78356.0,29.16,0.02,Low Risk
U191,2024,9,883524.0,Salary Increases & Fixed Expenses Remain Stable,268751,70925.0,100196,171121.0,97630.0,36.33,0.02,Low Risk
U191,2024,10,981154.0,Salary Increases & Fixed Expenses Remain Stable,268751,70925.0,99391,170316.0,98435.0,36.63,-0.0,Low Risk
U191,2024,11,1079589.0,Salary Increases & Fixed Expenses Remain Stable,268751,70925.0,133003,203928.0,64823.0,24.12,-0.03,Medium Risk
U191,2024,12,1144412.0,Salary Increases & Fixed Expenses Remain Stable,268751,70925.0,132452,203377.0,65374.0,24.33,0.05,Medium Risk
U192,2024,1,226320.0,Stable Salary & Stable Fixed Expenses,211736,115320.0,72428,187748.0,23988.0,11.33,0.02,High Risk
U192,2024,2,250308.0,Stable Salary & Stable Fixed Expenses,211736,115320.0,67140,182460.0,29276.0,13.83,-0.03,High Risk
U192,2024,3,279584.0,Stable Salary & Stable Fixed Expenses,211736,115320.0,67857,183177.0,28559.0,13.49,-0.03,High Risk
U192,2024,4,308143.0,Stable Salary & Stable Fixed Expenses,211736,115320.0,94031,209351.0,2385.0,1.13,-0.03,High Risk
U192,2024,5,310528.0,Stable Salary & Stable Fixed Expenses,211736,115320.0,82991,198311.0,13425.0,6.34,0.01,High Risk
U192,2024,6,323953.0,Stable Salary & Stable Fixed Expenses,211736,115320.0,102750,218070.0,-6334.0,-2.99,0.02,High Risk
U192,2024,7,317619.0,Stable Salary & Stable Fixed Expenses,211736,115320.0,86690,202010.0,9726.0,4.59,-0.04,High Risk
U192,2024,8,327345.0,Stable Salary & Stable Fixed Expenses,211736,115320.0,87626,202946.0,8790.0,4.15,-0.01,High Risk
U192,2024,9,336135.0,Stable Salary & Stable Fixed Expenses,211736,115320.0,78112,193432.0,18304.0,8.64,-0.04,High Risk
U192,2024,10,354439.0,Stable Salary & Stable Fixed Expenses,211736,115320.0,79203,194523.0,17213.0,8.13,0.01,High Risk
U192,2024,11,371652.0,Stable Salary & Stable Fixed Expenses,211736,115320.0,69375,184695.0,27041.0,12.77,0.05,High Risk
U192,2024,12,398693.0,Stable Salary & Stable Fixed Expenses,211736,115320.0,98707,214027.0,-2291.0,-1.08,0.02,High Risk
U193,2024,1,220488.0,Salary Increases & Fixed Expenses Remain Stable,167206,43132.0,44942,88074.0,79132.0,47.33,0.01,Low Risk
U193,2024,2,299620.0,Salary Increases & Fixed Expenses Remain Stable,167206,43132.0,33762,76894.0,90312.0,54.01,-0.02,Low Risk
U193,2024,3,389932.0,Salary Increases & Fixed Expenses Remain Stable,167206,43132.0,35868,79000.0,88206.0,52.75,0.05,Low Risk
U193,2024,4,478138.0,Salary Increases & Fixed Expenses Remain Stable,185362,43132.0,37395,80527.0,104835.0,56.56,-0.02,Low Risk
U193,2024,5,582973.0,Salary Increases & Fixed Expenses Remain Stable,185362,43132.0,45189,88321.0,97041.0,52.35,-0.01,Low Risk
U193,2024,6,680014.0,Salary Increases & Fixed Expenses Remain Stable,185362,43132.0,40095,83227.0,102135.0,55.1,-0.03,Low Risk
U193,2024,7,782149.0,Salary Increases & Fixed Expenses Remain Stable,185362,43132.0,38157,81289.0,104073.0,56.15,-0.03,Low Risk
U193,2024,8,886222.0,Salary Increases & Fixed Expenses Remain Stable,185362,43132.0,44180,87312.0,98050.0,52.9,0.0,Low Risk
U193,2024,9,984272.0,Salary Increases & Fixed Expenses Remain Stable,185362,43132.0,55444,98576.0,86786.0,46.82,-0.01,Low Risk
U193,2024,10,1071058.0,Salary Increases & Fixed Expenses Remain Stable,185362,43132.0,41396,84528.0,100834.0,54.4,-0.04,Low Risk
U193,2024,11,1171892.0,Salary Increases & Fixed Expenses Remain Stable,185362,43132.0,60357,103489.0,81873.0,44.17,0.01,Low Risk
U193,2024,12,1253765.0,Salary Increases & Fixed Expenses Remain Stable,185362,43132.0,43991,87123.0,98239.0,53.0,0.04,Low Risk
U194,2024,1,250000.0,Salary Increases & Fixed Expenses Remain Stable,282806,106710.0,60376,167086.0,115720.0,40.92,0.01,Low Risk
U194,2024,2,365720.0,Salary Increases & Fixed Expenses Remain Stable,282806,106710.0,75545,182255.0,100551.0,35.55,0.02,Low Risk
U194,2024,3,466271.0,Salary Increases & Fixed Expenses Remain Stable,282806,106710.0,106275,212985.0,69821.0,24.69,0.02,Medium Risk
U194,2024,4,536092.0,Salary Increases & Fixed Expenses Remain Stable,282806,106710.0,74490,181200.0,101606.0,35.93,-0.03,Low Risk
U194,2024,5,637698.0,Salary Increases & Fixed Expenses Remain Stable,282806,106710.0,61413,168123.0,114683.0,40.55,-0.03,Low Risk
U194,2024,6,752381.0,Salary Increases & Fixed Expenses Remain Stable,289399,106710.0,79584,186294.0,103105.0,35.63,0.02,Low Risk
U194,2024,7,855486.0,Salary Increases & Fixed Expenses Remain Stable,289399,106710.0,69258,175968.0,113431.0,39.2,-0.05,Low Risk
U194,2024,8,968917.0,Salary Increases & Fixed Expenses Remain Stable,289399,106710.0,74299,181009.0,108390.0,37.45,0.02,Low Risk
U194,2024,9,1077307.0,Salary Increases & Fixed Expenses Remain Stable,289399,106710.0,91648,198358.0,91041.0,31.46,0.04,Low Risk
U194,2024,10,1168348.0,Salary Increases & Fixed Expenses Remain Stable,289399,106710.0,97774,204484.0,84915.0,29.34,-0.01,Low Risk
U194,2024,11,1253263.0,Salary Increases & Fixed Expenses Remain Stable,289399,106710.0,84759,191469.0,97930.0,33.84,-0.01,Low Risk
U194,2024,12,1351193.0,Salary Increases & Fixed Expenses Remain Stable,289399,106710.0,105594,212304.0,77095.0,26.64,-0.03,Low Risk
U195,2024,1,200675.0,Salary Increases & Fixed Expenses Remain Stable,134163,51048.0,59520,110568.0,23595.0,17.59,-0.03,Medium Risk
U195,2024,2,224270.0,Salary Increases & Fixed Expenses Remain Stable,134163,51048.0,50162,101210.0,32953.0,24.56,-0.02,Medium Risk
U195,2024,3,257223.0,Salary Increases & Fixed Expenses Remain Stable,134163,51048.0,63936,114984.0,19179.0,14.3,-0.02,High Risk
U195,2024,4,276402.0,Salary Increases & Fixed Expenses Remain Stable,140170,51048.0,61680,112728.0,27442.0,19.58,0.01,Medium Risk
U195,2024,5,303844.0,Salary Increases & Fixed Expenses Remain Stable,140170,51048.0,52603,103651.0,36519.0,26.05,0.04,Low Risk
U195,2024,6,340363.0,Salary Increases & Fixed Expenses Remain Stable,140170,51048.0,54019,105067.0,35103.0,25.04,-0.04,Low Risk
U195,2024,7,375466.0,Salary Increases & Fixed Expenses Remain Stable,140170,51048.0,50865,101913.0,38257.0,27.29,0.03,Low Risk
U195,2024,8,413723.0,Salary Increases & Fixed Expenses Remain Stable,140170,51048.0,63505,114553.0,25617.0,18.28,0.04,Medium Risk
U195,2024,9,439340.0,Salary Increases & Fixed Expenses Remain Stable,140170,51048.0,61419,112467.0,27703.0,19.76,-0.03,Medium Risk
U195,2024,10,467043.0,Salary Increases & Fixed Expenses Remain Stable,140170,51048.0,67589,118637.0,21533.0,15.36,-0.0,Medium Risk
U195,2024,11,488576.0,Salary Increases & Fixed Expenses Remain Stable,140170,51048.0,69248,120296.0,19874.0,14.18,-0.03,High Risk
U195,2024,12,508450.0,Salary Increases & Fixed Expenses Remain Stable,140170,51048.0,44292,95340.0,44830.0,31.98,-0.01,Low Risk
U196,2024,1,219694.0,Salary Increases & Fixed Expenses Remain Stable,203602,66220.0,57555,123775.0,79827.0,39.21,0.05,Low Risk
U196,2024,2,299521.0,Salary Increases & Fixed Expenses Remain Stable,203602,66220.0,51132,117352.0,86250.0,42.36,-0.01,Low Risk
U196,2024,3,385771.0,Salary Increases & Fixed Expenses Remain Stable,231391,66220.0,64528,130748.0,100643.0,43.49,-0.05,Low Risk
U196,2024,4,486414.0,Salary Increases & Fixed Expenses Remain Stable,231391,66220.0,54025,120245.0,111146.0,48.03,-0.04,Low Risk
U196,2024,5,597560.0,Salary Increases & Fixed Expenses Remain Stable,231391,66220.0,54154,120374.0,111017.0,47.98,0.04,Low Risk
U196,2024,6,708577.0,Salary Increases & Fixed Expenses Remain Stable,231391,66220.0,56186,122406.0,108985.0,47.1,-0.05,Low Risk
U196,2024,7,817562.0,Salary Increases & Fixed Expenses Remain Stable,231391,66220.0,47447,113667.0,117724.0,50.88,0.04,Low Risk
U196,2024,8,935286.0,Salary Increases & Fixed Expenses Remain Stable,231391,66220.0,67908,134128.0,97263.0,42.03,0.01,Low Risk
U196,2024,9,1032549.0,Salary Increases & Fixed Expenses Remain Stable,231391,66220.0,58528,124748.0,106643.0,46.09,0.03,Low Risk
U196,2024,10,1139192.0,Salary Increases & Fixed Expenses Remain Stable,231391,66220.0,52601,118821.0,112570.0,48.65,0.01,Low Risk
U196,2024,11,1251762.0,Salary Increases & Fixed Expenses Remain Stable,231391,66220.0,58713,124933.0,106458.0,46.01,0.02,Low Risk
U196,2024,12,1358220.0,Salary Increases & Fixed Expenses Remain Stable,231391,66220.0,55506,121726.0,109665.0,47.39,-0.02,Low Risk
U197,2024,1,158401.0,Stable Salary & Decreasing Fixed Expenses,144875,74660.0,32140,106800.0,38075.0,26.28,-0.01,Low Risk
U197,2024,2,196476.0,Stable Salary & Decreasing Fixed Expenses,144875,74660.0,41513,116173.0,28702.0,19.81,0.04,Medium Risk
U197,2024,3,225178.0,Stable Salary & Decreasing Fixed Expenses,144875,74660.0,30567,105227.0,39648.0,27.37,-0.03,Low Risk
U197,2024,4,264826.0,Stable Salary & Decreasing Fixed Expenses,144875,74660.0,42508,117168.0,27707.0,19.12,0.02,Medium Risk
U197,2024,5,292533.0,Stable Salary & Decreasing Fixed Expenses,144875,74660.0,30393,105053.0,39822.0,27.49,0.02,Low Risk
U197,2024,6,332355.0,Stable Salary & Decreasing Fixed Expenses,144875,74660.0,36518,111178.0,33697.0,23.26,-0.01,Medium Risk
U197,2024,7,366052.0,Stable Salary & Decreasing Fixed Expenses,144875,73532.0,30326,103858.0,41017.0,28.31,-0.01,Low Risk
U197,2024,8,407069.0,Stable Salary & Decreasing Fixed Expenses,144875,73532.0,41863,115395.0,29480.0,20.35,0.05,Medium Risk
U197,2024,9,436549.0,Stable Salary & Decreasing Fixed Expenses,144875,73532.0,35557,109089.0,35786.0,24.7,0.04,Medium Risk
U197,2024,10,472335.0,Stable Salary & Decreasing Fixed Expenses,144875,73532.0,34631,108163.0,36712.0,25.34,0.03,Low Risk
U197,2024,11,509047.0,Stable Salary & Decreasing Fixed Expenses,144875,73532.0,31483,105015.0,39860.0,27.51,0.02,Low Risk
U197,2024,12,548907.0,Stable Salary & Decreasing Fixed Expenses,144875,73532.0,36447,109979.0,34896.0,24.09,0.02,Medium Risk
U198,2024,1,250000.0,Salary Increases & Fixed Expenses Increase,293401,99128.0,66769,165897.0,127504.0,43.46,0.05,Low Risk
U198,2024,2,377504.0,Salary Increases & Fixed Expenses Increase,293401,99128.0,60645,159773.0,133628.0,45.54,-0.0,Low Risk
U198,2024,3,511132.0,Salary Increases & Fixed Expenses Increase,293401,99128.0,74469,173597.0,119804.0,40.83,0.03,Low Risk
U198,2024,4,630936.0,Salary Increases & Fixed Expenses Increase,293401,99128.0,82392,181520.0,111881.0,38.13,-0.02,Low Risk
U198,2024,5,742817.0,Salary Increases & Fixed Expenses Increase,293401,99128.0,64063,163191.0,130210.0,44.38,0.04,Low Risk
U198,2024,6,873027.0,Salary Increases & Fixed Expenses Increase,317659,99128.0,69216,168344.0,149315.0,47.0,-0.01,Low Risk
U198,2024,7,1022342.0,Salary Increases & Fixed Expenses Increase,317659,99128.0,64744,163872.0,153787.0,48.41,-0.04,Low Risk
U198,2024,8,1176129.0,Salary Increases & Fixed Expenses Increase,317659,100157.0,70453,170610.0,147049.0,46.29,0.02,Low Risk
U198,2024,9,1323178.0,Salary Increases & Fixed Expenses Increase,317659,100157.0,69387,169544.0,148115.0,46.63,0.01,Low Risk
U198,2024,10,1471293.0,Salary Increases & Fixed Expenses Increase,317659,100157.0,88771,188928.0,128731.0,40.52,0.04,Low Risk
U198,2024,11,1600024.0,Salary Increases & Fixed Expenses Increase,317659,102003.0,73194,175197.0,142462.0,44.85,0.05,Low Risk
U198,2024,12,1742486.0,Salary Increases & Fixed Expenses Increase,317659,102003.0,65667,167670.0,149989.0,47.22,0.02,Low Risk
U199,2024,1,239311.0,Salary Increases & Fixed Expenses Increase,121723,41556.0,30334,71890.0,49833.0,40.94,0.02,Low Risk
U199,2024,2,289144.0,Salary Increases & Fixed Expenses Increase,121723,41556.0,32729,74285.0,47438.0,38.97,0.03,Low Risk
U199,2024,3,336582.0,Salary Increases & Fixed Expenses Increase,131089,43172.0,33683,76855.0,54234.0,41.37,0.01,Low Risk
U199,2024,4,390816.0,Salary Increases & Fixed Expenses Increase,131089,43172.0,34066,77238.0,53851.0,41.08,0.0,Low Risk
U199,2024,5,444667.0,Salary Increases & Fixed Expenses Increase,131089,44145.0,34559,78704.0,52385.0,39.96,-0.01,Low Risk
U199,2024,6,497052.0,Salary Increases & Fixed Expenses Increase,131089,44145.0,34060,78205.0,52884.0,40.34,0.02,Low Risk
U199,2024,7,549936.0,Salary Increases & Fixed Expenses Increase,131089,45587.0,31169,76756.0,54333.0,41.45,0.01,Low Risk
U199,2024,8,604269.0,Salary Increases & Fixed Expenses Increase,131089,45587.0,39132,84719.0,46370.0,35.37,0.04,Low Risk
U199,2024,9,650639.0,Salary Increases & Fixed Expenses Increase,131089,45587.0,27005,72592.0,58497.0,44.62,-0.0,Low Risk
U199,2024,10,709136.0,Salary Increases & Fixed Expenses Increase,131089,45587.0,29193,74780.0,56309.0,42.95,-0.01,Low Risk
U199,2024,11,765445.0,Salary Increases & Fixed Expenses Increase,131089,45587.0,32590,78177.0,52912.0,40.36,0.02,Low Risk
U199,2024,12,818357.0,Salary Increases & Fixed Expenses Increase,131089,45587.0,26594,72181.0,58908.0,44.94,-0.01,Low Risk
U200,2024,1,135539.0,Stable Salary & Increasing Fixed Expenses,77552,29726.0,34096,63822.0,13730.0,17.7,0.05,Medium Risk
U200,2024,2,149269.0,Stable Salary & Increasing Fixed Expenses,77552,29726.0,31087,60813.0,16739.0,21.58,0.01,Medium Risk
U200,2024,3,166008.0,Stable Salary & Increasing Fixed Expenses,77552,29726.0,31219,60945.0,16607.0,21.41,-0.03,Medium Risk
U200,2024,4,182615.0,Stable Salary & Increasing Fixed Expenses,77552,30897.0,36877,67774.0,9778.0,12.61,-0.0,High Risk
U200,2024,5,192393.0,Stable Salary & Increasing Fixed Expenses,77552,30897.0,26639,57536.0,20016.0,25.81,0.01,Low Risk
U200,2024,6,212409.0,Stable Salary & Increasing Fixed Expenses,77552,30897.0,28203,59100.0,18452.0,23.79,-0.03,Medium Risk
U200,2024,7,230861.0,Stable Salary & Increasing Fixed Expenses,77552,30897.0,35566,66463.0,11089.0,14.3,-0.03,High Risk
U200,2024,8,241950.0,Stable Salary & Increasing Fixed Expenses,77552,30897.0,24807,55704.0,21848.0,28.17,0.01,Low Risk
U200,2024,9,263798.0,Stable Salary & Increasing Fixed Expenses,77552,30897.0,33353,64250.0,13302.0,17.15,-0.03,Medium Risk
U200,2024,10,277100.0,Stable Salary & Increasing Fixed Expenses,77552,30897.0,32929,63826.0,13726.0,17.7,-0.04,Medium Risk
U200,2024,11,290826.0,Stable Salary & Increasing Fixed Expenses,77552,30897.0,41050,71947.0,5605.0,7.23,0.02,High Risk
U200,2024,12,296431.0,Stable Salary & Increasing Fixed Expenses,77552,30897.0,38417,69314.0,8238.0,10.62,0.01,High Risk
U201,2024,1,250000.0,Stable Salary & Increasing Fixed Expenses,259177,69424.0,64106,133530.0,125647.0,48.48,0.05,Low Risk
U201,2024,2,375647.0,Stable Salary & Increasing Fixed Expenses,259177,69424.0,76246,145670.0,113507.0,43.8,-0.04,Low Risk
U201,2024,3,489154.0,Stable Salary & Increasing Fixed Expenses,259177,69424.0,57860,127284.0,131893.0,50.89,-0.03,Low Risk
U201,2024,4,621047.0,Stable Salary & Increasing Fixed Expenses,259177,69424.0,55969,125393.0,133784.0,51.62,0.01,Low Risk
U201,2024,5,754831.0,Stable Salary & Increasing Fixed Expenses,259177,69424.0,77396,146820.0,112357.0,43.35,-0.03,Low Risk
U201,2024,6,867188.0,Stable Salary & Increasing Fixed Expenses,259177,69424.0,65969,135393.0,123784.0,47.76,0.0,Low Risk
U201,2024,7,990972.0,Stable Salary & Increasing Fixed Expenses,259177,69424.0,59780,129204.0,129973.0,50.15,-0.01,Low Risk
U201,2024,8,1120945.0,Stable Salary & Increasing Fixed Expenses,259177,69424.0,56606,126030.0,133147.0,51.37,0.04,Low Risk
U201,2024,9,1254092.0,Stable Salary & Increasing Fixed Expenses,259177,69424.0,59825,129249.0,129928.0,50.13,-0.01,Low Risk
U201,2024,10,1384020.0,Stable Salary & Increasing Fixed Expenses,259177,70471.0,74404,144875.0,114302.0,44.1,-0.03,Low Risk
U201,2024,11,1498322.0,Stable Salary & Increasing Fixed Expenses,259177,70471.0,62349,132820.0,126357.0,48.75,0.02,Low Risk
U201,2024,12,1624679.0,Stable Salary & Increasing Fixed Expenses,259177,70471.0,67916,138387.0,120790.0,46.61,0.02,Low Risk
U202,2024,1,212887.0,Stable Salary & Increasing Fixed Expenses,211102,103365.0,115964,219329.0,-8227.0,-3.9,-0.01,High Risk
U202,2024,2,204660.0,Stable Salary & Increasing Fixed Expenses,211102,103365.0,139469,242834.0,-31732.0,-15.03,-0.02,High Risk
U202,2024,3,172928.0,Stable Salary & Increasing Fixed Expenses,211102,103365.0,108177,211542.0,-440.0,-0.21,-0.03,High Risk
U202,2024,4,172488.0,Stable Salary & Increasing Fixed Expenses,211102,103365.0,110784,214149.0,-3047.0,-1.44,-0.0,High Risk
U202,2024,5,169441.0,Stable Salary & Increasing Fixed Expenses,211102,103365.0,138338,241703.0,-30601.0,-14.5,-0.0,High Risk
U202,2024,6,138840.0,Stable Salary & Increasing Fixed Expenses,211102,103365.0,115952,219317.0,-8215.0,-3.89,-0.01,High Risk
U202,2024,7,130625.0,Stable Salary & Increasing Fixed Expenses,211102,103365.0,130659,234024.0,-22922.0,-10.86,0.04,High Risk
U202,2024,8,107703.0,Stable Salary & Increasing Fixed Expenses,211102,103365.0,124494,227859.0,-16757.0,-7.94,-0.0,High Risk
U202,2024,9,90946.0,Stable Salary & Increasing Fixed Expenses,211102,103365.0,106837,210202.0,900.0,0.43,-0.0,High Risk
U202,2024,10,91846.0,Stable Salary & Increasing Fixed Expenses,211102,103365.0,108415,211780.0,-678.0,-0.32,0.0,High Risk
U202,2024,11,91168.0,Stable Salary & Increasing Fixed Expenses,211102,103365.0,146840,250205.0,-39103.0,-18.52,-0.01,High Risk
U202,2024,12,52065.0,Stable Salary & Increasing Fixed Expenses,211102,103365.0,136100,239465.0,-28363.0,-13.44,-0.02,High Risk
U203,2024,1,250000.0,Salary Increases & Fixed Expenses Increase,265759,110568.0,108635,219203.0,46556.0,17.52,-0.0,Medium Risk
U203,2024,2,296556.0,Salary Increases & Fixed Expenses Increase,265759,110568.0,122055,232623.0,33136.0,12.47,-0.03,High Risk
U203,2024,3,329692.0,Salary Increases & Fixed Expenses Increase,265759,110568.0,97489,208057.0,57702.0,21.71,0.01,Medium Risk
U203,2024,4,387394.0,Salary Increases & Fixed Expenses Increase,265759,110568.0,121045,231613.0,34146.0,12.85,0.03,High Risk
U203,2024,5,421540.0,Salary Increases & Fixed Expenses Increase,265759,111780.0,89633,201413.0,64346.0,24.21,-0.01,Medium Risk
U203,2024,6,485886.0,Salary Increases & Fixed Expenses Increase,281846,111780.0,119197,230977.0,50869.0,18.05,-0.01,Medium Risk
U203,2024,7,536755.0,Salary Increases & Fixed Expenses Increase,281846,111780.0,126844,238624.0,43222.0,15.34,-0.04,Medium Risk
U203,2024,8,579977.0,Salary Increases & Fixed Expenses Increase,281846,113155.0,98353,211508.0,70338.0,24.96,0.03,Medium Risk
U203,2024,9,650315.0,Salary Increases & Fixed Expenses Increase,281846,113155.0,134683,247838.0,34008.0,12.07,-0.03,High Risk
U203,2024,10,684323.0,Salary Increases & Fixed Expenses Increase,281846,113155.0,92564,205719.0,76127.0,27.01,-0.01,Low Risk
U203,2024,11,760450.0,Salary Increases & Fixed Expenses Increase,281846,113956.0,134701,248657.0,33189.0,11.78,-0.0,High Risk
U203,2024,12,793639.0,Salary Increases & Fixed Expenses Increase,281846,113956.0,107525,221481.0,60365.0,21.42,0.03,Medium Risk
U204,2024,1,249634.0,Salary Increases & Fixed Expenses Remain Stable,238836,80807.0,112167,192974.0,45862.0,19.2,0.05,Medium Risk
U204,2024,2,295496.0,Salary Increases & Fixed Expenses Remain Stable,238836,80807.0,83239,164046.0,74790.0,31.31,-0.03,Low Risk
U204,2024,3,370286.0,Salary Increases & Fixed Expenses Remain Stable,248442,80807.0,104501,185308.0,63134.0,25.41,-0.0,Low Risk
U204,2024,4,433420.0,Salary Increases & Fixed Expenses Remain Stable,248442,80807.0,121191,201998.0,46444.0,18.69,-0.03,Medium Risk
U204,2024,5,479864.0,Salary Increases & Fixed Expenses Remain Stable,248442,80807.0,87633,168440.0,80002.0,32.2,-0.01,Low Risk
U204,2024,6,559866.0,Salary Increases & Fixed Expenses Remain Stable,248442,80807.0,117668,198475.0,49967.0,20.11,0.04,Medium Risk
U204,2024,7,609833.0,Salary Increases & Fixed Expenses Remain Stable,248442,80807.0,112387,193194.0,55248.0,22.24,0.04,Medium Risk
U204,2024,8,665081.0,Salary Increases & Fixed Expenses Remain Stable,248442,80807.0,109613,190420.0,58022.0,23.35,0.02,Medium Risk
U204,2024,9,723103.0,Salary Increases & Fixed Expenses Remain Stable,248442,80807.0,119978,200785.0,47657.0,19.18,0.03,Medium Risk
U204,2024,10,770760.0,Salary Increases & Fixed Expenses Remain Stable,248442,80807.0,117910,198717.0,49725.0,20.01,-0.03,Medium Risk
U204,2024,11,820485.0,Salary Increases & Fixed Expenses Remain Stable,248442,80807.0,134717,215524.0,32918.0,13.25,0.04,High Risk
U204,2024,12,853403.0,Salary Increases & Fixed Expenses Remain Stable,248442,80807.0,90771,171578.0,76864.0,30.94,-0.02,Low Risk
U205,2024,1,236222.0,Stable Salary & Increasing Fixed Expenses,197883,49427.0,121116,170543.0,27340.0,13.82,-0.05,High Risk
U205,2024,2,263562.0,Stable Salary & Increasing Fixed Expenses,197883,49427.0,120862,170289.0,27594.0,13.94,-0.04,High Risk
U205,2024,3,291156.0,Stable Salary & Increasing Fixed Expenses,197883,49427.0,127433,176860.0,21023.0,10.62,0.03,High Risk
U205,2024,4,312179.0,Stable Salary & Increasing Fixed Expenses,197883,49427.0,109247,158674.0,39209.0,19.81,0.03,Medium Risk
U205,2024,5,351388.0,Stable Salary & Increasing Fixed Expenses,197883,50866.0,105512,156378.0,41505.0,20.97,-0.0,Medium Risk
U205,2024,6,392893.0,Stable Salary & Increasing Fixed Expenses,197883,50866.0,129695,180561.0,17322.0,8.75,-0.02,High Risk
U205,2024,7,410215.0,Stable Salary & Increasing Fixed Expenses,197883,50866.0,107839,158705.0,39178.0,19.8,0.03,Medium Risk
U205,2024,8,449393.0,Stable Salary & Increasing Fixed Expenses,197883,50866.0,119386,170252.0,27631.0,13.96,0.02,High Risk
U205,2024,9,477024.0,Stable Salary & Increasing Fixed Expenses,197883,50866.0,112400,163266.0,34617.0,17.49,-0.0,Medium Risk
U205,2024,10,511641.0,Stable Salary & Increasing Fixed Expenses,197883,50866.0,115384,166250.0,31633.0,15.99,0.02,Medium Risk
U205,2024,11,543274.0,Stable Salary & Increasing Fixed Expenses,197883,50866.0,127492,178358.0,19525.0,9.87,-0.03,High Risk
U205,2024,12,562799.0,Stable Salary & Increasing Fixed Expenses,197883,50866.0,118328,169194.0,28689.0,14.5,-0.04,High Risk
U206,2024,1,243296.0,Salary Increases & Fixed Expenses Remain Stable,217385,119835.0,50793,170628.0,46757.0,21.51,0.01,Medium Risk
U206,2024,2,290053.0,Salary Increases & Fixed Expenses Remain Stable,217385,119835.0,52237,172072.0,45313.0,20.84,-0.04,Medium Risk
U206,2024,3,335366.0,Salary Increases & Fixed Expenses Remain Stable,217385,119835.0,70722,190557.0,26828.0,12.34,-0.0,High Risk
U206,2024,4,362194.0,Salary Increases & Fixed Expenses Remain Stable,224125,119835.0,61412,181247.0,42878.0,19.13,-0.01,Medium Risk
U206,2024,5,405072.0,Salary Increases & Fixed Expenses Remain Stable,224125,119835.0,48475,168310.0,55815.0,24.9,-0.01,Medium Risk
U206,2024,6,460887.0,Salary Increases & Fixed Expenses Remain Stable,224125,119835.0,56864,176699.0,47426.0,21.16,-0.02,Medium Risk
U206,2024,7,508313.0,Salary Increases & Fixed Expenses Remain Stable,224125,119835.0,53555,173390.0,50735.0,22.64,-0.04,Medium Risk
U206,2024,8,559048.0,Salary Increases & Fixed Expenses Remain Stable,224125,119835.0,52728,172563.0,51562.0,23.01,0.03,Medium Risk
U206,2024,9,610610.0,Salary Increases & Fixed Expenses Remain Stable,224125,119835.0,58527,178362.0,45763.0,20.42,0.02,Medium Risk
U206,2024,10,656373.0,Salary Increases & Fixed Expenses Remain Stable,224125,119835.0,76438,196273.0,27852.0,12.43,0.02,High Risk
U206,2024,11,684225.0,Salary Increases & Fixed Expenses Remain Stable,224125,119835.0,70203,190038.0,34087.0,15.21,-0.02,Medium Risk
U206,2024,12,718312.0,Salary Increases & Fixed Expenses Remain Stable,224125,119835.0,66528,186363.0,37762.0,16.85,-0.0,Medium Risk
U207,2024,1,244277.0,Salary Increases & Fixed Expenses Increase,77710,31485.0,40246,71731.0,5979.0,7.69,-0.02,High Risk
U207,2024,2,250256.0,Salary Increases & Fixed Expenses Increase,77710,31485.0,41587,73072.0,4638.0,5.97,0.03,High Risk
U207,2024,3,254894.0,Salary Increases & Fixed Expenses Increase,77710,31485.0,48225,79710.0,-2000.0,-2.57,0.04,High Risk
U207,2024,4,252894.0,Salary Increases & Fixed Expenses Increase,77710,31485.0,38939,70424.0,7286.0,9.38,-0.01,High Risk
U207,2024,5,260180.0,Salary Increases & Fixed Expenses Increase,77710,32466.0,47933,80399.0,-2689.0,-3.46,0.04,High Risk
U207,2024,6,257491.0,Salary Increases & Fixed Expenses Increase,96457,32466.0,53068,85534.0,10923.0,11.32,0.05,High Risk
U207,2024,7,268414.0,Salary Increases & Fixed Expenses Increase,96457,33207.0,57958,91165.0,5292.0,5.49,0.03,High Risk
U207,2024,8,273706.0,Salary Increases & Fixed Expenses Increase,96457,33207.0,65634,98841.0,-2384.0,-2.47,-0.01,High Risk
U207,2024,9,271322.0,Salary Increases & Fixed Expenses Increase,96457,33207.0,50322,83529.0,12928.0,13.4,-0.04,High Risk
U207,2024,10,284250.0,Salary Increases & Fixed Expenses Increase,96457,33207.0,61479,94686.0,1771.0,1.84,0.04,High Risk
U207,2024,11,286021.0,Salary Increases & Fixed Expenses Increase,96457,34167.0,50512,84679.0,11778.0,12.21,-0.01,High Risk
U207,2024,12,297799.0,Salary Increases & Fixed Expenses Increase,96457,34167.0,51900,86067.0,10390.0,10.77,0.04,High Risk
U208,2024,1,208268.0,Salary Increases & Fixed Expenses Remain Stable,84502,31971.0,35581,67552.0,16950.0,20.06,0.04,Medium Risk
U208,2024,2,225218.0,Salary Increases & Fixed Expenses Remain Stable,84502,31971.0,32432,64403.0,20099.0,23.79,-0.05,Medium Risk
U208,2024,3,245317.0,Salary Increases & Fixed Expenses Remain Stable,84502,31971.0,34266,66237.0,18265.0,21.61,-0.03,Medium Risk
U208,2024,4,263582.0,Salary Increases & Fixed Expenses Remain Stable,84502,31971.0,36585,68556.0,15946.0,18.87,-0.02,Medium Risk
U208,2024,5,279528.0,Salary Increases & Fixed Expenses Remain Stable,84502,31971.0,31758,63729.0,20773.0,24.58,0.02,Medium Risk
U208,2024,6,300301.0,Salary Increases & Fixed Expenses Remain Stable,109372,31971.0,36500,68471.0,40901.0,37.4,-0.05,Low Risk
U208,2024,7,341202.0,Salary Increases & Fixed Expenses Remain Stable,109372,31971.0,43733,75704.0,33668.0,30.78,0.01,Low Risk
U208,2024,8,374870.0,Salary Increases & Fixed Expenses Remain Stable,109372,31971.0,50698,82669.0,26703.0,24.41,-0.03,Medium Risk
U208,2024,9,401573.0,Salary Increases & Fixed Expenses Remain Stable,109372,31971.0,49498,81469.0,27903.0,25.51,-0.03,Low Risk
U208,2024,10,429476.0,Salary Increases & Fixed Expenses Remain Stable,109372,31971.0,47162,79133.0,30239.0,27.65,-0.0,Low Risk
U208,2024,11,459715.0,Salary Increases & Fixed Expenses Remain Stable,109372,31971.0,50650,82621.0,26751.0,24.46,0.03,Medium Risk
U208,2024,12,486466.0,Salary Increases & Fixed Expenses Remain Stable,109372,31971.0,44116,76087.0,33285.0,30.43,-0.01,Low Risk
U209,2024,1,237468.0,Stable Salary & Increasing Fixed Expenses,122493,63191.0,43678,106869.0,15624.0,12.76,-0.03,High Risk
U209,2024,2,253092.0,Stable Salary & Increasing Fixed Expenses,122493,63191.0,56781,119972.0,2521.0,2.06,0.02,High Risk
U209,2024,3,255613.0,Stable Salary & Increasing Fixed Expenses,122493,63191.0,57450,120641.0,1852.0,1.51,-0.01,High Risk
U209,2024,4,257465.0,Stable Salary & Increasing Fixed Expenses,122493,63191.0,52055,115246.0,7247.0,5.92,0.02,High Risk
U209,2024,5,264712.0,Stable Salary & Increasing Fixed Expenses,122493,63191.0,57449,120640.0,1853.0,1.51,-0.01,High Risk
U209,2024,6,266565.0,Stable Salary & Increasing Fixed Expenses,122493,63191.0,37691,100882.0,21611.0,17.64,0.04,Medium Risk
U209,2024,7,288176.0,Stable Salary & Increasing Fixed Expenses,122493,63191.0,37871,101062.0,21431.0,17.5,-0.04,Medium Risk
U209,2024,8,309607.0,Stable Salary & Increasing Fixed Expenses,122493,63191.0,53678,116869.0,5624.0,4.59,0.03,High Risk
U209,2024,9,315231.0,Stable Salary & Increasing Fixed Expenses,122493,64590.0,69424,134014.0,-11521.0,-9.41,-0.04,High Risk
U209,2024,10,303710.0,Stable Salary & Increasing Fixed Expenses,122493,64590.0,55297,119887.0,2606.0,2.13,-0.04,High Risk
U209,2024,11,306316.0,Stable Salary & Increasing Fixed Expenses,122493,64590.0,52201,116791.0,5702.0,4.65,-0.03,High Risk
U209,2024,12,312018.0,Stable Salary & Increasing Fixed Expenses,122493,64590.0,59304,123894.0,-1401.0,-1.14,0.01,High Risk
U210,2024,1,111742.0,Salary Increases & Fixed Expenses Increase,78231,24599.0,49996,74595.0,3636.0,4.65,0.01,High Risk
U210,2024,2,115378.0,Salary Increases & Fixed Expenses Increase,78231,24599.0,44834,69433.0,8798.0,11.25,-0.03,High Risk
U210,2024,3,124176.0,Salary Increases & Fixed Expenses Increase,78231,24599.0,40833,65432.0,12799.0,16.36,0.04,Medium Risk
U210,2024,4,136975.0,Salary Increases & Fixed Expenses Increase,78231,24599.0,39927,64526.0,13705.0,17.52,-0.01,Medium Risk
U210,2024,5,150680.0,Salary Increases & Fixed Expenses Increase,102187,24599.0,63837,88436.0,13751.0,13.46,-0.05,High Risk
U210,2024,6,164431.0,Salary Increases & Fixed Expenses Increase,102187,24599.0,66985,91584.0,10603.0,10.38,0.04,High Risk
U210,2024,7,175034.0,Salary Increases & Fixed Expenses Increase,102187,25449.0,56034,81483.0,20704.0,20.26,0.03,Medium Risk
U210,2024,8,195738.0,Salary Increases & Fixed Expenses Increase,102187,27193.0,71171,98364.0,3823.0,3.74,0.03,High Risk
U210,2024,9,199561.0,Salary Increases & Fixed Expenses Increase,102187,27193.0,76338,103531.0,-1344.0,-1.32,-0.01,High Risk
U210,2024,10,198217.0,Salary Increases & Fixed Expenses Increase,102187,27193.0,57268,84461.0,17726.0,17.35,-0.04,Medium Risk
U210,2024,11,215943.0,Salary Increases & Fixed Expenses Increase,102187,27193.0,76039,103232.0,-1045.0,-1.02,0.03,High Risk
U210,2024,12,214898.0,Salary Increases & Fixed Expenses Increase,102187,27193.0,66119,93312.0,8875.0,8.69,0.04,High Risk
U211,2024,1,225338.0,Stable Salary & Stable Fixed Expenses,148079,51317.0,38030,89347.0,58732.0,39.66,0.02,Low Risk
U211,2024,2,284070.0,Stable Salary & Stable Fixed Expenses,148079,51317.0,42846,94163.0,53916.0,36.41,0.04,Low Risk
U211,2024,3,337986.0,Stable Salary & Stable Fixed Expenses,148079,51317.0,33482,84799.0,63280.0,42.73,0.04,Low Risk
U211,2024,4,401266.0,Stable Salary & Stable Fixed Expenses,148079,51317.0,35878,87195.0,60884.0,41.12,0.0,Low Risk
U211,2024,5,462150.0,Stable Salary & Stable Fixed Expenses,148079,51317.0,43612,94929.0,53150.0,35.89,0.01,Low Risk
U211,2024,6,515300.0,Stable Salary & Stable Fixed Expenses,148079,51317.0,39445,90762.0,57317.0,38.71,-0.01,Low Risk
U211,2024,7,572617.0,Stable Salary & Stable Fixed Expenses,148079,51317.0,44043,95360.0,52719.0,35.6,-0.03,Low Risk
U211,2024,8,625336.0,Stable Salary & Stable Fixed Expenses,148079,51317.0,36863,88180.0,59899.0,40.45,0.0,Low Risk
U211,2024,9,685235.0,Stable Salary & Stable Fixed Expenses,148079,51317.0,38325,89642.0,58437.0,39.46,0.02,Low Risk
U211,2024,10,743672.0,Stable Salary & Stable Fixed Expenses,148079,51317.0,35656,86973.0,61106.0,41.27,-0.01,Low Risk
U211,2024,11,804778.0,Stable Salary & Stable Fixed Expenses,148079,51317.0,39002,90319.0,57760.0,39.01,0.03,Low Risk
U211,2024,12,862538.0,Stable Salary & Stable Fixed Expenses,148079,51317.0,40009,91326.0,56753.0,38.33,-0.02,Low Risk
U212,2024,1,162792.0,Salary Increases & Fixed Expenses Increase,154890,58157.0,64070,122227.0,32663.0,21.09,-0.04,Medium Risk
U212,2024,2,195455.0,Salary Increases & Fixed Expenses Increase,154890,58157.0,67203,125360.0,29530.0,19.07,-0.01,Medium Risk
U212,2024,3,224985.0,Salary Increases & Fixed Expenses Increase,154890,58157.0,56033,114190.0,40700.0,26.28,0.05,Low Risk
U212,2024,4,265685.0,Salary Increases & Fixed Expenses Increase,173341,58157.0,64596,122753.0,50588.0,29.18,-0.01,Low Risk
U212,2024,5,316273.0,Salary Increases & Fixed Expenses Increase,173341,58157.0,63668,121825.0,51516.0,29.72,0.03,Low Risk
U212,2024,6,367789.0,Salary Increases & Fixed Expenses Increase,173341,58157.0,85931,144088.0,29253.0,16.88,0.02,Medium Risk
U212,2024,7,397042.0,Salary Increases & Fixed Expenses Increase,173341,58157.0,65364,123521.0,49820.0,28.74,-0.04,Low Risk
U212,2024,8,446862.0,Salary Increases & Fixed Expenses Increase,173341,58157.0,78330,136487.0,36854.0,21.26,-0.03,Medium Risk
U212,2024,9,483716.0,Salary Increases & Fixed Expenses Increase,173341,58157.0,94834,152991.0,20350.0,11.74,0.03,High Risk
U212,2024,10,504066.0,Salary Increases & Fixed Expenses Increase,173341,58157.0,55214,113371.0,59970.0,34.6,-0.0,Low Risk
U212,2024,11,564036.0,Salary Increases & Fixed Expenses Increase,173341,58157.0,77766,135923.0,37418.0,21.59,-0.02,Medium Risk
U212,2024,12,601454.0,Salary Increases & Fixed Expenses Increase,173341,58157.0,56284,114441.0,58900.0,33.98,-0.02,Low Risk
U213,2024,1,168711.0,Stable Salary & Increasing Fixed Expenses,135629,77375.0,56151,133526.0,2103.0,1.55,-0.02,High Risk
U213,2024,2,170814.0,Stable Salary & Increasing Fixed Expenses,135629,77375.0,54718,132093.0,3536.0,2.61,0.04,High Risk
U213,2024,3,174350.0,Stable Salary & Increasing Fixed Expenses,135629,77375.0,58007,135382.0,247.0,0.18,0.04,High Risk
U213,2024,4,174597.0,Stable Salary & Increasing Fixed Expenses,135629,77375.0,55510,132885.0,2744.0,2.02,-0.02,High Risk
U213,2024,5,177341.0,Stable Salary & Increasing Fixed Expenses,135629,77375.0,63481,140856.0,-5227.0,-3.85,0.04,High Risk
U213,2024,6,172114.0,Stable Salary & Increasing Fixed Expenses,135629,77375.0,65208,142583.0,-6954.0,-5.13,0.0,High Risk
U213,2024,7,165160.0,Stable Salary & Increasing Fixed Expenses,135629,78150.0,58576,136726.0,-1097.0,-0.81,-0.02,High Risk
U213,2024,8,164063.0,Stable Salary & Increasing Fixed Expenses,135629,78150.0,59083,137233.0,-1604.0,-1.18,0.03,High Risk
U213,2024,9,162459.0,Stable Salary & Increasing Fixed Expenses,135629,78150.0,53305,131455.0,4174.0,3.08,-0.01,High Risk
U213,2024,10,166633.0,Stable Salary & Increasing Fixed Expenses,135629,78150.0,56689,134839.0,790.0,0.58,-0.02,High Risk
U213,2024,11,167423.0,Stable Salary & Increasing Fixed Expenses,135629,78150.0,76708,154858.0,-19229.0,-14.18,0.01,High Risk
U213,2024,12,148194.0,Stable Salary & Increasing Fixed Expenses,135629,78150.0,60592,138742.0,-3113.0,-2.3,0.01,High Risk
U214,2024,1,102559.0,Stable Salary & Stable Fixed Expenses,96265,37276.0,36777,74053.0,22212.0,23.07,0.0,Medium Risk
U214,2024,2,124771.0,Stable Salary & Stable Fixed Expenses,96265,37276.0,33506,70782.0,25483.0,26.47,0.03,Low Risk
U214,2024,3,150254.0,Stable Salary & Stable Fixed Expenses,96265,37276.0,35143,72419.0,23846.0,24.77,-0.01,Medium Risk
U214,2024,4,174100.0,Stable Salary & Stable Fixed Expenses,96265,37276.0,31725,69001.0,27264.0,28.32,0.0,Low Risk
U214,2024,5,201364.0,Stable Salary & Stable Fixed Expenses,96265,37276.0,46359,83635.0,12630.0,13.12,0.0,High Risk
U214,2024,6,213994.0,Stable Salary & Stable Fixed Expenses,96265,37276.0,41494,78770.0,17495.0,18.17,-0.02,Medium Risk
U214,2024,7,231489.0,Stable Salary & Stable Fixed Expenses,96265,37276.0,45154,82430.0,13835.0,14.37,-0.03,High Risk
U214,2024,8,245324.0,Stable Salary & Stable Fixed Expenses,96265,37276.0,45540,82816.0,13449.0,13.97,-0.03,High Risk
U214,2024,9,258773.0,Stable Salary & Stable Fixed Expenses,96265,37276.0,45620,82896.0,13369.0,13.89,0.03,High Risk
U214,2024,10,272142.0,Stable Salary & Stable Fixed Expenses,96265,37276.0,35656,72932.0,23333.0,24.24,-0.01,Medium Risk
U214,2024,11,295475.0,Stable Salary & Stable Fixed Expenses,96265,37276.0,36571,73847.0,22418.0,23.29,-0.03,Medium Risk
U214,2024,12,317893.0,Stable Salary & Stable Fixed Expenses,96265,37276.0,40839,78115.0,18150.0,18.85,-0.01,Medium Risk
U215,2024,1,248314.0,Stable Salary & Increasing Fixed Expenses,248105,92288.0,80232,172520.0,75585.0,30.46,-0.02,Low Risk
U215,2024,2,323899.0,Stable Salary & Increasing Fixed Expenses,248105,92288.0,89452,181740.0,66365.0,26.75,0.04,Low Risk
U215,2024,3,390264.0,Stable Salary & Increasing Fixed Expenses,248105,92288.0,108607,200895.0,47210.0,19.03,0.04,Medium Risk
U215,2024,4,437474.0,Stable Salary & Increasing Fixed Expenses,248105,92288.0,77682,169970.0,78135.0,31.49,0.0,Low Risk
U215,2024,5,515609.0,Stable Salary & Increasing Fixed Expenses,248105,92288.0,117788,210076.0,38029.0,15.33,0.02,Medium Risk
U215,2024,6,553638.0,Stable Salary & Increasing Fixed Expenses,248105,92288.0,101130,193418.0,54687.0,22.04,0.01,Medium Risk
U215,2024,7,608325.0,Stable Salary & Increasing Fixed Expenses,248105,93435.0,103657,197092.0,51013.0,20.56,0.03,Medium Risk
U215,2024,8,659338.0,Stable Salary & Increasing Fixed Expenses,248105,93435.0,91317,184752.0,63353.0,25.53,0.01,Low Risk
U215,2024,9,722691.0,Stable Salary & Increasing Fixed Expenses,248105,93435.0,109579,203014.0,45091.0,18.17,-0.03,Medium Risk
U215,2024,10,767782.0,Stable Salary & Increasing Fixed Expenses,248105,93435.0,79962,173397.0,74708.0,30.11,0.01,Low Risk
U215,2024,11,842490.0,Stable Salary & Increasing Fixed Expenses,248105,93435.0,105417,198852.0,49253.0,19.85,-0.0,Medium Risk
U215,2024,12,891743.0,Stable Salary & Increasing Fixed Expenses,248105,93435.0,122960,216395.0,31710.0,12.78,-0.03,High Risk
U216,2024,1,221056.0,Stable Salary & Increasing Fixed Expenses,220209,71467.0,52734,124201.0,96008.0,43.6,-0.01,Low Risk
U216,2024,2,317064.0,Stable Salary & Increasing Fixed Expenses,220209,71467.0,50477,121944.0,98265.0,44.62,0.02,Low Risk
U216,2024,3,415329.0,Stable Salary & Increasing Fixed Expenses,220209,73429.0,48508,121937.0,98272.0,44.63,0.02,Low Risk
U216,2024,4,513601.0,Stable Salary & Increasing Fixed Expenses,220209,73429.0,60092,133521.0,86688.0,39.37,-0.0,Low Risk
U216,2024,5,600289.0,Stable Salary & Increasing Fixed Expenses,220209,73429.0,50585,124014.0,96195.0,43.68,0.0,Low Risk
U216,2024,6,696484.0,Stable Salary & Increasing Fixed Expenses,220209,73429.0,60677,134106.0,86103.0,39.1,0.0,Low Risk
U216,2024,7,782587.0,Stable Salary & Increasing Fixed Expenses,220209,73429.0,52170,125599.0,94610.0,42.96,0.0,Low Risk
U216,2024,8,877197.0,Stable Salary & Increasing Fixed Expenses,220209,73429.0,55892,129321.0,90888.0,41.27,0.05,Low Risk
U216,2024,9,968085.0,Stable Salary & Increasing Fixed Expenses,220209,73429.0,65978,139407.0,80802.0,36.69,0.03,Low Risk
U216,2024,10,1048887.0,Stable Salary & Increasing Fixed Expenses,220209,73429.0,56743,130172.0,90037.0,40.89,-0.03,Low Risk
U216,2024,11,1138924.0,Stable Salary & Increasing Fixed Expenses,220209,73429.0,52679,126108.0,94101.0,42.73,0.03,Low Risk
U216,2024,12,1233025.0,Stable Salary & Increasing Fixed Expenses,220209,75381.0,64431,139812.0,80397.0,36.51,0.02,Low Risk
U217,2024,1,182755.0,Stable Salary & Increasing Fixed Expenses,120417,71995.0,27215,99210.0,21207.0,17.61,-0.0,Medium Risk
U217,2024,2,203962.0,Stable Salary & Increasing Fixed Expenses,120417,71995.0,35476,107471.0,12946.0,10.75,-0.04,High Risk
U217,2024,3,216908.0,Stable Salary & Increasing Fixed Expenses,120417,71995.0,24616,96611.0,23806.0,19.77,-0.04,Medium Risk
U217,2024,4,240714.0,Stable Salary & Increasing Fixed Expenses,120417,73735.0,28645,102380.0,18037.0,14.98,0.02,High Risk
U217,2024,5,258751.0,Stable Salary & Increasing Fixed Expenses,120417,75621.0,28165,103786.0,16631.0,13.81,-0.03,High Risk
U217,2024,6,275382.0,Stable Salary & Increasing Fixed Expenses,120417,75621.0,27245,102866.0,17551.0,14.58,0.03,High Risk
U217,2024,7,292933.0,Stable Salary & Increasing Fixed Expenses,120417,75621.0,26499,102120.0,18297.0,15.19,-0.04,Medium Risk
U217,2024,8,311230.0,Stable Salary & Increasing Fixed Expenses,120417,75621.0,32865,108486.0,11931.0,9.91,0.02,High Risk
U217,2024,9,323161.0,Stable Salary & Increasing Fixed Expenses,120417,75621.0,33562,109183.0,11234.0,9.33,0.01,High Risk
U217,2024,10,334395.0,Stable Salary & Increasing Fixed Expenses,120417,75621.0,25899,101520.0,18897.0,15.69,0.03,Medium Risk
U217,2024,11,353292.0,Stable Salary & Increasing Fixed Expenses,120417,75621.0,39964,115585.0,4832.0,4.01,-0.02,High Risk
U217,2024,12,358124.0,Stable Salary & Increasing Fixed Expenses,120417,75621.0,32412,108033.0,12384.0,10.28,0.01,High Risk
U218,2024,1,250000.0,Salary Increases & Fixed Expenses Remain Stable,260210,85656.0,128352,214008.0,46202.0,17.76,-0.01,Medium Risk
U218,2024,2,296202.0,Salary Increases & Fixed Expenses Remain Stable,260210,85656.0,107718,193374.0,66836.0,25.69,-0.03,Low Risk
U218,2024,3,363038.0,Salary Increases & Fixed Expenses Remain Stable,266172,85656.0,115034,200690.0,65482.0,24.6,-0.02,Medium Risk
U218,2024,4,428520.0,Salary Increases & Fixed Expenses Remain Stable,266172,85656.0,113266,198922.0,67250.0,25.27,-0.05,Low Risk
U218,2024,5,495770.0,Salary Increases & Fixed Expenses Remain Stable,266172,85656.0,92379,178035.0,88137.0,33.11,0.01,Low Risk
U218,2024,6,583907.0,Salary Increases & Fixed Expenses Remain Stable,266172,85656.0,121406,207062.0,59110.0,22.21,0.03,Medium Risk
U218,2024,7,643017.0,Salary Increases & Fixed Expenses Remain Stable,266172,85656.0,114424,200080.0,66092.0,24.83,-0.02,Medium Risk
U218,2024,8,709109.0,Salary Increases & Fixed Expenses Remain Stable,266172,85656.0,120883,206539.0,59633.0,22.4,-0.01,Medium Risk
U218,2024,9,768742.0,Salary Increases & Fixed Expenses Remain Stable,266172,85656.0,124061,209717.0,56455.0,21.21,0.04,Medium Risk
U218,2024,10,825197.0,Salary Increases & Fixed Expenses Remain Stable,266172,85656.0,108395,194051.0,72121.0,27.1,0.03,Low Risk
U218,2024,11,897318.0,Salary Increases & Fixed Expenses Remain Stable,266172,85656.0,109519,195175.0,70997.0,26.67,0.04,Low Risk
U218,2024,12,968315.0,Salary Increases & Fixed Expenses Remain Stable,266172,85656.0,104752,190408.0,75764.0,28.46,0.04,Low Risk
U219,2024,1,250000.0,Salary Increases & Fixed Expenses Remain Stable,267200,101377.0,63983,165360.0,101840.0,38.11,-0.01,Low Risk
U219,2024,2,351840.0,Salary Increases & Fixed Expenses Remain Stable,267200,101377.0,68309,169686.0,97514.0,36.49,0.03,Low Risk
U219,2024,3,449354.0,Salary Increases & Fixed Expenses Remain Stable,267200,101377.0,90462,191839.0,75361.0,28.2,-0.04,Low Risk
U219,2024,4,524715.0,Salary Increases & Fixed Expenses Remain Stable,283756,101377.0,60937,162314.0,121442.0,42.8,0.04,Low Risk
U219,2024,5,646157.0,Salary Increases & Fixed Expenses Remain Stable,283756,101377.0,59099,160476.0,123280.0,43.45,0.02,Low Risk
U219,2024,6,769437.0,Salary Increases & Fixed Expenses Remain Stable,283756,101377.0,75355,176732.0,107024.0,37.72,-0.01,Low Risk
U219,2024,7,876461.0,Salary Increases & Fixed Expenses Remain Stable,283756,101377.0,62153,163530.0,120226.0,42.37,0.02,Low Risk
U219,2024,8,996687.0,Salary Increases & Fixed Expenses Remain Stable,283756,101377.0,72148,173525.0,110231.0,38.85,0.01,Low Risk
U219,2024,9,1106918.0,Salary Increases & Fixed Expenses Remain Stable,283756,101377.0,74345,175722.0,108034.0,38.07,0.04,Low Risk
U219,2024,10,1214952.0,Salary Increases & Fixed Expenses Remain Stable,283756,101377.0,76561,177938.0,105818.0,37.29,-0.05,Low Risk
U219,2024,11,1320770.0,Salary Increases & Fixed Expenses Remain Stable,283756,101377.0,91798,193175.0,90581.0,31.92,0.01,Low Risk
U219,2024,12,1411351.0,Salary Increases & Fixed Expenses Remain Stable,283756,101377.0,93351,194728.0,89028.0,31.37,-0.03,Low Risk
U220,2024,1,242758.0,Salary Increases & Fixed Expenses Decrease,207075,93510.0,60355,153865.0,53210.0,25.7,-0.05,Low Risk
U220,2024,2,295968.0,Salary Increases & Fixed Expenses Decrease,207075,93510.0,53439,146949.0,60126.0,29.04,-0.01,Low Risk
U220,2024,3,356094.0,Salary Increases & Fixed Expenses Decrease,207075,93510.0,60220,153730.0,53345.0,25.76,0.03,Low Risk
U220,2024,4,409439.0,Salary Increases & Fixed Expenses Decrease,207075,93510.0,61168,154678.0,52397.0,25.3,-0.02,Low Risk
U220,2024,5,461836.0,Salary Increases & Fixed Expenses Decrease,207075,93510.0,49620,143130.0,63945.0,30.88,0.02,Low Risk
U220,2024,6,525781.0,Salary Increases & Fixed Expenses Decrease,207075,93510.0,55591,149101.0,57974.0,28.0,0.03,Low Risk
U220,2024,7,583755.0,Salary Increases & Fixed Expenses Decrease,216563,93510.0,44230,137740.0,78823.0,36.4,-0.02,Low Risk
U220,2024,8,662578.0,Salary Increases & Fixed Expenses Decrease,216563,93510.0,51646,145156.0,71407.0,32.97,-0.01,Low Risk
U220,2024,9,733985.0,Salary Increases & Fixed Expenses Decrease,216563,93510.0,57662,151172.0,65391.0,30.19,-0.03,Low Risk
U220,2024,10,799376.0,Salary Increases & Fixed Expenses Decrease,216563,91828.0,47216,139044.0,77519.0,35.8,-0.05,Low Risk
U220,2024,11,876895.0,Salary Increases & Fixed Expenses Decrease,216563,91828.0,68243,160071.0,56492.0,26.09,-0.04,Low Risk
U220,2024,12,933387.0,Salary Increases & Fixed Expenses Decrease,216563,90755.0,60093,150848.0,65715.0,30.34,-0.04,Low Risk
U221,2024,1,224892.0,Stable Salary & Increasing Fixed Expenses,183614,54167.0,49437,103604.0,80010.0,43.58,0.01,Low Risk
U221,2024,2,304902.0,Stable Salary & Increasing Fixed Expenses,183614,54167.0,44254,98421.0,85193.0,46.4,0.03,Low Risk
U221,2024,3,390095.0,Stable Salary & Increasing Fixed Expenses,183614,54167.0,56871,111038.0,72576.0,39.53,-0.01,Low Risk
U221,2024,4,462671.0,Stable Salary & Increasing Fixed Expenses,183614,54167.0,37397,91564.0,92050.0,50.13,0.01,Low Risk
U221,2024,5,554721.0,Stable Salary & Increasing Fixed Expenses,183614,54167.0,41546,95713.0,87901.0,47.87,0.02,Low Risk
U221,2024,6,642622.0,Stable Salary & Increasing Fixed Expenses,183614,54167.0,48476,102643.0,80971.0,44.1,-0.01,Low Risk
U221,2024,7,723593.0,Stable Salary & Increasing Fixed Expenses,183614,54167.0,45895,100062.0,83552.0,45.5,0.04,Low Risk
U221,2024,8,807145.0,Stable Salary & Increasing Fixed Expenses,183614,54167.0,38014,92181.0,91433.0,49.8,0.05,Low Risk
U221,2024,9,898578.0,Stable Salary & Increasing Fixed Expenses,183614,54167.0,61114,115281.0,68333.0,37.22,-0.02,Low Risk
U221,2024,10,966911.0,Stable Salary & Increasing Fixed Expenses,183614,54167.0,55912,110079.0,73535.0,40.05,-0.0,Low Risk
U221,2024,11,1040446.0,Stable Salary & Increasing Fixed Expenses,183614,54167.0,60295,114462.0,69152.0,37.66,0.02,Low Risk
U221,2024,12,1109598.0,Stable Salary & Increasing Fixed Expenses,183614,54167.0,58613,112780.0,70834.0,38.58,0.02,Low Risk
U222,2024,1,73344.0,Stable Salary & Stable Fixed Expenses,20052,20819.0,6330,27149.0,-7097.0,-35.39,-0.01,High Risk
U222,2024,2,66247.0,Stable Salary & Stable Fixed Expenses,20052,20819.0,9594,30413.0,-10361.0,-51.67,-0.03,High Risk
U222,2024,3,55886.0,Stable Salary & Stable Fixed Expenses,20052,20819.0,9169,29988.0,-9936.0,-49.55,0.05,High Risk
U222,2024,4,45950.0,Stable Salary & Stable Fixed Expenses,20052,20819.0,7388,28207.0,-8155.0,-40.67,0.02,High Risk
U222,2024,5,37795.0,Stable Salary & Stable Fixed Expenses,20052,20819.0,7632,28451.0,-8399.0,-41.89,-0.02,High Risk
U222,2024,6,29396.0,Stable Salary & Stable Fixed Expenses,20052,20819.0,8179,28998.0,-8946.0,-44.61,-0.03,High Risk
U222,2024,7,20450.0,Stable Salary & Stable Fixed Expenses,20052,20819.0,6190,27009.0,-6957.0,-34.69,-0.05,High Risk
U222,2024,8,13493.0,Stable Salary & Stable Fixed Expenses,20052,20819.0,7966,28785.0,-8733.0,-43.55,0.03,High Risk
U222,2024,9,4760.0,Stable Salary & Stable Fixed Expenses,20052,20819.0,7540,28359.0,-8307.0,-41.43,-0.02,High Risk
U222,2024,10,-3547.0,Stable Salary & Stable Fixed Expenses,20052,20819.0,9584,30403.0,-10351.0,-51.62,-0.02,High Risk
U222,2024,11,-13898.0,Stable Salary & Stable Fixed Expenses,20052,20819.0,7168,27987.0,-7935.0,-39.57,-0.03,High Risk
U222,2024,12,-21833.0,Stable Salary & Stable Fixed Expenses,20052,20819.0,7863,28682.0,-8630.0,-43.04,-0.02,High Risk
U223,2024,1,234632.0,Salary Increases & Fixed Expenses Increase,230678,111545.0,112489,224034.0,6644.0,2.88,0.02,High Risk
U223,2024,2,241276.0,Salary Increases & Fixed Expenses Increase,230678,111545.0,104542,216087.0,14591.0,6.33,0.02,High Risk
U223,2024,3,255867.0,Salary Increases & Fixed Expenses Increase,244930,111545.0,118763,230308.0,14622.0,5.97,0.02,High Risk
U223,2024,4,270489.0,Salary Increases & Fixed Expenses Increase,244930,111545.0,91206,202751.0,42179.0,17.22,0.05,Medium Risk
U223,2024,5,312668.0,Salary Increases & Fixed Expenses Increase,244930,111545.0,108635,220180.0,24750.0,10.1,-0.01,High Risk
U223,2024,6,337418.0,Salary Increases & Fixed Expenses Increase,244930,111545.0,114817,226362.0,18568.0,7.58,0.0,High Risk
U223,2024,7,355986.0,Salary Increases & Fixed Expenses Increase,244930,112315.0,91615,203930.0,41000.0,16.74,0.0,Medium Risk
U223,2024,8,396986.0,Salary Increases & Fixed Expenses Increase,244930,112315.0,78520,190835.0,54095.0,22.09,0.02,Medium Risk
U223,2024,9,451081.0,Salary Increases & Fixed Expenses Increase,244930,112315.0,101191,213506.0,31424.0,12.83,0.02,High Risk
U223,2024,10,482505.0,Salary Increases & Fixed Expenses Increase,244930,112315.0,104779,217094.0,27836.0,11.36,-0.03,High Risk
U223,2024,11,510341.0,Salary Increases & Fixed Expenses Increase,244930,112315.0,83054,195369.0,49561.0,20.23,-0.0,Medium Risk
U223,2024,12,559902.0,Salary Increases & Fixed Expenses Increase,244930,112315.0,91004,203319.0,41611.0,16.99,-0.05,Medium Risk
U224,2024,1,231467.0,Stable Salary & Decreasing Fixed Expenses,203309,90544.0,89121,179665.0,23644.0,11.63,-0.01,High Risk
U224,2024,2,255111.0,Stable Salary & Decreasing Fixed Expenses,203309,90544.0,83580,174124.0,29185.0,14.35,0.03,High Risk
U224,2024,3,284296.0,Stable Salary & Decreasing Fixed Expenses,203309,90544.0,65873,156417.0,46892.0,23.06,0.02,Medium Risk
U224,2024,4,331188.0,Stable Salary & Decreasing Fixed Expenses,203309,90544.0,97634,188178.0,15131.0,7.44,-0.02,High Risk
U224,2024,5,346319.0,Stable Salary & Decreasing Fixed Expenses,203309,90544.0,90863,181407.0,21902.0,10.77,0.05,High Risk
U224,2024,6,368221.0,Stable Salary & Decreasing Fixed Expenses,203309,90544.0,98653,189197.0,14112.0,6.94,-0.02,High Risk
U224,2024,7,382333.0,Stable Salary & Decreasing Fixed Expenses,203309,90544.0,61939,152483.0,50826.0,25.0,0.03,Medium Risk
U224,2024,8,433159.0,Stable Salary & Decreasing Fixed Expenses,203309,90544.0,68966,159510.0,43799.0,21.54,0.03,Medium Risk
U224,2024,9,476958.0,Stable Salary & Decreasing Fixed Expenses,203309,90544.0,90374,180918.0,22391.0,11.01,-0.0,High Risk
U224,2024,10,499349.0,Stable Salary & Decreasing Fixed Expenses,203309,90544.0,87158,177702.0,25607.0,12.6,0.01,High Risk
U224,2024,11,524956.0,Stable Salary & Decreasing Fixed Expenses,203309,90544.0,110522,201066.0,2243.0,1.1,-0.02,High Risk
U224,2024,12,527199.0,Stable Salary & Decreasing Fixed Expenses,203309,90544.0,93943,184487.0,18822.0,9.26,0.05,High Risk
U225,2024,1,65910.0,Stable Salary & Increasing Fixed Expenses,21556,20772.0,8598,29370.0,-7814.0,-36.25,-0.02,High Risk
U225,2024,2,58096.0,Stable Salary & Increasing Fixed Expenses,21556,20772.0,10189,30961.0,-9405.0,-43.63,-0.01,High Risk
U225,2024,3,48691.0,Stable Salary & Increasing Fixed Expenses,21556,20772.0,12370,33142.0,-11586.0,-53.75,-0.04,High Risk
U225,2024,4,37105.0,Stable Salary & Increasing Fixed Expenses,21556,20772.0,9395,30167.0,-8611.0,-39.95,-0.03,High Risk
U225,2024,5,28494.0,Stable Salary & Increasing Fixed Expenses,21556,20772.0,8268,29040.0,-7484.0,-34.72,-0.04,High Risk
U225,2024,6,21010.0,Stable Salary & Increasing Fixed Expenses,21556,20772.0,7536,28308.0,-6752.0,-31.32,0.01,High Risk
U225,2024,7,14258.0,Stable Salary & Increasing Fixed Expenses,21556,20772.0,6742,27514.0,-5958.0,-27.64,0.01,High Risk
U225,2024,8,8300.0,Stable Salary & Increasing Fixed Expenses,21556,20772.0,8606,29378.0,-7822.0,-36.29,-0.04,High Risk
U225,2024,9,478.0,Stable Salary & Increasing Fixed Expenses,21556,20772.0,10132,30904.0,-9348.0,-43.37,-0.05,High Risk
U225,2024,10,-8870.0,Stable Salary & Increasing Fixed Expenses,21556,20772.0,10304,31076.0,-9520.0,-44.16,0.05,High Risk
U225,2024,11,-18390.0,Stable Salary & Increasing Fixed Expenses,21556,22099.0,9487,31586.0,-10030.0,-46.53,-0.01,High Risk
U225,2024,12,-28420.0,Stable Salary & Increasing Fixed Expenses,21556,23335.0,8168,31503.0,-9947.0,-46.14,0.02,High Risk
U226,2024,1,250000.0,Salary Increases & Fixed Expenses Increase,295111,100269.0,101082,201351.0,93760.0,31.77,0.03,Low Risk
U226,2024,2,343760.0,Salary Increases & Fixed Expenses Increase,295111,100269.0,121861,222130.0,72981.0,24.73,0.04,Medium Risk
U226,2024,3,416741.0,Salary Increases & Fixed Expenses Increase,303065,100269.0,146532,246801.0,56264.0,18.56,-0.04,Medium Risk
U226,2024,4,473005.0,Salary Increases & Fixed Expenses Increase,303065,100269.0,122201,222470.0,80595.0,26.59,-0.0,Low Risk
U226,2024,5,553600.0,Salary Increases & Fixed Expenses Increase,303065,100269.0,148992,249261.0,53804.0,17.75,-0.0,Medium Risk
U226,2024,6,607404.0,Salary Increases & Fixed Expenses Increase,303065,100269.0,109621,209890.0,93175.0,30.74,-0.02,Low Risk
U226,2024,7,700579.0,Salary Increases & Fixed Expenses Increase,303065,100269.0,125234,225503.0,77562.0,25.59,0.03,Low Risk
U226,2024,8,778141.0,Salary Increases & Fixed Expenses Increase,303065,100269.0,143342,243611.0,59454.0,19.62,-0.01,Medium Risk
U226,2024,9,837595.0,Salary Increases & Fixed Expenses Increase,303065,100269.0,105398,205667.0,97398.0,32.14,0.0,Low Risk
U226,2024,10,934993.0,Salary Increases & Fixed Expenses Increase,303065,100269.0,142618,242887.0,60178.0,19.86,-0.03,Medium Risk
U226,2024,11,995171.0,Salary Increases & Fixed Expenses Increase,303065,100269.0,153981,254250.0,48815.0,16.11,-0.02,Medium Risk
U226,2024,12,1043986.0,Salary Increases & Fixed Expenses Increase,303065,100269.0,133698,233967.0,69098.0,22.8,-0.04,Medium Risk
U227,2024,1,192380.0,Salary Increases & Fixed Expenses Decrease,181894,59608.0,61862,121470.0,60424.0,33.22,0.02,Low Risk
U227,2024,2,252804.0,Salary Increases & Fixed Expenses Decrease,181894,59608.0,71170,130778.0,51116.0,28.1,0.03,Low Risk
U227,2024,3,303920.0,Salary Increases & Fixed Expenses Decrease,181894,59608.0,113245,172853.0,9041.0,4.97,0.02,High Risk
U227,2024,4,312961.0,Salary Increases & Fixed Expenses Decrease,181894,59608.0,56327,115935.0,65959.0,36.26,0.04,Low Risk
U227,2024,5,378920.0,Salary Increases & Fixed Expenses Decrease,206605,59608.0,74559,134167.0,72438.0,35.06,-0.03,Low Risk
U227,2024,6,451358.0,Salary Increases & Fixed Expenses Decrease,206605,59608.0,70547,130155.0,76450.0,37.0,0.01,Low Risk
U227,2024,7,527808.0,Salary Increases & Fixed Expenses Decrease,206605,59608.0,101840,161448.0,45157.0,21.86,0.03,Medium Risk
U227,2024,8,572965.0,Salary Increases & Fixed Expenses Decrease,206605,59608.0,70470,130078.0,76527.0,37.04,0.02,Low Risk
U227,2024,9,649492.0,Salary Increases & Fixed Expenses Decrease,206605,59608.0,109023,168631.0,37974.0,18.38,-0.01,Medium Risk
U227,2024,10,687466.0,Salary Increases & Fixed Expenses Decrease,206605,59608.0,130880,190488.0,16117.0,7.8,-0.03,High Risk
U227,2024,11,703583.0,Salary Increases & Fixed Expenses Decrease,206605,59608.0,87853,147461.0,59144.0,28.63,-0.05,Low Risk
U227,2024,12,762727.0,Salary Increases & Fixed Expenses Decrease,206605,59608.0,107765,167373.0,39232.0,18.99,0.0,Medium Risk
U228,2024,1,193157.0,Salary Increases & Fixed Expenses Remain Stable,164556,45154.0,41471,86625.0,77931.0,47.36,0.02,Low Risk
U228,2024,2,271088.0,Salary Increases & Fixed Expenses Remain Stable,164556,45154.0,34045,79199.0,85357.0,51.87,0.03,Low Risk
U228,2024,3,356445.0,Salary Increases & Fixed Expenses Remain Stable,164556,45154.0,46603,91757.0,72799.0,44.24,0.01,Low Risk
U228,2024,4,429244.0,Salary Increases & Fixed Expenses Remain Stable,191709,45154.0,52492,97646.0,94063.0,49.07,0.03,Low Risk
U228,2024,5,523307.0,Salary Increases & Fixed Expenses Remain Stable,191709,45154.0,51863,97017.0,94692.0,49.39,-0.03,Low Risk
U228,2024,6,617999.0,Salary Increases & Fixed Expenses Remain Stable,191709,45154.0,57244,102398.0,89311.0,46.59,0.03,Low Risk
U228,2024,7,707310.0,Salary Increases & Fixed Expenses Remain Stable,191709,45154.0,40235,85389.0,106320.0,55.46,0.02,Low Risk
U228,2024,8,813630.0,Salary Increases & Fixed Expenses Remain Stable,191709,45154.0,45943,91097.0,100612.0,52.48,0.0,Low Risk
U228,2024,9,914242.0,Salary Increases & Fixed Expenses Remain Stable,191709,45154.0,60832,105986.0,85723.0,44.72,-0.05,Low Risk
U228,2024,10,999965.0,Salary Increases & Fixed Expenses Remain Stable,191709,45154.0,52132,97286.0,94423.0,49.25,-0.02,Low Risk
U228,2024,11,1094388.0,Salary Increases & Fixed Expenses Remain Stable,191709,45154.0,54114,99268.0,92441.0,48.22,-0.04,Low Risk
U228,2024,12,1186829.0,Salary Increases & Fixed Expenses Remain Stable,191709,45154.0,44650,89804.0,101905.0,53.16,0.02,Low Risk
U229,2024,1,199192.0,Salary Increases & Fixed Expenses Remain Stable,23606,10411.0,8433,18844.0,4762.0,20.17,-0.01,Medium Risk
U229,2024,2,203954.0,Salary Increases & Fixed Expenses Remain Stable,23606,10411.0,8570,18981.0,4625.0,19.59,-0.01,Medium Risk
U229,2024,3,208579.0,Salary Increases & Fixed Expenses Remain Stable,23606,10411.0,11124,21535.0,2071.0,8.77,-0.04,High Risk
U229,2024,4,210650.0,Salary Increases & Fixed Expenses Remain Stable,23606,10411.0,7365,17776.0,5830.0,24.7,0.03,Medium Risk
U229,2024,5,216480.0,Salary Increases & Fixed Expenses Remain Stable,23606,10411.0,8295,18706.0,4900.0,20.76,0.04,Medium Risk
U229,2024,6,221380.0,Salary Increases & Fixed Expenses Remain Stable,39406,10411.0,18682,29093.0,10313.0,26.17,0.01,Low Risk
U229,2024,7,231693.0,Salary Increases & Fixed Expenses Remain Stable,39406,10411.0,16298,26709.0,12697.0,32.22,0.02,Low Risk
U229,2024,8,244390.0,Salary Increases & Fixed Expenses Remain Stable,39406,10411.0,13174,23585.0,15821.0,40.15,0.04,Low Risk
U229,2024,9,260211.0,Salary Increases & Fixed Expenses Remain Stable,39406,10411.0,18117,28528.0,10878.0,27.6,-0.02,Low Risk
U229,2024,10,271089.0,Salary Increases & Fixed Expenses Remain Stable,39406,10411.0,17063,27474.0,11932.0,30.28,-0.03,Low Risk
U229,2024,11,283021.0,Salary Increases & Fixed Expenses Remain Stable,39406,10411.0,15252,25663.0,13743.0,34.88,-0.01,Low Risk
U229,2024,12,296764.0,Salary Increases & Fixed Expenses Remain Stable,39406,10411.0,14277,24688.0,14718.0,37.35,0.03,Low Risk
U230,2024,1,191410.0,Salary Increases & Fixed Expenses Decrease,54405,31273.0,13711,44984.0,9421.0,17.32,-0.03,Medium Risk
U230,2024,2,200831.0,Salary Increases & Fixed Expenses Decrease,54405,31273.0,15127,46400.0,8005.0,14.71,0.01,High Risk
U230,2024,3,208836.0,Salary Increases & Fixed Expenses Decrease,66393,31273.0,21069,52342.0,14051.0,21.16,-0.01,Medium Risk
U230,2024,4,222887.0,Salary Increases & Fixed Expenses Decrease,66393,31273.0,19063,50336.0,16057.0,24.18,0.01,Medium Risk
U230,2024,5,238944.0,Salary Increases & Fixed Expenses Decrease,66393,31273.0,13723,44996.0,21397.0,32.23,-0.03,Low Risk
U230,2024,6,260341.0,Salary Increases & Fixed Expenses Decrease,66393,31273.0,17717,48990.0,17403.0,26.21,-0.02,Low Risk
U230,2024,7,277744.0,Salary Increases & Fixed Expenses Decrease,66393,31273.0,16849,48122.0,18271.0,27.52,-0.01,Low Risk
U230,2024,8,296015.0,Salary Increases & Fixed Expenses Decrease,66393,31273.0,13696,44969.0,21424.0,32.27,0.01,Low Risk
U230,2024,9,317439.0,Salary Increases & Fixed Expenses Decrease,66393,31273.0,16118,47391.0,19002.0,28.62,-0.02,Low Risk
U230,2024,10,336441.0,Salary Increases & Fixed Expenses Decrease,66393,31273.0,17022,48295.0,18098.0,27.26,0.0,Low Risk
U230,2024,11,354539.0,Salary Increases & Fixed Expenses Decrease,66393,31273.0,15249,46522.0,19871.0,29.93,0.0,Low Risk
U230,2024,12,374410.0,Salary Increases & Fixed Expenses Decrease,66393,30674.0,21313,51987.0,14406.0,21.7,-0.05,Medium Risk
U231,2024,1,205853.0,Salary Increases & Fixed Expenses Remain Stable,107635,55408.0,51096,106504.0,1131.0,1.05,-0.05,High Risk
U231,2024,2,206984.0,Salary Increases & Fixed Expenses Remain Stable,107635,55408.0,40266,95674.0,11961.0,11.11,0.04,High Risk
U231,2024,3,218945.0,Salary Increases & Fixed Expenses Remain Stable,107635,55408.0,48685,104093.0,3542.0,3.29,0.04,High Risk
U231,2024,4,222487.0,Salary Increases & Fixed Expenses Remain Stable,107635,55408.0,41099,96507.0,11128.0,10.34,-0.01,High Risk
U231,2024,5,233615.0,Salary Increases & Fixed Expenses Remain Stable,128075,55408.0,58512,113920.0,14155.0,11.05,0.0,High Risk
U231,2024,6,247770.0,Salary Increases & Fixed Expenses Remain Stable,128075,55408.0,42526,97934.0,30141.0,23.53,0.01,Medium Risk
U231,2024,7,277911.0,Salary Increases & Fixed Expenses Remain Stable,128075,55408.0,39256,94664.0,33411.0,26.09,0.02,Low Risk
U231,2024,8,311322.0,Salary Increases & Fixed Expenses Remain Stable,128075,55408.0,54392,109800.0,18275.0,14.27,0.01,High Risk
U231,2024,9,329597.0,Salary Increases & Fixed Expenses Remain Stable,128075,55408.0,49880,105288.0,22787.0,17.79,-0.05,Medium Risk
U231,2024,10,352384.0,Salary Increases & Fixed Expenses Remain Stable,128075,55408.0,60731,116139.0,11936.0,9.32,0.04,High Risk
U231,2024,11,364320.0,Salary Increases & Fixed Expenses Remain Stable,128075,55408.0,57679,113087.0,14988.0,11.7,0.01,High Risk
U231,2024,12,379308.0,Salary Increases & Fixed Expenses Remain Stable,128075,55408.0,49651,105059.0,23016.0,17.97,0.03,Medium Risk
U232,2024,1,153372.0,Salary Increases & Fixed Expenses Remain Stable,62717,38284.0,14180,52464.0,10253.0,16.35,-0.04,Medium Risk
U232,2024,2,163625.0,Salary Increases & Fixed Expenses Remain Stable,62717,38284.0,14601,52885.0,9832.0,15.68,-0.04,Medium Risk
U232,2024,3,173457.0,Salary Increases & Fixed Expenses Remain Stable,62717,38284.0,16960,55244.0,7473.0,11.92,0.02,High Risk
U232,2024,4,180930.0,Salary Increases & Fixed Expenses Remain Stable,62717,38284.0,16485,54769.0,7948.0,12.67,-0.03,High Risk
U232,2024,5,188878.0,Salary Increases & Fixed Expenses Remain Stable,62717,38284.0,17951,56235.0,6482.0,10.34,-0.04,High Risk
U232,2024,6,195360.0,Salary Increases & Fixed Expenses Remain Stable,79998,38284.0,20503,58787.0,21211.0,26.51,-0.04,Low Risk
U232,2024,7,216571.0,Salary Increases & Fixed Expenses Remain Stable,79998,38284.0,20235,58519.0,21479.0,26.85,-0.03,Low Risk
U232,2024,8,238050.0,Salary Increases & Fixed Expenses Remain Stable,79998,38284.0,19898,58182.0,21816.0,27.27,-0.03,Low Risk
U232,2024,9,259866.0,Salary Increases & Fixed Expenses Remain Stable,79998,38284.0,25843,64127.0,15871.0,19.84,0.05,Medium Risk
U232,2024,10,275737.0,Salary Increases & Fixed Expenses Remain Stable,79998,38284.0,20069,58353.0,21645.0,27.06,0.04,Low Risk
U232,2024,11,297382.0,Salary Increases & Fixed Expenses Remain Stable,79998,38284.0,21066,59350.0,20648.0,25.81,0.0,Low Risk
U232,2024,12,318030.0,Salary Increases & Fixed Expenses Remain Stable,79998,38284.0,22788,61072.0,18926.0,23.66,0.02,Medium Risk
U233,2024,1,241316.0,Salary Increases & Fixed Expenses Increase,188203,60800.0,52485,113285.0,74918.0,39.81,0.03,Low Risk
U233,2024,2,316234.0,Salary Increases & Fixed Expenses Increase,188203,61714.0,49330,111044.0,77159.0,41.0,0.05,Low Risk
U233,2024,3,393393.0,Salary Increases & Fixed Expenses Increase,188203,62530.0,45511,108041.0,80162.0,42.59,-0.04,Low Risk
U233,2024,4,473555.0,Salary Increases & Fixed Expenses Increase,188203,63223.0,56028,119251.0,68952.0,36.64,-0.04,Low Risk
U233,2024,5,542507.0,Salary Increases & Fixed Expenses Increase,217660,63223.0,58010,121233.0,96427.0,44.3,-0.04,Low Risk
U233,2024,6,638934.0,Salary Increases & Fixed Expenses Increase,217660,63223.0,59018,122241.0,95419.0,43.84,-0.03,Low Risk
U233,2024,7,734353.0,Salary Increases & Fixed Expenses Increase,217660,63223.0,45804,109027.0,108633.0,49.91,-0.01,Low Risk
U233,2024,8,842986.0,Salary Increases & Fixed Expenses Increase,217660,63223.0,54927,118150.0,99510.0,45.72,0.04,Low Risk
U233,2024,9,942496.0,Salary Increases & Fixed Expenses Increase,217660,63223.0,47175,110398.0,107262.0,49.28,0.03,Low Risk
U233,2024,10,1049758.0,Salary Increases & Fixed Expenses Increase,217660,63223.0,45437,108660.0,109000.0,50.08,-0.0,Low Risk
U233,2024,11,1158758.0,Salary Increases & Fixed Expenses Increase,217660,63223.0,63848,127071.0,90589.0,41.62,0.01,Low Risk
U233,2024,12,1249347.0,Salary Increases & Fixed Expenses Increase,217660,63223.0,62688,125911.0,91749.0,42.15,-0.04,Low Risk
U234,2024,1,213240.0,Salary Increases & Fixed Expenses Remain Stable,159784,56118.0,97305,153423.0,6361.0,3.98,-0.02,High Risk
U234,2024,2,219601.0,Salary Increases & Fixed Expenses Remain Stable,159784,56118.0,93471,149589.0,10195.0,6.38,0.04,High Risk
U234,2024,3,229796.0,Salary Increases & Fixed Expenses Remain Stable,159784,56118.0,106923,163041.0,-3257.0,-2.04,0.05,High Risk
U234,2024,4,226539.0,Salary Increases & Fixed Expenses Remain Stable,179046,56118.0,96401,152519.0,26527.0,14.82,0.03,High Risk
U234,2024,5,253066.0,Salary Increases & Fixed Expenses Remain Stable,179046,56118.0,116322,172440.0,6606.0,3.69,-0.03,High Risk
U234,2024,6,259672.0,Salary Increases & Fixed Expenses Remain Stable,179046,56118.0,96203,152321.0,26725.0,14.93,0.02,High Risk
U234,2024,7,286397.0,Salary Increases & Fixed Expenses Remain Stable,179046,56118.0,103149,159267.0,19779.0,11.05,-0.03,High Risk
U234,2024,8,306176.0,Salary Increases & Fixed Expenses Remain Stable,179046,56118.0,95794,151912.0,27134.0,15.15,0.02,Medium Risk
U234,2024,9,333310.0,Salary Increases & Fixed Expenses Remain Stable,179046,56118.0,114762,170880.0,8166.0,4.56,-0.04,High Risk
U234,2024,10,341476.0,Salary Increases & Fixed Expenses Remain Stable,179046,56118.0,96271,152389.0,26657.0,14.89,-0.04,High Risk
U234,2024,11,368133.0,Salary Increases & Fixed Expenses Remain Stable,179046,56118.0,116047,172165.0,6881.0,3.84,0.04,High Risk
U234,2024,12,375014.0,Salary Increases & Fixed Expenses Remain Stable,179046,56118.0,98146,154264.0,24782.0,13.84,0.01,High Risk
U235,2024,1,238957.0,Salary Increases & Fixed Expenses Increase,233518,100113.0,53144,153257.0,80261.0,34.37,-0.03,Low Risk
U235,2024,2,319218.0,Salary Increases & Fixed Expenses Increase,233518,100113.0,68598,168711.0,64807.0,27.75,-0.03,Low Risk
U235,2024,3,384025.0,Salary Increases & Fixed Expenses Increase,233518,100113.0,54689,154802.0,78716.0,33.71,0.01,Low Risk
U235,2024,4,462741.0,Salary Increases & Fixed Expenses Increase,233518,100113.0,63898,164011.0,69507.0,29.77,0.04,Low Risk
U235,2024,5,532248.0,Salary Increases & Fixed Expenses Increase,233518,100113.0,63925,164038.0,69480.0,29.75,-0.04,Low Risk
U235,2024,6,601728.0,Salary Increases & Fixed Expenses Increase,233518,100113.0,48053,148166.0,85352.0,36.55,0.03,Low Risk
U235,2024,7,687080.0,Salary Increases & Fixed Expenses Increase,261120,100113.0,55203,155316.0,105804.0,40.52,-0.02,Low Risk
U235,2024,8,792884.0,Salary Increases & Fixed Expenses Increase,261120,100113.0,66809,166922.0,94198.0,36.07,0.03,Low Risk
U235,2024,9,887082.0,Salary Increases & Fixed Expenses Increase,261120,100113.0,67449,167562.0,93558.0,35.83,-0.03,Low Risk
U235,2024,10,980640.0,Salary Increases & Fixed Expenses Increase,261120,101365.0,56389,157754.0,103366.0,39.59,0.03,Low Risk
U235,2024,11,1084006.0,Salary Increases & Fixed Expenses Increase,261120,101365.0,74257,175622.0,85498.0,32.74,-0.04,Low Risk
U235,2024,12,1169504.0,Salary Increases & Fixed Expenses Increase,261120,102167.0,55357,157524.0,103596.0,39.67,0.02,Low Risk
U236,2024,1,247810.0,Salary Increases & Fixed Expenses Decrease,230036,85385.0,114867,200252.0,29784.0,12.95,0.03,High Risk
U236,2024,2,277594.0,Salary Increases & Fixed Expenses Decrease,230036,85385.0,91081,176466.0,53570.0,23.29,0.03,Medium Risk
U236,2024,3,331164.0,Salary Increases & Fixed Expenses Decrease,230036,85385.0,112578,197963.0,32073.0,13.94,-0.01,High Risk
U236,2024,4,363237.0,Salary Increases & Fixed Expenses Decrease,230036,85385.0,74292,159677.0,70359.0,30.59,0.01,Low Risk
U236,2024,5,433596.0,Salary Increases & Fixed Expenses Decrease,230036,85385.0,70110,155495.0,74541.0,32.4,0.04,Low Risk
U236,2024,6,508137.0,Salary Increases & Fixed Expenses Decrease,249052,85385.0,109983,195368.0,53684.0,21.56,0.04,Medium Risk
U236,2024,7,561821.0,Salary Increases & Fixed Expenses Decrease,249052,85385.0,93023,178408.0,70644.0,28.37,-0.05,Low Risk
U236,2024,8,632465.0,Salary Increases & Fixed Expenses Decrease,249052,84328.0,110256,194584.0,54468.0,21.87,0.01,Medium Risk
U236,2024,9,686933.0,Salary Increases & Fixed Expenses Decrease,249052,84328.0,93982,178310.0,70742.0,28.4,-0.02,Low Risk
U236,2024,10,757675.0,Salary Increases & Fixed Expenses Decrease,249052,84328.0,105068,189396.0,59656.0,23.95,-0.04,Medium Risk
U236,2024,11,817331.0,Salary Increases & Fixed Expenses Decrease,249052,84328.0,121333,205661.0,43391.0,17.42,0.02,Medium Risk
U236,2024,12,860722.0,Salary Increases & Fixed Expenses Decrease,249052,84328.0,122112,206440.0,42612.0,17.11,0.03,Medium Risk
U237,2024,1,245991.0,Stable Salary & Stable Fixed Expenses,236764,66320.0,80724,147044.0,89720.0,37.89,0.04,Low Risk
U237,2024,2,335711.0,Stable Salary & Stable Fixed Expenses,236764,66320.0,88637,154957.0,81807.0,34.55,0.03,Low Risk
U237,2024,3,417518.0,Stable Salary & Stable Fixed Expenses,236764,66320.0,87768,154088.0,82676.0,34.92,-0.01,Low Risk
U237,2024,4,500194.0,Stable Salary & Stable Fixed Expenses,236764,66320.0,100167,166487.0,70277.0,29.68,0.01,Low Risk
U237,2024,5,570471.0,Stable Salary & Stable Fixed Expenses,236764,66320.0,75675,141995.0,94769.0,40.03,-0.03,Low Risk
U237,2024,6,665240.0,Stable Salary & Stable Fixed Expenses,236764,66320.0,86470,152790.0,83974.0,35.47,-0.01,Low Risk
U237,2024,7,749214.0,Stable Salary & Stable Fixed Expenses,236764,66320.0,81128,147448.0,89316.0,37.72,0.02,Low Risk
U237,2024,8,838530.0,Stable Salary & Stable Fixed Expenses,236764,66320.0,73325,139645.0,97119.0,41.02,0.01,Low Risk
U237,2024,9,935649.0,Stable Salary & Stable Fixed Expenses,236764,66320.0,108608,174928.0,61836.0,26.12,0.04,Low Risk
U237,2024,10,997485.0,Stable Salary & Stable Fixed Expenses,236764,66320.0,115039,181359.0,55405.0,23.4,0.04,Medium Risk
U237,2024,11,1052890.0,Stable Salary & Stable Fixed Expenses,236764,66320.0,87533,153853.0,82911.0,35.02,0.05,Low Risk
U237,2024,12,1135801.0,Stable Salary & Stable Fixed Expenses,236764,66320.0,72436,138756.0,98008.0,41.39,-0.03,Low Risk
U238,2024,1,42740.0,Stable Salary & Increasing Fixed Expenses,26365,11917.0,8453,20370.0,5995.0,22.74,0.02,Medium Risk
U238,2024,2,48735.0,Stable Salary & Increasing Fixed Expenses,26365,11917.0,12053,23970.0,2395.0,9.08,0.02,High Risk
U238,2024,3,51130.0,Stable Salary & Increasing Fixed Expenses,26365,11917.0,9154,21071.0,5294.0,20.08,0.0,Medium Risk
U238,2024,4,56424.0,Stable Salary & Increasing Fixed Expenses,26365,11917.0,12668,24585.0,1780.0,6.75,0.04,High Risk
U238,2024,5,58204.0,Stable Salary & Increasing Fixed Expenses,26365,11917.0,9230,21147.0,5218.0,19.79,0.03,Medium Risk
U238,2024,6,63422.0,Stable Salary & Increasing Fixed Expenses,26365,12792.0,8886,21678.0,4687.0,17.78,0.01,Medium Risk
U238,2024,7,68109.0,Stable Salary & Increasing Fixed Expenses,26365,12792.0,10509,23301.0,3064.0,11.62,-0.03,High Risk
U238,2024,8,71173.0,Stable Salary & Increasing Fixed Expenses,26365,12792.0,10492,23284.0,3081.0,11.69,0.04,High Risk
U238,2024,9,74254.0,Stable Salary & Increasing Fixed Expenses,26365,13533.0,10781,24314.0,2051.0,7.78,-0.0,High Risk
U238,2024,10,76305.0,Stable Salary & Increasing Fixed Expenses,26365,13533.0,11131,24664.0,1701.0,6.45,0.03,High Risk
U238,2024,11,78006.0,Stable Salary & Increasing Fixed Expenses,26365,13533.0,9989,23522.0,2843.0,10.78,-0.04,High Risk
U238,2024,12,80849.0,Stable Salary & Increasing Fixed Expenses,26365,13533.0,12715,26248.0,117.0,0.44,-0.04,High Risk
U239,2024,1,94066.0,Salary Increases & Fixed Expenses Increase,90462,28779.0,43407,72186.0,18276.0,20.2,-0.01,Medium Risk
U239,2024,2,112342.0,Salary Increases & Fixed Expenses Increase,90462,28779.0,43948,72727.0,17735.0,19.6,-0.04,Medium Risk
U239,2024,3,130077.0,Salary Increases & Fixed Expenses Increase,103210,30727.0,35575,66302.0,36908.0,35.76,-0.01,Low Risk
U239,2024,4,166985.0,Salary Increases & Fixed Expenses Increase,103210,32557.0,45572,78129.0,25081.0,24.3,-0.02,Medium Risk
U239,2024,5,192066.0,Salary Increases & Fixed Expenses Increase,103210,33871.0,43502,77373.0,25837.0,25.03,0.03,Low Risk
U239,2024,6,217903.0,Salary Increases & Fixed Expenses Increase,103210,33871.0,36817,70688.0,32522.0,31.51,0.04,Low Risk
U239,2024,7,250425.0,Salary Increases & Fixed Expenses Increase,103210,33871.0,48169,82040.0,21170.0,20.51,0.04,Medium Risk
U239,2024,8,271595.0,Salary Increases & Fixed Expenses Increase,103210,33871.0,41955,75826.0,27384.0,26.53,-0.01,Low Risk
U239,2024,9,298979.0,Salary Increases & Fixed Expenses Increase,103210,33871.0,38544,72415.0,30795.0,29.84,-0.02,Low Risk
U239,2024,10,329774.0,Salary Increases & Fixed Expenses Increase,103210,33871.0,38016,71887.0,31323.0,30.35,0.04,Low Risk
U239,2024,11,361097.0,Salary Increases & Fixed Expenses Increase,103210,33871.0,34887,68758.0,34452.0,33.38,0.02,Low Risk
U239,2024,12,395549.0,Salary Increases & Fixed Expenses Increase,103210,33871.0,46870,80741.0,22469.0,21.77,0.04,Medium Risk
U240,2024,1,82104.0,Salary Increases & Fixed Expenses Increase,70568,32901.0,28791,61692.0,8876.0,12.58,-0.01,High Risk
U240,2024,2,90980.0,Salary Increases & Fixed Expenses Increase,70568,33922.0,33454,67376.0,3192.0,4.52,-0.03,High Risk
U240,2024,3,94172.0,Salary Increases & Fixed Expenses Increase,70568,33922.0,28177,62099.0,8469.0,12.0,0.04,High Risk
U240,2024,4,102641.0,Salary Increases & Fixed Expenses Increase,70568,33922.0,25665,59587.0,10981.0,15.56,0.05,Medium Risk
U240,2024,5,113622.0,Salary Increases & Fixed Expenses Increase,70568,33922.0,24102,58024.0,12544.0,17.78,0.01,Medium Risk
U240,2024,6,126166.0,Salary Increases & Fixed Expenses Increase,70568,33922.0,23053,56975.0,13593.0,19.26,-0.04,Medium Risk
U240,2024,7,139759.0,Salary Increases & Fixed Expenses Increase,70568,33922.0,23509,57431.0,13137.0,18.62,-0.01,Medium Risk
U240,2024,8,152896.0,Salary Increases & Fixed Expenses Increase,87639,33922.0,38283,72205.0,15434.0,17.61,0.01,Medium Risk
U240,2024,9,168330.0,Salary Increases & Fixed Expenses Increase,87639,33922.0,35031,68953.0,18686.0,21.32,-0.03,Medium Risk
U240,2024,10,187016.0,Salary Increases & Fixed Expenses Increase,87639,33922.0,38790,72712.0,14927.0,17.03,0.01,Medium Risk
U240,2024,11,201943.0,Salary Increases & Fixed Expenses Increase,87639,35424.0,30154,65578.0,22061.0,25.17,-0.01,Low Risk
U240,2024,12,224004.0,Salary Increases & Fixed Expenses Increase,87639,35424.0,50890,86314.0,1325.0,1.51,0.01,High Risk
U241,2024,1,238587.0,Stable Salary & Increasing Fixed Expenses,175305,42238.0,66500,108738.0,66567.0,37.97,0.01,Low Risk
U241,2024,2,305154.0,Stable Salary & Increasing Fixed Expenses,175305,42238.0,84737,126975.0,48330.0,27.57,0.02,Low Risk
U241,2024,3,353484.0,Stable Salary & Increasing Fixed Expenses,175305,42238.0,70157,112395.0,62910.0,35.89,-0.02,Low Risk
U241,2024,4,416394.0,Stable Salary & Increasing Fixed Expenses,175305,43979.0,57931,101910.0,73395.0,41.87,0.03,Low Risk
U241,2024,5,489789.0,Stable Salary & Increasing Fixed Expenses,175305,43979.0,68344,112323.0,62982.0,35.93,-0.03,Low Risk
U241,2024,6,552771.0,Stable Salary & Increasing Fixed Expenses,175305,43979.0,80295,124274.0,51031.0,29.11,-0.02,Low Risk
U241,2024,7,603802.0,Stable Salary & Increasing Fixed Expenses,175305,43979.0,78397,122376.0,52929.0,30.19,0.02,Low Risk
U241,2024,8,656731.0,Stable Salary & Increasing Fixed Expenses,175305,43979.0,82617,126596.0,48709.0,27.79,-0.04,Low Risk
U241,2024,9,705440.0,Stable Salary & Increasing Fixed Expenses,175305,43979.0,82709,126688.0,48617.0,27.73,-0.04,Low Risk
U241,2024,10,754057.0,Stable Salary & Increasing Fixed Expenses,175305,43979.0,87408,131387.0,43918.0,25.05,-0.02,Low Risk
U241,2024,11,797975.0,Stable Salary & Increasing Fixed Expenses,175305,43979.0,63906,107885.0,67420.0,38.46,-0.02,Low Risk
U241,2024,12,865395.0,Stable Salary & Increasing Fixed Expenses,175305,43979.0,77116,121095.0,54210.0,30.92,-0.03,Low Risk
U242,2024,1,235663.0,Stable Salary & Decreasing Fixed Expenses,204687,77078.0,76778,153856.0,50831.0,24.83,0.04,Medium Risk
U242,2024,2,286494.0,Stable Salary & Decreasing Fixed Expenses,204687,77078.0,66147,143225.0,61462.0,30.03,-0.03,Low Risk
U242,2024,3,347956.0,Stable Salary & Decreasing Fixed Expenses,204687,77078.0,80530,157608.0,47079.0,23.0,0.0,Medium Risk
U242,2024,4,395035.0,Stable Salary & Decreasing Fixed Expenses,204687,77078.0,70130,147208.0,57479.0,28.08,0.03,Low Risk
U242,2024,5,452514.0,Stable Salary & Decreasing Fixed Expenses,204687,77078.0,95148,172226.0,32461.0,15.86,-0.02,Medium Risk
U242,2024,6,484975.0,Stable Salary & Decreasing Fixed Expenses,204687,77078.0,99477,176555.0,28132.0,13.74,-0.05,High Risk
U242,2024,7,513107.0,Stable Salary & Decreasing Fixed Expenses,204687,77078.0,62032,139110.0,65577.0,32.04,0.0,Low Risk
U242,2024,8,578684.0,Stable Salary & Decreasing Fixed Expenses,204687,77078.0,101903,178981.0,25706.0,12.56,0.0,High Risk
U242,2024,9,604390.0,Stable Salary & Decreasing Fixed Expenses,204687,77078.0,90798,167876.0,36811.0,17.98,0.03,Medium Risk
U242,2024,10,641201.0,Stable Salary & Decreasing Fixed Expenses,204687,77078.0,95267,172345.0,32342.0,15.8,-0.03,Medium Risk
U242,2024,11,673543.0,Stable Salary & Decreasing Fixed Expenses,204687,76349.0,63784,140133.0,64554.0,31.54,0.03,Low Risk
U242,2024,12,738097.0,Stable Salary & Decreasing Fixed Expenses,204687,76349.0,89839,166188.0,38499.0,18.81,-0.01,Medium Risk
U243,2024,1,198623.0,Salary Increases & Fixed Expenses Decrease,121711,56271.0,26077,82348.0,39363.0,32.34,0.02,Low Risk
U243,2024,2,237986.0,Salary Increases & Fixed Expenses Decrease,121711,56271.0,34576,90847.0,30864.0,25.36,-0.04,Low Risk
U243,2024,3,268850.0,Salary Increases & Fixed Expenses Decrease,141569,56271.0,41226,97497.0,44072.0,31.13,-0.04,Low Risk
U243,2024,4,312922.0,Salary Increases & Fixed Expenses Decrease,141569,56271.0,29229,85500.0,56069.0,39.61,-0.01,Low Risk
U243,2024,5,368991.0,Salary Increases & Fixed Expenses Decrease,141569,56271.0,41591,97862.0,43707.0,30.87,0.04,Low Risk
U243,2024,6,412698.0,Salary Increases & Fixed Expenses Decrease,141569,56271.0,34684,90955.0,50614.0,35.75,-0.01,Low Risk
U243,2024,7,463312.0,Salary Increases & Fixed Expenses Decrease,141569,56271.0,34048,90319.0,51250.0,36.2,-0.02,Low Risk
U243,2024,8,514562.0,Salary Increases & Fixed Expenses Decrease,141569,56271.0,38698,94969.0,46600.0,32.92,0.04,Low Risk
U243,2024,9,561162.0,Salary Increases & Fixed Expenses Decrease,141569,56271.0,37736,94007.0,47562.0,33.6,0.01,Low Risk
U243,2024,10,608724.0,Salary Increases & Fixed Expenses Decrease,141569,56271.0,41585,97856.0,43713.0,30.88,-0.0,Low Risk
U243,2024,11,652437.0,Salary Increases & Fixed Expenses Decrease,141569,56271.0,35611,91882.0,49687.0,35.1,0.03,Low Risk
U243,2024,12,702124.0,Salary Increases & Fixed Expenses Decrease,141569,55113.0,41422,96535.0,45034.0,31.81,-0.04,Low Risk
U244,2024,1,250000.0,Salary Increases & Fixed Expenses Remain Stable,252972,61660.0,167064,228724.0,24248.0,9.59,-0.02,High Risk
U244,2024,2,274248.0,Salary Increases & Fixed Expenses Remain Stable,252972,61660.0,148827,210487.0,42485.0,16.79,0.02,Medium Risk
U244,2024,3,316733.0,Salary Increases & Fixed Expenses Remain Stable,252972,61660.0,173202,234862.0,18110.0,7.16,-0.0,High Risk
U244,2024,4,334843.0,Salary Increases & Fixed Expenses Remain Stable,252972,61660.0,170354,232014.0,20958.0,8.28,0.02,High Risk
U244,2024,5,355801.0,Salary Increases & Fixed Expenses Remain Stable,265086,61660.0,170823,232483.0,32603.0,12.3,0.02,High Risk
U244,2024,6,388404.0,Salary Increases & Fixed Expenses Remain Stable,265086,61660.0,139143,200803.0,64283.0,24.25,-0.04,Medium Risk
U244,2024,7,452687.0,Salary Increases & Fixed Expenses Remain Stable,265086,61660.0,146040,207700.0,57386.0,21.65,0.04,Medium Risk
U244,2024,8,510073.0,Salary Increases & Fixed Expenses Remain Stable,265086,61660.0,143796,205456.0,59630.0,22.49,0.0,Medium Risk
U244,2024,9,569703.0,Salary Increases & Fixed Expenses Remain Stable,265086,61660.0,154761,216421.0,48665.0,18.36,-0.02,Medium Risk
U244,2024,10,618368.0,Salary Increases & Fixed Expenses Remain Stable,265086,61660.0,152191,213851.0,51235.0,19.33,-0.01,Medium Risk
U244,2024,11,669603.0,Salary Increases & Fixed Expenses Remain Stable,265086,61660.0,135990,197650.0,67436.0,25.44,-0.03,Low Risk
U244,2024,12,737039.0,Salary Increases & Fixed Expenses Remain Stable,265086,61660.0,134805,196465.0,68621.0,25.89,-0.05,Low Risk
U245,2024,1,250000.0,Stable Salary & Stable Fixed Expenses,276716,111805.0,125846,237651.0,39065.0,14.12,-0.04,High Risk
U245,2024,2,289065.0,Stable Salary & Stable Fixed Expenses,276716,111805.0,87874,199679.0,77037.0,27.84,-0.03,Low Risk
U245,2024,3,366102.0,Stable Salary & Stable Fixed Expenses,276716,111805.0,112153,223958.0,52758.0,19.07,-0.03,Medium Risk
U245,2024,4,418860.0,Stable Salary & Stable Fixed Expenses,276716,111805.0,134057,245862.0,30854.0,11.15,0.02,High Risk
U245,2024,5,449714.0,Stable Salary & Stable Fixed Expenses,276716,111805.0,110954,222759.0,53957.0,19.5,-0.03,Medium Risk
U245,2024,6,503671.0,Stable Salary & Stable Fixed Expenses,276716,111805.0,135108,246913.0,29803.0,10.77,-0.01,High Risk
U245,2024,7,533474.0,Stable Salary & Stable Fixed Expenses,276716,111805.0,136439,248244.0,28472.0,10.29,-0.03,High Risk
U245,2024,8,561946.0,Stable Salary & Stable Fixed Expenses,276716,111805.0,86673,198478.0,78238.0,28.27,-0.04,Low Risk
U245,2024,9,640184.0,Stable Salary & Stable Fixed Expenses,276716,111805.0,87519,199324.0,77392.0,27.97,0.02,Low Risk
U245,2024,10,717576.0,Stable Salary & Stable Fixed Expenses,276716,111805.0,94317,206122.0,70594.0,25.51,-0.02,Low Risk
U245,2024,11,788170.0,Stable Salary & Stable Fixed Expenses,276716,111805.0,134898,246703.0,30013.0,10.85,-0.05,High Risk
U245,2024,12,818183.0,Stable Salary & Stable Fixed Expenses,276716,111805.0,88673,200478.0,76238.0,27.55,-0.02,Low Risk
U246,2024,1,92792.0,Salary Increases & Fixed Expenses Remain Stable,43637,18859.0,10712,29571.0,14066.0,32.23,0.01,Low Risk
U246,2024,2,106858.0,Salary Increases & Fixed Expenses Remain Stable,43637,18859.0,9429,28288.0,15349.0,35.17,-0.02,Low Risk
U246,2024,3,122207.0,Salary Increases & Fixed Expenses Remain Stable,43637,18859.0,11190,30049.0,13588.0,31.14,-0.03,Low Risk
U246,2024,4,135795.0,Salary Increases & Fixed Expenses Remain Stable,43637,18859.0,12686,31545.0,12092.0,27.71,-0.03,Low Risk
U246,2024,5,147887.0,Salary Increases & Fixed Expenses Remain Stable,71220,18859.0,14500,33359.0,37861.0,53.16,-0.01,Low Risk
U246,2024,6,185748.0,Salary Increases & Fixed Expenses Remain Stable,71220,18859.0,17207,36066.0,35154.0,49.36,-0.05,Low Risk
U246,2024,7,220902.0,Salary Increases & Fixed Expenses Remain Stable,71220,18859.0,20070,38929.0,32291.0,45.34,0.01,Low Risk
U246,2024,8,253193.0,Salary Increases & Fixed Expenses Remain Stable,71220,18859.0,18968,37827.0,33393.0,46.89,0.04,Low Risk
U246,2024,9,286586.0,Salary Increases & Fixed Expenses Remain Stable,71220,18859.0,16791,35650.0,35570.0,49.94,-0.03,Low Risk
U246,2024,10,322156.0,Salary Increases & Fixed Expenses Remain Stable,71220,18859.0,16030,34889.0,36331.0,51.01,0.01,Low Risk
U246,2024,11,358487.0,Salary Increases & Fixed Expenses Remain Stable,71220,18859.0,23559,42418.0,28802.0,40.44,0.02,Low Risk
U246,2024,12,387289.0,Salary Increases & Fixed Expenses Remain Stable,71220,18859.0,15177,34036.0,37184.0,52.21,-0.04,Low Risk
U247,2024,1,176872.0,Stable Salary & Increasing Fixed Expenses,147405,57484.0,55846,113330.0,34075.0,23.12,-0.03,Medium Risk
U247,2024,2,210947.0,Stable Salary & Increasing Fixed Expenses,147405,57484.0,48976,106460.0,40945.0,27.78,0.03,Low Risk
U247,2024,3,251892.0,Stable Salary & Increasing Fixed Expenses,147405,57484.0,59243,116727.0,30678.0,20.81,0.04,Medium Risk
U247,2024,4,282570.0,Stable Salary & Increasing Fixed Expenses,147405,57484.0,69432,126916.0,20489.0,13.9,0.02,High Risk
U247,2024,5,303059.0,Stable Salary & Increasing Fixed Expenses,147405,57484.0,56845,114329.0,33076.0,22.44,-0.01,Medium Risk
U247,2024,6,336135.0,Stable Salary & Increasing Fixed Expenses,147405,57484.0,53930,111414.0,35991.0,24.42,-0.04,Medium Risk
U247,2024,7,372126.0,Stable Salary & Increasing Fixed Expenses,147405,57484.0,56051,113535.0,33870.0,22.98,0.03,Medium Risk
U247,2024,8,405996.0,Stable Salary & Increasing Fixed Expenses,147405,57484.0,50008,107492.0,39913.0,27.08,-0.0,Low Risk
U247,2024,9,445909.0,Stable Salary & Increasing Fixed Expenses,147405,57484.0,56146,113630.0,33775.0,22.91,0.02,Medium Risk
U247,2024,10,479684.0,Stable Salary & Increasing Fixed Expenses,147405,57484.0,53362,110846.0,36559.0,24.8,0.02,Medium Risk
U247,2024,11,516243.0,Stable Salary & Increasing Fixed Expenses,147405,57484.0,74824,132308.0,15097.0,10.24,0.03,High Risk
U247,2024,12,531340.0,Stable Salary & Increasing Fixed Expenses,147405,57484.0,72845,130329.0,17076.0,11.58,-0.04,High Risk
U248,2024,1,250000.0,Stable Salary & Stable Fixed Expenses,252813,88861.0,146836,235697.0,17116.0,6.77,-0.01,High Risk
U248,2024,2,267116.0,Stable Salary & Stable Fixed Expenses,252813,88861.0,148979,237840.0,14973.0,5.92,-0.04,High Risk
U248,2024,3,282089.0,Stable Salary & Stable Fixed Expenses,252813,88861.0,207981,296842.0,-44029.0,-17.42,0.02,High Risk
U248,2024,4,238060.0,Stable Salary & Stable Fixed Expenses,252813,88861.0,126484,215345.0,37468.0,14.82,-0.02,High Risk
U248,2024,5,275528.0,Stable Salary & Stable Fixed Expenses,252813,88861.0,132290,221151.0,31662.0,12.52,0.04,High Risk
U248,2024,6,307190.0,Stable Salary & Stable Fixed Expenses,252813,88861.0,142440,231301.0,21512.0,8.51,0.04,High Risk
U248,2024,7,328702.0,Stable Salary & Stable Fixed Expenses,252813,88861.0,132087,220948.0,31865.0,12.6,0.04,High Risk
U248,2024,8,360567.0,Stable Salary & Stable Fixed Expenses,252813,88861.0,137804,226665.0,26148.0,10.34,-0.02,High Risk
U248,2024,9,386715.0,Stable Salary & Stable Fixed Expenses,252813,88861.0,159040,247901.0,4912.0,1.94,-0.03,High Risk
U248,2024,10,391627.0,Stable Salary & Stable Fixed Expenses,252813,88861.0,190447,279308.0,-26495.0,-10.48,-0.03,High Risk
U248,2024,11,365132.0,Stable Salary & Stable Fixed Expenses,252813,88861.0,152827,241688.0,11125.0,4.4,0.0,High Risk
U248,2024,12,376257.0,Stable Salary & Stable Fixed Expenses,252813,88861.0,196126,284987.0,-32174.0,-12.73,0.01,High Risk
U249,2024,1,220648.0,Salary Increases & Fixed Expenses Increase,214512,66607.0,62221,128828.0,85684.0,39.94,-0.01,Low Risk
U249,2024,2,306332.0,Salary Increases & Fixed Expenses Increase,214512,66607.0,54438,121045.0,93467.0,43.57,0.01,Low Risk
U249,2024,3,399799.0,Salary Increases & Fixed Expenses Increase,214512,66607.0,47161,113768.0,100744.0,46.96,0.01,Low Risk
U249,2024,4,500543.0,Salary Increases & Fixed Expenses Increase,219529,67611.0,47377,114988.0,104541.0,47.62,0.03,Low Risk
U249,2024,5,605084.0,Salary Increases & Fixed Expenses Increase,219529,67611.0,54807,122418.0,97111.0,44.24,-0.0,Low Risk
U249,2024,6,702195.0,Salary Increases & Fixed Expenses Increase,219529,68916.0,46377,115293.0,104236.0,47.48,-0.02,Low Risk
U249,2024,7,806431.0,Salary Increases & Fixed Expenses Increase,219529,68916.0,56852,125768.0,93761.0,42.71,-0.04,Low Risk
U249,2024,8,900192.0,Salary Increases & Fixed Expenses Increase,219529,68916.0,44410,113326.0,106203.0,48.38,-0.02,Low Risk
U249,2024,9,1006395.0,Salary Increases & Fixed Expenses Increase,219529,68916.0,54770,123686.0,95843.0,43.66,0.04,Low Risk
U249,2024,10,1102238.0,Salary Increases & Fixed Expenses Increase,219529,68916.0,45207,114123.0,105406.0,48.01,-0.0,Low Risk
U249,2024,11,1207644.0,Salary Increases & Fixed Expenses Increase,219529,68916.0,60297,129213.0,90316.0,41.14,0.04,Low Risk
U249,2024,12,1297960.0,Salary Increases & Fixed Expenses Increase,219529,70779.0,47092,117871.0,101658.0,46.31,0.02,Low Risk
U250,2024,1,180163.0,Salary Increases & Fixed Expenses Remain Stable,99112,35232.0,48757,83989.0,15123.0,15.26,0.04,Medium Risk
U250,2024,2,195286.0,Salary Increases & Fixed Expenses Remain Stable,99112,35232.0,38477,73709.0,25403.0,25.63,0.01,Low Risk
U250,2024,3,220689.0,Salary Increases & Fixed Expenses Remain Stable,99112,35232.0,45556,80788.0,18324.0,18.49,-0.05,Medium Risk
U250,2024,4,239013.0,Salary Increases & Fixed Expenses Remain Stable,99112,35232.0,44060,79292.0,19820.0,20.0,-0.02,Medium Risk
U250,2024,5,258833.0,Salary Increases & Fixed Expenses Remain Stable,99112,35232.0,44896,80128.0,18984.0,19.15,0.02,Medium Risk
U250,2024,6,277817.0,Salary Increases & Fixed Expenses Remain Stable,113142,35232.0,40338,75570.0,37572.0,33.21,0.02,Low Risk
U250,2024,7,315389.0,Salary Increases & Fixed Expenses Remain Stable,113142,35232.0,51065,86297.0,26845.0,23.73,-0.0,Medium Risk
U250,2024,8,342234.0,Salary Increases & Fixed Expenses Remain Stable,113142,35232.0,34963,70195.0,42947.0,37.96,-0.05,Low Risk
U250,2024,9,385181.0,Salary Increases & Fixed Expenses Remain Stable,113142,35232.0,54707,89939.0,23203.0,20.51,0.02,Medium Risk
U250,2024,10,408384.0,Salary Increases & Fixed Expenses Remain Stable,113142,35232.0,66753,101985.0,11157.0,9.86,-0.02,High Risk
U250,2024,11,419541.0,Salary Increases & Fixed Expenses Remain Stable,113142,35232.0,37303,72535.0,40607.0,35.89,-0.01,Low Risk
U250,2024,12,460148.0,Salary Increases & Fixed Expenses Remain Stable,113142,35232.0,49492,84724.0,28418.0,25.12,-0.03,Low Risk
U251,2024,1,179987.0,Salary Increases & Fixed Expenses Remain Stable,100176,70419.0,38649,109068.0,-8892.0,-8.88,0.03,High Risk
U251,2024,2,171095.0,Salary Increases & Fixed Expenses Remain Stable,100176,70419.0,38508,108927.0,-8751.0,-8.74,0.01,High Risk
U251,2024,3,162344.0,Salary Increases & Fixed Expenses Remain Stable,100176,70419.0,56394,126813.0,-26637.0,-26.59,-0.02,High Risk
U251,2024,4,135707.0,Salary Increases & Fixed Expenses Remain Stable,122364,70419.0,58634,129053.0,-6689.0,-5.47,0.01,High Risk
U251,2024,5,129018.0,Salary Increases & Fixed Expenses Remain Stable,122364,70419.0,59994,130413.0,-8049.0,-6.58,0.03,High Risk
U251,2024,6,120969.0,Salary Increases & Fixed Expenses Remain Stable,122364,70419.0,42866,113285.0,9079.0,7.42,-0.04,High Risk
U251,2024,7,130048.0,Salary Increases & Fixed Expenses Remain Stable,122364,70419.0,38469,108888.0,13476.0,11.01,-0.05,High Risk
U251,2024,8,143524.0,Salary Increases & Fixed Expenses Remain Stable,122364,70419.0,41017,111436.0,10928.0,8.93,-0.0,High Risk
U251,2024,9,154452.0,Salary Increases & Fixed Expenses Remain Stable,122364,70419.0,51109,121528.0,836.0,0.68,-0.04,High Risk
U251,2024,10,155288.0,Salary Increases & Fixed Expenses Remain Stable,122364,70419.0,62439,132858.0,-10494.0,-8.58,0.01,High Risk
U251,2024,11,144794.0,Salary Increases & Fixed Expenses Remain Stable,122364,70419.0,54048,124467.0,-2103.0,-1.72,-0.03,High Risk
U251,2024,12,142691.0,Salary Increases & Fixed Expenses Remain Stable,122364,70419.0,60761,131180.0,-8816.0,-7.2,0.02,High Risk
U252,2024,1,250000.0,Salary Increases & Fixed Expenses Increase,258703,92303.0,93192,185495.0,73208.0,28.3,-0.03,Low Risk
U252,2024,2,323208.0,Salary Increases & Fixed Expenses Increase,258703,92303.0,101252,193555.0,65148.0,25.18,-0.04,Low Risk
U252,2024,3,388356.0,Salary Increases & Fixed Expenses Increase,258703,92303.0,128993,221296.0,37407.0,14.46,-0.03,High Risk
U252,2024,4,425763.0,Salary Increases & Fixed Expenses Increase,278036,92303.0,98042,190345.0,87691.0,31.54,0.01,Low Risk
U252,2024,5,513454.0,Salary Increases & Fixed Expenses Increase,278036,93981.0,125630,219611.0,58425.0,21.01,-0.02,Medium Risk
U252,2024,6,571879.0,Salary Increases & Fixed Expenses Increase,278036,95855.0,108450,204305.0,73731.0,26.52,-0.0,Low Risk
U252,2024,7,645610.0,Salary Increases & Fixed Expenses Increase,278036,95855.0,99850,195705.0,82331.0,29.61,0.04,Low Risk
U252,2024,8,727941.0,Salary Increases & Fixed Expenses Increase,278036,95855.0,134033,229888.0,48148.0,17.32,0.04,Medium Risk
U252,2024,9,776089.0,Salary Increases & Fixed Expenses Increase,278036,95855.0,121178,217033.0,61003.0,21.94,-0.03,Medium Risk
U252,2024,10,837092.0,Salary Increases & Fixed Expenses Increase,278036,95855.0,138735,234590.0,43446.0,15.63,0.02,Medium Risk
U252,2024,11,880538.0,Salary Increases & Fixed Expenses Increase,278036,95855.0,97494,193349.0,84687.0,30.46,0.02,Low Risk
U252,2024,12,965225.0,Salary Increases & Fixed Expenses Increase,278036,95855.0,134402,230257.0,47779.0,17.18,0.04,Medium Risk
U253,2024,1,237526.0,Salary Increases & Fixed Expenses Increase,101320,60734.0,39667,100401.0,919.0,0.91,-0.03,High Risk
U253,2024,2,238445.0,Salary Increases & Fixed Expenses Increase,101320,61820.0,43412,105232.0,-3912.0,-3.86,0.03,High Risk
U253,2024,3,234533.0,Salary Increases & Fixed Expenses Increase,101320,61820.0,55361,117181.0,-15861.0,-15.65,0.03,High Risk
U253,2024,4,218672.0,Salary Increases & Fixed Expenses Increase,101320,63272.0,40255,103527.0,-2207.0,-2.18,0.01,High Risk
U253,2024,5,216465.0,Salary Increases & Fixed Expenses Increase,116109,63272.0,39044,102316.0,13793.0,11.88,-0.02,High Risk
U253,2024,6,230258.0,Salary Increases & Fixed Expenses Increase,116109,64209.0,41082,105291.0,10818.0,9.32,0.01,High Risk
U253,2024,7,241076.0,Salary Increases & Fixed Expenses Increase,116109,66099.0,46463,112562.0,3547.0,3.05,0.01,High Risk
U253,2024,8,244623.0,Salary Increases & Fixed Expenses Increase,116109,66099.0,43619,109718.0,6391.0,5.5,-0.02,High Risk
U253,2024,9,251014.0,Salary Increases & Fixed Expenses Increase,116109,66099.0,49015,115114.0,995.0,0.86,0.0,High Risk
U253,2024,10,252009.0,Salary Increases & Fixed Expenses Increase,116109,66099.0,69988,136087.0,-19978.0,-17.21,-0.0,High Risk
U253,2024,11,232031.0,Salary Increases & Fixed Expenses Increase,116109,66099.0,65549,131648.0,-15539.0,-13.38,0.01,High Risk
U253,2024,12,216492.0,Salary Increases & Fixed Expenses Increase,116109,67461.0,57836,125297.0,-9188.0,-7.91,-0.03,High Risk
U254,2024,1,214475.0,Salary Increases & Fixed Expenses Increase,122942,52092.0,29801,81893.0,41049.0,33.39,-0.01,Low Risk
U254,2024,2,255524.0,Salary Increases & Fixed Expenses Increase,122942,52092.0,26211,78303.0,44639.0,36.31,0.02,Low Risk
U254,2024,3,300163.0,Salary Increases & Fixed Expenses Increase,122942,52092.0,41408,93500.0,29442.0,23.95,0.04,Medium Risk
U254,2024,4,329605.0,Salary Increases & Fixed Expenses Increase,122942,52092.0,28142,80234.0,42708.0,34.74,-0.02,Low Risk
U254,2024,5,372313.0,Salary Increases & Fixed Expenses Increase,131726,52092.0,29801,81893.0,49833.0,37.83,0.04,Low Risk
U254,2024,6,422146.0,Salary Increases & Fixed Expenses Increase,131726,53170.0,37187,90357.0,41369.0,31.41,-0.01,Low Risk
U254,2024,7,463515.0,Salary Increases & Fixed Expenses Increase,131726,53170.0,38221,91391.0,40335.0,30.62,-0.01,Low Risk
U254,2024,8,503850.0,Salary Increases & Fixed Expenses Increase,131726,53170.0,32808,85978.0,45748.0,34.73,0.01,Low Risk
U254,2024,9,549598.0,Salary Increases & Fixed Expenses Increase,131726,53170.0,39374,92544.0,39182.0,29.75,-0.04,Low Risk
U254,2024,10,588780.0,Salary Increases & Fixed Expenses Increase,131726,54626.0,41777,96403.0,35323.0,26.82,0.0,Low Risk
U254,2024,11,624103.0,Salary Increases & Fixed Expenses Increase,131726,54626.0,33739,88365.0,43361.0,32.92,0.02,Low Risk
U254,2024,12,667464.0,Salary Increases & Fixed Expenses Increase,131726,54626.0,42835,97461.0,34265.0,26.01,0.04,Low Risk
U255,2024,1,250000.0,Stable Salary & Decreasing Fixed Expenses,265662,113577.0,119755,233332.0,32330.0,12.17,-0.04,High Risk
U255,2024,2,282330.0,Stable Salary & Decreasing Fixed Expenses,265662,113577.0,111106,224683.0,40979.0,15.43,0.0,Medium Risk
U255,2024,3,323309.0,Stable Salary & Decreasing Fixed Expenses,265662,113577.0,109174,222751.0,42911.0,16.15,-0.03,Medium Risk
U255,2024,4,366220.0,Stable Salary & Decreasing Fixed Expenses,265662,113577.0,79736,193313.0,72349.0,27.23,0.01,Low Risk
U255,2024,5,438569.0,Stable Salary & Decreasing Fixed Expenses,265662,113577.0,82442,196019.0,69643.0,26.21,-0.0,Low Risk
U255,2024,6,508212.0,Stable Salary & Decreasing Fixed Expenses,265662,113577.0,130923,244500.0,21162.0,7.97,-0.01,High Risk
U255,2024,7,529374.0,Stable Salary & Decreasing Fixed Expenses,265662,113577.0,107412,220989.0,44673.0,16.82,0.02,Medium Risk
U255,2024,8,574047.0,Stable Salary & Decreasing Fixed Expenses,265662,113577.0,94682,208259.0,57403.0,21.61,0.01,Medium Risk
U255,2024,9,631450.0,Stable Salary & Decreasing Fixed Expenses,265662,113577.0,111551,225128.0,40534.0,15.26,0.04,Medium Risk
U255,2024,10,671984.0,Stable Salary & Decreasing Fixed Expenses,265662,113577.0,101612,215189.0,50473.0,19.0,0.02,Medium Risk
U255,2024,11,722457.0,Stable Salary & Decreasing Fixed Expenses,265662,113577.0,118464,232041.0,33621.0,12.66,-0.01,High Risk
U255,2024,12,756078.0,Stable Salary & Decreasing Fixed Expenses,265662,113577.0,84345,197922.0,67740.0,25.5,-0.02,Low Risk
U256,2024,1,181186.0,Salary Increases & Fixed Expenses Remain Stable,32804,14784.0,15297,30081.0,2723.0,8.3,0.03,High Risk
U256,2024,2,183909.0,Salary Increases & Fixed Expenses Remain Stable,32804,14784.0,9891,24675.0,8129.0,24.78,0.02,Medium Risk
U256,2024,3,192038.0,Salary Increases & Fixed Expenses Remain Stable,32804,14784.0,15827,30611.0,2193.0,6.69,-0.04,High Risk
U256,2024,4,194231.0,Salary Increases & Fixed Expenses Remain Stable,32804,14784.0,10102,24886.0,7918.0,24.14,-0.01,Medium Risk
U256,2024,5,202149.0,Salary Increases & Fixed Expenses Remain Stable,32804,14784.0,15747,30531.0,2273.0,6.93,0.01,High Risk
U256,2024,6,204422.0,Salary Increases & Fixed Expenses Remain Stable,32804,14784.0,14797,29581.0,3223.0,9.83,-0.04,High Risk
U256,2024,7,207645.0,Salary Increases & Fixed Expenses Remain Stable,48106,14784.0,15055,29839.0,18267.0,37.97,-0.05,Low Risk
U256,2024,8,225912.0,Salary Increases & Fixed Expenses Remain Stable,48106,14784.0,14478,29262.0,18844.0,39.17,0.01,Low Risk
U256,2024,9,244756.0,Salary Increases & Fixed Expenses Remain Stable,48106,14784.0,17705,32489.0,15617.0,32.46,0.01,Low Risk
U256,2024,10,260373.0,Salary Increases & Fixed Expenses Remain Stable,48106,14784.0,18281,33065.0,15041.0,31.27,-0.05,Low Risk
U256,2024,11,275414.0,Salary Increases & Fixed Expenses Remain Stable,48106,14784.0,24580,39364.0,8742.0,18.17,-0.03,Medium Risk
U256,2024,12,284156.0,Salary Increases & Fixed Expenses Remain Stable,48106,14784.0,22049,36833.0,11273.0,23.43,-0.02,Medium Risk
U257,2024,1,220219.0,Salary Increases & Fixed Expenses Remain Stable,20897,17070.0,13454,30524.0,-9627.0,-46.07,0.04,High Risk
U257,2024,2,210592.0,Salary Increases & Fixed Expenses Remain Stable,20897,17070.0,14153,31223.0,-10326.0,-49.41,-0.05,High Risk
U257,2024,3,200266.0,Salary Increases & Fixed Expenses Remain Stable,20897,17070.0,10781,27851.0,-6954.0,-33.28,-0.03,High Risk
U257,2024,4,193312.0,Salary Increases & Fixed Expenses Remain Stable,20897,17070.0,11532,28602.0,-7705.0,-36.87,0.02,High Risk
U257,2024,5,185607.0,Salary Increases & Fixed Expenses Remain Stable,43736,17070.0,24935,42005.0,1731.0,3.96,0.01,High Risk
U257,2024,6,187338.0,Salary Increases & Fixed Expenses Remain Stable,43736,17070.0,23130,40200.0,3536.0,8.08,0.02,High Risk
U257,2024,7,190874.0,Salary Increases & Fixed Expenses Remain Stable,43736,17070.0,28998,46068.0,-2332.0,-5.33,0.03,High Risk
U257,2024,8,188542.0,Salary Increases & Fixed Expenses Remain Stable,43736,17070.0,22342,39412.0,4324.0,9.89,0.05,High Risk
U257,2024,9,192866.0,Salary Increases & Fixed Expenses Remain Stable,43736,17070.0,27362,44432.0,-696.0,-1.59,0.02,High Risk
U257,2024,10,192170.0,Salary Increases & Fixed Expenses Remain Stable,43736,17070.0,29600,46670.0,-2934.0,-6.71,-0.03,High Risk
U257,2024,11,189236.0,Salary Increases & Fixed Expenses Remain Stable,43736,17070.0,25640,42710.0,1026.0,2.35,-0.04,High Risk
U257,2024,12,190262.0,Salary Increases & Fixed Expenses Remain Stable,43736,17070.0,25154,42224.0,1512.0,3.46,-0.03,High Risk
U258,2024,1,133661.0,Salary Increases & Fixed Expenses Increase,127298,73503.0,39218,112721.0,14577.0,11.45,0.01,High Risk
U258,2024,2,148238.0,Salary Increases & Fixed Expenses Increase,127298,73503.0,53859,127362.0,-64.0,-0.05,-0.02,High Risk
U258,2024,3,148174.0,Salary Increases & Fixed Expenses Increase,153616,73503.0,61754,135257.0,18359.0,11.95,-0.03,High Risk
U258,2024,4,166533.0,Salary Increases & Fixed Expenses Increase,153616,74666.0,60270,134936.0,18680.0,12.16,-0.05,High Risk
U258,2024,5,185213.0,Salary Increases & Fixed Expenses Increase,153616,74666.0,71132,145798.0,7818.0,5.09,-0.01,High Risk
U258,2024,6,193031.0,Salary Increases & Fixed Expenses Increase,153616,74666.0,62492,137158.0,16458.0,10.71,-0.03,High Risk
U258,2024,7,209489.0,Salary Increases & Fixed Expenses Increase,153616,74666.0,57825,132491.0,21125.0,13.75,0.05,High Risk
U258,2024,8,230614.0,Salary Increases & Fixed Expenses Increase,153616,74666.0,52912,127578.0,26038.0,16.95,-0.03,Medium Risk
U258,2024,9,256652.0,Salary Increases & Fixed Expenses Increase,153616,74666.0,47296,121962.0,31654.0,20.61,-0.01,Medium Risk
U258,2024,10,288306.0,Salary Increases & Fixed Expenses Increase,153616,74666.0,62890,137556.0,16060.0,10.45,-0.03,High Risk
U258,2024,11,304366.0,Salary Increases & Fixed Expenses Increase,153616,74666.0,76462,151128.0,2488.0,1.62,0.03,High Risk
U258,2024,12,306854.0,Salary Increases & Fixed Expenses Increase,153616,74666.0,72130,146796.0,6820.0,4.44,0.03,High Risk
U259,2024,1,250000.0,Salary Increases & Fixed Expenses Remain Stable,259298,81726.0,61626,143352.0,115946.0,44.72,-0.01,Low Risk
U259,2024,2,365946.0,Salary Increases & Fixed Expenses Remain Stable,259298,81726.0,57280,139006.0,120292.0,46.39,0.03,Low Risk
U259,2024,3,486238.0,Salary Increases & Fixed Expenses Remain Stable,259298,81726.0,65979,147705.0,111593.0,43.04,0.02,Low Risk
U259,2024,4,597831.0,Salary Increases & Fixed Expenses Remain Stable,259298,81726.0,75060,156786.0,102512.0,39.53,-0.01,Low Risk
U259,2024,5,700343.0,Salary Increases & Fixed Expenses Remain Stable,259298,81726.0,53026,134752.0,124546.0,48.03,-0.02,Low Risk
U259,2024,6,824889.0,Salary Increases & Fixed Expenses Remain Stable,259298,81726.0,61298,143024.0,116274.0,44.84,0.01,Low Risk
U259,2024,7,941163.0,Salary Increases & Fixed Expenses Remain Stable,259298,81726.0,69397,151123.0,108175.0,41.72,0.05,Low Risk
U259,2024,8,1049338.0,Salary Increases & Fixed Expenses Remain Stable,273622,81726.0,64506,146232.0,127390.0,46.56,0.0,Low Risk
U259,2024,9,1176728.0,Salary Increases & Fixed Expenses Remain Stable,273622,81726.0,82252,163978.0,109644.0,40.07,-0.02,Low Risk
U259,2024,10,1286372.0,Salary Increases & Fixed Expenses Remain Stable,273622,81726.0,89797,171523.0,102099.0,37.31,-0.01,Low Risk
U259,2024,11,1388471.0,Salary Increases & Fixed Expenses Remain Stable,273622,81726.0,88931,170657.0,102965.0,37.63,-0.03,Low Risk
U259,2024,12,1491436.0,Salary Increases & Fixed Expenses Remain Stable,273622,81726.0,73057,154783.0,118839.0,43.43,-0.03,Low Risk
U260,2024,1,139208.0,Stable Salary & Increasing Fixed Expenses,135696,45852.0,44600,90452.0,45244.0,33.34,0.04,Low Risk
U260,2024,2,184452.0,Stable Salary & Increasing Fixed Expenses,135696,45852.0,47084,92936.0,42760.0,31.51,0.03,Low Risk
U260,2024,3,227212.0,Stable Salary & Increasing Fixed Expenses,135696,45852.0,53673,99525.0,36171.0,26.66,0.01,Low Risk
U260,2024,4,263383.0,Stable Salary & Increasing Fixed Expenses,135696,45852.0,47065,92917.0,42779.0,31.53,-0.03,Low Risk
U260,2024,5,306162.0,Stable Salary & Increasing Fixed Expenses,135696,45852.0,43682,89534.0,46162.0,34.02,-0.03,Low Risk
U260,2024,6,352324.0,Stable Salary & Increasing Fixed Expenses,135696,45852.0,52845,98697.0,36999.0,27.27,-0.03,Low Risk
U260,2024,7,389323.0,Stable Salary & Increasing Fixed Expenses,135696,45852.0,52888,98740.0,36956.0,27.23,0.03,Low Risk
U260,2024,8,426279.0,Stable Salary & Increasing Fixed Expenses,135696,45852.0,52792,98644.0,37052.0,27.31,-0.0,Low Risk
U260,2024,9,463331.0,Stable Salary & Increasing Fixed Expenses,135696,47294.0,64662,111956.0,23740.0,17.49,0.0,Medium Risk
U260,2024,10,487071.0,Stable Salary & Increasing Fixed Expenses,135696,47294.0,49841,97135.0,38561.0,28.42,-0.05,Low Risk
U260,2024,11,525632.0,Stable Salary & Increasing Fixed Expenses,135696,47294.0,66789,114083.0,21613.0,15.93,-0.0,Medium Risk
U260,2024,12,547245.0,Stable Salary & Increasing Fixed Expenses,135696,47294.0,52469,99763.0,35933.0,26.48,-0.04,Low Risk
U261,2024,1,232021.0,Salary Increases & Fixed Expenses Remain Stable,192619,67620.0,98076,165696.0,26923.0,13.98,-0.05,High Risk
U261,2024,2,258944.0,Salary Increases & Fixed Expenses Remain Stable,192619,67620.0,121553,189173.0,3446.0,1.79,-0.01,High Risk
U261,2024,3,262390.0,Salary Increases & Fixed Expenses Remain Stable,192619,67620.0,110804,178424.0,14195.0,7.37,0.04,High Risk
U261,2024,4,276585.0,Salary Increases & Fixed Expenses Remain Stable,192619,67620.0,116430,184050.0,8569.0,4.45,-0.03,High Risk
U261,2024,5,285154.0,Salary Increases & Fixed Expenses Remain Stable,192619,67620.0,118269,185889.0,6730.0,3.49,0.01,High Risk
U261,2024,6,291884.0,Salary Increases & Fixed Expenses Remain Stable,203688,67620.0,140304,207924.0,-4236.0,-2.08,-0.03,High Risk
U261,2024,7,287648.0,Salary Increases & Fixed Expenses Remain Stable,203688,67620.0,139175,206795.0,-3107.0,-1.53,0.04,High Risk
U261,2024,8,284541.0,Salary Increases & Fixed Expenses Remain Stable,203688,67620.0,129152,196772.0,6916.0,3.4,-0.01,High Risk
U261,2024,9,291457.0,Salary Increases & Fixed Expenses Remain Stable,203688,67620.0,140940,208560.0,-4872.0,-2.39,-0.01,High Risk
U261,2024,10,286585.0,Salary Increases & Fixed Expenses Remain Stable,203688,67620.0,141862,209482.0,-5794.0,-2.84,-0.03,High Risk
U261,2024,11,280791.0,Salary Increases & Fixed Expenses Remain Stable,203688,67620.0,109881,177501.0,26187.0,12.86,0.01,High Risk
U261,2024,12,306978.0,Salary Increases & Fixed Expenses Remain Stable,203688,67620.0,103905,171525.0,32163.0,15.79,-0.04,Medium Risk
U262,2024,1,126521.0,Salary Increases & Fixed Expenses Increase,95096,27008.0,35783,62791.0,32305.0,33.97,0.05,Low Risk
U262,2024,2,158826.0,Salary Increases & Fixed Expenses Increase,95096,27008.0,40329,67337.0,27759.0,29.19,0.02,Low Risk
U262,2024,3,186585.0,Salary Increases & Fixed Expenses Increase,95096,27008.0,31731,58739.0,36357.0,38.23,0.01,Low Risk
U262,2024,4,222942.0,Salary Increases & Fixed Expenses Increase,95096,27888.0,41548,69436.0,25660.0,26.98,-0.04,Low Risk
U262,2024,5,248602.0,Salary Increases & Fixed Expenses Increase,95096,27888.0,35627,63515.0,31581.0,33.21,-0.01,Low Risk
U262,2024,6,280183.0,Salary Increases & Fixed Expenses Increase,95096,27888.0,47312,75200.0,19896.0,20.92,0.05,Medium Risk
U262,2024,7,300079.0,Salary Increases & Fixed Expenses Increase,118248,27888.0,53671,81559.0,36689.0,31.03,0.03,Low Risk
U262,2024,8,336768.0,Salary Increases & Fixed Expenses Increase,118248,27888.0,38417,66305.0,51943.0,43.93,-0.02,Low Risk
U262,2024,9,388711.0,Salary Increases & Fixed Expenses Increase,118248,29657.0,35639,65296.0,52952.0,44.78,-0.02,Low Risk
U262,2024,10,441663.0,Salary Increases & Fixed Expenses Increase,118248,29657.0,42631,72288.0,45960.0,38.87,0.0,Low Risk
U262,2024,11,487623.0,Salary Increases & Fixed Expenses Increase,118248,29657.0,44999,74656.0,43592.0,36.86,0.0,Low Risk
U262,2024,12,531215.0,Salary Increases & Fixed Expenses Increase,118248,29657.0,41468,71125.0,47123.0,39.85,0.01,Low Risk
U263,2024,1,240090.0,Stable Salary & Increasing Fixed Expenses,235568,110410.0,67538,177948.0,57620.0,24.46,0.02,Medium Risk
U263,2024,2,297710.0,Stable Salary & Increasing Fixed Expenses,235568,110410.0,49772,160182.0,75386.0,32.0,0.01,Low Risk
U263,2024,3,373096.0,Stable Salary & Increasing Fixed Expenses,235568,110410.0,56489,166899.0,68669.0,29.15,-0.05,Low Risk
U263,2024,4,441765.0,Stable Salary & Increasing Fixed Expenses,235568,110410.0,57657,168067.0,67501.0,28.65,-0.03,Low Risk
U263,2024,5,509266.0,Stable Salary & Increasing Fixed Expenses,235568,110410.0,54115,164525.0,71043.0,30.16,-0.03,Low Risk
U263,2024,6,580309.0,Stable Salary & Increasing Fixed Expenses,235568,110410.0,51155,161565.0,74003.0,31.41,0.05,Low Risk
U263,2024,7,654312.0,Stable Salary & Increasing Fixed Expenses,235568,111615.0,62276,173891.0,61677.0,26.18,-0.04,Low Risk
U263,2024,8,715989.0,Stable Salary & Increasing Fixed Expenses,235568,111615.0,50077,161692.0,73876.0,31.36,-0.02,Low Risk
U263,2024,9,789865.0,Stable Salary & Increasing Fixed Expenses,235568,111615.0,49048,160663.0,74905.0,31.8,0.03,Low Risk
U263,2024,10,864770.0,Stable Salary & Increasing Fixed Expenses,235568,111615.0,66188,177803.0,57765.0,24.52,0.04,Medium Risk
U263,2024,11,922535.0,Stable Salary & Increasing Fixed Expenses,235568,111615.0,53570,165185.0,70383.0,29.88,0.02,Low Risk
U263,2024,12,992918.0,Stable Salary & Increasing Fixed Expenses,235568,111615.0,56549,168164.0,67404.0,28.61,-0.01,Low Risk
U264,2024,1,226499.0,Salary Increases & Fixed Expenses Increase,164097,44101.0,86534,130635.0,33462.0,20.39,-0.01,Medium Risk
U264,2024,2,259961.0,Salary Increases & Fixed Expenses Increase,164097,44101.0,113595,157696.0,6401.0,3.9,-0.01,High Risk
U264,2024,3,266362.0,Salary Increases & Fixed Expenses Increase,164097,45967.0,108881,154848.0,9249.0,5.64,0.01,High Risk
U264,2024,4,275611.0,Salary Increases & Fixed Expenses Increase,171627,45967.0,109101,155068.0,16559.0,9.65,0.04,High Risk
U264,2024,5,292170.0,Salary Increases & Fixed Expenses Increase,171627,45967.0,113099,159066.0,12561.0,7.32,0.05,High Risk
U264,2024,6,304731.0,Salary Increases & Fixed Expenses Increase,171627,45967.0,91897,137864.0,33763.0,19.67,0.0,Medium Risk
U264,2024,7,338494.0,Salary Increases & Fixed Expenses Increase,171627,45967.0,112702,158669.0,12958.0,7.55,-0.02,High Risk
U264,2024,8,351452.0,Salary Increases & Fixed Expenses Increase,171627,45967.0,91053,137020.0,34607.0,20.16,0.01,Medium Risk
U264,2024,9,386059.0,Salary Increases & Fixed Expenses Increase,171627,45967.0,98089,144056.0,27571.0,16.06,-0.01,Medium Risk
U264,2024,10,413630.0,Salary Increases & Fixed Expenses Increase,171627,45967.0,119393,165360.0,6267.0,3.65,-0.01,High Risk
U264,2024,11,419897.0,Salary Increases & Fixed Expenses Increase,171627,45967.0,97502,143469.0,28158.0,16.41,0.05,Medium Risk
U264,2024,12,448055.0,Salary Increases & Fixed Expenses Increase,171627,45967.0,91249,137216.0,34411.0,20.05,-0.03,Medium Risk
U265,2024,1,250000.0,Stable Salary & Stable Fixed Expenses,287173,94103.0,123829,217932.0,69241.0,24.11,0.01,Medium Risk
U265,2024,2,319241.0,Stable Salary & Stable Fixed Expenses,287173,94103.0,88993,183096.0,104077.0,36.24,0.03,Low Risk
U265,2024,3,423318.0,Stable Salary & Stable Fixed Expenses,287173,94103.0,112802,206905.0,80268.0,27.95,0.03,Low Risk
U265,2024,4,503586.0,Stable Salary & Stable Fixed Expenses,287173,94103.0,97187,191290.0,95883.0,33.39,0.0,Low Risk
U265,2024,5,599469.0,Stable Salary & Stable Fixed Expenses,287173,94103.0,96784,190887.0,96286.0,33.53,0.0,Low Risk
U265,2024,6,695755.0,Stable Salary & Stable Fixed Expenses,287173,94103.0,89389,183492.0,103681.0,36.1,0.0,Low Risk
U265,2024,7,799436.0,Stable Salary & Stable Fixed Expenses,287173,94103.0,128076,222179.0,64994.0,22.63,0.04,Medium Risk
U265,2024,8,864430.0,Stable Salary & Stable Fixed Expenses,287173,94103.0,134582,228685.0,58488.0,20.37,-0.02,Medium Risk
U265,2024,9,922918.0,Stable Salary & Stable Fixed Expenses,287173,94103.0,156470,250573.0,36600.0,12.74,0.02,High Risk
U265,2024,10,959518.0,Stable Salary & Stable Fixed Expenses,287173,94103.0,115111,209214.0,77959.0,27.15,0.03,Low Risk
U265,2024,11,1037477.0,Stable Salary & Stable Fixed Expenses,287173,94103.0,152974,247077.0,40096.0,13.96,0.01,High Risk
U265,2024,12,1077573.0,Stable Salary & Stable Fixed Expenses,287173,94103.0,169082,263185.0,23988.0,8.35,-0.04,High Risk
U266,2024,1,249725.0,Salary Increases & Fixed Expenses Increase,186237,55695.0,38603,94298.0,91939.0,49.37,-0.02,Low Risk
U266,2024,2,341664.0,Salary Increases & Fixed Expenses Increase,186237,55695.0,41245,96940.0,89297.0,47.95,0.05,Low Risk
U266,2024,3,430961.0,Salary Increases & Fixed Expenses Increase,186237,55695.0,48680,104375.0,81862.0,43.96,-0.03,Low Risk
U266,2024,4,512823.0,Salary Increases & Fixed Expenses Increase,186237,55695.0,52724,108419.0,77818.0,41.78,-0.04,Low Risk
U266,2024,5,590641.0,Salary Increases & Fixed Expenses Increase,186237,55695.0,45125,100820.0,85417.0,45.86,-0.03,Low Risk
U266,2024,6,676058.0,Salary Increases & Fixed Expenses Increase,186237,57511.0,53522,111033.0,75204.0,40.38,0.0,Low Risk
U266,2024,7,751262.0,Salary Increases & Fixed Expenses Increase,209476,57511.0,57041,114552.0,94924.0,45.31,0.04,Low Risk
U266,2024,8,846186.0,Salary Increases & Fixed Expenses Increase,209476,57511.0,55254,112765.0,96711.0,46.17,-0.01,Low Risk
U266,2024,9,942897.0,Salary Increases & Fixed Expenses Increase,209476,57511.0,59100,116611.0,92865.0,44.33,0.04,Low Risk
U266,2024,10,1035762.0,Salary Increases & Fixed Expenses Increase,209476,57511.0,58961,116472.0,93004.0,44.4,-0.04,Low Risk
U266,2024,11,1128766.0,Salary Increases & Fixed Expenses Increase,209476,57511.0,52789,110300.0,99176.0,47.34,-0.01,Low Risk
U266,2024,12,1227942.0,Salary Increases & Fixed Expenses Increase,209476,57511.0,46135,103646.0,105830.0,50.52,-0.02,Low Risk
U267,2024,1,214671.0,Salary Increases & Fixed Expenses Remain Stable,169120,48755.0,73744,122499.0,46621.0,27.57,0.04,Low Risk
U267,2024,2,261292.0,Salary Increases & Fixed Expenses Remain Stable,169120,48755.0,83983,132738.0,36382.0,21.51,-0.04,Medium Risk
U267,2024,3,297674.0,Salary Increases & Fixed Expenses Remain Stable,169120,48755.0,65405,114160.0,54960.0,32.5,0.02,Low Risk
U267,2024,4,352634.0,Salary Increases & Fixed Expenses Remain Stable,169120,48755.0,67961,116716.0,52404.0,30.99,0.03,Low Risk
U267,2024,5,405038.0,Salary Increases & Fixed Expenses Remain Stable,198476,48755.0,86055,134810.0,63666.0,32.08,0.01,Low Risk
U267,2024,6,468704.0,Salary Increases & Fixed Expenses Remain Stable,198476,48755.0,92161,140916.0,57560.0,29.0,0.0,Low Risk
U267,2024,7,526264.0,Salary Increases & Fixed Expenses Remain Stable,198476,48755.0,62311,111066.0,87410.0,44.04,0.02,Low Risk
U267,2024,8,613674.0,Salary Increases & Fixed Expenses Remain Stable,198476,48755.0,93715,142470.0,56006.0,28.22,0.01,Low Risk
U267,2024,9,669680.0,Salary Increases & Fixed Expenses Remain Stable,198476,48755.0,81794,130549.0,67927.0,34.22,0.0,Low Risk
U267,2024,10,737607.0,Salary Increases & Fixed Expenses Remain Stable,198476,48755.0,93759,142514.0,55962.0,28.2,0.03,Low Risk
U267,2024,11,793569.0,Salary Increases & Fixed Expenses Remain Stable,198476,48755.0,86974,135729.0,62747.0,31.61,-0.02,Low Risk
U267,2024,12,856316.0,Salary Increases & Fixed Expenses Remain Stable,198476,48755.0,85113,133868.0,64608.0,32.55,0.04,Low Risk
U268,2024,1,201373.0,Salary Increases & Fixed Expenses Increase,119384,62779.0,69149,131928.0,-12544.0,-10.51,0.02,High Risk
U268,2024,2,188829.0,Salary Increases & Fixed Expenses Increase,119384,62779.0,63512,126291.0,-6907.0,-5.79,-0.01,High Risk
U268,2024,3,181922.0,Salary Increases & Fixed Expenses Increase,119384,64523.0,72762,137285.0,-17901.0,-14.99,-0.05,High Risk
U268,2024,4,164021.0,Salary Increases & Fixed Expenses Increase,119384,64523.0,72160,136683.0,-17299.0,-14.49,-0.04,High Risk
U268,2024,5,146722.0,Salary Increases & Fixed Expenses Increase,119384,64523.0,68976,133499.0,-14115.0,-11.82,-0.02,High Risk
U268,2024,6,132607.0,Salary Increases & Fixed Expenses Increase,146381,64523.0,81172,145695.0,686.0,0.47,0.0,High Risk
U268,2024,7,133293.0,Salary Increases & Fixed Expenses Increase,146381,64523.0,86934,151457.0,-5076.0,-3.47,-0.02,High Risk
U268,2024,8,128217.0,Salary Increases & Fixed Expenses Increase,146381,64523.0,86032,150555.0,-4174.0,-2.85,0.05,High Risk
U268,2024,9,124043.0,Salary Increases & Fixed Expenses Increase,146381,64523.0,87001,151524.0,-5143.0,-3.51,-0.05,High Risk
U268,2024,10,118900.0,Salary Increases & Fixed Expenses Increase,146381,64523.0,89504,154027.0,-7646.0,-5.22,-0.0,High Risk
U268,2024,11,111254.0,Salary Increases & Fixed Expenses Increase,146381,64523.0,82097,146620.0,-239.0,-0.16,-0.05,High Risk
U268,2024,12,111015.0,Salary Increases & Fixed Expenses Increase,146381,64523.0,101905,166428.0,-20047.0,-13.7,0.0,High Risk
U269,2024,1,181616.0,Salary Increases & Fixed Expenses Remain Stable,103629,50237.0,66439,116676.0,-13047.0,-12.59,0.01,High Risk
U269,2024,2,168569.0,Salary Increases & Fixed Expenses Remain Stable,103629,50237.0,53343,103580.0,49.0,0.05,-0.01,High Risk
U269,2024,3,168618.0,Salary Increases & Fixed Expenses Remain Stable,108678,50237.0,58591,108828.0,-150.0,-0.14,-0.04,High Risk
U269,2024,4,168468.0,Salary Increases & Fixed Expenses Remain Stable,108678,50237.0,64682,114919.0,-6241.0,-5.74,-0.04,High Risk
U269,2024,5,162227.0,Salary Increases & Fixed Expenses Remain Stable,108678,50237.0,68532,118769.0,-10091.0,-9.29,-0.03,High Risk
U269,2024,6,152136.0,Salary Increases & Fixed Expenses Remain Stable,108678,50237.0,69960,120197.0,-11519.0,-10.6,0.0,High Risk
U269,2024,7,140617.0,Salary Increases & Fixed Expenses Remain Stable,108678,50237.0,74128,124365.0,-15687.0,-14.43,0.04,High Risk
U269,2024,8,124930.0,Salary Increases & Fixed Expenses Remain Stable,108678,50237.0,74005,124242.0,-15564.0,-14.32,-0.03,High Risk
U269,2024,9,109366.0,Salary Increases & Fixed Expenses Remain Stable,108678,50237.0,74901,125138.0,-16460.0,-15.15,-0.02,High Risk
U269,2024,10,92906.0,Salary Increases & Fixed Expenses Remain Stable,108678,50237.0,66290,116527.0,-7849.0,-7.22,-0.01,High Risk
U269,2024,11,85057.0,Salary Increases & Fixed Expenses Remain Stable,108678,50237.0,58434,108671.0,7.0,0.01,-0.01,High Risk
U269,2024,12,85064.0,Salary Increases & Fixed Expenses Remain Stable,108678,50237.0,73569,123806.0,-15128.0,-13.92,0.04,High Risk
U270,2024,1,198358.0,Stable Salary & Increasing Fixed Expenses,127943,66367.0,26807,93174.0,34769.0,27.18,0.04,Low Risk
U270,2024,2,233127.0,Stable Salary & Increasing Fixed Expenses,127943,66367.0,36840,103207.0,24736.0,19.33,-0.05,Medium Risk
U270,2024,3,257863.0,Stable Salary & Increasing Fixed Expenses,127943,67794.0,48018,115812.0,12131.0,9.48,0.02,High Risk
U270,2024,4,269994.0,Stable Salary & Increasing Fixed Expenses,127943,67794.0,34642,102436.0,25507.0,19.94,0.0,Medium Risk
U270,2024,5,295501.0,Stable Salary & Increasing Fixed Expenses,127943,67794.0,35615,103409.0,24534.0,19.18,-0.04,Medium Risk
U270,2024,6,320035.0,Stable Salary & Increasing Fixed Expenses,127943,67794.0,27127,94921.0,33022.0,25.81,-0.05,Low Risk
U270,2024,7,353057.0,Stable Salary & Increasing Fixed Expenses,127943,67794.0,30470,98264.0,29679.0,23.2,0.05,Medium Risk
U270,2024,8,382736.0,Stable Salary & Increasing Fixed Expenses,127943,67794.0,31408,99202.0,28741.0,22.46,0.01,Medium Risk
U270,2024,9,411477.0,Stable Salary & Increasing Fixed Expenses,127943,67794.0,29800,97594.0,30349.0,23.72,0.03,Medium Risk
U270,2024,10,441826.0,Stable Salary & Increasing Fixed Expenses,127943,67794.0,30331,98125.0,29818.0,23.31,-0.04,Medium Risk
U270,2024,11,471644.0,Stable Salary & Increasing Fixed Expenses,127943,67794.0,34689,102483.0,25460.0,19.9,-0.05,Medium Risk
U270,2024,12,497104.0,Stable Salary & Increasing Fixed Expenses,127943,67794.0,41472,109266.0,18677.0,14.6,-0.01,High Risk
U271,2024,1,223446.0,Salary Increases & Fixed Expenses Increase,134267,47606.0,37442,85048.0,49219.0,36.66,-0.0,Low Risk
U271,2024,2,272665.0,Salary Increases & Fixed Expenses Increase,134267,47606.0,37426,85032.0,49235.0,36.67,-0.01,Low Risk
U271,2024,3,321900.0,Salary Increases & Fixed Expenses Increase,134267,49362.0,27626,76988.0,57279.0,42.66,0.04,Low Risk
U271,2024,4,379179.0,Salary Increases & Fixed Expenses Increase,134267,50789.0,27108,77897.0,56370.0,41.98,0.02,Low Risk
U271,2024,5,435549.0,Salary Increases & Fixed Expenses Increase,134267,50789.0,27929,78718.0,55549.0,41.37,-0.01,Low Risk
U271,2024,6,491098.0,Salary Increases & Fixed Expenses Increase,134267,50789.0,34974,85763.0,48504.0,36.13,0.03,Low Risk
U271,2024,7,539602.0,Salary Increases & Fixed Expenses Increase,134267,50789.0,37007,87796.0,46471.0,34.61,0.04,Low Risk
U271,2024,8,586073.0,Salary Increases & Fixed Expenses Increase,155725,52417.0,46449,98866.0,56859.0,36.51,0.01,Low Risk
U271,2024,9,642932.0,Salary Increases & Fixed Expenses Increase,155725,52417.0,36689,89106.0,66619.0,42.78,-0.01,Low Risk
U271,2024,10,709551.0,Salary Increases & Fixed Expenses Increase,155725,52417.0,31174,83591.0,72134.0,46.32,0.05,Low Risk
U271,2024,11,781685.0,Salary Increases & Fixed Expenses Increase,155725,52417.0,44396,96813.0,58912.0,37.83,0.01,Low Risk
U271,2024,12,840597.0,Salary Increases & Fixed Expenses Increase,155725,52417.0,39749,92166.0,63559.0,40.81,0.02,Low Risk
U272,2024,1,194087.0,Stable Salary & Increasing Fixed Expenses,135560,69779.0,27761,97540.0,38020.0,28.05,-0.03,Low Risk
U272,2024,2,232107.0,Stable Salary & Increasing Fixed Expenses,135560,69779.0,28506,98285.0,37275.0,27.5,-0.0,Low Risk
U272,2024,3,269382.0,Stable Salary & Increasing Fixed Expenses,135560,71413.0,31760,103173.0,32387.0,23.89,0.05,Medium Risk
U272,2024,4,301769.0,Stable Salary & Increasing Fixed Expenses,135560,71413.0,38227,109640.0,25920.0,19.12,0.01,Medium Risk
U272,2024,5,327689.0,Stable Salary & Increasing Fixed Expenses,135560,71413.0,32399,103812.0,31748.0,23.42,-0.04,Medium Risk
U272,2024,6,359437.0,Stable Salary & Increasing Fixed Expenses,135560,71413.0,36011,107424.0,28136.0,20.76,0.01,Medium Risk
U272,2024,7,387573.0,Stable Salary & Increasing Fixed Expenses,135560,71413.0,33158,104571.0,30989.0,22.86,0.02,Medium Risk
U272,2024,8,418562.0,Stable Salary & Increasing Fixed Expenses,135560,71413.0,28737,100150.0,35410.0,26.12,0.04,Low Risk
U272,2024,9,453972.0,Stable Salary & Increasing Fixed Expenses,135560,72594.0,43237,115831.0,19729.0,14.55,0.05,High Risk
U272,2024,10,473701.0,Stable Salary & Increasing Fixed Expenses,135560,72594.0,30416,103010.0,32550.0,24.01,0.01,Medium Risk
U272,2024,11,506251.0,Stable Salary & Increasing Fixed Expenses,135560,72594.0,31288,103882.0,31678.0,23.37,0.04,Medium Risk
U272,2024,12,537929.0,Stable Salary & Increasing Fixed Expenses,135560,72594.0,32576,105170.0,30390.0,22.42,0.01,Medium Risk
U273,2024,1,250000.0,Stable Salary & Stable Fixed Expenses,274842,69010.0,79263,148273.0,126569.0,46.05,-0.04,Low Risk
U273,2024,2,376569.0,Stable Salary & Stable Fixed Expenses,274842,69010.0,55057,124067.0,150775.0,54.86,0.01,Low Risk
U273,2024,3,527344.0,Stable Salary & Stable Fixed Expenses,274842,69010.0,77359,146369.0,128473.0,46.74,0.02,Low Risk
U273,2024,4,655817.0,Stable Salary & Stable Fixed Expenses,274842,69010.0,59482,128492.0,146350.0,53.25,0.04,Low Risk
U273,2024,5,802167.0,Stable Salary & Stable Fixed Expenses,274842,69010.0,74582,143592.0,131250.0,47.75,0.01,Low Risk
U273,2024,6,933417.0,Stable Salary & Stable Fixed Expenses,274842,69010.0,66575,135585.0,139257.0,50.67,0.0,Low Risk
U273,2024,7,1072674.0,Stable Salary & Stable Fixed Expenses,274842,69010.0,74138,143148.0,131694.0,47.92,-0.04,Low Risk
U273,2024,8,1204368.0,Stable Salary & Stable Fixed Expenses,274842,69010.0,61534,130544.0,144298.0,52.5,0.01,Low Risk
U273,2024,9,1348666.0,Stable Salary & Stable Fixed Expenses,274842,69010.0,65223,134233.0,140609.0,51.16,0.03,Low Risk
U273,2024,10,1489275.0,Stable Salary & Stable Fixed Expenses,274842,69010.0,83563,152573.0,122269.0,44.49,0.04,Low Risk
U273,2024,11,1611544.0,Stable Salary & Stable Fixed Expenses,274842,69010.0,66806,135816.0,139026.0,50.58,-0.05,Low Risk
U273,2024,12,1750570.0,Stable Salary & Stable Fixed Expenses,274842,69010.0,88158,157168.0,117674.0,42.82,0.01,Low Risk
U274,2024,1,195514.0,Stable Salary & Stable Fixed Expenses,188579,58468.0,91585,150053.0,38526.0,20.43,-0.05,Medium Risk
U274,2024,2,234040.0,Stable Salary & Stable Fixed Expenses,188579,58468.0,88620,147088.0,41491.0,22.0,0.02,Medium Risk
U274,2024,3,275531.0,Stable Salary & Stable Fixed Expenses,188579,58468.0,98141,156609.0,31970.0,16.95,0.02,Medium Risk
U274,2024,4,307501.0,Stable Salary & Stable Fixed Expenses,188579,58468.0,90480,148948.0,39631.0,21.02,-0.0,Medium Risk
U274,2024,5,347132.0,Stable Salary & Stable Fixed Expenses,188579,58468.0,84852,143320.0,45259.0,24.0,-0.05,Medium Risk
U274,2024,6,392391.0,Stable Salary & Stable Fixed Expenses,188579,58468.0,71445,129913.0,58666.0,31.11,0.02,Low Risk
U274,2024,7,451057.0,Stable Salary & Stable Fixed Expenses,188579,58468.0,83637,142105.0,46474.0,24.64,-0.0,Medium Risk
U274,2024,8,497531.0,Stable Salary & Stable Fixed Expenses,188579,58468.0,72904,131372.0,57207.0,30.34,0.01,Low Risk
U274,2024,9,554738.0,Stable Salary & Stable Fixed Expenses,188579,58468.0,97404,155872.0,32707.0,17.34,-0.04,Medium Risk
U274,2024,10,587445.0,Stable Salary & Stable Fixed Expenses,188579,58468.0,86699,145167.0,43412.0,23.02,-0.03,Medium Risk
U274,2024,11,630857.0,Stable Salary & Stable Fixed Expenses,188579,58468.0,89295,147763.0,40816.0,21.64,-0.03,Medium Risk
U274,2024,12,671673.0,Stable Salary & Stable Fixed Expenses,188579,58468.0,90396,148864.0,39715.0,21.06,-0.04,Medium Risk
U275,2024,1,250000.0,Stable Salary & Stable Fixed Expenses,293461,110626.0,65844,176470.0,116991.0,39.87,-0.05,Low Risk
U275,2024,2,366991.0,Stable Salary & Stable Fixed Expenses,293461,110626.0,72446,183072.0,110389.0,37.62,0.04,Low Risk
U275,2024,3,477380.0,Stable Salary & Stable Fixed Expenses,293461,110626.0,66739,177365.0,116096.0,39.56,-0.03,Low Risk
U275,2024,4,593476.0,Stable Salary & Stable Fixed Expenses,293461,110626.0,74159,184785.0,108676.0,37.03,0.0,Low Risk
U275,2024,5,702152.0,Stable Salary & Stable Fixed Expenses,293461,110626.0,87470,198096.0,95365.0,32.5,-0.0,Low Risk
U275,2024,6,797517.0,Stable Salary & Stable Fixed Expenses,293461,110626.0,87043,197669.0,95792.0,32.64,0.05,Low Risk
U275,2024,7,893309.0,Stable Salary & Stable Fixed Expenses,293461,110626.0,59748,170374.0,123087.0,41.94,-0.03,Low Risk
U275,2024,8,1016396.0,Stable Salary & Stable Fixed Expenses,293461,110626.0,73113,183739.0,109722.0,37.39,-0.04,Low Risk
U275,2024,9,1126118.0,Stable Salary & Stable Fixed Expenses,293461,110626.0,69396,180022.0,113439.0,38.66,-0.02,Low Risk
U275,2024,10,1239557.0,Stable Salary & Stable Fixed Expenses,293461,110626.0,97594,208220.0,85241.0,29.05,-0.04,Low Risk
U275,2024,11,1324798.0,Stable Salary & Stable Fixed Expenses,293461,110626.0,68455,179081.0,114380.0,38.98,0.05,Low Risk
U275,2024,12,1439178.0,Stable Salary & Stable Fixed Expenses,293461,110626.0,84825,195451.0,98010.0,33.4,0.02,Low Risk
U276,2024,1,204390.0,Salary Increases & Fixed Expenses Remain Stable,73538,36833.0,15432,52265.0,21273.0,28.93,0.03,Low Risk
U276,2024,2,225663.0,Salary Increases & Fixed Expenses Remain Stable,73538,36833.0,16497,53330.0,20208.0,27.48,-0.0,Low Risk
U276,2024,3,245871.0,Salary Increases & Fixed Expenses Remain Stable,73538,36833.0,18889,55722.0,17816.0,24.23,-0.03,Medium Risk
U276,2024,4,263687.0,Salary Increases & Fixed Expenses Remain Stable,73538,36833.0,18525,55358.0,18180.0,24.72,-0.03,Medium Risk
U276,2024,5,281867.0,Salary Increases & Fixed Expenses Remain Stable,73538,36833.0,21036,57869.0,15669.0,21.31,0.0,Medium Risk
U276,2024,6,297536.0,Salary Increases & Fixed Expenses Remain Stable,73538,36833.0,20450,57283.0,16255.0,22.1,-0.01,Medium Risk
U276,2024,7,313791.0,Salary Increases & Fixed Expenses Remain Stable,73538,36833.0,21211,58044.0,15494.0,21.07,0.03,Medium Risk
U276,2024,8,329285.0,Salary Increases & Fixed Expenses Remain Stable,97816,36833.0,20808,57641.0,40175.0,41.07,0.03,Low Risk
U276,2024,9,369460.0,Salary Increases & Fixed Expenses Remain Stable,97816,36833.0,27072,63905.0,33911.0,34.67,0.01,Low Risk
U276,2024,10,403371.0,Salary Increases & Fixed Expenses Remain Stable,97816,36833.0,26298,63131.0,34685.0,35.46,-0.02,Low Risk
U276,2024,11,438056.0,Salary Increases & Fixed Expenses Remain Stable,97816,36833.0,24899,61732.0,36084.0,36.89,-0.04,Low Risk
U276,2024,12,474140.0,Salary Increases & Fixed Expenses Remain Stable,97816,36833.0,22921,59754.0,38062.0,38.91,0.03,Low Risk
U277,2024,1,229390.0,Salary Increases & Fixed Expenses Remain Stable,179235,60202.0,51316,111518.0,67717.0,37.78,0.05,Low Risk
U277,2024,2,297107.0,Salary Increases & Fixed Expenses Remain Stable,179235,60202.0,39662,99864.0,79371.0,44.28,-0.03,Low Risk
U277,2024,3,376478.0,Salary Increases & Fixed Expenses Remain Stable,179235,60202.0,46340,106542.0,72693.0,40.56,0.01,Low Risk
U277,2024,4,449171.0,Salary Increases & Fixed Expenses Remain Stable,179235,60202.0,36597,96799.0,82436.0,45.99,0.02,Low Risk
U277,2024,5,531607.0,Salary Increases & Fixed Expenses Remain Stable,179235,60202.0,40993,101195.0,78040.0,43.54,-0.04,Low Risk
U277,2024,6,609647.0,Salary Increases & Fixed Expenses Remain Stable,179235,60202.0,44432,104634.0,74601.0,41.62,-0.02,Low Risk
U277,2024,7,684248.0,Salary Increases & Fixed Expenses Remain Stable,179235,60202.0,53330,113532.0,65703.0,36.66,-0.04,Low Risk
U277,2024,8,749951.0,Salary Increases & Fixed Expenses Remain Stable,199532,60202.0,50815,111017.0,88515.0,44.36,0.04,Low Risk
U277,2024,9,838466.0,Salary Increases & Fixed Expenses Remain Stable,199532,60202.0,64649,124851.0,74681.0,37.43,-0.04,Low Risk
U277,2024,10,913147.0,Salary Increases & Fixed Expenses Remain Stable,199532,60202.0,53037,113239.0,86293.0,43.25,0.03,Low Risk
U277,2024,11,999440.0,Salary Increases & Fixed Expenses Remain Stable,199532,60202.0,47185,107387.0,92145.0,46.18,0.01,Low Risk
U277,2024,12,1091585.0,Salary Increases & Fixed Expenses Remain Stable,199532,60202.0,53339,113541.0,85991.0,43.1,0.03,Low Risk
U278,2024,1,245681.0,Stable Salary & Increasing Fixed Expenses,178976,44431.0,68824,113255.0,65721.0,36.72,-0.04,Low Risk
U278,2024,2,311402.0,Stable Salary & Increasing Fixed Expenses,178976,44431.0,64772,109203.0,69773.0,38.98,0.01,Low Risk
U278,2024,3,381175.0,Stable Salary & Increasing Fixed Expenses,178976,44431.0,104101,148532.0,30444.0,17.01,0.03,Medium Risk
U278,2024,4,411619.0,Stable Salary & Increasing Fixed Expenses,178976,44431.0,78698,123129.0,55847.0,31.2,0.02,Low Risk
U278,2024,5,467466.0,Stable Salary & Increasing Fixed Expenses,178976,44431.0,56468,100899.0,78077.0,43.62,0.02,Low Risk
U278,2024,6,545543.0,Stable Salary & Increasing Fixed Expenses,178976,44431.0,60098,104529.0,74447.0,41.6,-0.02,Low Risk
U278,2024,7,619990.0,Stable Salary & Increasing Fixed Expenses,178976,44431.0,71357,115788.0,63188.0,35.31,0.05,Low Risk
U278,2024,8,683178.0,Stable Salary & Increasing Fixed Expenses,178976,46083.0,59929,106012.0,72964.0,40.77,0.01,Low Risk
U278,2024,9,756142.0,Stable Salary & Increasing Fixed Expenses,178976,46083.0,69731,115814.0,63162.0,35.29,0.05,Low Risk
U278,2024,10,819304.0,Stable Salary & Increasing Fixed Expenses,178976,46083.0,78967,125050.0,53926.0,30.13,-0.03,Low Risk
U278,2024,11,873230.0,Stable Salary & Increasing Fixed Expenses,178976,46083.0,90754,136837.0,42139.0,23.54,0.02,Medium Risk
U278,2024,12,915369.0,Stable Salary & Increasing Fixed Expenses,178976,46083.0,82347,128430.0,50546.0,28.24,0.04,Low Risk
U279,2024,1,241931.0,Salary Increases & Fixed Expenses Remain Stable,117686,65950.0,51217,117167.0,519.0,0.44,0.01,High Risk
U279,2024,2,242450.0,Salary Increases & Fixed Expenses Remain Stable,117686,65950.0,55592,121542.0,-3856.0,-3.28,-0.04,High Risk
U279,2024,3,238594.0,Salary Increases & Fixed Expenses Remain Stable,117686,65950.0,42559,108509.0,9177.0,7.8,0.01,High Risk
U279,2024,4,247771.0,Salary Increases & Fixed Expenses Remain Stable,117686,65950.0,43510,109460.0,8226.0,6.99,-0.03,High Risk
U279,2024,5,255997.0,Salary Increases & Fixed Expenses Remain Stable,147266,65950.0,48225,114175.0,33091.0,22.47,0.02,Medium Risk
U279,2024,6,289088.0,Salary Increases & Fixed Expenses Remain Stable,147266,65950.0,57829,123779.0,23487.0,15.95,0.02,Medium Risk
U279,2024,7,312575.0,Salary Increases & Fixed Expenses Remain Stable,147266,65950.0,65119,131069.0,16197.0,11.0,0.03,High Risk
U279,2024,8,328772.0,Salary Increases & Fixed Expenses Remain Stable,147266,65950.0,53699,119649.0,27617.0,18.75,-0.04,Medium Risk
U279,2024,9,356389.0,Salary Increases & Fixed Expenses Remain Stable,147266,65950.0,54256,120206.0,27060.0,18.37,0.01,Medium Risk
U279,2024,10,383449.0,Salary Increases & Fixed Expenses Remain Stable,147266,65950.0,51601,117551.0,29715.0,20.18,0.05,Medium Risk
U279,2024,11,413164.0,Salary Increases & Fixed Expenses Remain Stable,147266,65950.0,51444,117394.0,29872.0,20.28,0.01,Medium Risk
U279,2024,12,443036.0,Salary Increases & Fixed Expenses Remain Stable,147266,65950.0,67219,133169.0,14097.0,9.57,-0.02,High Risk
U280,2024,1,182183.0,Salary Increases & Fixed Expenses Remain Stable,54322,33631.0,23392,57023.0,-2701.0,-4.97,-0.05,High Risk
U280,2024,2,179482.0,Salary Increases & Fixed Expenses Remain Stable,54322,33631.0,20289,53920.0,402.0,0.74,-0.0,High Risk
U280,2024,3,179884.0,Salary Increases & Fixed Expenses Remain Stable,54322,33631.0,20515,54146.0,176.0,0.32,-0.04,High Risk
U280,2024,4,180060.0,Salary Increases & Fixed Expenses Remain Stable,54322,33631.0,16706,50337.0,3985.0,7.34,-0.04,High Risk
U280,2024,5,184045.0,Salary Increases & Fixed Expenses Remain Stable,54322,33631.0,25740,59371.0,-5049.0,-9.29,0.02,High Risk
U280,2024,6,178996.0,Salary Increases & Fixed Expenses Remain Stable,54322,33631.0,17140,50771.0,3551.0,6.54,-0.01,High Risk
U280,2024,7,182547.0,Salary Increases & Fixed Expenses Remain Stable,63198,33631.0,24090,57721.0,5477.0,8.67,0.02,High Risk
U280,2024,8,188024.0,Salary Increases & Fixed Expenses Remain Stable,63198,33631.0,23541,57172.0,6026.0,9.54,0.02,High Risk
U280,2024,9,194050.0,Salary Increases & Fixed Expenses Remain Stable,63198,33631.0,26251,59882.0,3316.0,5.25,-0.05,High Risk
U280,2024,10,197366.0,Salary Increases & Fixed Expenses Remain Stable,63198,33631.0,20698,54329.0,8869.0,14.03,0.02,High Risk
U280,2024,11,206235.0,Salary Increases & Fixed Expenses Remain Stable,63198,33631.0,28145,61776.0,1422.0,2.25,0.01,High Risk
U280,2024,12,207657.0,Salary Increases & Fixed Expenses Remain Stable,63198,33631.0,20521,54152.0,9046.0,14.31,0.05,High Risk
U281,2024,1,183284.0,Salary Increases & Fixed Expenses Decrease,138629,66234.0,53412,119646.0,18983.0,13.69,0.01,High Risk
U281,2024,2,202267.0,Salary Increases & Fixed Expenses Decrease,138629,66234.0,41680,107914.0,30715.0,22.16,-0.03,Medium Risk
U281,2024,3,232982.0,Salary Increases & Fixed Expenses Decrease,138629,66234.0,58692,124926.0,13703.0,9.88,0.03,High Risk
U281,2024,4,246685.0,Salary Increases & Fixed Expenses Decrease,138629,66234.0,56759,122993.0,15636.0,11.28,0.03,High Risk
U281,2024,5,262321.0,Salary Increases & Fixed Expenses Decrease,138629,66234.0,42613,108847.0,29782.0,21.48,0.02,Medium Risk
U281,2024,6,292103.0,Salary Increases & Fixed Expenses Decrease,138629,66234.0,46252,112486.0,26143.0,18.86,-0.03,Medium Risk
U281,2024,7,318246.0,Salary Increases & Fixed Expenses Decrease,138629,66234.0,57367,123601.0,15028.0,10.84,0.01,High Risk
U281,2024,8,333274.0,Salary Increases & Fixed Expenses Decrease,161896,66234.0,76605,142839.0,19057.0,11.77,-0.03,High Risk
U281,2024,9,352331.0,Salary Increases & Fixed Expenses Decrease,161896,66234.0,56570,122804.0,39092.0,24.15,0.02,Medium Risk
U281,2024,10,391423.0,Salary Increases & Fixed Expenses Decrease,161896,66234.0,76631,142865.0,19031.0,11.76,-0.01,High Risk
U281,2024,11,410454.0,Salary Increases & Fixed Expenses Decrease,161896,66234.0,78465,144699.0,17197.0,10.62,0.0,High Risk
U281,2024,12,427651.0,Salary Increases & Fixed Expenses Decrease,161896,64866.0,59511,124377.0,37519.0,23.17,-0.04,Medium Risk
U282,2024,1,248274.0,Salary Increases & Fixed Expenses Remain Stable,185684,58235.0,70255,128490.0,57194.0,30.8,0.03,Low Risk
U282,2024,2,305468.0,Salary Increases & Fixed Expenses Remain Stable,185684,58235.0,72537,130772.0,54912.0,29.57,-0.02,Low Risk
U282,2024,3,360380.0,Salary Increases & Fixed Expenses Remain Stable,191732,58235.0,70021,128256.0,63476.0,33.11,0.03,Low Risk
U282,2024,4,423856.0,Salary Increases & Fixed Expenses Remain Stable,191732,58235.0,88412,146647.0,45085.0,23.51,-0.02,Medium Risk
U282,2024,5,468941.0,Salary Increases & Fixed Expenses Remain Stable,191732,58235.0,69840,128075.0,63657.0,33.2,0.03,Low Risk
U282,2024,6,532598.0,Salary Increases & Fixed Expenses Remain Stable,191732,58235.0,58663,116898.0,74834.0,39.03,-0.02,Low Risk
U282,2024,7,607432.0,Salary Increases & Fixed Expenses Remain Stable,191732,58235.0,87485,145720.0,46012.0,24.0,0.04,Medium Risk
U282,2024,8,653444.0,Salary Increases & Fixed Expenses Remain Stable,191732,58235.0,58543,116778.0,74954.0,39.09,0.02,Low Risk
U282,2024,9,728398.0,Salary Increases & Fixed Expenses Remain Stable,191732,58235.0,77512,135747.0,55985.0,29.2,0.03,Low Risk
U282,2024,10,784383.0,Salary Increases & Fixed Expenses Remain Stable,191732,58235.0,92355,150590.0,41142.0,21.46,-0.0,Medium Risk
U282,2024,11,825525.0,Salary Increases & Fixed Expenses Remain Stable,191732,58235.0,76863,135098.0,56634.0,29.54,-0.01,Low Risk
U282,2024,12,882159.0,Salary Increases & Fixed Expenses Remain Stable,191732,58235.0,87358,145593.0,46139.0,24.06,-0.01,Medium Risk
U283,2024,1,159884.0,Salary Increases & Fixed Expenses Remain Stable,159056,62366.0,36670,99036.0,60020.0,37.74,0.01,Low Risk
U283,2024,2,219904.0,Salary Increases & Fixed Expenses Remain Stable,159056,62366.0,43983,106349.0,52707.0,33.14,-0.03,Low Risk
U283,2024,3,272611.0,Salary Increases & Fixed Expenses Remain Stable,159056,62366.0,44557,106923.0,52133.0,32.78,0.04,Low Risk
U283,2024,4,324744.0,Salary Increases & Fixed Expenses Remain Stable,159056,62366.0,33810,96176.0,62880.0,39.53,0.02,Low Risk
U283,2024,5,387624.0,Salary Increases & Fixed Expenses Remain Stable,165227,62366.0,33535,95901.0,69326.0,41.96,0.0,Low Risk
U283,2024,6,456950.0,Salary Increases & Fixed Expenses Remain Stable,165227,62366.0,47145,109511.0,55716.0,33.72,-0.02,Low Risk
U283,2024,7,512666.0,Salary Increases & Fixed Expenses Remain Stable,165227,62366.0,34638,97004.0,68223.0,41.29,-0.05,Low Risk
U283,2024,8,580889.0,Salary Increases & Fixed Expenses Remain Stable,165227,62366.0,39955,102321.0,62906.0,38.07,0.04,Low Risk
U283,2024,9,643795.0,Salary Increases & Fixed Expenses Remain Stable,165227,62366.0,39894,102260.0,62967.0,38.11,0.04,Low Risk
U283,2024,10,706762.0,Salary Increases & Fixed Expenses Remain Stable,165227,62366.0,37569,99935.0,65292.0,39.52,-0.01,Low Risk
U283,2024,11,772054.0,Salary Increases & Fixed Expenses Remain Stable,165227,62366.0,41089,103455.0,61772.0,37.39,-0.03,Low Risk
U283,2024,12,833826.0,Salary Increases & Fixed Expenses Remain Stable,165227,62366.0,47996,110362.0,54865.0,33.21,-0.0,Low Risk
U284,2024,1,229895.0,Salary Increases & Fixed Expenses Remain Stable,175924,74594.0,49706,124300.0,51624.0,29.34,0.02,Low Risk
U284,2024,2,281519.0,Salary Increases & Fixed Expenses Remain Stable,175924,74594.0,43889,118483.0,57441.0,32.65,0.03,Low Risk
U284,2024,3,338960.0,Salary Increases & Fixed Expenses Remain Stable,202454,74594.0,59798,134392.0,68062.0,33.62,0.02,Low Risk
U284,2024,4,407022.0,Salary Increases & Fixed Expenses Remain Stable,202454,74594.0,60089,134683.0,67771.0,33.47,0.05,Low Risk
U284,2024,5,474793.0,Salary Increases & Fixed Expenses Remain Stable,202454,74594.0,52855,127449.0,75005.0,37.05,-0.03,Low Risk
U284,2024,6,549798.0,Salary Increases & Fixed Expenses Remain Stable,202454,74594.0,56457,131051.0,71403.0,35.27,-0.01,Low Risk
U284,2024,7,621201.0,Salary Increases & Fixed Expenses Remain Stable,202454,74594.0,58914,133508.0,68946.0,34.06,0.01,Low Risk
U284,2024,8,690147.0,Salary Increases & Fixed Expenses Remain Stable,202454,74594.0,51114,125708.0,76746.0,37.91,0.01,Low Risk
U284,2024,9,766893.0,Salary Increases & Fixed Expenses Remain Stable,202454,74594.0,62348,136942.0,65512.0,32.36,-0.03,Low Risk
U284,2024,10,832405.0,Salary Increases & Fixed Expenses Remain Stable,202454,74594.0,53952,128546.0,73908.0,36.51,-0.03,Low Risk
U284,2024,11,906313.0,Salary Increases & Fixed Expenses Remain Stable,202454,74594.0,53971,128565.0,73889.0,36.5,-0.04,Low Risk
U284,2024,12,980202.0,Salary Increases & Fixed Expenses Remain Stable,202454,74594.0,59848,134442.0,68012.0,33.59,0.04,Low Risk
U285,2024,1,214527.0,Salary Increases & Fixed Expenses Remain Stable,121525,59390.0,68807,128197.0,-6672.0,-5.49,0.05,High Risk
U285,2024,2,207855.0,Salary Increases & Fixed Expenses Remain Stable,121525,59390.0,62072,121462.0,63.0,0.05,-0.0,High Risk
U285,2024,3,207918.0,Salary Increases & Fixed Expenses Remain Stable,121525,59390.0,72012,131402.0,-9877.0,-8.13,-0.02,High Risk
U285,2024,4,198041.0,Salary Increases & Fixed Expenses Remain Stable,121525,59390.0,74533,133923.0,-12398.0,-10.2,0.01,High Risk
U285,2024,5,185643.0,Salary Increases & Fixed Expenses Remain Stable,126965,59390.0,85742,145132.0,-18167.0,-14.31,-0.02,High Risk
U285,2024,6,167476.0,Salary Increases & Fixed Expenses Remain Stable,126965,59390.0,80660,140050.0,-13085.0,-10.31,-0.04,High Risk
U285,2024,7,154391.0,Salary Increases & Fixed Expenses Remain Stable,126965,59390.0,66027,125417.0,1548.0,1.22,0.04,High Risk
U285,2024,8,155939.0,Salary Increases & Fixed Expenses Remain Stable,126965,59390.0,70013,129403.0,-2438.0,-1.92,0.02,High Risk
U285,2024,9,153501.0,Salary Increases & Fixed Expenses Remain Stable,126965,59390.0,71485,130875.0,-3910.0,-3.08,0.05,High Risk
U285,2024,10,149591.0,Salary Increases & Fixed Expenses Remain Stable,126965,59390.0,63962,123352.0,3613.0,2.85,0.01,High Risk
U285,2024,11,153204.0,Salary Increases & Fixed Expenses Remain Stable,126965,59390.0,97511,156901.0,-29936.0,-23.58,-0.04,High Risk
U285,2024,12,123268.0,Salary Increases & Fixed Expenses Remain Stable,126965,59390.0,72615,132005.0,-5040.0,-3.97,0.05,High Risk
U286,2024,1,152929.0,Stable Salary & Stable Fixed Expenses,88293,38744.0,17922,56666.0,31627.0,35.82,-0.02,Low Risk
U286,2024,2,184556.0,Stable Salary & Stable Fixed Expenses,88293,38744.0,22922,61666.0,26627.0,30.16,0.0,Low Risk
U286,2024,3,211183.0,Stable Salary & Stable Fixed Expenses,88293,38744.0,26159,64903.0,23390.0,26.49,-0.02,Low Risk
U286,2024,4,234573.0,Stable Salary & Stable Fixed Expenses,88293,38744.0,19396,58140.0,30153.0,34.15,0.0,Low Risk
U286,2024,5,264726.0,Stable Salary & Stable Fixed Expenses,88293,38744.0,21490,60234.0,28059.0,31.78,-0.01,Low Risk
U286,2024,6,292785.0,Stable Salary & Stable Fixed Expenses,88293,38744.0,24175,62919.0,25374.0,28.74,-0.0,Low Risk
U286,2024,7,318159.0,Stable Salary & Stable Fixed Expenses,88293,38744.0,20961,59705.0,28588.0,32.38,0.01,Low Risk
U286,2024,8,346747.0,Stable Salary & Stable Fixed Expenses,88293,38744.0,21160,59904.0,28389.0,32.15,0.01,Low Risk
U286,2024,9,375136.0,Stable Salary & Stable Fixed Expenses,88293,38744.0,24785,63529.0,24764.0,28.05,-0.03,Low Risk
U286,2024,10,399900.0,Stable Salary & Stable Fixed Expenses,88293,38744.0,17920,56664.0,31629.0,35.82,0.01,Low Risk
U286,2024,11,431529.0,Stable Salary & Stable Fixed Expenses,88293,38744.0,21676,60420.0,27873.0,31.57,-0.02,Low Risk
U286,2024,12,459402.0,Stable Salary & Stable Fixed Expenses,88293,38744.0,23893,62637.0,25656.0,29.06,0.0,Low Risk
U287,2024,1,181681.0,Salary Increases & Fixed Expenses Remain Stable,104493,55160.0,25429,80589.0,23904.0,22.88,0.04,Medium Risk
U287,2024,2,205585.0,Salary Increases & Fixed Expenses Remain Stable,104493,55160.0,26116,81276.0,23217.0,22.22,-0.0,Medium Risk
U287,2024,3,228802.0,Salary Increases & Fixed Expenses Remain Stable,110994,55160.0,31144,86304.0,24690.0,22.24,0.01,Medium Risk
U287,2024,4,253492.0,Salary Increases & Fixed Expenses Remain Stable,110994,55160.0,28289,83449.0,27545.0,24.82,0.0,Medium Risk
U287,2024,5,281037.0,Salary Increases & Fixed Expenses Remain Stable,110994,55160.0,22855,78015.0,32979.0,29.71,-0.05,Low Risk
U287,2024,6,314016.0,Salary Increases & Fixed Expenses Remain Stable,110994,55160.0,25179,80339.0,30655.0,27.62,0.0,Low Risk
U287,2024,7,344671.0,Salary Increases & Fixed Expenses Remain Stable,110994,55160.0,30044,85204.0,25790.0,23.24,0.01,Medium Risk
U287,2024,8,370461.0,Salary Increases & Fixed Expenses Remain Stable,110994,55160.0,29737,84897.0,26097.0,23.51,0.03,Medium Risk
U287,2024,9,396558.0,Salary Increases & Fixed Expenses Remain Stable,110994,55160.0,30678,85838.0,25156.0,22.66,0.01,Medium Risk
U287,2024,10,421714.0,Salary Increases & Fixed Expenses Remain Stable,110994,55160.0,24097,79257.0,31737.0,28.59,0.0,Low Risk
U287,2024,11,453451.0,Salary Increases & Fixed Expenses Remain Stable,110994,55160.0,30249,85409.0,25585.0,23.05,-0.03,Medium Risk
U287,2024,12,479036.0,Salary Increases & Fixed Expenses Remain Stable,110994,55160.0,22803,77963.0,33031.0,29.76,0.01,Low Risk
U288,2024,1,140173.0,Stable Salary & Increasing Fixed Expenses,70753,33584.0,31915,65499.0,5254.0,7.43,-0.05,High Risk
U288,2024,2,145427.0,Stable Salary & Increasing Fixed Expenses,70753,33584.0,26238,59822.0,10931.0,15.45,-0.02,Medium Risk
U288,2024,3,156358.0,Stable Salary & Increasing Fixed Expenses,70753,33584.0,34772,68356.0,2397.0,3.39,-0.03,High Risk
U288,2024,4,158755.0,Stable Salary & Increasing Fixed Expenses,70753,33584.0,27296,60880.0,9873.0,13.95,-0.04,High Risk
U288,2024,5,168628.0,Stable Salary & Increasing Fixed Expenses,70753,33584.0,25236,58820.0,11933.0,16.87,0.05,Medium Risk
U288,2024,6,180561.0,Stable Salary & Increasing Fixed Expenses,70753,33584.0,21259,54843.0,15910.0,22.49,-0.02,Medium Risk
U288,2024,7,196471.0,Stable Salary & Increasing Fixed Expenses,70753,34587.0,23071,57658.0,13095.0,18.51,-0.0,Medium Risk
U288,2024,8,209566.0,Stable Salary & Increasing Fixed Expenses,70753,34587.0,34297,68884.0,1869.0,2.64,0.05,High Risk
U288,2024,9,211435.0,Stable Salary & Increasing Fixed Expenses,70753,34587.0,21269,55856.0,14897.0,21.05,-0.02,Medium Risk
U288,2024,10,226332.0,Stable Salary & Increasing Fixed Expenses,70753,34587.0,31108,65695.0,5058.0,7.15,-0.03,High Risk
U288,2024,11,231390.0,Stable Salary & Increasing Fixed Expenses,70753,34587.0,31407,65994.0,4759.0,6.73,0.04,High Risk
U288,2024,12,236149.0,Stable Salary & Increasing Fixed Expenses,70753,34587.0,25947,60534.0,10219.0,14.44,0.01,High Risk
U289,2024,1,214976.0,Stable Salary & Decreasing Fixed Expenses,164444,47083.0,77499,124582.0,39862.0,24.24,0.04,Medium Risk
U289,2024,2,254838.0,Stable Salary & Decreasing Fixed Expenses,164444,47083.0,76491,123574.0,40870.0,24.85,-0.01,Medium Risk
U289,2024,3,295708.0,Stable Salary & Decreasing Fixed Expenses,164444,47083.0,61711,108794.0,55650.0,33.84,0.0,Low Risk
U289,2024,4,351358.0,Stable Salary & Decreasing Fixed Expenses,164444,47083.0,50243,97326.0,67118.0,40.82,0.02,Low Risk
U289,2024,5,418476.0,Stable Salary & Decreasing Fixed Expenses,164444,47083.0,68900,115983.0,48461.0,29.47,-0.01,Low Risk
U289,2024,6,466937.0,Stable Salary & Decreasing Fixed Expenses,164444,47083.0,58037,105120.0,59324.0,36.08,0.01,Low Risk
U289,2024,7,526261.0,Stable Salary & Decreasing Fixed Expenses,164444,47083.0,67360,114443.0,50001.0,30.41,-0.0,Low Risk
U289,2024,8,576262.0,Stable Salary & Decreasing Fixed Expenses,164444,47083.0,69017,116100.0,48344.0,29.4,0.02,Low Risk
U289,2024,9,624606.0,Stable Salary & Decreasing Fixed Expenses,164444,47083.0,72287,119370.0,45074.0,27.41,-0.03,Low Risk
U289,2024,10,669680.0,Stable Salary & Decreasing Fixed Expenses,164444,47083.0,63301,110384.0,54060.0,32.87,0.01,Low Risk
U289,2024,11,723740.0,Stable Salary & Decreasing Fixed Expenses,164444,47083.0,90009,137092.0,27352.0,16.63,0.01,Medium Risk
U289,2024,12,751092.0,Stable Salary & Decreasing Fixed Expenses,164444,47083.0,59584,106667.0,57777.0,35.13,-0.01,Low Risk
U290,2024,1,219280.0,Salary Increases & Fixed Expenses Increase,135453,73805.0,38373,112178.0,23275.0,17.18,0.03,Medium Risk
U290,2024,2,242555.0,Salary Increases & Fixed Expenses Increase,135453,75614.0,32900,108514.0,26939.0,19.89,-0.03,Medium Risk
U290,2024,3,269494.0,Salary Increases & Fixed Expenses Increase,135453,75614.0,44341,119955.0,15498.0,11.44,-0.02,High Risk
U290,2024,4,284992.0,Salary Increases & Fixed Expenses Increase,135453,76773.0,33511,110284.0,25169.0,18.58,-0.02,Medium Risk
U290,2024,5,310161.0,Salary Increases & Fixed Expenses Increase,145441,78055.0,36890,114945.0,30496.0,20.97,-0.03,Medium Risk
U290,2024,6,340657.0,Salary Increases & Fixed Expenses Increase,145441,78055.0,33111,111166.0,34275.0,23.57,0.02,Medium Risk
U290,2024,7,374932.0,Salary Increases & Fixed Expenses Increase,145441,79571.0,40858,120429.0,25012.0,17.2,0.04,Medium Risk
U290,2024,8,399944.0,Salary Increases & Fixed Expenses Increase,145441,79571.0,34015,113586.0,31855.0,21.9,-0.05,Medium Risk
U290,2024,9,431799.0,Salary Increases & Fixed Expenses Increase,145441,79571.0,45465,125036.0,20405.0,14.03,-0.02,High Risk
U290,2024,10,452204.0,Salary Increases & Fixed Expenses Increase,145441,79571.0,32552,112123.0,33318.0,22.91,-0.04,Medium Risk
U290,2024,11,485522.0,Salary Increases & Fixed Expenses Increase,145441,81039.0,34966,116005.0,29436.0,20.24,-0.02,Medium Risk
U290,2024,12,514958.0,Salary Increases & Fixed Expenses Increase,145441,81039.0,38536,119575.0,25866.0,17.78,-0.02,Medium Risk
U291,2024,1,168820.0,Salary Increases & Fixed Expenses Remain Stable,152178,48152.0,35868,84020.0,68158.0,44.79,0.05,Low Risk
U291,2024,2,236978.0,Salary Increases & Fixed Expenses Remain Stable,152178,48152.0,39641,87793.0,64385.0,42.31,0.04,Low Risk
U291,2024,3,301363.0,Salary Increases & Fixed Expenses Remain Stable,152178,48152.0,34507,82659.0,69519.0,45.68,0.03,Low Risk
U291,2024,4,370882.0,Salary Increases & Fixed Expenses Remain Stable,152178,48152.0,43900,92052.0,60126.0,39.51,0.02,Low Risk
U291,2024,5,431008.0,Salary Increases & Fixed Expenses Remain Stable,152178,48152.0,36234,84386.0,67792.0,44.55,0.05,Low Risk
U291,2024,6,498800.0,Salary Increases & Fixed Expenses Remain Stable,163644,48152.0,33033,81185.0,82459.0,50.39,0.02,Low Risk
U291,2024,7,581259.0,Salary Increases & Fixed Expenses Remain Stable,163644,48152.0,35803,83955.0,79689.0,48.7,0.03,Low Risk
U291,2024,8,660948.0,Salary Increases & Fixed Expenses Remain Stable,163644,48152.0,34492,82644.0,81000.0,49.5,-0.0,Low Risk
U291,2024,9,741948.0,Salary Increases & Fixed Expenses Remain Stable,163644,48152.0,50898,99050.0,64594.0,39.47,-0.04,Low Risk
U291,2024,10,806542.0,Salary Increases & Fixed Expenses Remain Stable,163644,48152.0,46295,94447.0,69197.0,42.29,-0.02,Low Risk
U291,2024,11,875739.0,Salary Increases & Fixed Expenses Remain Stable,163644,48152.0,42699,90851.0,72793.0,44.48,0.03,Low Risk
U291,2024,12,948532.0,Salary Increases & Fixed Expenses Remain Stable,163644,48152.0,35703,83855.0,79789.0,48.76,0.02,Low Risk
U292,2024,1,192765.0,Salary Increases & Fixed Expenses Remain Stable,190794,72760.0,88966,161726.0,29068.0,15.24,0.01,Medium Risk
U292,2024,2,221833.0,Salary Increases & Fixed Expenses Remain Stable,190794,72760.0,59450,132210.0,58584.0,30.71,-0.03,Low Risk
U292,2024,3,280417.0,Salary Increases & Fixed Expenses Remain Stable,190794,72760.0,80158,152918.0,37876.0,19.85,0.03,Medium Risk
U292,2024,4,318293.0,Salary Increases & Fixed Expenses Remain Stable,190794,72760.0,63751,136511.0,54283.0,28.45,0.03,Low Risk
U292,2024,5,372576.0,Salary Increases & Fixed Expenses Remain Stable,190794,72760.0,89008,161768.0,29026.0,15.21,0.01,Medium Risk
U292,2024,6,401602.0,Salary Increases & Fixed Expenses Remain Stable,197525,72760.0,76982,149742.0,47783.0,24.19,-0.01,Medium Risk
U292,2024,7,449385.0,Salary Increases & Fixed Expenses Remain Stable,197525,72760.0,94473,167233.0,30292.0,15.34,-0.04,Medium Risk
U292,2024,8,479677.0,Salary Increases & Fixed Expenses Remain Stable,197525,72760.0,86135,158895.0,38630.0,19.56,-0.02,Medium Risk
U292,2024,9,518307.0,Salary Increases & Fixed Expenses Remain Stable,197525,72760.0,72637,145397.0,52128.0,26.39,-0.03,Low Risk
U292,2024,10,570435.0,Salary Increases & Fixed Expenses Remain Stable,197525,72760.0,91337,164097.0,33428.0,16.92,-0.04,Medium Risk
U292,2024,11,603863.0,Salary Increases & Fixed Expenses Remain Stable,197525,72760.0,91523,164283.0,33242.0,16.83,0.04,Medium Risk
U292,2024,12,637105.0,Salary Increases & Fixed Expenses Remain Stable,197525,72760.0,74351,147111.0,50414.0,25.52,0.05,Low Risk
U293,2024,1,113520.0,Stable Salary & Increasing Fixed Expenses,101984,58239.0,43982,102221.0,-237.0,-0.23,0.0,High Risk
U293,2024,2,113283.0,Stable Salary & Increasing Fixed Expenses,101984,58239.0,37514,95753.0,6231.0,6.11,-0.04,High Risk
U293,2024,3,119514.0,Stable Salary & Increasing Fixed Expenses,101984,58239.0,38045,96284.0,5700.0,5.59,-0.02,High Risk
U293,2024,4,125214.0,Stable Salary & Increasing Fixed Expenses,101984,59976.0,34135,94111.0,7873.0,7.72,0.03,High Risk
U293,2024,5,133087.0,Stable Salary & Increasing Fixed Expenses,101984,59976.0,49745,109721.0,-7737.0,-7.59,0.03,High Risk
U293,2024,6,125350.0,Stable Salary & Increasing Fixed Expenses,101984,59976.0,44801,104777.0,-2793.0,-2.74,0.0,High Risk
U293,2024,7,122557.0,Stable Salary & Increasing Fixed Expenses,101984,59976.0,30851,90827.0,11157.0,10.94,-0.0,High Risk
U293,2024,8,133714.0,Stable Salary & Increasing Fixed Expenses,101984,59976.0,37499,97475.0,4509.0,4.42,0.04,High Risk
U293,2024,9,138223.0,Stable Salary & Increasing Fixed Expenses,101984,59976.0,54019,113995.0,-12011.0,-11.78,-0.01,High Risk
U293,2024,10,126212.0,Stable Salary & Increasing Fixed Expenses,101984,59976.0,30760,90736.0,11248.0,11.03,0.04,High Risk
U293,2024,11,137460.0,Stable Salary & Increasing Fixed Expenses,101984,59976.0,56628,116604.0,-14620.0,-14.34,-0.03,High Risk
U293,2024,12,122840.0,Stable Salary & Increasing Fixed Expenses,101984,59976.0,46994,106970.0,-4986.0,-4.89,0.01,High Risk
U294,2024,1,104479.0,Salary Increases & Fixed Expenses Decrease,57142,36507.0,23531,60038.0,-2896.0,-5.07,0.01,High Risk
U294,2024,2,101583.0,Salary Increases & Fixed Expenses Decrease,57142,36507.0,26437,62944.0,-5802.0,-10.15,0.04,High Risk
U294,2024,3,95781.0,Salary Increases & Fixed Expenses Decrease,57142,36507.0,24318,60825.0,-3683.0,-6.45,0.01,High Risk
U294,2024,4,92098.0,Salary Increases & Fixed Expenses Decrease,57142,36507.0,17578,54085.0,3057.0,5.35,0.01,High Risk
U294,2024,5,95155.0,Salary Increases & Fixed Expenses Decrease,67425,36507.0,25360,61867.0,5558.0,8.24,0.04,High Risk
U294,2024,6,100713.0,Salary Increases & Fixed Expenses Decrease,67425,36507.0,27968,64475.0,2950.0,4.38,-0.02,High Risk
U294,2024,7,103663.0,Salary Increases & Fixed Expenses Decrease,67425,36507.0,30030,66537.0,888.0,1.32,0.05,High Risk
U294,2024,8,104551.0,Salary Increases & Fixed Expenses Decrease,67425,36507.0,29677,66184.0,1241.0,1.84,0.0,High Risk
U294,2024,9,105792.0,Salary Increases & Fixed Expenses Decrease,67425,36507.0,30865,67372.0,53.0,0.08,-0.02,High Risk
U294,2024,10,105845.0,Salary Increases & Fixed Expenses Decrease,67425,36507.0,27128,63635.0,3790.0,5.62,0.01,High Risk
U294,2024,11,109635.0,Salary Increases & Fixed Expenses Decrease,67425,36507.0,22169,58676.0,8749.0,12.98,-0.03,High Risk
U294,2024,12,118384.0,Salary Increases & Fixed Expenses Decrease,67425,36507.0,29342,65849.0,1576.0,2.34,-0.05,High Risk
U295,2024,1,250000.0,Stable Salary & Stable Fixed Expenses,286599,84092.0,67511,151603.0,134996.0,47.1,0.04,Low Risk
U295,2024,2,384996.0,Stable Salary & Stable Fixed Expenses,286599,84092.0,59438,143530.0,143069.0,49.92,0.04,Low Risk
U295,2024,3,528065.0,Stable Salary & Stable Fixed Expenses,286599,84092.0,84813,168905.0,117694.0,41.07,0.03,Low Risk
U295,2024,4,645759.0,Stable Salary & Stable Fixed Expenses,286599,84092.0,77100,161192.0,125407.0,43.76,0.04,Low Risk
U295,2024,5,771166.0,Stable Salary & Stable Fixed Expenses,286599,84092.0,72937,157029.0,129570.0,45.21,-0.02,Low Risk
U295,2024,6,900736.0,Stable Salary & Stable Fixed Expenses,286599,84092.0,64751,148843.0,137756.0,48.07,-0.02,Low Risk
U295,2024,7,1038492.0,Stable Salary & Stable Fixed Expenses,286599,84092.0,76094,160186.0,126413.0,44.11,0.01,Low Risk
U295,2024,8,1164905.0,Stable Salary & Stable Fixed Expenses,286599,84092.0,68104,152196.0,134403.0,46.9,-0.05,Low Risk
U295,2024,9,1299308.0,Stable Salary & Stable Fixed Expenses,286599,84092.0,96239,180331.0,106268.0,37.08,0.05,Low Risk
U295,2024,10,1405576.0,Stable Salary & Stable Fixed Expenses,286599,84092.0,103882,187974.0,98625.0,34.41,0.05,Low Risk
U295,2024,11,1504201.0,Stable Salary & Stable Fixed Expenses,286599,84092.0,69751,153843.0,132756.0,46.32,-0.04,Low Risk
U295,2024,12,1636957.0,Stable Salary & Stable Fixed Expenses,286599,84092.0,83471,167563.0,119036.0,41.53,-0.0,Low Risk
U296,2024,1,197935.0,Salary Increases & Fixed Expenses Remain Stable,62981,23296.0,18571,41867.0,21114.0,33.52,-0.01,Low Risk
U296,2024,2,219049.0,Salary Increases & Fixed Expenses Remain Stable,62981,23296.0,17429,40725.0,22256.0,35.34,-0.01,Low Risk
U296,2024,3,241305.0,Salary Increases & Fixed Expenses Remain Stable,62981,23296.0,15344,38640.0,24341.0,38.65,0.02,Low Risk
U296,2024,4,265646.0,Salary Increases & Fixed Expenses Remain Stable,62981,23296.0,13186,36482.0,26499.0,42.07,-0.01,Low Risk
U296,2024,5,292145.0,Salary Increases & Fixed Expenses Remain Stable,62981,23296.0,14666,37962.0,25019.0,39.72,-0.04,Low Risk
U296,2024,6,317164.0,Salary Increases & Fixed Expenses Remain Stable,62981,23296.0,14509,37805.0,25176.0,39.97,0.05,Low Risk
U296,2024,7,342340.0,Salary Increases & Fixed Expenses Remain Stable,88429,23296.0,20900,44196.0,44233.0,50.02,-0.03,Low Risk
U296,2024,8,386573.0,Salary Increases & Fixed Expenses Remain Stable,88429,23296.0,18325,41621.0,46808.0,52.93,-0.01,Low Risk
U296,2024,9,433381.0,Salary Increases & Fixed Expenses Remain Stable,88429,23296.0,26166,49462.0,38967.0,44.07,-0.01,Low Risk
U296,2024,10,472348.0,Salary Increases & Fixed Expenses Remain Stable,88429,23296.0,21397,44693.0,43736.0,49.46,-0.04,Low Risk
U296,2024,11,516084.0,Salary Increases & Fixed Expenses Remain Stable,88429,23296.0,22496,45792.0,42637.0,48.22,-0.04,Low Risk
U296,2024,12,558721.0,Salary Increases & Fixed Expenses Remain Stable,88429,23296.0,26498,49794.0,38635.0,43.69,-0.02,Low Risk
U297,2024,1,221800.0,Salary Increases & Fixed Expenses Remain Stable,214177,87623.0,56662,144285.0,69892.0,32.63,0.05,Low Risk
U297,2024,2,291692.0,Salary Increases & Fixed Expenses Remain Stable,214177,87623.0,43796,131419.0,82758.0,38.64,0.04,Low Risk
U297,2024,3,374450.0,Salary Increases & Fixed Expenses Remain Stable,214177,87623.0,51949,139572.0,74605.0,34.83,0.02,Low Risk
U297,2024,4,449055.0,Salary Increases & Fixed Expenses Remain Stable,214177,87623.0,57562,145185.0,68992.0,32.21,0.01,Low Risk
U297,2024,5,518047.0,Salary Increases & Fixed Expenses Remain Stable,214177,87623.0,62885,150508.0,63669.0,29.73,-0.01,Low Risk
U297,2024,6,581716.0,Salary Increases & Fixed Expenses Remain Stable,214177,87623.0,44338,131961.0,82216.0,38.39,0.0,Low Risk
U297,2024,7,663932.0,Salary Increases & Fixed Expenses Remain Stable,214177,87623.0,44691,132314.0,81863.0,38.22,-0.05,Low Risk
U297,2024,8,745795.0,Salary Increases & Fixed Expenses Remain Stable,224803,87623.0,46639,134262.0,90541.0,40.28,0.04,Low Risk
U297,2024,9,836336.0,Salary Increases & Fixed Expenses Remain Stable,224803,87623.0,64857,152480.0,72323.0,32.17,-0.01,Low Risk
U297,2024,10,908659.0,Salary Increases & Fixed Expenses Remain Stable,224803,87623.0,46681,134304.0,90499.0,40.26,0.05,Low Risk
U297,2024,11,999158.0,Salary Increases & Fixed Expenses Remain Stable,224803,87623.0,56017,143640.0,81163.0,36.1,0.03,Low Risk
U297,2024,12,1080321.0,Salary Increases & Fixed Expenses Remain Stable,224803,87623.0,54002,141625.0,83178.0,37.0,-0.01,Low Risk
U298,2024,1,87770.0,Salary Increases & Fixed Expenses Increase,59374,32163.0,17500,49663.0,9711.0,16.36,-0.04,Medium Risk
U298,2024,2,97481.0,Salary Increases & Fixed Expenses Increase,59374,32163.0,12542,44705.0,14669.0,24.71,0.04,Medium Risk
U298,2024,3,112150.0,Salary Increases & Fixed Expenses Increase,59374,32163.0,18074,50237.0,9137.0,15.39,-0.01,Medium Risk
U298,2024,4,121287.0,Salary Increases & Fixed Expenses Increase,59374,32163.0,13539,45702.0,13672.0,23.03,-0.04,Medium Risk
U298,2024,5,134959.0,Salary Increases & Fixed Expenses Increase,65326,32163.0,15383,47546.0,17780.0,27.22,0.02,Low Risk
U298,2024,6,152739.0,Salary Increases & Fixed Expenses Increase,65326,32163.0,18763,50926.0,14400.0,22.04,-0.04,Medium Risk
U298,2024,7,167139.0,Salary Increases & Fixed Expenses Increase,65326,33259.0,13425,46684.0,18642.0,28.54,0.02,Low Risk
U298,2024,8,185781.0,Salary Increases & Fixed Expenses Increase,65326,33259.0,16151,49410.0,15916.0,24.36,-0.02,Medium Risk
U298,2024,9,201697.0,Salary Increases & Fixed Expenses Increase,65326,33259.0,20681,53940.0,11386.0,17.43,-0.04,Medium Risk
U298,2024,10,213083.0,Salary Increases & Fixed Expenses Increase,65326,34127.0,16668,50795.0,14531.0,22.24,-0.03,Medium Risk
U298,2024,11,227614.0,Salary Increases & Fixed Expenses Increase,65326,34127.0,19727,53854.0,11472.0,17.56,-0.02,Medium Risk
U298,2024,12,239086.0,Salary Increases & Fixed Expenses Increase,65326,34127.0,21678,55805.0,9521.0,14.57,0.01,High Risk
U299,2024,1,232422.0,Stable Salary & Stable Fixed Expenses,175190,65713.0,98763,164476.0,10714.0,6.12,0.01,High Risk
U299,2024,2,243136.0,Stable Salary & Stable Fixed Expenses,175190,65713.0,93270,158983.0,16207.0,9.25,-0.02,High Risk
U299,2024,3,259343.0,Stable Salary & Stable Fixed Expenses,175190,65713.0,111184,176897.0,-1707.0,-0.97,-0.05,High Risk
U299,2024,4,257636.0,Stable Salary & Stable Fixed Expenses,175190,65713.0,99873,165586.0,9604.0,5.48,-0.05,High Risk
U299,2024,5,267240.0,Stable Salary & Stable Fixed Expenses,175190,65713.0,107060,172773.0,2417.0,1.38,-0.05,High Risk
U299,2024,6,269657.0,Stable Salary & Stable Fixed Expenses,175190,65713.0,101797,167510.0,7680.0,4.38,0.05,High Risk
U299,2024,7,277337.0,Stable Salary & Stable Fixed Expenses,175190,65713.0,99679,165392.0,9798.0,5.59,-0.01,High Risk
U299,2024,8,287135.0,Stable Salary & Stable Fixed Expenses,175190,65713.0,95273,160986.0,14204.0,8.11,-0.0,High Risk
U299,2024,9,301339.0,Stable Salary & Stable Fixed Expenses,175190,65713.0,128284,193997.0,-18807.0,-10.74,0.01,High Risk
U299,2024,10,282532.0,Stable Salary & Stable Fixed Expenses,175190,65713.0,121996,187709.0,-12519.0,-7.15,-0.02,High Risk
U299,2024,11,270013.0,Stable Salary & Stable Fixed Expenses,175190,65713.0,136141,201854.0,-26664.0,-15.22,0.04,High Risk
U299,2024,12,243349.0,Stable Salary & Stable Fixed Expenses,175190,65713.0,105858,171571.0,3619.0,2.07,-0.05,High Risk
U300,2024,1,247896.0,Salary Increases & Fixed Expenses Increase,247780,88896.0,54962,143858.0,103922.0,41.94,-0.02,Low Risk
U300,2024,2,351818.0,Salary Increases & Fixed Expenses Increase,247780,88896.0,71339,160235.0,87545.0,35.33,0.05,Low Risk
U300,2024,3,439363.0,Salary Increases & Fixed Expenses Increase,274099,88896.0,71452,160348.0,113751.0,41.5,-0.03,Low Risk
U300,2024,4,553114.0,Salary Increases & Fixed Expenses Increase,274099,88896.0,70106,159002.0,115097.0,41.99,-0.0,Low Risk
U300,2024,5,668211.0,Salary Increases & Fixed Expenses Increase,274099,88896.0,59493,148389.0,125710.0,45.86,-0.03,Low Risk
U300,2024,6,793921.0,Salary Increases & Fixed Expenses Increase,274099,88896.0,77324,166220.0,107879.0,39.36,0.01,Low Risk
U300,2024,7,901800.0,Salary Increases & Fixed Expenses Increase,274099,88896.0,69216,158112.0,115987.0,42.32,0.03,Low Risk
U300,2024,8,1017787.0,Salary Increases & Fixed Expenses Increase,274099,90185.0,68191,158376.0,115723.0,42.22,-0.04,Low Risk
U300,2024,9,1133510.0,Salary Increases & Fixed Expenses Increase,274099,90185.0,65033,155218.0,118881.0,43.37,-0.03,Low Risk
U300,2024,10,1252391.0,Salary Increases & Fixed Expenses Increase,274099,90185.0,61134,151319.0,122780.0,44.79,-0.04,Low Risk
U300,2024,11,1375171.0,Salary Increases & Fixed Expenses Increase,274099,90185.0,61787,151972.0,122127.0,44.56,-0.01,Low Risk
U300,2024,12,1497298.0,Salary Increases & Fixed Expenses Increase,274099,90185.0,58617,148802.0,125297.0,45.71,-0.0,Low Risk
U301,2024,1,242118.0,Salary Increases & Fixed Expenses Increase,139233,76755.0,34366,111121.0,28112.0,20.19,-0.01,Medium Risk
U301,2024,2,270230.0,Salary Increases & Fixed Expenses Increase,139233,76755.0,30511,107266.0,31967.0,22.96,-0.03,Medium Risk
U301,2024,3,302197.0,Salary Increases & Fixed Expenses Increase,139233,77922.0,34298,112220.0,27013.0,19.4,0.04,Medium Risk
U301,2024,4,329210.0,Salary Increases & Fixed Expenses Increase,139233,77922.0,36089,114011.0,25222.0,18.11,-0.03,Medium Risk
U301,2024,5,354432.0,Salary Increases & Fixed Expenses Increase,139233,77922.0,30410,108332.0,30901.0,22.19,-0.02,Medium Risk
U301,2024,6,385333.0,Salary Increases & Fixed Expenses Increase,145352,77922.0,38703,116625.0,28727.0,19.76,0.05,Medium Risk
U301,2024,7,414060.0,Salary Increases & Fixed Expenses Increase,145352,77922.0,39284,117206.0,28146.0,19.36,-0.02,Medium Risk
U301,2024,8,442206.0,Salary Increases & Fixed Expenses Increase,145352,77922.0,29087,107009.0,38343.0,26.38,-0.0,Low Risk
U301,2024,9,480549.0,Salary Increases & Fixed Expenses Increase,145352,77922.0,45122,123044.0,22308.0,15.35,0.01,Medium Risk
U301,2024,10,502857.0,Salary Increases & Fixed Expenses Increase,145352,77922.0,38437,116359.0,28993.0,19.95,0.05,Medium Risk
U301,2024,11,531850.0,Salary Increases & Fixed Expenses Increase,145352,77922.0,43882,121804.0,23548.0,16.2,-0.03,Medium Risk
U301,2024,12,555398.0,Salary Increases & Fixed Expenses Increase,145352,77922.0,34025,111947.0,33405.0,22.98,-0.05,Medium Risk
U302,2024,1,250000.0,Salary Increases & Fixed Expenses Increase,285292,108650.0,126324,234974.0,50318.0,17.64,-0.04,Medium Risk
U302,2024,2,300318.0,Salary Increases & Fixed Expenses Increase,285292,108650.0,86004,194654.0,90638.0,31.77,-0.02,Low Risk
U302,2024,3,390956.0,Salary Increases & Fixed Expenses Increase,285292,108650.0,117047,225697.0,59595.0,20.89,0.05,Medium Risk
U302,2024,4,450551.0,Salary Increases & Fixed Expenses Increase,285292,110303.0,94834,205137.0,80155.0,28.1,-0.01,Low Risk
U302,2024,5,530706.0,Salary Increases & Fixed Expenses Increase,285292,110303.0,106167,216470.0,68822.0,24.12,-0.0,Medium Risk
U302,2024,6,599528.0,Salary Increases & Fixed Expenses Increase,313765,110303.0,108777,219080.0,94685.0,30.18,0.0,Low Risk
U302,2024,7,694213.0,Salary Increases & Fixed Expenses Increase,313765,110303.0,153272,263575.0,50190.0,16.0,-0.02,Medium Risk
U302,2024,8,744403.0,Salary Increases & Fixed Expenses Increase,313765,110303.0,155317,265620.0,48145.0,15.34,0.04,Medium Risk
U302,2024,9,792548.0,Salary Increases & Fixed Expenses Increase,313765,110303.0,131459,241762.0,72003.0,22.95,-0.05,Medium Risk
U302,2024,10,864551.0,Salary Increases & Fixed Expenses Increase,313765,111436.0,116990,228426.0,85339.0,27.2,0.02,Low Risk
U302,2024,11,949890.0,Salary Increases & Fixed Expenses Increase,313765,111436.0,148758,260194.0,53571.0,17.07,0.02,Medium Risk
U302,2024,12,1003461.0,Salary Increases & Fixed Expenses Increase,313765,112299.0,107910,220209.0,93556.0,29.82,0.0,Low Risk
U303,2024,1,192199.0,Salary Increases & Fixed Expenses Remain Stable,138760,77589.0,58530,136119.0,2641.0,1.9,-0.0,High Risk
U303,2024,2,194840.0,Salary Increases & Fixed Expenses Remain Stable,138760,77589.0,61244,138833.0,-73.0,-0.05,-0.02,High Risk
U303,2024,3,194767.0,Salary Increases & Fixed Expenses Remain Stable,138760,77589.0,63249,140838.0,-2078.0,-1.5,-0.04,High Risk
U303,2024,4,192689.0,Salary Increases & Fixed Expenses Remain Stable,138760,77589.0,50169,127758.0,11002.0,7.93,-0.01,High Risk
U303,2024,5,203691.0,Salary Increases & Fixed Expenses Remain Stable,138760,77589.0,52150,129739.0,9021.0,6.5,0.03,High Risk
U303,2024,6,212712.0,Salary Increases & Fixed Expenses Remain Stable,138760,77589.0,57983,135572.0,3188.0,2.3,0.01,High Risk
U303,2024,7,215900.0,Salary Increases & Fixed Expenses Remain Stable,138760,77589.0,67042,144631.0,-5871.0,-4.23,0.04,High Risk
U303,2024,8,210029.0,Salary Increases & Fixed Expenses Remain Stable,149661,77589.0,68457,146046.0,3615.0,2.42,0.0,High Risk
U303,2024,9,213644.0,Salary Increases & Fixed Expenses Remain Stable,149661,77589.0,69244,146833.0,2828.0,1.89,0.01,High Risk
U303,2024,10,216472.0,Salary Increases & Fixed Expenses Remain Stable,149661,77589.0,60149,137738.0,11923.0,7.97,0.01,High Risk
U303,2024,11,228395.0,Salary Increases & Fixed Expenses Remain Stable,149661,77589.0,84259,161848.0,-12187.0,-8.14,0.01,High Risk
U303,2024,12,216208.0,Salary Increases & Fixed Expenses Remain Stable,149661,77589.0,56415,134004.0,15657.0,10.46,-0.02,High Risk
U304,2024,1,213391.0,Stable Salary & Stable Fixed Expenses,166347,44597.0,45986,90583.0,75764.0,45.55,0.04,Low Risk
U304,2024,2,289155.0,Stable Salary & Stable Fixed Expenses,166347,44597.0,40410,85007.0,81340.0,48.9,0.05,Low Risk
U304,2024,3,370495.0,Stable Salary & Stable Fixed Expenses,166347,44597.0,45278,89875.0,76472.0,45.97,0.04,Low Risk
U304,2024,4,446967.0,Stable Salary & Stable Fixed Expenses,166347,44597.0,49807,94404.0,71943.0,43.25,-0.03,Low Risk
U304,2024,5,518910.0,Stable Salary & Stable Fixed Expenses,166347,44597.0,34141,78738.0,87609.0,52.67,0.05,Low Risk
U304,2024,6,606519.0,Stable Salary & Stable Fixed Expenses,166347,44597.0,37875,82472.0,83875.0,50.42,0.03,Low Risk
U304,2024,7,690394.0,Stable Salary & Stable Fixed Expenses,166347,44597.0,49778,94375.0,71972.0,43.27,-0.02,Low Risk
U304,2024,8,762366.0,Stable Salary & Stable Fixed Expenses,166347,44597.0,37787,82384.0,83963.0,50.47,-0.0,Low Risk
U304,2024,9,846329.0,Stable Salary & Stable Fixed Expenses,166347,44597.0,46828,91425.0,74922.0,45.04,-0.04,Low Risk
U304,2024,10,921251.0,Stable Salary & Stable Fixed Expenses,166347,44597.0,38010,82607.0,83740.0,50.34,0.04,Low Risk
U304,2024,11,1004991.0,Stable Salary & Stable Fixed Expenses,166347,44597.0,44969,89566.0,76781.0,46.16,0.04,Low Risk
U304,2024,12,1081772.0,Stable Salary & Stable Fixed Expenses,166347,44597.0,47094,91691.0,74656.0,44.88,-0.04,Low Risk
U305,2024,1,111017.0,Stable Salary & Stable Fixed Expenses,73828,38454.0,19768,58222.0,15606.0,21.14,0.04,Medium Risk
U305,2024,2,126623.0,Stable Salary & Stable Fixed Expenses,73828,38454.0,20193,58647.0,15181.0,20.56,-0.04,Medium Risk
U305,2024,3,141804.0,Stable Salary & Stable Fixed Expenses,73828,38454.0,18013,56467.0,17361.0,23.52,-0.05,Medium Risk
U305,2024,4,159165.0,Stable Salary & Stable Fixed Expenses,73828,38454.0,22120,60574.0,13254.0,17.95,-0.01,Medium Risk
U305,2024,5,172419.0,Stable Salary & Stable Fixed Expenses,73828,38454.0,17410,55864.0,17964.0,24.33,-0.02,Medium Risk
U305,2024,6,190383.0,Stable Salary & Stable Fixed Expenses,73828,38454.0,15413,53867.0,19961.0,27.04,-0.01,Low Risk
U305,2024,7,210344.0,Stable Salary & Stable Fixed Expenses,73828,38454.0,17162,55616.0,18212.0,24.67,0.03,Medium Risk
U305,2024,8,228556.0,Stable Salary & Stable Fixed Expenses,73828,38454.0,21316,59770.0,14058.0,19.04,0.04,Medium Risk
U305,2024,9,242614.0,Stable Salary & Stable Fixed Expenses,73828,38454.0,19496,57950.0,15878.0,21.51,-0.04,Medium Risk
U305,2024,10,258492.0,Stable Salary & Stable Fixed Expenses,73828,38454.0,20841,59295.0,14533.0,19.68,0.04,Medium Risk
U305,2024,11,273025.0,Stable Salary & Stable Fixed Expenses,73828,38454.0,18957,57411.0,16417.0,22.24,0.03,Medium Risk
U305,2024,12,289442.0,Stable Salary & Stable Fixed Expenses,73828,38454.0,22539,60993.0,12835.0,17.39,0.0,Medium Risk
U306,2024,1,203050.0,Salary Increases & Fixed Expenses Increase,118673,58487.0,48646,107133.0,11540.0,9.72,0.0,High Risk
U306,2024,2,214590.0,Salary Increases & Fixed Expenses Increase,118673,58487.0,41424,99911.0,18762.0,15.81,0.01,Medium Risk
U306,2024,3,233352.0,Salary Increases & Fixed Expenses Increase,118673,60354.0,36879,97233.0,21440.0,18.07,-0.04,Medium Risk
U306,2024,4,254792.0,Salary Increases & Fixed Expenses Increase,118673,60354.0,37806,98160.0,20513.0,17.29,-0.0,Medium Risk
U306,2024,5,275305.0,Salary Increases & Fixed Expenses Increase,118673,60354.0,52373,112727.0,5946.0,5.01,0.0,High Risk
U306,2024,6,281251.0,Salary Increases & Fixed Expenses Increase,142157,60354.0,55767,116121.0,26036.0,18.31,-0.0,Medium Risk
U306,2024,7,307287.0,Salary Increases & Fixed Expenses Increase,142157,60354.0,46278,106632.0,35525.0,24.99,-0.03,Medium Risk
U306,2024,8,342812.0,Salary Increases & Fixed Expenses Increase,142157,60354.0,52203,112557.0,29600.0,20.82,0.01,Medium Risk
U306,2024,9,372412.0,Salary Increases & Fixed Expenses Increase,142157,60354.0,45896,106250.0,35907.0,25.26,0.02,Low Risk
U306,2024,10,408319.0,Salary Increases & Fixed Expenses Increase,142157,60354.0,47656,108010.0,34147.0,24.02,0.04,Medium Risk
U306,2024,11,442466.0,Salary Increases & Fixed Expenses Increase,142157,60354.0,55398,115752.0,26405.0,18.57,-0.02,Medium Risk
U306,2024,12,468871.0,Salary Increases & Fixed Expenses Increase,142157,60354.0,70943,131297.0,10860.0,7.64,-0.02,High Risk
U307,2024,1,250000.0,Salary Increases & Fixed Expenses Remain Stable,293370,91893.0,77494,169387.0,123983.0,42.26,-0.03,Low Risk
U307,2024,2,373983.0,Salary Increases & Fixed Expenses Remain Stable,293370,91893.0,74753,166646.0,126724.0,43.2,0.03,Low Risk
U307,2024,3,500707.0,Salary Increases & Fixed Expenses Remain Stable,314766,91893.0,68464,160357.0,154409.0,49.06,-0.03,Low Risk
U307,2024,4,655116.0,Salary Increases & Fixed Expenses Remain Stable,314766,91893.0,91896,183789.0,130977.0,41.61,0.0,Low Risk
U307,2024,5,786093.0,Salary Increases & Fixed Expenses Remain Stable,314766,91893.0,88931,180824.0,133942.0,42.55,-0.02,Low Risk
U307,2024,6,920035.0,Salary Increases & Fixed Expenses Remain Stable,314766,91893.0,77703,169596.0,145170.0,46.12,-0.04,Low Risk
U307,2024,7,1065205.0,Salary Increases & Fixed Expenses Remain Stable,314766,91893.0,77748,169641.0,145125.0,46.11,0.05,Low Risk
U307,2024,8,1210330.0,Salary Increases & Fixed Expenses Remain Stable,314766,91893.0,89480,181373.0,133393.0,42.38,0.02,Low Risk
U307,2024,9,1343723.0,Salary Increases & Fixed Expenses Remain Stable,314766,91893.0,76088,167981.0,146785.0,46.63,-0.01,Low Risk
U307,2024,10,1490508.0,Salary Increases & Fixed Expenses Remain Stable,314766,91893.0,76410,168303.0,146463.0,46.53,-0.02,Low Risk
U307,2024,11,1636971.0,Salary Increases & Fixed Expenses Remain Stable,314766,91893.0,73322,165215.0,149551.0,47.51,0.03,Low Risk
U307,2024,12,1786522.0,Salary Increases & Fixed Expenses Remain Stable,314766,91893.0,86835,178728.0,136038.0,43.22,0.04,Low Risk
U308,2024,1,249978.0,Stable Salary & Increasing Fixed Expenses,247533,111983.0,63901,175884.0,71649.0,28.95,0.02,Low Risk
U308,2024,2,321627.0,Stable Salary & Increasing Fixed Expenses,247533,111983.0,51895,163878.0,83655.0,33.8,0.04,Low Risk
U308,2024,3,405282.0,Stable Salary & Increasing Fixed Expenses,247533,111983.0,50545,162528.0,85005.0,34.34,0.04,Low Risk
U308,2024,4,490287.0,Stable Salary & Increasing Fixed Expenses,247533,111983.0,73893,185876.0,61657.0,24.91,-0.01,Medium Risk
U308,2024,5,551944.0,Stable Salary & Increasing Fixed Expenses,247533,111983.0,61227,173210.0,74323.0,30.03,-0.02,Low Risk
U308,2024,6,626267.0,Stable Salary & Increasing Fixed Expenses,247533,111983.0,60253,172236.0,75297.0,30.42,0.03,Low Risk
U308,2024,7,701564.0,Stable Salary & Increasing Fixed Expenses,247533,111983.0,65557,177540.0,69993.0,28.28,-0.04,Low Risk
U308,2024,8,771557.0,Stable Salary & Increasing Fixed Expenses,247533,111983.0,60851,172834.0,74699.0,30.18,-0.01,Low Risk
U308,2024,9,846256.0,Stable Salary & Increasing Fixed Expenses,247533,112552.0,54988,167540.0,79993.0,32.32,-0.0,Low Risk
U308,2024,10,926249.0,Stable Salary & Increasing Fixed Expenses,247533,112552.0,57190,169742.0,77791.0,31.43,0.02,Low Risk
U308,2024,11,1004040.0,Stable Salary & Increasing Fixed Expenses,247533,112552.0,49571,162123.0,85410.0,34.5,0.03,Low Risk
U308,2024,12,1089450.0,Stable Salary & Increasing Fixed Expenses,247533,112552.0,54536,167088.0,80445.0,32.5,0.03,Low Risk
U309,2024,1,250000.0,Stable Salary & Increasing Fixed Expenses,297985,90652.0,187108,277760.0,20225.0,6.79,-0.05,High Risk
U309,2024,2,270225.0,Stable Salary & Increasing Fixed Expenses,297985,90652.0,182351,273003.0,24982.0,8.38,-0.02,High Risk
U309,2024,3,295207.0,Stable Salary & Increasing Fixed Expenses,297985,90652.0,199396,290048.0,7937.0,2.66,-0.01,High Risk
U309,2024,4,303144.0,Stable Salary & Increasing Fixed Expenses,297985,90652.0,186237,276889.0,21096.0,7.08,0.02,High Risk
U309,2024,5,324240.0,Stable Salary & Increasing Fixed Expenses,297985,90652.0,205457,296109.0,1876.0,0.63,0.0,High Risk
U309,2024,6,326116.0,Stable Salary & Increasing Fixed Expenses,297985,90652.0,200498,291150.0,6835.0,2.29,-0.02,High Risk
U309,2024,7,332951.0,Stable Salary & Increasing Fixed Expenses,297985,91680.0,191712,283392.0,14593.0,4.9,-0.04,High Risk
U309,2024,8,347544.0,Stable Salary & Increasing Fixed Expenses,297985,91680.0,191786,283466.0,14519.0,4.87,0.04,High Risk
U309,2024,9,362063.0,Stable Salary & Increasing Fixed Expenses,297985,93562.0,186999,280561.0,17424.0,5.85,-0.01,High Risk
U309,2024,10,379487.0,Stable Salary & Increasing Fixed Expenses,297985,93562.0,190668,284230.0,13755.0,4.62,-0.04,High Risk
U309,2024,11,393242.0,Stable Salary & Increasing Fixed Expenses,297985,93562.0,188960,282522.0,15463.0,5.19,-0.0,High Risk
U309,2024,12,408705.0,Stable Salary & Increasing Fixed Expenses,297985,93562.0,175368,268930.0,29055.0,9.75,-0.03,High Risk
U310,2024,1,237241.0,Salary Increases & Fixed Expenses Remain Stable,216788,100561.0,124954,225515.0,-8727.0,-4.03,-0.01,High Risk
U310,2024,2,228514.0,Salary Increases & Fixed Expenses Remain Stable,216788,100561.0,132493,233054.0,-16266.0,-7.5,-0.01,High Risk
U310,2024,3,212248.0,Salary Increases & Fixed Expenses Remain Stable,216788,100561.0,143498,244059.0,-27271.0,-12.58,0.04,High Risk
U310,2024,4,184977.0,Salary Increases & Fixed Expenses Remain Stable,216788,100561.0,121899,222460.0,-5672.0,-2.62,0.02,High Risk
U310,2024,5,179305.0,Salary Increases & Fixed Expenses Remain Stable,216788,100561.0,115381,215942.0,846.0,0.39,0.0,High Risk
U310,2024,6,180151.0,Salary Increases & Fixed Expenses Remain Stable,243827,100561.0,130070,230631.0,13196.0,5.41,-0.05,High Risk
U310,2024,7,193347.0,Salary Increases & Fixed Expenses Remain Stable,243827,100561.0,153503,254064.0,-10237.0,-4.2,0.01,High Risk
U310,2024,8,183110.0,Salary Increases & Fixed Expenses Remain Stable,243827,100561.0,122543,223104.0,20723.0,8.5,0.05,High Risk
U310,2024,9,203833.0,Salary Increases & Fixed Expenses Remain Stable,243827,100561.0,157281,257842.0,-14015.0,-5.75,-0.02,High Risk
U310,2024,10,189818.0,Salary Increases & Fixed Expenses Remain Stable,243827,100561.0,168551,269112.0,-25285.0,-10.37,-0.01,High Risk
U310,2024,11,164533.0,Salary Increases & Fixed Expenses Remain Stable,243827,100561.0,138098,238659.0,5168.0,2.12,-0.05,High Risk
U310,2024,12,169701.0,Salary Increases & Fixed Expenses Remain Stable,243827,100561.0,142064,242625.0,1202.0,0.49,-0.03,High Risk
U311,2024,1,250000.0,Stable Salary & Increasing Fixed Expenses,295444,76464.0,109209,185673.0,109771.0,37.15,0.02,Low Risk
U311,2024,2,359771.0,Stable Salary & Increasing Fixed Expenses,295444,76464.0,92108,168572.0,126872.0,42.94,-0.03,Low Risk
U311,2024,3,486643.0,Stable Salary & Increasing Fixed Expenses,295444,76464.0,89973,166437.0,129007.0,43.67,0.03,Low Risk
U311,2024,4,615650.0,Stable Salary & Increasing Fixed Expenses,295444,76464.0,143467,219931.0,75513.0,25.56,-0.04,Low Risk
U311,2024,5,691163.0,Stable Salary & Increasing Fixed Expenses,295444,76464.0,103270,179734.0,115710.0,39.16,-0.03,Low Risk
U311,2024,6,806873.0,Stable Salary & Increasing Fixed Expenses,295444,76464.0,138458,214922.0,80522.0,27.25,-0.0,Low Risk
U311,2024,7,887395.0,Stable Salary & Increasing Fixed Expenses,295444,76464.0,143676,220140.0,75304.0,25.49,-0.01,Low Risk
U311,2024,8,962699.0,Stable Salary & Increasing Fixed Expenses,295444,76464.0,118568,195032.0,100412.0,33.99,-0.0,Low Risk
U311,2024,9,1063111.0,Stable Salary & Increasing Fixed Expenses,295444,76464.0,127242,203706.0,91738.0,31.05,-0.01,Low Risk
U311,2024,10,1154849.0,Stable Salary & Increasing Fixed Expenses,295444,78394.0,134925,213319.0,82125.0,27.8,-0.0,Low Risk
U311,2024,11,1236974.0,Stable Salary & Increasing Fixed Expenses,295444,78394.0,120735,199129.0,96315.0,32.6,-0.04,Low Risk
U311,2024,12,1333289.0,Stable Salary & Increasing Fixed Expenses,295444,78394.0,108660,187054.0,108390.0,36.69,0.02,Low Risk
U312,2024,1,171712.0,Salary Increases & Fixed Expenses Increase,91956,34449.0,38099,72548.0,19408.0,21.11,-0.04,Medium Risk
U312,2024,2,191120.0,Salary Increases & Fixed Expenses Increase,91956,34984.0,31195,66179.0,25777.0,28.03,0.04,Low Risk
U312,2024,3,216897.0,Salary Increases & Fixed Expenses Increase,91956,36209.0,28899,65108.0,26848.0,29.2,0.01,Low Risk
U312,2024,4,243745.0,Salary Increases & Fixed Expenses Increase,91956,37307.0,29230,66537.0,25419.0,27.64,0.0,Low Risk
U312,2024,5,269164.0,Salary Increases & Fixed Expenses Increase,91956,37307.0,32794,70101.0,21855.0,23.77,-0.01,Medium Risk
U312,2024,6,291019.0,Salary Increases & Fixed Expenses Increase,91956,37307.0,42290,79597.0,12359.0,13.44,0.05,High Risk
U312,2024,7,303378.0,Salary Increases & Fixed Expenses Increase,91956,37307.0,33042,70349.0,21607.0,23.5,-0.04,Medium Risk
U312,2024,8,324985.0,Salary Increases & Fixed Expenses Increase,112121,37307.0,49850,87157.0,24964.0,22.27,-0.05,Medium Risk
U312,2024,9,349949.0,Salary Increases & Fixed Expenses Increase,112121,37307.0,38401,75708.0,36413.0,32.48,0.03,Low Risk
U312,2024,10,386362.0,Salary Increases & Fixed Expenses Increase,112121,37307.0,42730,80037.0,32084.0,28.62,-0.02,Low Risk
U312,2024,11,418446.0,Salary Increases & Fixed Expenses Increase,112121,37307.0,46259,83566.0,28555.0,25.47,0.04,Low Risk
U312,2024,12,447001.0,Salary Increases & Fixed Expenses Increase,112121,37307.0,50659,87966.0,24155.0,21.54,-0.0,Medium Risk
U313,2024,1,237791.0,Stable Salary & Stable Fixed Expenses,226459,95157.0,113038,208195.0,18264.0,8.07,0.03,High Risk
U313,2024,2,256055.0,Stable Salary & Stable Fixed Expenses,226459,95157.0,96875,192032.0,34427.0,15.2,0.03,Medium Risk
U313,2024,3,290482.0,Stable Salary & Stable Fixed Expenses,226459,95157.0,103495,198652.0,27807.0,12.28,-0.05,High Risk
U313,2024,4,318289.0,Stable Salary & Stable Fixed Expenses,226459,95157.0,73870,169027.0,57432.0,25.36,0.04,Low Risk
U313,2024,5,375721.0,Stable Salary & Stable Fixed Expenses,226459,95157.0,86787,181944.0,44515.0,19.66,0.05,Medium Risk
U313,2024,6,420236.0,Stable Salary & Stable Fixed Expenses,226459,95157.0,106779,201936.0,24523.0,10.83,0.02,High Risk
U313,2024,7,444759.0,Stable Salary & Stable Fixed Expenses,226459,95157.0,90908,186065.0,40394.0,17.84,-0.02,Medium Risk
U313,2024,8,485153.0,Stable Salary & Stable Fixed Expenses,226459,95157.0,82284,177441.0,49018.0,21.65,0.04,Medium Risk
U313,2024,9,534171.0,Stable Salary & Stable Fixed Expenses,226459,95157.0,77976,173133.0,53326.0,23.55,0.03,Medium Risk
U313,2024,10,587497.0,Stable Salary & Stable Fixed Expenses,226459,95157.0,84711,179868.0,46591.0,20.57,-0.01,Medium Risk
U313,2024,11,634088.0,Stable Salary & Stable Fixed Expenses,226459,95157.0,83221,178378.0,48081.0,21.23,-0.03,Medium Risk
U313,2024,12,682169.0,Stable Salary & Stable Fixed Expenses,226459,95157.0,111589,206746.0,19713.0,8.7,0.02,High Risk
U314,2024,1,198024.0,Salary Increases & Fixed Expenses Increase,197499,61531.0,87796,149327.0,48172.0,24.39,-0.04,Medium Risk
U314,2024,2,246196.0,Salary Increases & Fixed Expenses Increase,197499,61531.0,85797,147328.0,50171.0,25.4,-0.0,Low Risk
U314,2024,3,296367.0,Salary Increases & Fixed Expenses Increase,197499,61531.0,99889,161420.0,36079.0,18.27,0.04,Medium Risk
U314,2024,4,332446.0,Salary Increases & Fixed Expenses Increase,197499,62998.0,75065,138063.0,59436.0,30.09,0.05,Low Risk
U314,2024,5,391882.0,Salary Increases & Fixed Expenses Increase,197499,62998.0,78297,141295.0,56204.0,28.46,-0.04,Low Risk
U314,2024,6,448086.0,Salary Increases & Fixed Expenses Increase,219106,62998.0,82092,145090.0,74016.0,33.78,-0.03,Low Risk
U314,2024,7,522102.0,Salary Increases & Fixed Expenses Increase,219106,62998.0,87779,150777.0,68329.0,31.19,0.01,Low Risk
U314,2024,8,590431.0,Salary Increases & Fixed Expenses Increase,219106,62998.0,73844,136842.0,82264.0,37.55,-0.04,Low Risk
U314,2024,9,672695.0,Salary Increases & Fixed Expenses Increase,219106,62998.0,99914,162912.0,56194.0,25.65,-0.04,Low Risk
U314,2024,10,728889.0,Salary Increases & Fixed Expenses Increase,219106,62998.0,110549,173547.0,45559.0,20.79,0.03,Medium Risk
U314,2024,11,774448.0,Salary Increases & Fixed Expenses Increase,219106,62998.0,117483,180481.0,38625.0,17.63,-0.03,Medium Risk
U314,2024,12,813073.0,Salary Increases & Fixed Expenses Increase,219106,62998.0,99360,162358.0,56748.0,25.9,-0.02,Low Risk
U315,2024,1,250000.0,Salary Increases & Fixed Expenses Remain Stable,280213,69627.0,60844,130471.0,149742.0,53.44,0.03,Low Risk
U315,2024,2,399742.0,Salary Increases & Fixed Expenses Remain Stable,280213,69627.0,71058,140685.0,139528.0,49.79,-0.03,Low Risk
U315,2024,3,539270.0,Salary Increases & Fixed Expenses Remain Stable,293522,69627.0,84794,154421.0,139101.0,47.39,-0.04,Low Risk
U315,2024,4,678371.0,Salary Increases & Fixed Expenses Remain Stable,293522,69627.0,65800,135427.0,158095.0,53.86,0.03,Low Risk
U315,2024,5,836466.0,Salary Increases & Fixed Expenses Remain Stable,293522,69627.0,63613,133240.0,160282.0,54.61,-0.0,Low Risk
U315,2024,6,996748.0,Salary Increases & Fixed Expenses Remain Stable,293522,69627.0,58966,128593.0,164929.0,56.19,0.03,Low Risk
U315,2024,7,1161677.0,Salary Increases & Fixed Expenses Remain Stable,293522,69627.0,60938,130565.0,162957.0,55.52,-0.02,Low Risk
U315,2024,8,1324634.0,Salary Increases & Fixed Expenses Remain Stable,293522,69627.0,61529,131156.0,162366.0,55.32,0.05,Low Risk
U315,2024,9,1487000.0,Salary Increases & Fixed Expenses Remain Stable,293522,69627.0,73181,142808.0,150714.0,51.35,0.01,Low Risk
U315,2024,10,1637714.0,Salary Increases & Fixed Expenses Remain Stable,293522,69627.0,65519,135146.0,158376.0,53.96,-0.02,Low Risk
U315,2024,11,1796090.0,Salary Increases & Fixed Expenses Remain Stable,293522,69627.0,70208,139835.0,153687.0,52.36,-0.02,Low Risk
U315,2024,12,1949777.0,Salary Increases & Fixed Expenses Remain Stable,293522,69627.0,80681,150308.0,143214.0,48.79,-0.03,Low Risk
U316,2024,1,238115.0,Stable Salary & Increasing Fixed Expenses,189457,69972.0,91068,161040.0,28417.0,15.0,0.03,High Risk
U316,2024,2,266532.0,Stable Salary & Increasing Fixed Expenses,189457,69972.0,85147,155119.0,34338.0,18.12,0.02,Medium Risk
U316,2024,3,300870.0,Stable Salary & Increasing Fixed Expenses,189457,69972.0,71831,141803.0,47654.0,25.15,-0.01,Low Risk
U316,2024,4,348524.0,Stable Salary & Increasing Fixed Expenses,189457,69972.0,70670,140642.0,48815.0,25.77,-0.01,Low Risk
U316,2024,5,397339.0,Stable Salary & Increasing Fixed Expenses,189457,71886.0,79988,151874.0,37583.0,19.84,0.02,Medium Risk
U316,2024,6,434922.0,Stable Salary & Increasing Fixed Expenses,189457,71886.0,88385,160271.0,29186.0,15.41,-0.0,Medium Risk
U316,2024,7,464108.0,Stable Salary & Increasing Fixed Expenses,189457,71886.0,77647,149533.0,39924.0,21.07,0.02,Medium Risk
U316,2024,8,504032.0,Stable Salary & Increasing Fixed Expenses,189457,71886.0,92222,164108.0,25349.0,13.38,0.05,High Risk
U316,2024,9,529381.0,Stable Salary & Increasing Fixed Expenses,189457,71886.0,67170,139056.0,50401.0,26.6,0.04,Low Risk
U316,2024,10,579782.0,Stable Salary & Increasing Fixed Expenses,189457,71886.0,61864,133750.0,55707.0,29.4,-0.03,Low Risk
U316,2024,11,635489.0,Stable Salary & Increasing Fixed Expenses,189457,71886.0,66677,138563.0,50894.0,26.86,-0.03,Low Risk
U316,2024,12,686383.0,Stable Salary & Increasing Fixed Expenses,189457,71886.0,74100,145986.0,43471.0,22.95,-0.04,Medium Risk
U317,2024,1,201471.0,Salary Increases & Fixed Expenses Remain Stable,175831,61333.0,69108,130441.0,45390.0,25.81,0.03,Low Risk
U317,2024,2,246861.0,Salary Increases & Fixed Expenses Remain Stable,175831,61333.0,71937,133270.0,42561.0,24.21,0.05,Medium Risk
U317,2024,3,289422.0,Salary Increases & Fixed Expenses Remain Stable,175831,61333.0,64199,125532.0,50299.0,28.61,0.04,Low Risk
U317,2024,4,339721.0,Salary Increases & Fixed Expenses Remain Stable,175831,61333.0,78125,139458.0,36373.0,20.69,0.01,Medium Risk
U317,2024,5,376094.0,Salary Increases & Fixed Expenses Remain Stable,175831,61333.0,71991,133324.0,42507.0,24.17,0.05,Medium Risk
U317,2024,6,418601.0,Salary Increases & Fixed Expenses Remain Stable,175831,61333.0,55173,116506.0,59325.0,33.74,-0.01,Low Risk
U317,2024,7,477926.0,Salary Increases & Fixed Expenses Remain Stable,183965,61333.0,72664,133997.0,49968.0,27.16,-0.02,Low Risk
U317,2024,8,527894.0,Salary Increases & Fixed Expenses Remain Stable,183965,61333.0,89149,150482.0,33483.0,18.2,0.04,Medium Risk
U317,2024,9,561377.0,Salary Increases & Fixed Expenses Remain Stable,183965,61333.0,77543,138876.0,45089.0,24.51,0.03,Medium Risk
U317,2024,10,606466.0,Salary Increases & Fixed Expenses Remain Stable,183965,61333.0,76756,138089.0,45876.0,24.94,0.0,Medium Risk
U317,2024,11,652342.0,Salary Increases & Fixed Expenses Remain Stable,183965,61333.0,58205,119538.0,64427.0,35.02,0.0,Low Risk
U317,2024,12,716769.0,Salary Increases & Fixed Expenses Remain Stable,183965,61333.0,64998,126331.0,57634.0,31.33,0.04,Low Risk
U318,2024,1,250000.0,Salary Increases & Fixed Expenses Remain Stable,291390,75959.0,131000,206959.0,84431.0,28.98,-0.03,Low Risk
U318,2024,2,334431.0,Salary Increases & Fixed Expenses Remain Stable,291390,75959.0,111463,187422.0,103968.0,35.68,-0.02,Low Risk
U318,2024,3,438399.0,Salary Increases & Fixed Expenses Remain Stable,291390,75959.0,95335,171294.0,120096.0,41.21,-0.03,Low Risk
U318,2024,4,558495.0,Salary Increases & Fixed Expenses Remain Stable,291390,75959.0,135486,211445.0,79945.0,27.44,0.01,Low Risk
U318,2024,5,638440.0,Salary Increases & Fixed Expenses Remain Stable,291390,75959.0,100086,176045.0,115345.0,39.58,-0.03,Low Risk
U318,2024,6,753785.0,Salary Increases & Fixed Expenses Remain Stable,291390,75959.0,102085,178044.0,113346.0,38.9,-0.04,Low Risk
U318,2024,7,867131.0,Salary Increases & Fixed Expenses Remain Stable,291390,75959.0,98552,174511.0,116879.0,40.11,-0.0,Low Risk
U318,2024,8,984010.0,Salary Increases & Fixed Expenses Remain Stable,308691,75959.0,118413,194372.0,114319.0,37.03,0.05,Low Risk
U318,2024,9,1098329.0,Salary Increases & Fixed Expenses Remain Stable,308691,75959.0,119874,195833.0,112858.0,36.56,-0.04,Low Risk
U318,2024,10,1211187.0,Salary Increases & Fixed Expenses Remain Stable,308691,75959.0,112064,188023.0,120668.0,39.09,0.02,Low Risk
U318,2024,11,1331855.0,Salary Increases & Fixed Expenses Remain Stable,308691,75959.0,113148,189107.0,119584.0,38.74,0.02,Low Risk
U318,2024,12,1451439.0,Salary Increases & Fixed Expenses Remain Stable,308691,75959.0,138712,214671.0,94020.0,30.46,-0.05,Low Risk
U319,2024,1,250000.0,Stable Salary & Stable Fixed Expenses,254906,65839.0,82532,148371.0,106535.0,41.79,-0.03,Low Risk
U319,2024,2,356535.0,Stable Salary & Stable Fixed Expenses,254906,65839.0,105002,170841.0,84065.0,32.98,0.05,Low Risk
U319,2024,3,440600.0,Stable Salary & Stable Fixed Expenses,254906,65839.0,128743,194582.0,60324.0,23.67,0.0,Medium Risk
U319,2024,4,500924.0,Stable Salary & Stable Fixed Expenses,254906,65839.0,117663,183502.0,71404.0,28.01,0.01,Low Risk
U319,2024,5,572328.0,Stable Salary & Stable Fixed Expenses,254906,65839.0,92105,157944.0,96962.0,38.04,0.02,Low Risk
U319,2024,6,669290.0,Stable Salary & Stable Fixed Expenses,254906,65839.0,107697,173536.0,81370.0,31.92,0.01,Low Risk
U319,2024,7,750660.0,Stable Salary & Stable Fixed Expenses,254906,65839.0,81677,147516.0,107390.0,42.13,-0.04,Low Risk
U319,2024,8,858050.0,Stable Salary & Stable Fixed Expenses,254906,65839.0,101684,167523.0,87383.0,34.28,0.03,Low Risk
U319,2024,9,945433.0,Stable Salary & Stable Fixed Expenses,254906,65839.0,139825,205664.0,49242.0,19.32,0.01,Medium Risk
U319,2024,10,994675.0,Stable Salary & Stable Fixed Expenses,254906,65839.0,100369,166208.0,88698.0,34.8,-0.02,Low Risk
U319,2024,11,1083373.0,Stable Salary & Stable Fixed Expenses,254906,65839.0,120054,185893.0,69013.0,27.07,0.03,Low Risk
U319,2024,12,1152386.0,Stable Salary & Stable Fixed Expenses,254906,65839.0,122067,187906.0,67000.0,26.28,0.01,Low Risk
U320,2024,1,92517.0,Salary Increases & Fixed Expenses Remain Stable,59425,25067.0,36147,61214.0,-1789.0,-3.01,0.02,High Risk
U320,2024,2,90728.0,Salary Increases & Fixed Expenses Remain Stable,59425,25067.0,37942,63009.0,-3584.0,-6.03,-0.02,High Risk
U320,2024,3,87144.0,Salary Increases & Fixed Expenses Remain Stable,59425,25067.0,38042,63109.0,-3684.0,-6.2,0.04,High Risk
U320,2024,4,83460.0,Salary Increases & Fixed Expenses Remain Stable,59425,25067.0,36856,61923.0,-2498.0,-4.2,-0.04,High Risk
U320,2024,5,80962.0,Salary Increases & Fixed Expenses Remain Stable,59425,25067.0,36079,61146.0,-1721.0,-2.9,0.02,High Risk
U320,2024,6,79241.0,Salary Increases & Fixed Expenses Remain Stable,59425,25067.0,37798,62865.0,-3440.0,-5.79,-0.04,High Risk
U320,2024,7,75801.0,Salary Increases & Fixed Expenses Remain Stable,59425,25067.0,32672,57739.0,1686.0,2.84,0.01,High Risk
U320,2024,8,77487.0,Salary Increases & Fixed Expenses Remain Stable,84738,25067.0,50367,75434.0,9304.0,10.98,-0.01,High Risk
U320,2024,9,86791.0,Salary Increases & Fixed Expenses Remain Stable,84738,25067.0,53058,78125.0,6613.0,7.8,-0.04,High Risk
U320,2024,10,93404.0,Salary Increases & Fixed Expenses Remain Stable,84738,25067.0,53034,78101.0,6637.0,7.83,-0.02,High Risk
U320,2024,11,100041.0,Salary Increases & Fixed Expenses Remain Stable,84738,25067.0,51732,76799.0,7939.0,9.37,-0.04,High Risk
U320,2024,12,107980.0,Salary Increases & Fixed Expenses Remain Stable,84738,25067.0,43497,68564.0,16174.0,19.09,0.01,Medium Risk
U321,2024,1,216128.0,Salary Increases & Fixed Expenses Remain Stable,33299,16053.0,11108,27161.0,6138.0,18.43,0.01,Medium Risk
U321,2024,2,222266.0,Salary Increases & Fixed Expenses Remain Stable,33299,16053.0,13621,29674.0,3625.0,10.89,0.0,High Risk
U321,2024,3,225891.0,Salary Increases & Fixed Expenses Remain Stable,33299,16053.0,14013,30066.0,3233.0,9.71,0.01,High Risk
U321,2024,4,229124.0,Salary Increases & Fixed Expenses Remain Stable,33299,16053.0,11306,27359.0,5940.0,17.84,-0.01,Medium Risk
U321,2024,5,235064.0,Salary Increases & Fixed Expenses Remain Stable,33299,16053.0,11382,27435.0,5864.0,17.61,-0.05,Medium Risk
U321,2024,6,240928.0,Salary Increases & Fixed Expenses Remain Stable,33299,16053.0,13780,29833.0,3466.0,10.41,-0.04,High Risk
U321,2024,7,244394.0,Salary Increases & Fixed Expenses Remain Stable,33299,16053.0,14564,30617.0,2682.0,8.05,-0.01,High Risk
U321,2024,8,247076.0,Salary Increases & Fixed Expenses Remain Stable,45105,16053.0,18918,34971.0,10134.0,22.47,-0.0,Medium Risk
U321,2024,9,257210.0,Salary Increases & Fixed Expenses Remain Stable,45105,16053.0,18053,34106.0,10999.0,24.39,-0.02,Medium Risk
U321,2024,10,268209.0,Salary Increases & Fixed Expenses Remain Stable,45105,16053.0,22453,38506.0,6599.0,14.63,0.05,High Risk
U321,2024,11,274808.0,Salary Increases & Fixed Expenses Remain Stable,45105,16053.0,18949,35002.0,10103.0,22.4,-0.02,Medium Risk
U321,2024,12,284911.0,Salary Increases & Fixed Expenses Remain Stable,45105,16053.0,19776,35829.0,9276.0,20.57,0.0,Medium Risk
U322,2024,1,224344.0,Stable Salary & Increasing Fixed Expenses,67159,27648.0,15813,43461.0,23698.0,35.29,-0.04,Low Risk
U322,2024,2,248042.0,Stable Salary & Increasing Fixed Expenses,67159,27648.0,17004,44652.0,22507.0,33.51,-0.02,Low Risk
U322,2024,3,270549.0,Stable Salary & Increasing Fixed Expenses,67159,28849.0,18831,47680.0,19479.0,29.0,-0.05,Low Risk
U322,2024,4,290028.0,Stable Salary & Increasing Fixed Expenses,67159,30678.0,16411,47089.0,20070.0,29.88,-0.04,Low Risk
U322,2024,5,310098.0,Stable Salary & Increasing Fixed Expenses,67159,30678.0,15218,45896.0,21263.0,31.66,0.02,Low Risk
U322,2024,6,331361.0,Stable Salary & Increasing Fixed Expenses,67159,30678.0,15694,46372.0,20787.0,30.95,-0.0,Low Risk
U322,2024,7,352148.0,Stable Salary & Increasing Fixed Expenses,67159,30678.0,15506,46184.0,20975.0,31.23,0.03,Low Risk
U322,2024,8,373123.0,Stable Salary & Increasing Fixed Expenses,67159,30678.0,13614,44292.0,22867.0,34.05,-0.02,Low Risk
U322,2024,9,395990.0,Stable Salary & Increasing Fixed Expenses,67159,30678.0,17893,48571.0,18588.0,27.68,0.03,Low Risk
U322,2024,10,414578.0,Stable Salary & Increasing Fixed Expenses,67159,30678.0,14840,45518.0,21641.0,32.22,0.04,Low Risk
U322,2024,11,436219.0,Stable Salary & Increasing Fixed Expenses,67159,30678.0,17936,48614.0,18545.0,27.61,-0.01,Low Risk
U322,2024,12,454764.0,Stable Salary & Increasing Fixed Expenses,67159,30678.0,18676,49354.0,17805.0,26.51,0.02,Low Risk
U323,2024,1,250000.0,Stable Salary & Stable Fixed Expenses,279616,95356.0,92680,188036.0,91580.0,32.75,0.05,Low Risk
U323,2024,2,341580.0,Stable Salary & Stable Fixed Expenses,279616,95356.0,103661,199017.0,80599.0,28.82,0.02,Low Risk
U323,2024,3,422179.0,Stable Salary & Stable Fixed Expenses,279616,95356.0,162640,257996.0,21620.0,7.73,0.02,High Risk
U323,2024,4,443799.0,Stable Salary & Stable Fixed Expenses,279616,95356.0,103753,199109.0,80507.0,28.79,0.01,Low Risk
U323,2024,5,524306.0,Stable Salary & Stable Fixed Expenses,279616,95356.0,130480,225836.0,53780.0,19.23,0.03,Medium Risk
U323,2024,6,578086.0,Stable Salary & Stable Fixed Expenses,279616,95356.0,115676,211032.0,68584.0,24.53,0.04,Medium Risk
U323,2024,7,646670.0,Stable Salary & Stable Fixed Expenses,279616,95356.0,126389,221745.0,57871.0,20.7,-0.03,Medium Risk
U323,2024,8,704541.0,Stable Salary & Stable Fixed Expenses,279616,95356.0,121234,216590.0,63026.0,22.54,0.04,Medium Risk
U323,2024,9,767567.0,Stable Salary & Stable Fixed Expenses,279616,95356.0,157685,253041.0,26575.0,9.5,-0.02,High Risk
U323,2024,10,794142.0,Stable Salary & Stable Fixed Expenses,279616,95356.0,151831,247187.0,32429.0,11.6,0.01,High Risk
U323,2024,11,826571.0,Stable Salary & Stable Fixed Expenses,279616,95356.0,155581,250937.0,28679.0,10.26,-0.05,High Risk
U323,2024,12,855250.0,Stable Salary & Stable Fixed Expenses,279616,95356.0,123355,218711.0,60905.0,21.78,-0.02,Medium Risk
U324,2024,1,232901.0,Stable Salary & Stable Fixed Expenses,102701,45270.0,43646,88916.0,13785.0,13.42,-0.01,High Risk
U324,2024,2,246686.0,Stable Salary & Stable Fixed Expenses,102701,45270.0,48142,93412.0,9289.0,9.04,0.03,High Risk
U324,2024,3,255975.0,Stable Salary & Stable Fixed Expenses,102701,45270.0,50783,96053.0,6648.0,6.47,-0.04,High Risk
U324,2024,4,262623.0,Stable Salary & Stable Fixed Expenses,102701,45270.0,31926,77196.0,25505.0,24.83,-0.02,Medium Risk
U324,2024,5,288128.0,Stable Salary & Stable Fixed Expenses,102701,45270.0,31117,76387.0,26314.0,25.62,-0.02,Low Risk
U324,2024,6,314442.0,Stable Salary & Stable Fixed Expenses,102701,45270.0,31906,77176.0,25525.0,24.85,0.0,Medium Risk
U324,2024,7,339967.0,Stable Salary & Stable Fixed Expenses,102701,45270.0,43397,88667.0,14034.0,13.66,-0.01,High Risk
U324,2024,8,354001.0,Stable Salary & Stable Fixed Expenses,102701,45270.0,32203,77473.0,25228.0,24.56,-0.04,Medium Risk
U324,2024,9,379229.0,Stable Salary & Stable Fixed Expenses,102701,45270.0,54104,99374.0,3327.0,3.24,-0.03,High Risk
U324,2024,10,382556.0,Stable Salary & Stable Fixed Expenses,102701,45270.0,52106,97376.0,5325.0,5.18,0.05,High Risk
U324,2024,11,387881.0,Stable Salary & Stable Fixed Expenses,102701,45270.0,50348,95618.0,7083.0,6.9,-0.04,High Risk
U324,2024,12,394964.0,Stable Salary & Stable Fixed Expenses,102701,45270.0,57730,103000.0,-299.0,-0.29,-0.05,High Risk
U325,2024,1,50948.0,Salary Increases & Fixed Expenses Increase,40153,21765.0,11916,33681.0,6472.0,16.12,-0.05,Medium Risk
U325,2024,2,57420.0,Salary Increases & Fixed Expenses Increase,40153,21765.0,8901,30666.0,9487.0,23.63,-0.03,Medium Risk
U325,2024,3,66907.0,Salary Increases & Fixed Expenses Increase,40153,21765.0,8565,30330.0,9823.0,24.46,-0.01,Medium Risk
U325,2024,4,76730.0,Salary Increases & Fixed Expenses Increase,40153,21765.0,9640,31405.0,8748.0,21.79,0.03,Medium Risk
U325,2024,5,85478.0,Salary Increases & Fixed Expenses Increase,40153,22722.0,10303,33025.0,7128.0,17.75,0.02,Medium Risk
U325,2024,6,92606.0,Salary Increases & Fixed Expenses Increase,67246,22722.0,18368,41090.0,26156.0,38.9,0.02,Low Risk
U325,2024,7,118762.0,Salary Increases & Fixed Expenses Increase,67246,22722.0,17524,40246.0,27000.0,40.15,0.03,Low Risk
U325,2024,8,145762.0,Salary Increases & Fixed Expenses Increase,67246,23604.0,16600,40204.0,27042.0,40.21,0.01,Low Risk
U325,2024,9,172804.0,Salary Increases & Fixed Expenses Increase,67246,23604.0,16539,40143.0,27103.0,40.3,-0.0,Low Risk
U325,2024,10,199907.0,Salary Increases & Fixed Expenses Increase,67246,23604.0,14197,37801.0,29445.0,43.79,-0.0,Low Risk
U325,2024,11,229352.0,Salary Increases & Fixed Expenses Increase,67246,23604.0,18703,42307.0,24939.0,37.09,0.02,Low Risk
U325,2024,12,254291.0,Salary Increases & Fixed Expenses Increase,67246,23604.0,13911,37515.0,29731.0,44.21,0.0,Low Risk
U326,2024,1,159335.0,Stable Salary & Increasing Fixed Expenses,148799,76405.0,67443,143848.0,4951.0,3.33,-0.0,High Risk
U326,2024,2,164286.0,Stable Salary & Increasing Fixed Expenses,148799,76405.0,55341,131746.0,17053.0,11.46,0.02,High Risk
U326,2024,3,181339.0,Stable Salary & Increasing Fixed Expenses,148799,76405.0,63551,139956.0,8843.0,5.94,0.02,High Risk
U326,2024,4,190182.0,Stable Salary & Increasing Fixed Expenses,148799,76405.0,63838,140243.0,8556.0,5.75,0.03,High Risk
U326,2024,5,198738.0,Stable Salary & Increasing Fixed Expenses,148799,76405.0,54738,131143.0,17656.0,11.87,-0.04,High Risk
U326,2024,6,216394.0,Stable Salary & Increasing Fixed Expenses,148799,76405.0,59472,135877.0,12922.0,8.68,0.03,High Risk
U326,2024,7,229316.0,Stable Salary & Increasing Fixed Expenses,148799,76405.0,51310,127715.0,21084.0,14.17,-0.02,High Risk
U326,2024,8,250400.0,Stable Salary & Increasing Fixed Expenses,148799,76405.0,51939,128344.0,20455.0,13.75,0.03,High Risk
U326,2024,9,270855.0,Stable Salary & Increasing Fixed Expenses,148799,77415.0,75709,153124.0,-4325.0,-2.91,0.01,High Risk
U326,2024,10,266530.0,Stable Salary & Increasing Fixed Expenses,148799,78097.0,63244,141341.0,7458.0,5.01,-0.0,High Risk
U326,2024,11,273988.0,Stable Salary & Increasing Fixed Expenses,148799,78097.0,63576,141673.0,7126.0,4.79,0.03,High Risk
U326,2024,12,281114.0,Stable Salary & Increasing Fixed Expenses,148799,78097.0,50181,128278.0,20521.0,13.79,0.0,High Risk
U327,2024,1,57410.0,Stable Salary & Stable Fixed Expenses,26464,14896.0,6093,20989.0,5475.0,20.69,0.04,Medium Risk
U327,2024,2,62885.0,Stable Salary & Stable Fixed Expenses,26464,14896.0,5555,20451.0,6013.0,22.72,-0.01,Medium Risk
U327,2024,3,68898.0,Stable Salary & Stable Fixed Expenses,26464,14896.0,9583,24479.0,1985.0,7.5,-0.01,High Risk
U327,2024,4,70883.0,Stable Salary & Stable Fixed Expenses,26464,14896.0,6057,20953.0,5511.0,20.82,0.03,Medium Risk
U327,2024,5,76394.0,Stable Salary & Stable Fixed Expenses,26464,14896.0,6761,21657.0,4807.0,18.16,0.03,Medium Risk
U327,2024,6,81201.0,Stable Salary & Stable Fixed Expenses,26464,14896.0,6050,20946.0,5518.0,20.85,0.04,Medium Risk
U327,2024,7,86719.0,Stable Salary & Stable Fixed Expenses,26464,14896.0,5757,20653.0,5811.0,21.96,0.01,Medium Risk
U327,2024,8,92530.0,Stable Salary & Stable Fixed Expenses,26464,14896.0,5454,20350.0,6114.0,23.1,0.04,Medium Risk
U327,2024,9,98644.0,Stable Salary & Stable Fixed Expenses,26464,14896.0,7333,22229.0,4235.0,16.0,-0.04,Medium Risk
U327,2024,10,102879.0,Stable Salary & Stable Fixed Expenses,26464,14896.0,8686,23582.0,2882.0,10.89,0.05,High Risk
U327,2024,11,105761.0,Stable Salary & Stable Fixed Expenses,26464,14896.0,7494,22390.0,4074.0,15.39,0.05,Medium Risk
U327,2024,12,109835.0,Stable Salary & Stable Fixed Expenses,26464,14896.0,9595,24491.0,1973.0,7.46,-0.03,High Risk
U328,2024,1,236149.0,Stable Salary & Stable Fixed Expenses,231547,60917.0,97220,158137.0,73410.0,31.7,-0.03,Low Risk
U328,2024,2,309559.0,Stable Salary & Stable Fixed Expenses,231547,60917.0,109130,170047.0,61500.0,26.56,-0.04,Low Risk
U328,2024,3,371059.0,Stable Salary & Stable Fixed Expenses,231547,60917.0,71133,132050.0,99497.0,42.97,-0.05,Low Risk
U328,2024,4,470556.0,Stable Salary & Stable Fixed Expenses,231547,60917.0,98871,159788.0,71759.0,30.99,0.04,Low Risk
U328,2024,5,542315.0,Stable Salary & Stable Fixed Expenses,231547,60917.0,111380,172297.0,59250.0,25.59,-0.0,Low Risk
U328,2024,6,601565.0,Stable Salary & Stable Fixed Expenses,231547,60917.0,115046,175963.0,55584.0,24.01,0.03,Medium Risk
U328,2024,7,657149.0,Stable Salary & Stable Fixed Expenses,231547,60917.0,109984,170901.0,60646.0,26.19,-0.02,Low Risk
U328,2024,8,717795.0,Stable Salary & Stable Fixed Expenses,231547,60917.0,73241,134158.0,97389.0,42.06,0.05,Low Risk
U328,2024,9,815184.0,Stable Salary & Stable Fixed Expenses,231547,60917.0,97861,158778.0,72769.0,31.43,0.01,Low Risk
U328,2024,10,887953.0,Stable Salary & Stable Fixed Expenses,231547,60917.0,69990,130907.0,100640.0,43.46,-0.05,Low Risk
U328,2024,11,988593.0,Stable Salary & Stable Fixed Expenses,231547,60917.0,100261,161178.0,70369.0,30.39,0.02,Low Risk
U328,2024,12,1058962.0,Stable Salary & Stable Fixed Expenses,231547,60917.0,107013,167930.0,63617.0,27.47,0.02,Low Risk
U329,2024,1,250000.0,Stable Salary & Increasing Fixed Expenses,274265,103528.0,178779,282307.0,-8042.0,-2.93,-0.03,High Risk
U329,2024,2,241958.0,Stable Salary & Increasing Fixed Expenses,274265,104139.0,137567,241706.0,32559.0,11.87,-0.02,High Risk
U329,2024,3,274517.0,Stable Salary & Increasing Fixed Expenses,274265,105880.0,205594,311474.0,-37209.0,-13.57,0.04,High Risk
U329,2024,4,237308.0,Stable Salary & Increasing Fixed Expenses,274265,105880.0,176544,282424.0,-8159.0,-2.97,-0.0,High Risk
U329,2024,5,229149.0,Stable Salary & Increasing Fixed Expenses,274265,105880.0,184493,290373.0,-16108.0,-5.87,0.0,High Risk
U329,2024,6,213041.0,Stable Salary & Increasing Fixed Expenses,274265,105880.0,163175,269055.0,5210.0,1.9,-0.0,High Risk
U329,2024,7,218251.0,Stable Salary & Increasing Fixed Expenses,274265,107630.0,145575,253205.0,21060.0,7.68,0.02,High Risk
U329,2024,8,239311.0,Stable Salary & Increasing Fixed Expenses,274265,107630.0,190738,298368.0,-24103.0,-8.79,0.03,High Risk
U329,2024,9,215208.0,Stable Salary & Increasing Fixed Expenses,274265,107630.0,187646,295276.0,-21011.0,-7.66,-0.01,High Risk
U329,2024,10,194197.0,Stable Salary & Increasing Fixed Expenses,274265,107630.0,232784,340414.0,-66149.0,-24.12,-0.04,High Risk
U329,2024,11,128048.0,Stable Salary & Increasing Fixed Expenses,274265,107630.0,171202,278832.0,-4567.0,-1.67,0.02,High Risk
U329,2024,12,123481.0,Stable Salary & Increasing Fixed Expenses,274265,107630.0,157389,265019.0,9246.0,3.37,-0.04,High Risk
U330,2024,1,239352.0,Stable Salary & Increasing Fixed Expenses,153407,46286.0,53262,99548.0,53859.0,35.11,0.05,Low Risk
U330,2024,2,293211.0,Stable Salary & Increasing Fixed Expenses,153407,47014.0,70422,117436.0,35971.0,23.45,0.04,Medium Risk
U330,2024,3,329182.0,Stable Salary & Increasing Fixed Expenses,153407,48840.0,51991,100831.0,52576.0,34.27,-0.02,Low Risk
U330,2024,4,381758.0,Stable Salary & Increasing Fixed Expenses,153407,48840.0,66491,115331.0,38076.0,24.82,0.01,Medium Risk
U330,2024,5,419834.0,Stable Salary & Increasing Fixed Expenses,153407,48840.0,56152,104992.0,48415.0,31.56,0.04,Low Risk
U330,2024,6,468249.0,Stable Salary & Increasing Fixed Expenses,153407,48840.0,67005,115845.0,37562.0,24.49,-0.05,Medium Risk
U330,2024,7,505811.0,Stable Salary & Increasing Fixed Expenses,153407,48840.0,74648,123488.0,29919.0,19.5,-0.03,Medium Risk
U330,2024,8,535730.0,Stable Salary & Increasing Fixed Expenses,153407,48840.0,55507,104347.0,49060.0,31.98,0.01,Low Risk
U330,2024,9,584790.0,Stable Salary & Increasing Fixed Expenses,153407,48840.0,66346,115186.0,38221.0,24.91,0.01,Medium Risk
U330,2024,10,623011.0,Stable Salary & Increasing Fixed Expenses,153407,48840.0,63867,112707.0,40700.0,26.53,-0.04,Low Risk
U330,2024,11,663711.0,Stable Salary & Increasing Fixed Expenses,153407,48840.0,51161,100001.0,53406.0,34.81,-0.02,Low Risk
U330,2024,12,717117.0,Stable Salary & Increasing Fixed Expenses,153407,50148.0,60367,110515.0,42892.0,27.96,-0.03,Low Risk
U331,2024,1,139095.0,Salary Increases & Fixed Expenses Remain Stable,137489,67465.0,42201,109666.0,27823.0,20.24,0.03,Medium Risk
U331,2024,2,166918.0,Salary Increases & Fixed Expenses Remain Stable,137489,67465.0,66024,133489.0,4000.0,2.91,-0.04,High Risk
U331,2024,3,170918.0,Salary Increases & Fixed Expenses Remain Stable,137489,67465.0,56870,124335.0,13154.0,9.57,0.01,High Risk
U331,2024,4,184072.0,Salary Increases & Fixed Expenses Remain Stable,137489,67465.0,45965,113430.0,24059.0,17.5,-0.05,Medium Risk
U331,2024,5,208131.0,Salary Increases & Fixed Expenses Remain Stable,137489,67465.0,58509,125974.0,11515.0,8.38,0.03,High Risk
U331,2024,6,219646.0,Salary Increases & Fixed Expenses Remain Stable,137489,67465.0,49752,117217.0,20272.0,14.74,0.01,High Risk
U331,2024,7,239918.0,Salary Increases & Fixed Expenses Remain Stable,145584,67465.0,46778,114243.0,31341.0,21.53,0.01,Medium Risk
U331,2024,8,271259.0,Salary Increases & Fixed Expenses Remain Stable,145584,67465.0,71961,139426.0,6158.0,4.23,-0.04,High Risk
U331,2024,9,277417.0,Salary Increases & Fixed Expenses Remain Stable,145584,67465.0,78888,146353.0,-769.0,-0.53,0.04,High Risk
U331,2024,10,276648.0,Salary Increases & Fixed Expenses Remain Stable,145584,67465.0,69607,137072.0,8512.0,5.85,-0.01,High Risk
U331,2024,11,285160.0,Salary Increases & Fixed Expenses Remain Stable,145584,67465.0,57022,124487.0,21097.0,14.49,-0.0,High Risk
U331,2024,12,306257.0,Salary Increases & Fixed Expenses Remain Stable,145584,67465.0,48469,115934.0,29650.0,20.37,-0.0,Medium Risk
U332,2024,1,58903.0,Stable Salary & Stable Fixed Expenses,31117,10402.0,7940,18342.0,12775.0,41.05,-0.05,Low Risk
U332,2024,2,71678.0,Stable Salary & Stable Fixed Expenses,31117,10402.0,7158,17560.0,13557.0,43.57,0.03,Low Risk
U332,2024,3,85235.0,Stable Salary & Stable Fixed Expenses,31117,10402.0,8889,19291.0,11826.0,38.0,0.0,Low Risk
U332,2024,4,97061.0,Stable Salary & Stable Fixed Expenses,31117,10402.0,6361,16763.0,14354.0,46.13,0.05,Low Risk
U332,2024,5,111415.0,Stable Salary & Stable Fixed Expenses,31117,10402.0,6839,17241.0,13876.0,44.59,0.01,Low Risk
U332,2024,6,125291.0,Stable Salary & Stable Fixed Expenses,31117,10402.0,8064,18466.0,12651.0,40.66,0.03,Low Risk
U332,2024,7,137942.0,Stable Salary & Stable Fixed Expenses,31117,10402.0,7630,18032.0,13085.0,42.05,0.02,Low Risk
U332,2024,8,151027.0,Stable Salary & Stable Fixed Expenses,31117,10402.0,6273,16675.0,14442.0,46.41,-0.02,Low Risk
U332,2024,9,165469.0,Stable Salary & Stable Fixed Expenses,31117,10402.0,8707,19109.0,12008.0,38.59,0.05,Low Risk
U332,2024,10,177477.0,Stable Salary & Stable Fixed Expenses,31117,10402.0,8126,18528.0,12589.0,40.46,0.01,Low Risk
U332,2024,11,190066.0,Stable Salary & Stable Fixed Expenses,31117,10402.0,7050,17452.0,13665.0,43.91,0.04,Low Risk
U332,2024,12,203731.0,Stable Salary & Stable Fixed Expenses,31117,10402.0,7084,17486.0,13631.0,43.81,-0.03,Low Risk
U333,2024,1,239677.0,Salary Increases & Fixed Expenses Increase,231448,87988.0,62308,150296.0,81152.0,35.06,-0.03,Low Risk
U333,2024,2,320829.0,Salary Increases & Fixed Expenses Increase,231448,87988.0,63205,151193.0,80255.0,34.68,-0.02,Low Risk
U333,2024,3,401084.0,Salary Increases & Fixed Expenses Increase,231448,87988.0,73130,161118.0,70330.0,30.39,0.02,Low Risk
U333,2024,4,471414.0,Salary Increases & Fixed Expenses Increase,231448,87988.0,46334,134322.0,97126.0,41.96,-0.01,Low Risk
U333,2024,5,568540.0,Salary Increases & Fixed Expenses Increase,231448,89197.0,58702,147899.0,83549.0,36.1,0.01,Low Risk
U333,2024,6,652089.0,Salary Increases & Fixed Expenses Increase,242606,89197.0,51852,141049.0,101557.0,41.86,0.03,Low Risk
U333,2024,7,753646.0,Salary Increases & Fixed Expenses Increase,242606,89197.0,66032,155229.0,87377.0,36.02,0.04,Low Risk
U333,2024,8,841023.0,Salary Increases & Fixed Expenses Increase,242606,90717.0,53933,144650.0,97956.0,40.38,-0.03,Low Risk
U333,2024,9,938979.0,Salary Increases & Fixed Expenses Increase,242606,90717.0,62466,153183.0,89423.0,36.86,-0.05,Low Risk
U333,2024,10,1028402.0,Salary Increases & Fixed Expenses Increase,242606,92610.0,75751,168361.0,74245.0,30.6,-0.01,Low Risk
U333,2024,11,1102647.0,Salary Increases & Fixed Expenses Increase,242606,92610.0,71869,164479.0,78127.0,32.2,0.0,Low Risk
U333,2024,12,1180774.0,Salary Increases & Fixed Expenses Increase,242606,92610.0,61252,153862.0,88744.0,36.58,0.05,Low Risk
U334,2024,1,73947.0,Salary Increases & Fixed Expenses Increase,21431,11052.0,10266,21318.0,113.0,0.53,0.04,High Risk
U334,2024,2,74060.0,Salary Increases & Fixed Expenses Increase,21431,11052.0,8846,19898.0,1533.0,7.15,0.02,High Risk
U334,2024,3,75593.0,Salary Increases & Fixed Expenses Increase,21431,11052.0,9837,20889.0,542.0,2.53,0.0,High Risk
U334,2024,4,76135.0,Salary Increases & Fixed Expenses Increase,21431,11052.0,7291,18343.0,3088.0,14.41,0.03,High Risk
U334,2024,5,79223.0,Salary Increases & Fixed Expenses Increase,21431,12215.0,8635,20850.0,581.0,2.71,0.04,High Risk
U334,2024,6,79804.0,Salary Increases & Fixed Expenses Increase,46521,12215.0,14014,26229.0,20292.0,43.62,-0.03,Low Risk
U334,2024,7,100096.0,Salary Increases & Fixed Expenses Increase,46521,12215.0,19067,31282.0,15239.0,32.76,0.01,Low Risk
U334,2024,8,115335.0,Salary Increases & Fixed Expenses Increase,46521,12215.0,22358,34573.0,11948.0,25.68,-0.01,Low Risk
U334,2024,9,127283.0,Salary Increases & Fixed Expenses Increase,46521,12215.0,17467,29682.0,16839.0,36.2,-0.02,Low Risk
U334,2024,10,144122.0,Salary Increases & Fixed Expenses Increase,46521,12215.0,26642,38857.0,7664.0,16.47,-0.02,Medium Risk
U334,2024,11,151786.0,Salary Increases & Fixed Expenses Increase,46521,12215.0,15173,27388.0,19133.0,41.13,0.02,Low Risk
U334,2024,12,170919.0,Salary Increases & Fixed Expenses Increase,46521,12215.0,23987,36202.0,10319.0,22.18,-0.02,Medium Risk
U335,2024,1,237136.0,Salary Increases & Fixed Expenses Remain Stable,181882,70726.0,56480,127206.0,54676.0,30.06,-0.01,Low Risk
U335,2024,2,291812.0,Salary Increases & Fixed Expenses Remain Stable,181882,70726.0,69966,140692.0,41190.0,22.65,0.0,Medium Risk
U335,2024,3,333002.0,Salary Increases & Fixed Expenses Remain Stable,181882,70726.0,98486,169212.0,12670.0,6.97,0.03,High Risk
U335,2024,4,345672.0,Salary Increases & Fixed Expenses Remain Stable,181882,70726.0,89640,160366.0,21516.0,11.83,0.05,High Risk
U335,2024,5,367188.0,Salary Increases & Fixed Expenses Remain Stable,207959,70726.0,63160,133886.0,74073.0,35.62,-0.04,Low Risk
U335,2024,6,441261.0,Salary Increases & Fixed Expenses Remain Stable,207959,70726.0,70158,140884.0,67075.0,32.25,0.04,Low Risk
U335,2024,7,508336.0,Salary Increases & Fixed Expenses Remain Stable,207959,70726.0,98762,169488.0,38471.0,18.5,-0.02,Medium Risk
U335,2024,8,546807.0,Salary Increases & Fixed Expenses Remain Stable,207959,70726.0,72056,142782.0,65177.0,31.34,0.05,Low Risk
U335,2024,9,611984.0,Salary Increases & Fixed Expenses Remain Stable,207959,70726.0,108769,179495.0,28464.0,13.69,-0.01,High Risk
U335,2024,10,640448.0,Salary Increases & Fixed Expenses Remain Stable,207959,70726.0,92485,163211.0,44748.0,21.52,-0.02,Medium Risk
U335,2024,11,685196.0,Salary Increases & Fixed Expenses Remain Stable,207959,70726.0,110104,180830.0,27129.0,13.05,-0.01,High Risk
U335,2024,12,712325.0,Salary Increases & Fixed Expenses Remain Stable,207959,70726.0,117945,188671.0,19288.0,9.27,-0.02,High Risk
U336,2024,1,244000.0,Salary Increases & Fixed Expenses Remain Stable,238477,95754.0,63931,159685.0,78792.0,33.04,0.01,Low Risk
U336,2024,2,322792.0,Salary Increases & Fixed Expenses Remain Stable,238477,95754.0,64642,160396.0,78081.0,32.74,0.03,Low Risk
U336,2024,3,400873.0,Salary Increases & Fixed Expenses Remain Stable,238477,95754.0,57704,153458.0,85019.0,35.65,0.05,Low Risk
U336,2024,4,485892.0,Salary Increases & Fixed Expenses Remain Stable,262267,95754.0,59416,155170.0,107097.0,40.84,0.01,Low Risk
U336,2024,5,592989.0,Salary Increases & Fixed Expenses Remain Stable,262267,95754.0,54946,150700.0,111567.0,42.54,-0.05,Low Risk
U336,2024,6,704556.0,Salary Increases & Fixed Expenses Remain Stable,262267,95754.0,55050,150804.0,111463.0,42.5,-0.02,Low Risk
U336,2024,7,816019.0,Salary Increases & Fixed Expenses Remain Stable,262267,95754.0,66444,162198.0,100069.0,38.16,0.04,Low Risk
U336,2024,8,916088.0,Salary Increases & Fixed Expenses Remain Stable,262267,95754.0,59758,155512.0,106755.0,40.7,0.02,Low Risk
U336,2024,9,1022843.0,Salary Increases & Fixed Expenses Remain Stable,262267,95754.0,71678,167432.0,94835.0,36.16,-0.02,Low Risk
U336,2024,10,1117678.0,Salary Increases & Fixed Expenses Remain Stable,262267,95754.0,61348,157102.0,105165.0,40.1,-0.03,Low Risk
U336,2024,11,1222843.0,Salary Increases & Fixed Expenses Remain Stable,262267,95754.0,60475,156229.0,106038.0,40.43,-0.03,Low Risk
U336,2024,12,1328881.0,Salary Increases & Fixed Expenses Remain Stable,262267,95754.0,62001,157755.0,104512.0,39.85,0.04,Low Risk
U337,2024,1,79167.0,Salary Increases & Fixed Expenses Remain Stable,38851,13165.0,8841,22006.0,16845.0,43.36,-0.04,Low Risk
U337,2024,2,96012.0,Salary Increases & Fixed Expenses Remain Stable,38851,13165.0,8711,21876.0,16975.0,43.69,-0.0,Low Risk
U337,2024,3,112987.0,Salary Increases & Fixed Expenses Remain Stable,38851,13165.0,10922,24087.0,14764.0,38.0,-0.01,Low Risk
U337,2024,4,127751.0,Salary Increases & Fixed Expenses Remain Stable,38851,13165.0,10703,23868.0,14983.0,38.57,-0.02,Low Risk
U337,2024,5,142734.0,Salary Increases & Fixed Expenses Remain Stable,45485,13165.0,11765,24930.0,20555.0,45.19,-0.01,Low Risk
U337,2024,6,163289.0,Salary Increases & Fixed Expenses Remain Stable,45485,13165.0,10478,23643.0,21842.0,48.02,0.01,Low Risk
U337,2024,7,185131.0,Salary Increases & Fixed Expenses Remain Stable,45485,13165.0,11463,24628.0,20857.0,45.85,-0.01,Low Risk
U337,2024,8,205988.0,Salary Increases & Fixed Expenses Remain Stable,45485,13165.0,10231,23396.0,22089.0,48.56,0.02,Low Risk
U337,2024,9,228077.0,Salary Increases & Fixed Expenses Remain Stable,45485,13165.0,12563,25728.0,19757.0,43.44,0.01,Low Risk
U337,2024,10,247834.0,Salary Increases & Fixed Expenses Remain Stable,45485,13165.0,11747,24912.0,20573.0,45.23,0.05,Low Risk
U337,2024,11,268407.0,Salary Increases & Fixed Expenses Remain Stable,45485,13165.0,12886,26051.0,19434.0,42.73,-0.0,Low Risk
U337,2024,12,287841.0,Salary Increases & Fixed Expenses Remain Stable,45485,13165.0,12287,25452.0,20033.0,44.04,-0.04,Low Risk
U338,2024,1,171174.0,Salary Increases & Fixed Expenses Increase,153365,52189.0,54431,106620.0,46745.0,30.48,0.01,Low Risk
U338,2024,2,217919.0,Salary Increases & Fixed Expenses Increase,153365,53768.0,71874,125642.0,27723.0,18.08,-0.03,Medium Risk
U338,2024,3,245642.0,Salary Increases & Fixed Expenses Increase,153365,53768.0,75795,129563.0,23802.0,15.52,0.03,Medium Risk
U338,2024,4,269444.0,Salary Increases & Fixed Expenses Increase,171857,53768.0,67978,121746.0,50111.0,29.16,0.0,Low Risk
U338,2024,5,319555.0,Salary Increases & Fixed Expenses Increase,171857,54541.0,52758,107299.0,64558.0,37.56,0.01,Low Risk
U338,2024,6,384113.0,Salary Increases & Fixed Expenses Increase,171857,54541.0,58022,112563.0,59294.0,34.5,0.03,Low Risk
U338,2024,7,443407.0,Salary Increases & Fixed Expenses Increase,171857,54541.0,82585,137126.0,34731.0,20.21,0.02,Medium Risk
U338,2024,8,478138.0,Salary Increases & Fixed Expenses Increase,171857,54541.0,66480,121021.0,50836.0,29.58,-0.01,Low Risk
U338,2024,9,528974.0,Salary Increases & Fixed Expenses Increase,171857,54541.0,56768,111309.0,60548.0,35.23,0.03,Low Risk
U338,2024,10,589522.0,Salary Increases & Fixed Expenses Increase,171857,54541.0,68857,123398.0,48459.0,28.2,0.03,Low Risk
U338,2024,11,637981.0,Salary Increases & Fixed Expenses Increase,171857,54541.0,91416,145957.0,25900.0,15.07,-0.03,Medium Risk
U338,2024,12,663881.0,Salary Increases & Fixed Expenses Increase,171857,54541.0,69741,124282.0,47575.0,27.68,-0.04,Low Risk
U339,2024,1,160310.0,Stable Salary & Increasing Fixed Expenses,146586,62239.0,71844,134083.0,12503.0,8.53,0.02,High Risk
U339,2024,2,172813.0,Stable Salary & Increasing Fixed Expenses,146586,62910.0,70652,133562.0,13024.0,8.88,0.02,High Risk
U339,2024,3,185837.0,Stable Salary & Increasing Fixed Expenses,146586,62910.0,85824,148734.0,-2148.0,-1.47,0.03,High Risk
U339,2024,4,183689.0,Stable Salary & Increasing Fixed Expenses,146586,62910.0,67917,130827.0,15759.0,10.75,0.03,High Risk
U339,2024,5,199448.0,Stable Salary & Increasing Fixed Expenses,146586,62910.0,57782,120692.0,25894.0,17.66,0.02,Medium Risk
U339,2024,6,225342.0,Stable Salary & Increasing Fixed Expenses,146586,62910.0,50963,113873.0,32713.0,22.32,-0.02,Medium Risk
U339,2024,7,258055.0,Stable Salary & Increasing Fixed Expenses,146586,62910.0,48953,111863.0,34723.0,23.69,0.05,Medium Risk
U339,2024,8,292778.0,Stable Salary & Increasing Fixed Expenses,146586,62910.0,65117,128027.0,18559.0,12.66,-0.03,High Risk
U339,2024,9,311337.0,Stable Salary & Increasing Fixed Expenses,146586,62910.0,54477,117387.0,29199.0,19.92,-0.01,Medium Risk
U339,2024,10,340536.0,Stable Salary & Increasing Fixed Expenses,146586,62910.0,79270,142180.0,4406.0,3.01,-0.03,High Risk
U339,2024,11,344942.0,Stable Salary & Increasing Fixed Expenses,146586,62910.0,68743,131653.0,14933.0,10.19,-0.03,High Risk
U339,2024,12,359875.0,Stable Salary & Increasing Fixed Expenses,146586,62910.0,57446,120356.0,26230.0,17.89,0.01,Medium Risk
U340,2024,1,209140.0,Salary Increases & Fixed Expenses Remain Stable,85420,36663.0,21427,58090.0,27330.0,31.99,-0.04,Low Risk
U340,2024,2,236470.0,Salary Increases & Fixed Expenses Remain Stable,85420,36663.0,22354,59017.0,26403.0,30.91,-0.0,Low Risk
U340,2024,3,262873.0,Salary Increases & Fixed Expenses Remain Stable,85420,36663.0,22982,59645.0,25775.0,30.17,0.05,Low Risk
U340,2024,4,288648.0,Salary Increases & Fixed Expenses Remain Stable,85420,36663.0,23767,60430.0,24990.0,29.26,-0.03,Low Risk
U340,2024,5,313638.0,Salary Increases & Fixed Expenses Remain Stable,85420,36663.0,17393,54056.0,31364.0,36.72,0.0,Low Risk
U340,2024,6,345002.0,Salary Increases & Fixed Expenses Remain Stable,85420,36663.0,24225,60888.0,24532.0,28.72,0.04,Low Risk
U340,2024,7,369534.0,Salary Increases & Fixed Expenses Remain Stable,111187,36663.0,29550,66213.0,44974.0,40.45,-0.04,Low Risk
U340,2024,8,414508.0,Salary Increases & Fixed Expenses Remain Stable,111187,36663.0,29137,65800.0,45387.0,40.82,0.02,Low Risk
U340,2024,9,459895.0,Salary Increases & Fixed Expenses Remain Stable,111187,36663.0,25945,62608.0,48579.0,43.69,0.02,Low Risk
U340,2024,10,508474.0,Salary Increases & Fixed Expenses Remain Stable,111187,36663.0,35876,72539.0,38648.0,34.76,0.02,Low Risk
U340,2024,11,547122.0,Salary Increases & Fixed Expenses Remain Stable,111187,36663.0,28650,65313.0,45874.0,41.26,0.01,Low Risk
U340,2024,12,592996.0,Salary Increases & Fixed Expenses Remain Stable,111187,36663.0,28128,64791.0,46396.0,41.73,0.05,Low Risk
U341,2024,1,149825.0,Stable Salary & Decreasing Fixed Expenses,146461,52858.0,41947,94805.0,51656.0,35.27,-0.02,Low Risk
U341,2024,2,201481.0,Stable Salary & Decreasing Fixed Expenses,146461,52858.0,33344,86202.0,60259.0,41.14,-0.05,Low Risk
U341,2024,3,261740.0,Stable Salary & Decreasing Fixed Expenses,146461,52858.0,43846,96704.0,49757.0,33.97,0.01,Low Risk
U341,2024,4,311497.0,Stable Salary & Decreasing Fixed Expenses,146461,52858.0,38976,91834.0,54627.0,37.3,-0.01,Low Risk
U341,2024,5,366124.0,Stable Salary & Decreasing Fixed Expenses,146461,52858.0,36962,89820.0,56641.0,38.67,-0.04,Low Risk
U341,2024,6,422765.0,Stable Salary & Decreasing Fixed Expenses,146461,52858.0,36277,89135.0,57326.0,39.14,0.01,Low Risk
U341,2024,7,480091.0,Stable Salary & Decreasing Fixed Expenses,146461,52858.0,38976,91834.0,54627.0,37.3,-0.02,Low Risk
U341,2024,8,534718.0,Stable Salary & Decreasing Fixed Expenses,146461,52858.0,33194,86052.0,60409.0,41.25,-0.0,Low Risk
U341,2024,9,595127.0,Stable Salary & Decreasing Fixed Expenses,146461,52858.0,32706,85564.0,60897.0,41.58,-0.01,Low Risk
U341,2024,10,656024.0,Stable Salary & Decreasing Fixed Expenses,146461,52858.0,40982,93840.0,52621.0,35.93,0.02,Low Risk
U341,2024,11,708645.0,Stable Salary & Decreasing Fixed Expenses,146461,52347.0,41450,93797.0,52664.0,35.96,0.05,Low Risk
U341,2024,12,761309.0,Stable Salary & Decreasing Fixed Expenses,146461,52347.0,32502,84849.0,61612.0,42.07,0.0,Low Risk
U342,2024,1,250000.0,Salary Increases & Fixed Expenses Decrease,275538,65895.0,59821,125716.0,149822.0,54.37,-0.02,Low Risk
U342,2024,2,399822.0,Salary Increases & Fixed Expenses Decrease,275538,65895.0,69804,135699.0,139839.0,50.75,-0.04,Low Risk
U342,2024,3,539661.0,Salary Increases & Fixed Expenses Decrease,275538,65895.0,80575,146470.0,129068.0,46.84,-0.01,Low Risk
U342,2024,4,668729.0,Salary Increases & Fixed Expenses Decrease,275538,65895.0,60227,126122.0,149416.0,54.23,0.04,Low Risk
U342,2024,5,818145.0,Salary Increases & Fixed Expenses Decrease,299952,65895.0,71816,137711.0,162241.0,54.09,-0.05,Low Risk
U342,2024,6,980386.0,Salary Increases & Fixed Expenses Decrease,299952,65895.0,68131,134026.0,165926.0,55.32,0.0,Low Risk
U342,2024,7,1146312.0,Salary Increases & Fixed Expenses Decrease,299952,64400.0,70986,135386.0,164566.0,54.86,0.04,Low Risk
U342,2024,8,1310878.0,Salary Increases & Fixed Expenses Decrease,299952,64400.0,84307,148707.0,151245.0,50.42,-0.03,Low Risk
U342,2024,9,1462123.0,Salary Increases & Fixed Expenses Decrease,299952,64400.0,68444,132844.0,167108.0,55.71,0.04,Low Risk
U342,2024,10,1629231.0,Salary Increases & Fixed Expenses Decrease,299952,64400.0,61786,126186.0,173766.0,57.93,-0.02,Low Risk
U342,2024,11,1802997.0,Salary Increases & Fixed Expenses Decrease,299952,64400.0,68066,132466.0,167486.0,55.84,-0.03,Low Risk
U342,2024,12,1970483.0,Salary Increases & Fixed Expenses Decrease,299952,64400.0,72508,136908.0,163044.0,54.36,0.02,Low Risk
U343,2024,1,231008.0,Salary Increases & Fixed Expenses Remain Stable,128812,44174.0,28163,72337.0,56475.0,43.84,0.01,Low Risk
U343,2024,2,287483.0,Salary Increases & Fixed Expenses Remain Stable,128812,44174.0,34450,78624.0,50188.0,38.96,-0.01,Low Risk
U343,2024,3,337671.0,Salary Increases & Fixed Expenses Remain Stable,128812,44174.0,36900,81074.0,47738.0,37.06,0.04,Low Risk
U343,2024,4,385409.0,Salary Increases & Fixed Expenses Remain Stable,147193,44174.0,38172,82346.0,64847.0,44.06,0.03,Low Risk
U343,2024,5,450256.0,Salary Increases & Fixed Expenses Remain Stable,147193,44174.0,40357,84531.0,62662.0,42.57,-0.03,Low Risk
U343,2024,6,512918.0,Salary Increases & Fixed Expenses Remain Stable,147193,44174.0,42892,87066.0,60127.0,40.85,0.0,Low Risk
U343,2024,7,573045.0,Salary Increases & Fixed Expenses Remain Stable,147193,44174.0,40454,84628.0,62565.0,42.51,0.02,Low Risk
U343,2024,8,635610.0,Salary Increases & Fixed Expenses Remain Stable,147193,44174.0,37985,82159.0,65034.0,44.18,-0.01,Low Risk
U343,2024,9,700644.0,Salary Increases & Fixed Expenses Remain Stable,147193,44174.0,44892,89066.0,58127.0,39.49,0.03,Low Risk
U343,2024,10,758771.0,Salary Increases & Fixed Expenses Remain Stable,147193,44174.0,39444,83618.0,63575.0,43.19,0.03,Low Risk
U343,2024,11,822346.0,Salary Increases & Fixed Expenses Remain Stable,147193,44174.0,49231,93405.0,53788.0,36.54,0.04,Low Risk
U343,2024,12,876134.0,Salary Increases & Fixed Expenses Remain Stable,147193,44174.0,52623,96797.0,50396.0,34.24,-0.0,Low Risk
U344,2024,1,151180.0,Stable Salary & Stable Fixed Expenses,51221,29183.0,11129,40312.0,10909.0,21.3,-0.04,Medium Risk
U344,2024,2,162089.0,Stable Salary & Stable Fixed Expenses,51221,29183.0,12373,41556.0,9665.0,18.87,0.01,Medium Risk
U344,2024,3,171754.0,Stable Salary & Stable Fixed Expenses,51221,29183.0,17501,46684.0,4537.0,8.86,-0.04,High Risk
U344,2024,4,176291.0,Stable Salary & Stable Fixed Expenses,51221,29183.0,10788,39971.0,11250.0,21.96,-0.02,Medium Risk
U344,2024,5,187541.0,Stable Salary & Stable Fixed Expenses,51221,29183.0,13322,42505.0,8716.0,17.02,0.04,Medium Risk
U344,2024,6,196257.0,Stable Salary & Stable Fixed Expenses,51221,29183.0,13707,42890.0,8331.0,16.26,-0.01,Medium Risk
U344,2024,7,204588.0,Stable Salary & Stable Fixed Expenses,51221,29183.0,13008,42191.0,9030.0,17.63,0.01,Medium Risk
U344,2024,8,213618.0,Stable Salary & Stable Fixed Expenses,51221,29183.0,13965,43148.0,8073.0,15.76,0.0,Medium Risk
U344,2024,9,221691.0,Stable Salary & Stable Fixed Expenses,51221,29183.0,14504,43687.0,7534.0,14.71,-0.04,High Risk
U344,2024,10,229225.0,Stable Salary & Stable Fixed Expenses,51221,29183.0,13961,43144.0,8077.0,15.77,0.03,Medium Risk
U344,2024,11,237302.0,Stable Salary & Stable Fixed Expenses,51221,29183.0,14950,44133.0,7088.0,13.84,0.0,High Risk
U344,2024,12,244390.0,Stable Salary & Stable Fixed Expenses,51221,29183.0,13776,42959.0,8262.0,16.13,-0.02,Medium Risk
U345,2024,1,250000.0,Salary Increases & Fixed Expenses Increase,271329,96587.0,99957,196544.0,74785.0,27.56,0.04,Low Risk
U345,2024,2,324785.0,Salary Increases & Fixed Expenses Increase,271329,96587.0,121765,218352.0,52977.0,19.53,-0.02,Medium Risk
U345,2024,3,377762.0,Salary Increases & Fixed Expenses Increase,271329,96587.0,130418,227005.0,44324.0,16.34,0.0,Medium Risk
U345,2024,4,422086.0,Salary Increases & Fixed Expenses Increase,271329,96587.0,113853,210440.0,60889.0,22.44,-0.01,Medium Risk
U345,2024,5,482975.0,Salary Increases & Fixed Expenses Increase,271329,96587.0,126738,223325.0,48004.0,17.69,0.02,Medium Risk
U345,2024,6,530979.0,Salary Increases & Fixed Expenses Increase,288087,97557.0,121801,219358.0,68729.0,23.86,-0.02,Medium Risk
U345,2024,7,599708.0,Salary Increases & Fixed Expenses Increase,288087,97557.0,117073,214630.0,73457.0,25.5,0.01,Low Risk
U345,2024,8,673165.0,Salary Increases & Fixed Expenses Increase,288087,97557.0,108033,205590.0,82497.0,28.64,0.05,Low Risk
U345,2024,9,755662.0,Salary Increases & Fixed Expenses Increase,288087,97557.0,147286,244843.0,43244.0,15.01,-0.03,Medium Risk
U345,2024,10,798906.0,Salary Increases & Fixed Expenses Increase,288087,97557.0,88044,185601.0,102486.0,35.57,0.0,Low Risk
U345,2024,11,901392.0,Salary Increases & Fixed Expenses Increase,288087,97557.0,95065,192622.0,95465.0,33.14,-0.02,Low Risk
U345,2024,12,996857.0,Salary Increases & Fixed Expenses Increase,288087,99431.0,89658,189089.0,98998.0,34.36,0.05,Low Risk
U346,2024,1,250000.0,Salary Increases & Fixed Expenses Increase,282746,61810.0,90451,152261.0,130485.0,46.15,0.01,Low Risk
U346,2024,2,380485.0,Salary Increases & Fixed Expenses Increase,282746,61810.0,96039,157849.0,124897.0,44.17,-0.03,Low Risk
U346,2024,3,505382.0,Salary Increases & Fixed Expenses Increase,282746,61810.0,92946,154756.0,127990.0,45.27,0.04,Low Risk
U346,2024,4,633372.0,Salary Increases & Fixed Expenses Increase,282746,61810.0,115097,176907.0,105839.0,37.43,-0.0,Low Risk
U346,2024,5,739211.0,Salary Increases & Fixed Expenses Increase,302132,61810.0,105700,167510.0,134622.0,44.56,-0.02,Low Risk
U346,2024,6,873833.0,Salary Increases & Fixed Expenses Increase,302132,61810.0,108359,170169.0,131963.0,43.68,0.0,Low Risk
U346,2024,7,1005796.0,Salary Increases & Fixed Expenses Increase,302132,61810.0,129211,191021.0,111111.0,36.78,0.01,Low Risk
U346,2024,8,1116907.0,Salary Increases & Fixed Expenses Increase,302132,61810.0,117127,178937.0,123195.0,40.78,-0.01,Low Risk
U346,2024,9,1240102.0,Salary Increases & Fixed Expenses Increase,302132,61810.0,156043,217853.0,84279.0,27.89,-0.01,Low Risk
U346,2024,10,1324381.0,Salary Increases & Fixed Expenses Increase,302132,61810.0,138308,200118.0,102014.0,33.76,0.01,Low Risk
U346,2024,11,1426395.0,Salary Increases & Fixed Expenses Increase,302132,61810.0,133360,195170.0,106962.0,35.4,0.03,Low Risk
U346,2024,12,1533357.0,Salary Increases & Fixed Expenses Increase,302132,61810.0,149670,211480.0,90652.0,30.0,0.04,Low Risk
U347,2024,1,250000.0,Salary Increases & Fixed Expenses Remain Stable,250061,60842.0,85943,146785.0,103276.0,41.3,0.01,Low Risk
U347,2024,2,353276.0,Salary Increases & Fixed Expenses Remain Stable,250061,60842.0,105206,166048.0,84013.0,33.6,0.02,Low Risk
U347,2024,3,437289.0,Salary Increases & Fixed Expenses Remain Stable,250061,60842.0,109832,170674.0,79387.0,31.75,0.01,Low Risk
U347,2024,4,516676.0,Salary Increases & Fixed Expenses Remain Stable,250061,60842.0,79673,140515.0,109546.0,43.81,0.0,Low Risk
U347,2024,5,626222.0,Salary Increases & Fixed Expenses Remain Stable,259804,60842.0,82763,143605.0,116199.0,44.73,0.04,Low Risk
U347,2024,6,742421.0,Salary Increases & Fixed Expenses Remain Stable,259804,60842.0,93403,154245.0,105559.0,40.63,0.04,Low Risk
U347,2024,7,847980.0,Salary Increases & Fixed Expenses Remain Stable,259804,60842.0,89860,150702.0,109102.0,41.99,-0.02,Low Risk
U347,2024,8,957082.0,Salary Increases & Fixed Expenses Remain Stable,259804,60842.0,114569,175411.0,84393.0,32.48,0.01,Low Risk
U347,2024,9,1041475.0,Salary Increases & Fixed Expenses Remain Stable,259804,60842.0,112252,173094.0,86710.0,33.38,0.05,Low Risk
U347,2024,10,1128185.0,Salary Increases & Fixed Expenses Remain Stable,259804,60842.0,94212,155054.0,104750.0,40.32,0.04,Low Risk
U347,2024,11,1232935.0,Salary Increases & Fixed Expenses Remain Stable,259804,60842.0,125979,186821.0,72983.0,28.09,0.04,Low Risk
U347,2024,12,1305918.0,Salary Increases & Fixed Expenses Remain Stable,259804,60842.0,113565,174407.0,85397.0,32.87,0.02,Low Risk
U348,2024,1,249321.0,Stable Salary & Stable Fixed Expenses,108150,61482.0,27736,89218.0,18932.0,17.51,-0.02,Medium Risk
U348,2024,2,268253.0,Stable Salary & Stable Fixed Expenses,108150,61482.0,22974,84456.0,23694.0,21.91,0.01,Medium Risk
U348,2024,3,291947.0,Stable Salary & Stable Fixed Expenses,108150,61482.0,38081,99563.0,8587.0,7.94,-0.04,High Risk
U348,2024,4,300534.0,Stable Salary & Stable Fixed Expenses,108150,61482.0,22410,83892.0,24258.0,22.43,-0.01,Medium Risk
U348,2024,5,324792.0,Stable Salary & Stable Fixed Expenses,108150,61482.0,27042,88524.0,19626.0,18.15,0.03,Medium Risk
U348,2024,6,344418.0,Stable Salary & Stable Fixed Expenses,108150,61482.0,26197,87679.0,20471.0,18.93,-0.05,Medium Risk
U348,2024,7,364889.0,Stable Salary & Stable Fixed Expenses,108150,61482.0,22959,84441.0,23709.0,21.92,0.04,Medium Risk
U348,2024,8,388598.0,Stable Salary & Stable Fixed Expenses,108150,61482.0,28513,89995.0,18155.0,16.79,-0.02,Medium Risk
U348,2024,9,406753.0,Stable Salary & Stable Fixed Expenses,108150,61482.0,34863,96345.0,11805.0,10.92,0.05,High Risk
U348,2024,10,418558.0,Stable Salary & Stable Fixed Expenses,108150,61482.0,33924,95406.0,12744.0,11.78,0.04,High Risk
U348,2024,11,431302.0,Stable Salary & Stable Fixed Expenses,108150,61482.0,33818,95300.0,12850.0,11.88,0.0,High Risk
U348,2024,12,444152.0,Stable Salary & Stable Fixed Expenses,108150,61482.0,27173,88655.0,19495.0,18.03,-0.05,Medium Risk
U349,2024,1,162872.0,Salary Increases & Fixed Expenses Remain Stable,144398,75793.0,45136,120929.0,23469.0,16.25,-0.05,Medium Risk
U349,2024,2,186341.0,Salary Increases & Fixed Expenses Remain Stable,144398,75793.0,50653,126446.0,17952.0,12.43,0.05,High Risk
U349,2024,3,204293.0,Salary Increases & Fixed Expenses Remain Stable,144398,75793.0,46908,122701.0,21697.0,15.03,-0.03,Medium Risk
U349,2024,4,225990.0,Salary Increases & Fixed Expenses Remain Stable,144398,75793.0,52130,127923.0,16475.0,11.41,0.05,High Risk
U349,2024,5,242465.0,Salary Increases & Fixed Expenses Remain Stable,172969,75793.0,71969,147762.0,25207.0,14.57,0.03,High Risk
U349,2024,6,267672.0,Salary Increases & Fixed Expenses Remain Stable,172969,75793.0,59860,135653.0,37316.0,21.57,0.04,Medium Risk
U349,2024,7,304988.0,Salary Increases & Fixed Expenses Remain Stable,172969,75793.0,68108,143901.0,29068.0,16.81,-0.04,Medium Risk
U349,2024,8,334056.0,Salary Increases & Fixed Expenses Remain Stable,172969,75793.0,61606,137399.0,35570.0,20.56,-0.03,Medium Risk
U349,2024,9,369626.0,Salary Increases & Fixed Expenses Remain Stable,172969,75793.0,58622,134415.0,38554.0,22.29,0.03,Medium Risk
U349,2024,10,408180.0,Salary Increases & Fixed Expenses Remain Stable,172969,75793.0,66436,142229.0,30740.0,17.77,-0.04,Medium Risk
U349,2024,11,438920.0,Salary Increases & Fixed Expenses Remain Stable,172969,75793.0,82032,157825.0,15144.0,8.76,0.04,High Risk
U349,2024,12,454064.0,Salary Increases & Fixed Expenses Remain Stable,172969,75793.0,54303,130096.0,42873.0,24.79,0.04,Medium Risk
U350,2024,1,160024.0,Stable Salary & Increasing Fixed Expenses,122163,49805.0,84613,134418.0,-12255.0,-10.03,0.01,High Risk
U350,2024,2,147769.0,Stable Salary & Increasing Fixed Expenses,122163,49805.0,68580,118385.0,3778.0,3.09,-0.01,High Risk
U350,2024,3,151547.0,Stable Salary & Increasing Fixed Expenses,122163,49805.0,88032,137837.0,-15674.0,-12.83,-0.01,High Risk
U350,2024,4,135873.0,Stable Salary & Increasing Fixed Expenses,122163,49805.0,81217,131022.0,-8859.0,-7.25,-0.03,High Risk
U350,2024,5,127014.0,Stable Salary & Increasing Fixed Expenses,122163,49805.0,73004,122809.0,-646.0,-0.53,0.0,High Risk
U350,2024,6,126368.0,Stable Salary & Increasing Fixed Expenses,122163,49805.0,63147,112952.0,9211.0,7.54,0.02,High Risk
U350,2024,7,135579.0,Stable Salary & Increasing Fixed Expenses,122163,50573.0,84884,135457.0,-13294.0,-10.88,-0.0,High Risk
U350,2024,8,122285.0,Stable Salary & Increasing Fixed Expenses,122163,50573.0,65753,116326.0,5837.0,4.78,-0.03,High Risk
U350,2024,9,128122.0,Stable Salary & Increasing Fixed Expenses,122163,50573.0,78497,129070.0,-6907.0,-5.65,0.04,High Risk
U350,2024,10,121215.0,Stable Salary & Increasing Fixed Expenses,122163,50573.0,81728,132301.0,-10138.0,-8.3,-0.03,High Risk
U350,2024,11,111077.0,Stable Salary & Increasing Fixed Expenses,122163,50573.0,70536,121109.0,1054.0,0.86,-0.04,High Risk
U350,2024,12,112131.0,Stable Salary & Increasing Fixed Expenses,122163,50573.0,90159,140732.0,-18569.0,-15.2,0.04,High Risk
U351,2024,1,250000.0,Stable Salary & Increasing Fixed Expenses,252645,92619.0,59448,152067.0,100578.0,39.81,0.01,Low Risk
U351,2024,2,350578.0,Stable Salary & Increasing Fixed Expenses,252645,94272.0,72110,166382.0,86263.0,34.14,0.04,Low Risk
U351,2024,3,436841.0,Stable Salary & Increasing Fixed Expenses,252645,94272.0,62326,156598.0,96047.0,38.02,-0.04,Low Risk
U351,2024,4,532888.0,Stable Salary & Increasing Fixed Expenses,252645,94272.0,51087,145359.0,107286.0,42.47,0.03,Low Risk
U351,2024,5,640174.0,Stable Salary & Increasing Fixed Expenses,252645,94272.0,51242,145514.0,107131.0,42.4,-0.04,Low Risk
U351,2024,6,747305.0,Stable Salary & Increasing Fixed Expenses,252645,94272.0,60993,155265.0,97380.0,38.54,0.01,Low Risk
U351,2024,7,844685.0,Stable Salary & Increasing Fixed Expenses,252645,94272.0,55076,149348.0,103297.0,40.89,0.01,Low Risk
U351,2024,8,947982.0,Stable Salary & Increasing Fixed Expenses,252645,94272.0,65229,159501.0,93144.0,36.87,0.01,Low Risk
U351,2024,9,1041126.0,Stable Salary & Increasing Fixed Expenses,252645,95702.0,60171,155873.0,96772.0,38.3,0.0,Low Risk
U351,2024,10,1137898.0,Stable Salary & Increasing Fixed Expenses,252645,95702.0,73126,168828.0,83817.0,33.18,0.02,Low Risk
U351,2024,11,1221715.0,Stable Salary & Increasing Fixed Expenses,252645,95702.0,58590,154292.0,98353.0,38.93,-0.03,Low Risk
U351,2024,12,1320068.0,Stable Salary & Increasing Fixed Expenses,252645,95702.0,58834,154536.0,98109.0,38.83,-0.01,Low Risk
U352,2024,1,250000.0,Salary Increases & Fixed Expenses Increase,293858,118167.0,180030,298197.0,-4339.0,-1.48,0.02,High Risk
U352,2024,2,245661.0,Salary Increases & Fixed Expenses Increase,293858,118167.0,175630,293797.0,61.0,0.02,0.02,High Risk
U352,2024,3,245722.0,Salary Increases & Fixed Expenses Increase,293858,118801.0,186994,305795.0,-11937.0,-4.06,-0.02,High Risk
U352,2024,4,233785.0,Salary Increases & Fixed Expenses Increase,293858,118801.0,157435,276236.0,17622.0,6.0,-0.02,High Risk
U352,2024,5,251407.0,Salary Increases & Fixed Expenses Increase,293858,118801.0,176119,294920.0,-1062.0,-0.36,0.01,High Risk
U352,2024,6,250345.0,Salary Increases & Fixed Expenses Increase,293858,118801.0,175835,294636.0,-778.0,-0.26,-0.01,High Risk
U352,2024,7,249567.0,Salary Increases & Fixed Expenses Increase,293858,118801.0,191114,309915.0,-16057.0,-5.46,0.02,High Risk
U352,2024,8,233510.0,Salary Increases & Fixed Expenses Increase,308524,119655.0,204201,323856.0,-15332.0,-4.97,-0.01,High Risk
U352,2024,9,218178.0,Salary Increases & Fixed Expenses Increase,308524,119655.0,197718,317373.0,-8849.0,-2.87,0.02,High Risk
U352,2024,10,209329.0,Salary Increases & Fixed Expenses Increase,308524,120231.0,215171,335402.0,-26878.0,-8.71,-0.04,High Risk
U352,2024,11,182451.0,Salary Increases & Fixed Expenses Increase,308524,120231.0,191368,311599.0,-3075.0,-1.0,0.03,High Risk
U352,2024,12,179376.0,Salary Increases & Fixed Expenses Increase,308524,121277.0,230435,351712.0,-43188.0,-14.0,0.02,High Risk
U353,2024,1,250000.0,Salary Increases & Fixed Expenses Remain Stable,259778,65994.0,86599,152593.0,107185.0,41.26,-0.03,Low Risk
U353,2024,2,357185.0,Salary Increases & Fixed Expenses Remain Stable,259778,65994.0,80965,146959.0,112819.0,43.43,-0.01,Low Risk
U353,2024,3,470004.0,Salary Increases & Fixed Expenses Remain Stable,259778,65994.0,79856,145850.0,113928.0,43.86,0.01,Low Risk
U353,2024,4,583932.0,Salary Increases & Fixed Expenses Remain Stable,259778,65994.0,115351,181345.0,78433.0,30.19,0.04,Low Risk
U353,2024,5,662365.0,Salary Increases & Fixed Expenses Remain Stable,259778,65994.0,95648,161642.0,98136.0,37.78,0.02,Low Risk
U353,2024,6,760501.0,Salary Increases & Fixed Expenses Remain Stable,259778,65994.0,93561,159555.0,100223.0,38.58,0.04,Low Risk
U353,2024,7,860724.0,Salary Increases & Fixed Expenses Remain Stable,288226,65994.0,111114,177108.0,111118.0,38.55,-0.03,Low Risk
U353,2024,8,971842.0,Salary Increases & Fixed Expenses Remain Stable,288226,65994.0,114137,180131.0,108095.0,37.5,0.02,Low Risk
U353,2024,9,1079937.0,Salary Increases & Fixed Expenses Remain Stable,288226,65994.0,126077,192071.0,96155.0,33.36,-0.04,Low Risk
U353,2024,10,1176092.0,Salary Increases & Fixed Expenses Remain Stable,288226,65994.0,113911,179905.0,108321.0,37.58,-0.02,Low Risk
U353,2024,11,1284413.0,Salary Increases & Fixed Expenses Remain Stable,288226,65994.0,145767,211761.0,76465.0,26.53,-0.01,Low Risk
U353,2024,12,1360878.0,Salary Increases & Fixed Expenses Remain Stable,288226,65994.0,105564,171558.0,116668.0,40.48,-0.04,Low Risk
U354,2024,1,62915.0,Salary Increases & Fixed Expenses Remain Stable,46765,14907.0,15270,30177.0,16588.0,35.47,-0.01,Low Risk
U354,2024,2,79503.0,Salary Increases & Fixed Expenses Remain Stable,46765,14907.0,20734,35641.0,11124.0,23.79,-0.01,Medium Risk
U354,2024,3,90627.0,Salary Increases & Fixed Expenses Remain Stable,46765,14907.0,20647,35554.0,11211.0,23.97,-0.03,Medium Risk
U354,2024,4,101838.0,Salary Increases & Fixed Expenses Remain Stable,74294,14907.0,36132,51039.0,23255.0,31.3,-0.02,Low Risk
U354,2024,5,125093.0,Salary Increases & Fixed Expenses Remain Stable,74294,14907.0,24256,39163.0,35131.0,47.29,-0.02,Low Risk
U354,2024,6,160224.0,Salary Increases & Fixed Expenses Remain Stable,74294,14907.0,31332,46239.0,28055.0,37.76,0.02,Low Risk
U354,2024,7,188279.0,Salary Increases & Fixed Expenses Remain Stable,74294,14907.0,31138,46045.0,28249.0,38.02,0.04,Low Risk
U354,2024,8,216528.0,Salary Increases & Fixed Expenses Remain Stable,74294,14907.0,33010,47917.0,26377.0,35.5,0.04,Low Risk
U354,2024,9,242905.0,Salary Increases & Fixed Expenses Remain Stable,74294,14907.0,25027,39934.0,34360.0,46.25,0.04,Low Risk
U354,2024,10,277265.0,Salary Increases & Fixed Expenses Remain Stable,74294,14907.0,24571,39478.0,34816.0,46.86,-0.02,Low Risk
U354,2024,11,312081.0,Salary Increases & Fixed Expenses Remain Stable,74294,14907.0,34927,49834.0,24460.0,32.92,0.0,Low Risk
U354,2024,12,336541.0,Salary Increases & Fixed Expenses Remain Stable,74294,14907.0,33692,48599.0,25695.0,34.59,0.03,Low Risk
U355,2024,1,212495.0,Stable Salary & Increasing Fixed Expenses,28805,22910.0,10878,33788.0,-4983.0,-17.3,0.01,High Risk
U355,2024,2,207512.0,Stable Salary & Increasing Fixed Expenses,28805,22910.0,10777,33687.0,-4882.0,-16.95,0.01,High Risk
U355,2024,3,202630.0,Stable Salary & Increasing Fixed Expenses,28805,23561.0,16729,40290.0,-11485.0,-39.87,-0.0,High Risk
U355,2024,4,191145.0,Stable Salary & Increasing Fixed Expenses,28805,24251.0,9136,33387.0,-4582.0,-15.91,-0.02,High Risk
U355,2024,5,186563.0,Stable Salary & Increasing Fixed Expenses,28805,24251.0,12422,36673.0,-7868.0,-27.31,-0.05,High Risk
U355,2024,6,178695.0,Stable Salary & Increasing Fixed Expenses,28805,24251.0,10421,34672.0,-5867.0,-20.37,0.05,High Risk
U355,2024,7,172828.0,Stable Salary & Increasing Fixed Expenses,28805,24251.0,9011,33262.0,-4457.0,-15.47,-0.01,High Risk
U355,2024,8,168371.0,Stable Salary & Increasing Fixed Expenses,28805,24251.0,8900,33151.0,-4346.0,-15.09,0.02,High Risk
U355,2024,9,164025.0,Stable Salary & Increasing Fixed Expenses,28805,24251.0,13243,37494.0,-8689.0,-30.16,0.01,High Risk
U355,2024,10,155336.0,Stable Salary & Increasing Fixed Expenses,28805,24251.0,14460,38711.0,-9906.0,-34.39,-0.02,High Risk
U355,2024,11,145430.0,Stable Salary & Increasing Fixed Expenses,28805,24251.0,12378,36629.0,-7824.0,-27.16,-0.04,High Risk
U355,2024,12,137606.0,Stable Salary & Increasing Fixed Expenses,28805,24251.0,16160,40411.0,-11606.0,-40.29,-0.03,High Risk
U356,2024,1,213005.0,Stable Salary & Stable Fixed Expenses,35060,15585.0,7286,22871.0,12189.0,34.77,0.01,Low Risk
U356,2024,2,225194.0,Stable Salary & Stable Fixed Expenses,35060,15585.0,9042,24627.0,10433.0,29.76,-0.01,Low Risk
U356,2024,3,235627.0,Stable Salary & Stable Fixed Expenses,35060,15585.0,10056,25641.0,9419.0,26.87,-0.05,Low Risk
U356,2024,4,245046.0,Stable Salary & Stable Fixed Expenses,35060,15585.0,9498,25083.0,9977.0,28.46,-0.03,Low Risk
U356,2024,5,255023.0,Stable Salary & Stable Fixed Expenses,35060,15585.0,8124,23709.0,11351.0,32.38,-0.0,Low Risk
U356,2024,6,266374.0,Stable Salary & Stable Fixed Expenses,35060,15585.0,8078,23663.0,11397.0,32.51,0.02,Low Risk
U356,2024,7,277771.0,Stable Salary & Stable Fixed Expenses,35060,15585.0,7796,23381.0,11679.0,33.31,-0.04,Low Risk
U356,2024,8,289450.0,Stable Salary & Stable Fixed Expenses,35060,15585.0,8739,24324.0,10736.0,30.62,0.02,Low Risk
U356,2024,9,300186.0,Stable Salary & Stable Fixed Expenses,35060,15585.0,10092,25677.0,9383.0,26.76,-0.02,Low Risk
U356,2024,10,309569.0,Stable Salary & Stable Fixed Expenses,35060,15585.0,7182,22767.0,12293.0,35.06,0.02,Low Risk
U356,2024,11,321862.0,Stable Salary & Stable Fixed Expenses,35060,15585.0,8870,24455.0,10605.0,30.25,-0.02,Low Risk
U356,2024,12,332467.0,Stable Salary & Stable Fixed Expenses,35060,15585.0,8265,23850.0,11210.0,31.97,-0.04,Low Risk
U357,2024,1,249215.0,Salary Increases & Fixed Expenses Decrease,236574,78296.0,127531,205827.0,30747.0,13.0,0.0,High Risk
U357,2024,2,279962.0,Salary Increases & Fixed Expenses Decrease,236574,78296.0,155729,234025.0,2549.0,1.08,-0.04,High Risk
U357,2024,3,282511.0,Salary Increases & Fixed Expenses Decrease,236574,78296.0,131810,210106.0,26468.0,11.19,-0.02,High Risk
U357,2024,4,308979.0,Salary Increases & Fixed Expenses Decrease,236574,78296.0,126327,204623.0,31951.0,13.51,0.02,High Risk
U357,2024,5,340930.0,Salary Increases & Fixed Expenses Decrease,236574,78296.0,152430,230726.0,5848.0,2.47,0.04,High Risk
U357,2024,6,346778.0,Salary Increases & Fixed Expenses Decrease,259771,78296.0,145440,223736.0,36035.0,13.87,0.04,High Risk
U357,2024,7,382813.0,Salary Increases & Fixed Expenses Decrease,259771,78296.0,159109,237405.0,22366.0,8.61,0.02,High Risk
U357,2024,8,405179.0,Salary Increases & Fixed Expenses Decrease,259771,78296.0,171802,250098.0,9673.0,3.72,-0.05,High Risk
U357,2024,9,414852.0,Salary Increases & Fixed Expenses Decrease,259771,78296.0,197744,276040.0,-16269.0,-6.26,-0.02,High Risk
U357,2024,10,398583.0,Salary Increases & Fixed Expenses Decrease,259771,76608.0,179102,255710.0,4061.0,1.56,-0.04,High Risk
U357,2024,11,402644.0,Salary Increases & Fixed Expenses Decrease,259771,76608.0,154878,231486.0,28285.0,10.89,-0.04,High Risk
U357,2024,12,430929.0,Salary Increases & Fixed Expenses Decrease,259771,76608.0,148003,224611.0,35160.0,13.53,0.04,High Risk
U358,2024,1,204459.0,Stable Salary & Stable Fixed Expenses,194456,62217.0,42891,105108.0,89348.0,45.95,0.04,Low Risk
U358,2024,2,293807.0,Stable Salary & Stable Fixed Expenses,194456,62217.0,49350,111567.0,82889.0,42.63,-0.0,Low Risk
U358,2024,3,376696.0,Stable Salary & Stable Fixed Expenses,194456,62217.0,41919,104136.0,90320.0,46.45,-0.04,Low Risk
U358,2024,4,467016.0,Stable Salary & Stable Fixed Expenses,194456,62217.0,51868,114085.0,80371.0,41.33,0.0,Low Risk
U358,2024,5,547387.0,Stable Salary & Stable Fixed Expenses,194456,62217.0,55986,118203.0,76253.0,39.21,0.04,Low Risk
U358,2024,6,623640.0,Stable Salary & Stable Fixed Expenses,194456,62217.0,51347,113564.0,80892.0,41.6,-0.04,Low Risk
U358,2024,7,704532.0,Stable Salary & Stable Fixed Expenses,194456,62217.0,43643,105860.0,88596.0,45.56,0.03,Low Risk
U358,2024,8,793128.0,Stable Salary & Stable Fixed Expenses,194456,62217.0,49831,112048.0,82408.0,42.38,0.04,Low Risk
U358,2024,9,875536.0,Stable Salary & Stable Fixed Expenses,194456,62217.0,56266,118483.0,75973.0,39.07,-0.05,Low Risk
U358,2024,10,951509.0,Stable Salary & Stable Fixed Expenses,194456,62217.0,53656,115873.0,78583.0,40.41,-0.03,Low Risk
U358,2024,11,1030092.0,Stable Salary & Stable Fixed Expenses,194456,62217.0,50803,113020.0,81436.0,41.88,-0.03,Low Risk
U358,2024,12,1111528.0,Stable Salary & Stable Fixed Expenses,194456,62217.0,47586,109803.0,84653.0,43.53,0.04,Low Risk
U359,2024,1,225314.0,Salary Increases & Fixed Expenses Remain Stable,224142,70910.0,102042,172952.0,51190.0,22.84,-0.04,Medium Risk
U359,2024,2,276504.0,Salary Increases & Fixed Expenses Remain Stable,224142,70910.0,84308,155218.0,68924.0,30.75,-0.01,Low Risk
U359,2024,3,345428.0,Salary Increases & Fixed Expenses Remain Stable,224142,70910.0,100765,171675.0,52467.0,23.41,0.01,Medium Risk
U359,2024,4,397895.0,Salary Increases & Fixed Expenses Remain Stable,251256,70910.0,101219,172129.0,79127.0,31.49,-0.03,Low Risk
U359,2024,5,477022.0,Salary Increases & Fixed Expenses Remain Stable,251256,70910.0,82878,153788.0,97468.0,38.79,0.03,Low Risk
U359,2024,6,574490.0,Salary Increases & Fixed Expenses Remain Stable,251256,70910.0,89859,160769.0,90487.0,36.01,-0.0,Low Risk
U359,2024,7,664977.0,Salary Increases & Fixed Expenses Remain Stable,251256,70910.0,97338,168248.0,83008.0,33.04,0.03,Low Risk
U359,2024,8,747985.0,Salary Increases & Fixed Expenses Remain Stable,251256,70910.0,102096,173006.0,78250.0,31.14,-0.03,Low Risk
U359,2024,9,826235.0,Salary Increases & Fixed Expenses Remain Stable,251256,70910.0,134676,205586.0,45670.0,18.18,0.01,Medium Risk
U359,2024,10,871905.0,Salary Increases & Fixed Expenses Remain Stable,251256,70910.0,125577,196487.0,54769.0,21.8,-0.05,Medium Risk
U359,2024,11,926674.0,Salary Increases & Fixed Expenses Remain Stable,251256,70910.0,103073,173983.0,77273.0,30.75,0.0,Low Risk
U359,2024,12,1003947.0,Salary Increases & Fixed Expenses Remain Stable,251256,70910.0,104219,175129.0,76127.0,30.3,0.02,Low Risk
U360,2024,1,139845.0,Salary Increases & Fixed Expenses Increase,51907,29803.0,25215,55018.0,-3111.0,-5.99,-0.03,High Risk
U360,2024,2,136734.0,Salary Increases & Fixed Expenses Increase,51907,29803.0,23531,53334.0,-1427.0,-2.75,0.03,High Risk
U360,2024,3,135307.0,Salary Increases & Fixed Expenses Increase,79561,29803.0,34767,64570.0,14991.0,18.84,0.01,Medium Risk
U360,2024,4,150298.0,Salary Increases & Fixed Expenses Increase,79561,29803.0,32991,62794.0,16767.0,21.07,0.01,Medium Risk
U360,2024,5,167065.0,Salary Increases & Fixed Expenses Increase,79561,29803.0,34430,64233.0,15328.0,19.27,0.01,Medium Risk
U360,2024,6,182393.0,Salary Increases & Fixed Expenses Increase,79561,29803.0,24410,54213.0,25348.0,31.86,-0.04,Low Risk
U360,2024,7,207741.0,Salary Increases & Fixed Expenses Increase,79561,29803.0,30362,60165.0,19396.0,24.38,-0.02,Medium Risk
U360,2024,8,227137.0,Salary Increases & Fixed Expenses Increase,79561,29803.0,27531,57334.0,22227.0,27.94,0.04,Low Risk
U360,2024,9,249364.0,Salary Increases & Fixed Expenses Increase,79561,29803.0,25457,55260.0,24301.0,30.54,0.0,Low Risk
U360,2024,10,273665.0,Salary Increases & Fixed Expenses Increase,79561,31698.0,29601,61299.0,18262.0,22.95,-0.03,Medium Risk
U360,2024,11,291927.0,Salary Increases & Fixed Expenses Increase,79561,31698.0,32257,63955.0,15606.0,19.62,0.02,Medium Risk
U360,2024,12,307533.0,Salary Increases & Fixed Expenses Increase,79561,31698.0,38400,70098.0,9463.0,11.89,0.0,High Risk
U361,2024,1,97129.0,Stable Salary & Stable Fixed Expenses,68819,28626.0,19182,47808.0,21011.0,30.53,0.04,Low Risk
U361,2024,2,118140.0,Stable Salary & Stable Fixed Expenses,68819,28626.0,20509,49135.0,19684.0,28.6,0.04,Low Risk
U361,2024,3,137824.0,Stable Salary & Stable Fixed Expenses,68819,28626.0,18806,47432.0,21387.0,31.08,0.04,Low Risk
U361,2024,4,159211.0,Stable Salary & Stable Fixed Expenses,68819,28626.0,17769,46395.0,22424.0,32.58,-0.02,Low Risk
U361,2024,5,181635.0,Stable Salary & Stable Fixed Expenses,68819,28626.0,16079,44705.0,24114.0,35.04,-0.03,Low Risk
U361,2024,6,205749.0,Stable Salary & Stable Fixed Expenses,68819,28626.0,17725,46351.0,22468.0,32.65,0.01,Low Risk
U361,2024,7,228217.0,Stable Salary & Stable Fixed Expenses,68819,28626.0,18871,47497.0,21322.0,30.98,-0.01,Low Risk
U361,2024,8,249539.0,Stable Salary & Stable Fixed Expenses,68819,28626.0,14610,43236.0,25583.0,37.17,0.01,Low Risk
U361,2024,9,275122.0,Stable Salary & Stable Fixed Expenses,68819,28626.0,14535,43161.0,25658.0,37.28,-0.03,Low Risk
U361,2024,10,300780.0,Stable Salary & Stable Fixed Expenses,68819,28626.0,13941,42567.0,26252.0,38.15,0.02,Low Risk
U361,2024,11,327032.0,Stable Salary & Stable Fixed Expenses,68819,28626.0,14802,43428.0,25391.0,36.9,-0.02,Low Risk
U361,2024,12,352423.0,Stable Salary & Stable Fixed Expenses,68819,28626.0,16540,45166.0,23653.0,34.37,-0.03,Low Risk
U362,2024,1,65676.0,Stable Salary & Increasing Fixed Expenses,23387,11430.0,6088,17518.0,5869.0,25.1,0.01,Low Risk
U362,2024,2,71545.0,Stable Salary & Increasing Fixed Expenses,23387,11430.0,4868,16298.0,7089.0,30.31,0.04,Low Risk
U362,2024,3,78634.0,Stable Salary & Increasing Fixed Expenses,23387,11430.0,6710,18140.0,5247.0,22.44,-0.05,Medium Risk
U362,2024,4,83881.0,Stable Salary & Increasing Fixed Expenses,23387,11430.0,5256,16686.0,6701.0,28.65,-0.05,Low Risk
U362,2024,5,90582.0,Stable Salary & Increasing Fixed Expenses,23387,11430.0,6689,18119.0,5268.0,22.53,-0.01,Medium Risk
U362,2024,6,95850.0,Stable Salary & Increasing Fixed Expenses,23387,11430.0,6725,18155.0,5232.0,22.37,-0.04,Medium Risk
U362,2024,7,101082.0,Stable Salary & Increasing Fixed Expenses,23387,11430.0,5599,17029.0,6358.0,27.19,0.01,Low Risk
U362,2024,8,107440.0,Stable Salary & Increasing Fixed Expenses,23387,11430.0,5716,17146.0,6241.0,26.69,-0.03,Low Risk
U362,2024,9,113681.0,Stable Salary & Increasing Fixed Expenses,23387,11430.0,6062,17492.0,5895.0,25.21,-0.0,Low Risk
U362,2024,10,119576.0,Stable Salary & Increasing Fixed Expenses,23387,11430.0,6552,17982.0,5405.0,23.11,-0.03,Medium Risk
U362,2024,11,124981.0,Stable Salary & Increasing Fixed Expenses,23387,11430.0,4936,16366.0,7021.0,30.02,-0.01,Low Risk
U362,2024,12,132002.0,Stable Salary & Increasing Fixed Expenses,23387,12122.0,5407,17529.0,5858.0,25.05,0.02,Low Risk
U363,2024,1,233748.0,Salary Increases & Fixed Expenses Remain Stable,231082,110759.0,84943,195702.0,35380.0,15.31,-0.01,Medium Risk
U363,2024,2,269128.0,Salary Increases & Fixed Expenses Remain Stable,231082,110759.0,76664,187423.0,43659.0,18.89,-0.0,Medium Risk
U363,2024,3,312787.0,Salary Increases & Fixed Expenses Remain Stable,231082,110759.0,106197,216956.0,14126.0,6.11,0.01,High Risk
U363,2024,4,326913.0,Salary Increases & Fixed Expenses Remain Stable,231082,110759.0,100061,210820.0,20262.0,8.77,-0.03,High Risk
U363,2024,5,347175.0,Salary Increases & Fixed Expenses Remain Stable,231082,110759.0,82299,193058.0,38024.0,16.45,-0.02,Medium Risk
U363,2024,6,385199.0,Salary Increases & Fixed Expenses Remain Stable,231082,110759.0,76229,186988.0,44094.0,19.08,-0.03,Medium Risk
U363,2024,7,429293.0,Salary Increases & Fixed Expenses Remain Stable,245330,110759.0,79842,190601.0,54729.0,22.31,-0.02,Medium Risk
U363,2024,8,484022.0,Salary Increases & Fixed Expenses Remain Stable,245330,110759.0,103045,213804.0,31526.0,12.85,0.02,High Risk
U363,2024,9,515548.0,Salary Increases & Fixed Expenses Remain Stable,245330,110759.0,122767,233526.0,11804.0,4.81,0.02,High Risk
U363,2024,10,527352.0,Salary Increases & Fixed Expenses Remain Stable,245330,110759.0,112309,223068.0,22262.0,9.07,-0.03,High Risk
U363,2024,11,549614.0,Salary Increases & Fixed Expenses Remain Stable,245330,110759.0,127397,238156.0,7174.0,2.92,-0.03,High Risk
U363,2024,12,556788.0,Salary Increases & Fixed Expenses Remain Stable,245330,110759.0,100891,211650.0,33680.0,13.73,0.0,High Risk
U364,2024,1,105776.0,Salary Increases & Fixed Expenses Increase,87215,32650.0,33577,66227.0,20988.0,24.06,-0.03,Medium Risk
U364,2024,2,126764.0,Salary Increases & Fixed Expenses Increase,87215,32650.0,42637,75287.0,11928.0,13.68,-0.03,High Risk
U364,2024,3,138692.0,Salary Increases & Fixed Expenses Increase,87215,32650.0,45446,78096.0,9119.0,10.46,0.04,High Risk
U364,2024,4,147811.0,Salary Increases & Fixed Expenses Increase,87215,32650.0,31749,64399.0,22816.0,26.16,0.0,Low Risk
U364,2024,5,170627.0,Salary Increases & Fixed Expenses Increase,87215,34149.0,30345,64494.0,22721.0,26.05,-0.01,Low Risk
U364,2024,6,193348.0,Salary Increases & Fixed Expenses Increase,87215,34149.0,33148,67297.0,19918.0,22.84,0.0,Medium Risk
U364,2024,7,213266.0,Salary Increases & Fixed Expenses Increase,87215,34149.0,41739,75888.0,11327.0,12.99,0.03,High Risk
U364,2024,8,224593.0,Salary Increases & Fixed Expenses Increase,109893,34149.0,54314,88463.0,21430.0,19.5,-0.01,Medium Risk
U364,2024,9,246023.0,Salary Increases & Fixed Expenses Increase,109893,34149.0,53177,87326.0,22567.0,20.54,0.01,Medium Risk
U364,2024,10,268590.0,Salary Increases & Fixed Expenses Increase,109893,34149.0,63720,97869.0,12024.0,10.94,-0.0,High Risk
U364,2024,11,280614.0,Salary Increases & Fixed Expenses Increase,109893,34149.0,36842,70991.0,38902.0,35.4,0.01,Low Risk
U364,2024,12,319516.0,Salary Increases & Fixed Expenses Increase,109893,34149.0,45252,79401.0,30492.0,27.75,-0.02,Low Risk
U365,2024,1,130498.0,Salary Increases & Fixed Expenses Increase,119349,79949.0,44794,124743.0,-5394.0,-4.52,0.04,High Risk
U365,2024,2,125104.0,Salary Increases & Fixed Expenses Increase,119349,79949.0,41707,121656.0,-2307.0,-1.93,0.04,High Risk
U365,2024,3,122797.0,Salary Increases & Fixed Expenses Increase,119349,79949.0,36803,116752.0,2597.0,2.18,-0.03,High Risk
U365,2024,4,125394.0,Salary Increases & Fixed Expenses Increase,119349,79949.0,37859,117808.0,1541.0,1.29,0.04,High Risk
U365,2024,5,126935.0,Salary Increases & Fixed Expenses Increase,119349,79949.0,37181,117130.0,2219.0,1.86,-0.05,High Risk
U365,2024,6,129154.0,Salary Increases & Fixed Expenses Increase,119349,79949.0,43614,123563.0,-4214.0,-3.53,-0.05,High Risk
U365,2024,7,124940.0,Salary Increases & Fixed Expenses Increase,138390,79949.0,50214,130163.0,8227.0,5.94,0.05,High Risk
U365,2024,8,133167.0,Salary Increases & Fixed Expenses Increase,138390,79949.0,41596,121545.0,16845.0,12.17,-0.04,High Risk
U365,2024,9,150012.0,Salary Increases & Fixed Expenses Increase,138390,79949.0,47124,127073.0,11317.0,8.18,-0.03,High Risk
U365,2024,10,161329.0,Salary Increases & Fixed Expenses Increase,138390,79949.0,44352,124301.0,14089.0,10.18,0.01,High Risk
U365,2024,11,175418.0,Salary Increases & Fixed Expenses Increase,138390,79949.0,64833,144782.0,-6392.0,-4.62,-0.03,High Risk
U365,2024,12,169026.0,Salary Increases & Fixed Expenses Increase,138390,79949.0,61473,141422.0,-3032.0,-2.19,0.02,High Risk
U366,2024,1,117504.0,Salary Increases & Fixed Expenses Remain Stable,73093,30036.0,20447,50483.0,22610.0,30.93,0.03,Low Risk
U366,2024,2,140114.0,Salary Increases & Fixed Expenses Remain Stable,73093,30036.0,19387,49423.0,23670.0,32.38,0.02,Low Risk
U366,2024,3,163784.0,Salary Increases & Fixed Expenses Remain Stable,82505,30036.0,22472,52508.0,29997.0,36.36,-0.05,Low Risk
U366,2024,4,193781.0,Salary Increases & Fixed Expenses Remain Stable,82505,30036.0,21051,51087.0,31418.0,38.08,0.04,Low Risk
U366,2024,5,225199.0,Salary Increases & Fixed Expenses Remain Stable,82505,30036.0,19265,49301.0,33204.0,40.24,-0.04,Low Risk
U366,2024,6,258403.0,Salary Increases & Fixed Expenses Remain Stable,82505,30036.0,23242,53278.0,29227.0,35.42,-0.01,Low Risk
U366,2024,7,287630.0,Salary Increases & Fixed Expenses Remain Stable,82505,30036.0,19393,49429.0,33076.0,40.09,-0.04,Low Risk
U366,2024,8,320706.0,Salary Increases & Fixed Expenses Remain Stable,82505,30036.0,22401,52437.0,30068.0,36.44,-0.02,Low Risk
U366,2024,9,350774.0,Salary Increases & Fixed Expenses Remain Stable,82505,30036.0,26611,56647.0,25858.0,31.34,0.01,Low Risk
U366,2024,10,376632.0,Salary Increases & Fixed Expenses Remain Stable,82505,30036.0,26359,56395.0,26110.0,31.65,-0.01,Low Risk
U366,2024,11,402742.0,Salary Increases & Fixed Expenses Remain Stable,82505,30036.0,18689,48725.0,33780.0,40.94,0.0,Low Risk
U366,2024,12,436522.0,Salary Increases & Fixed Expenses Remain Stable,82505,30036.0,20148,50184.0,32321.0,39.17,-0.04,Low Risk
U367,2024,1,250000.0,Stable Salary & Stable Fixed Expenses,267230,118592.0,124095,242687.0,24543.0,9.18,-0.02,High Risk
U367,2024,2,274543.0,Stable Salary & Stable Fixed Expenses,267230,118592.0,101979,220571.0,46659.0,17.46,-0.03,Medium Risk
U367,2024,3,321202.0,Stable Salary & Stable Fixed Expenses,267230,118592.0,87125,205717.0,61513.0,23.02,-0.03,Medium Risk
U367,2024,4,382715.0,Stable Salary & Stable Fixed Expenses,267230,118592.0,118344,236936.0,30294.0,11.34,0.04,High Risk
U367,2024,5,413009.0,Stable Salary & Stable Fixed Expenses,267230,118592.0,108863,227455.0,39775.0,14.88,-0.0,High Risk
U367,2024,6,452784.0,Stable Salary & Stable Fixed Expenses,267230,118592.0,99553,218145.0,49085.0,18.37,-0.04,Medium Risk
U367,2024,7,501869.0,Stable Salary & Stable Fixed Expenses,267230,118592.0,126707,245299.0,21931.0,8.21,0.02,High Risk
U367,2024,8,523800.0,Stable Salary & Stable Fixed Expenses,267230,118592.0,115932,234524.0,32706.0,12.24,-0.01,High Risk
U367,2024,9,556506.0,Stable Salary & Stable Fixed Expenses,267230,118592.0,125770,244362.0,22868.0,8.56,-0.0,High Risk
U367,2024,10,579374.0,Stable Salary & Stable Fixed Expenses,267230,118592.0,104167,222759.0,44471.0,16.64,0.03,Medium Risk
U367,2024,11,623845.0,Stable Salary & Stable Fixed Expenses,267230,118592.0,96328,214920.0,52310.0,19.57,0.01,Medium Risk
U367,2024,12,676155.0,Stable Salary & Stable Fixed Expenses,267230,118592.0,113767,232359.0,34871.0,13.05,0.01,High Risk
U368,2024,1,236505.0,Salary Increases & Fixed Expenses Increase,205364,102162.0,63434,165596.0,39768.0,19.36,0.03,Medium Risk
U368,2024,2,276273.0,Salary Increases & Fixed Expenses Increase,205364,102162.0,62423,164585.0,40779.0,19.86,0.02,Medium Risk
U368,2024,3,317052.0,Salary Increases & Fixed Expenses Increase,205364,102162.0,101366,203528.0,1836.0,0.89,0.01,High Risk
U368,2024,4,318888.0,Salary Increases & Fixed Expenses Increase,233073,102162.0,107672,209834.0,23239.0,9.97,0.02,High Risk
U368,2024,5,342127.0,Salary Increases & Fixed Expenses Increase,233073,102162.0,72943,175105.0,57968.0,24.87,0.05,Medium Risk
U368,2024,6,400095.0,Salary Increases & Fixed Expenses Increase,233073,102813.0,101139,203952.0,29121.0,12.49,-0.03,High Risk
U368,2024,7,429216.0,Salary Increases & Fixed Expenses Increase,233073,104790.0,109009,213799.0,19274.0,8.27,0.04,High Risk
U368,2024,8,448490.0,Salary Increases & Fixed Expenses Increase,233073,104790.0,84162,188952.0,44121.0,18.93,-0.01,Medium Risk
U368,2024,9,492611.0,Salary Increases & Fixed Expenses Increase,233073,104790.0,121508,226298.0,6775.0,2.91,-0.01,High Risk
U368,2024,10,499386.0,Salary Increases & Fixed Expenses Increase,233073,104790.0,111717,216507.0,16566.0,7.11,-0.04,High Risk
U368,2024,11,515952.0,Salary Increases & Fixed Expenses Increase,233073,104790.0,95928,200718.0,32355.0,13.88,0.04,High Risk
U368,2024,12,548307.0,Salary Increases & Fixed Expenses Increase,233073,104790.0,77152,181942.0,51131.0,21.94,0.02,Medium Risk
U369,2024,1,174674.0,Stable Salary & Increasing Fixed Expenses,149343,63004.0,38697,101701.0,47642.0,31.9,0.01,Low Risk
U369,2024,2,222316.0,Stable Salary & Increasing Fixed Expenses,149343,63004.0,31337,94341.0,55002.0,36.83,0.02,Low Risk
U369,2024,3,277318.0,Stable Salary & Increasing Fixed Expenses,149343,63705.0,38058,101763.0,47580.0,31.86,-0.04,Low Risk
U369,2024,4,324898.0,Stable Salary & Increasing Fixed Expenses,149343,64930.0,39976,104906.0,44437.0,29.75,0.04,Low Risk
U369,2024,5,369335.0,Stable Salary & Increasing Fixed Expenses,149343,64930.0,32959,97889.0,51454.0,34.45,0.02,Low Risk
U369,2024,6,420789.0,Stable Salary & Increasing Fixed Expenses,149343,64930.0,43387,108317.0,41026.0,27.47,-0.04,Low Risk
U369,2024,7,461815.0,Stable Salary & Increasing Fixed Expenses,149343,64930.0,31365,96295.0,53048.0,35.52,-0.02,Low Risk
U369,2024,8,514863.0,Stable Salary & Increasing Fixed Expenses,149343,64930.0,34469,99399.0,49944.0,33.44,-0.05,Low Risk
U369,2024,9,564807.0,Stable Salary & Increasing Fixed Expenses,149343,64930.0,33642,98572.0,50771.0,34.0,0.01,Low Risk
U369,2024,10,615578.0,Stable Salary & Increasing Fixed Expenses,149343,64930.0,33042,97972.0,51371.0,34.4,-0.01,Low Risk
U369,2024,11,666949.0,Stable Salary & Increasing Fixed Expenses,149343,64930.0,32120,97050.0,52293.0,35.02,-0.01,Low Risk
U369,2024,12,719242.0,Stable Salary & Increasing Fixed Expenses,149343,64930.0,39736,104666.0,44677.0,29.92,-0.02,Low Risk
U370,2024,1,243381.0,Stable Salary & Increasing Fixed Expenses,104213,60348.0,69734,130082.0,-25869.0,-24.82,-0.01,High Risk
U370,2024,2,217512.0,Stable Salary & Increasing Fixed Expenses,104213,60348.0,59964,120312.0,-16099.0,-15.45,0.0,High Risk
U370,2024,3,201413.0,Stable Salary & Increasing Fixed Expenses,104213,60348.0,76147,136495.0,-32282.0,-30.98,0.05,High Risk
U370,2024,4,169131.0,Stable Salary & Increasing Fixed Expenses,104213,60348.0,64361,124709.0,-20496.0,-19.67,0.0,High Risk
U370,2024,5,148635.0,Stable Salary & Increasing Fixed Expenses,104213,60348.0,54560,114908.0,-10695.0,-10.26,-0.04,High Risk
U370,2024,6,137940.0,Stable Salary & Increasing Fixed Expenses,104213,60348.0,57089,117437.0,-13224.0,-12.69,-0.03,High Risk
U370,2024,7,124716.0,Stable Salary & Increasing Fixed Expenses,104213,61357.0,59393,120750.0,-16537.0,-15.87,0.04,High Risk
U370,2024,8,108179.0,Stable Salary & Increasing Fixed Expenses,104213,61357.0,63252,124609.0,-20396.0,-19.57,0.04,High Risk
U370,2024,9,87783.0,Stable Salary & Increasing Fixed Expenses,104213,61357.0,65505,126862.0,-22649.0,-21.73,0.01,High Risk
U370,2024,10,65134.0,Stable Salary & Increasing Fixed Expenses,104213,61357.0,85383,146740.0,-42527.0,-40.81,-0.04,High Risk
U370,2024,11,22607.0,Stable Salary & Increasing Fixed Expenses,104213,61357.0,77356,138713.0,-34500.0,-33.11,0.03,High Risk
U370,2024,12,-11893.0,Stable Salary & Increasing Fixed Expenses,104213,61357.0,80896,142253.0,-38040.0,-36.5,0.01,High Risk
U371,2024,1,208437.0,Salary Increases & Fixed Expenses Remain Stable,75108,33581.0,18402,51983.0,23125.0,30.79,-0.05,Low Risk
U371,2024,2,231562.0,Salary Increases & Fixed Expenses Remain Stable,75108,33581.0,19969,53550.0,21558.0,28.7,-0.02,Low Risk
U371,2024,3,253120.0,Salary Increases & Fixed Expenses Remain Stable,75108,33581.0,17571,51152.0,23956.0,31.9,0.01,Low Risk
U371,2024,4,277076.0,Salary Increases & Fixed Expenses Remain Stable,75108,33581.0,18512,52093.0,23015.0,30.64,0.04,Low Risk
U371,2024,5,300091.0,Salary Increases & Fixed Expenses Remain Stable,75108,33581.0,16007,49588.0,25520.0,33.98,-0.04,Low Risk
U371,2024,6,325611.0,Salary Increases & Fixed Expenses Remain Stable,90339,33581.0,25496,59077.0,31262.0,34.61,0.02,Low Risk
U371,2024,7,356873.0,Salary Increases & Fixed Expenses Remain Stable,90339,33581.0,26783,60364.0,29975.0,33.18,0.01,Low Risk
U371,2024,8,386848.0,Salary Increases & Fixed Expenses Remain Stable,90339,33581.0,22584,56165.0,34174.0,37.83,-0.05,Low Risk
U371,2024,9,421022.0,Salary Increases & Fixed Expenses Remain Stable,90339,33581.0,19230,52811.0,37528.0,41.54,-0.02,Low Risk
U371,2024,10,458550.0,Salary Increases & Fixed Expenses Remain Stable,90339,33581.0,19417,52998.0,37341.0,41.33,-0.05,Low Risk
U371,2024,11,495891.0,Salary Increases & Fixed Expenses Remain Stable,90339,33581.0,24930,58511.0,31828.0,35.23,0.02,Low Risk
U371,2024,12,527719.0,Salary Increases & Fixed Expenses Remain Stable,90339,33581.0,19200,52781.0,37558.0,41.57,0.02,Low Risk
U372,2024,1,225254.0,Stable Salary & Decreasing Fixed Expenses,88744,37688.0,42274,79962.0,8782.0,9.9,0.01,High Risk
U372,2024,2,234036.0,Stable Salary & Decreasing Fixed Expenses,88744,37688.0,28283,65971.0,22773.0,25.66,-0.0,Low Risk
U372,2024,3,256809.0,Stable Salary & Decreasing Fixed Expenses,88744,37688.0,32904,70592.0,18152.0,20.45,-0.04,Medium Risk
U372,2024,4,274961.0,Stable Salary & Decreasing Fixed Expenses,88744,37688.0,43937,81625.0,7119.0,8.02,-0.04,High Risk
U372,2024,5,282080.0,Stable Salary & Decreasing Fixed Expenses,88744,37688.0,34621,72309.0,16435.0,18.52,-0.05,Medium Risk
U372,2024,6,298515.0,Stable Salary & Decreasing Fixed Expenses,88744,37688.0,33743,71431.0,17313.0,19.51,0.03,Medium Risk
U372,2024,7,315828.0,Stable Salary & Decreasing Fixed Expenses,88744,37688.0,32778,70466.0,18278.0,20.6,-0.01,Medium Risk
U372,2024,8,334106.0,Stable Salary & Decreasing Fixed Expenses,88744,37688.0,37258,74946.0,13798.0,15.55,-0.01,Medium Risk
U372,2024,9,347904.0,Stable Salary & Decreasing Fixed Expenses,88744,37688.0,41324,79012.0,9732.0,10.97,0.01,High Risk
U372,2024,10,357636.0,Stable Salary & Decreasing Fixed Expenses,88744,37688.0,42501,80189.0,8555.0,9.64,-0.01,High Risk
U372,2024,11,366191.0,Stable Salary & Decreasing Fixed Expenses,88744,37688.0,32824,70512.0,18232.0,20.54,-0.03,Medium Risk
U372,2024,12,384423.0,Stable Salary & Decreasing Fixed Expenses,88744,37688.0,27355,65043.0,23701.0,26.71,-0.02,Low Risk
U373,2024,1,250000.0,Stable Salary & Stable Fixed Expenses,282348,114853.0,73107,187960.0,94388.0,33.43,0.01,Low Risk
U373,2024,2,344388.0,Stable Salary & Stable Fixed Expenses,282348,114853.0,77738,192591.0,89757.0,31.79,-0.02,Low Risk
U373,2024,3,434145.0,Stable Salary & Stable Fixed Expenses,282348,114853.0,69605,184458.0,97890.0,34.67,0.05,Low Risk
U373,2024,4,532035.0,Stable Salary & Stable Fixed Expenses,282348,114853.0,72357,187210.0,95138.0,33.7,-0.01,Low Risk
U373,2024,5,627173.0,Stable Salary & Stable Fixed Expenses,282348,114853.0,73539,188392.0,93956.0,33.28,0.0,Low Risk
U373,2024,6,721129.0,Stable Salary & Stable Fixed Expenses,282348,114853.0,72238,187091.0,95257.0,33.74,0.01,Low Risk
U373,2024,7,816386.0,Stable Salary & Stable Fixed Expenses,282348,114853.0,56491,171344.0,111004.0,39.31,-0.0,Low Risk
U373,2024,8,927390.0,Stable Salary & Stable Fixed Expenses,282348,114853.0,80327,195180.0,87168.0,30.87,-0.01,Low Risk
U373,2024,9,1014558.0,Stable Salary & Stable Fixed Expenses,282348,114853.0,85358,200211.0,82137.0,29.09,-0.02,Low Risk
U373,2024,10,1096695.0,Stable Salary & Stable Fixed Expenses,282348,114853.0,83702,198555.0,83793.0,29.68,-0.03,Low Risk
U373,2024,11,1180488.0,Stable Salary & Stable Fixed Expenses,282348,114853.0,87005,201858.0,80490.0,28.51,-0.01,Low Risk
U373,2024,12,1260978.0,Stable Salary & Stable Fixed Expenses,282348,114853.0,58442,173295.0,109053.0,38.62,-0.01,Low Risk
U374,2024,1,154273.0,Stable Salary & Stable Fixed Expenses,129127,63519.0,26211,89730.0,39397.0,30.51,-0.03,Low Risk
U374,2024,2,193670.0,Stable Salary & Stable Fixed Expenses,129127,63519.0,29747,93266.0,35861.0,27.77,0.03,Low Risk
U374,2024,3,229531.0,Stable Salary & Stable Fixed Expenses,129127,63519.0,41285,104804.0,24323.0,18.84,0.04,Medium Risk
U374,2024,4,253854.0,Stable Salary & Stable Fixed Expenses,129127,63519.0,34343,97862.0,31265.0,24.21,0.05,Medium Risk
U374,2024,5,285119.0,Stable Salary & Stable Fixed Expenses,129127,63519.0,28453,91972.0,37155.0,28.77,0.0,Low Risk
U374,2024,6,322274.0,Stable Salary & Stable Fixed Expenses,129127,63519.0,33663,97182.0,31945.0,24.74,0.05,Medium Risk
U374,2024,7,354219.0,Stable Salary & Stable Fixed Expenses,129127,63519.0,32395,95914.0,33213.0,25.72,0.01,Low Risk
U374,2024,8,387432.0,Stable Salary & Stable Fixed Expenses,129127,63519.0,32810,96329.0,32798.0,25.4,-0.02,Low Risk
U374,2024,9,420230.0,Stable Salary & Stable Fixed Expenses,129127,63519.0,35286,98805.0,30322.0,23.48,0.05,Medium Risk
U374,2024,10,450552.0,Stable Salary & Stable Fixed Expenses,129127,63519.0,48721,112240.0,16887.0,13.08,0.05,High Risk
U374,2024,11,467439.0,Stable Salary & Stable Fixed Expenses,129127,63519.0,43932,107451.0,21676.0,16.79,0.05,Medium Risk
U374,2024,12,489115.0,Stable Salary & Stable Fixed Expenses,129127,63519.0,45635,109154.0,19973.0,15.47,-0.02,Medium Risk
U375,2024,1,236370.0,Salary Increases & Fixed Expenses Increase,59933,31889.0,20399,52288.0,7645.0,12.76,0.01,High Risk
U375,2024,2,244015.0,Salary Increases & Fixed Expenses Increase,59933,33755.0,23173,56928.0,3005.0,5.01,0.05,High Risk
U375,2024,3,247020.0,Salary Increases & Fixed Expenses Increase,59933,33755.0,21651,55406.0,4527.0,7.55,0.03,High Risk
U375,2024,4,251547.0,Salary Increases & Fixed Expenses Increase,59933,33755.0,27669,61424.0,-1491.0,-2.49,0.05,High Risk
U375,2024,5,250056.0,Salary Increases & Fixed Expenses Increase,78203,35728.0,24889,60617.0,17586.0,22.49,-0.05,Medium Risk
U375,2024,6,267642.0,Salary Increases & Fixed Expenses Increase,78203,35728.0,31437,67165.0,11038.0,14.11,0.03,High Risk
U375,2024,7,278680.0,Salary Increases & Fixed Expenses Increase,78203,35728.0,26559,62287.0,15916.0,20.35,0.04,Medium Risk
U375,2024,8,294596.0,Salary Increases & Fixed Expenses Increase,78203,35728.0,25318,61046.0,17157.0,21.94,-0.05,Medium Risk
U375,2024,9,311753.0,Salary Increases & Fixed Expenses Increase,78203,35728.0,28919,64647.0,13556.0,17.33,-0.03,Medium Risk
U375,2024,10,325309.0,Salary Increases & Fixed Expenses Increase,78203,35728.0,35188,70916.0,7287.0,9.32,-0.04,High Risk
U375,2024,11,332596.0,Salary Increases & Fixed Expenses Increase,78203,35728.0,26162,61890.0,16313.0,20.86,0.02,Medium Risk
U375,2024,12,348909.0,Salary Increases & Fixed Expenses Increase,78203,36409.0,32525,68934.0,9269.0,11.85,0.02,High Risk
U376,2024,1,249884.0,Stable Salary & Increasing Fixed Expenses,135847,64223.0,41328,105551.0,30296.0,22.3,0.01,Medium Risk
U376,2024,2,280180.0,Stable Salary & Increasing Fixed Expenses,135847,64223.0,52142,116365.0,19482.0,14.34,-0.04,High Risk
U376,2024,3,299662.0,Stable Salary & Increasing Fixed Expenses,135847,64223.0,52705,116928.0,18919.0,13.93,0.05,High Risk
U376,2024,4,318581.0,Stable Salary & Increasing Fixed Expenses,135847,64223.0,67409,131632.0,4215.0,3.1,0.03,High Risk
U376,2024,5,322796.0,Stable Salary & Increasing Fixed Expenses,135847,64223.0,66881,131104.0,4743.0,3.49,-0.01,High Risk
U376,2024,6,327539.0,Stable Salary & Increasing Fixed Expenses,135847,64223.0,48444,112667.0,23180.0,17.06,0.03,Medium Risk
U376,2024,7,350719.0,Stable Salary & Increasing Fixed Expenses,135847,64223.0,52953,117176.0,18671.0,13.74,0.05,High Risk
U376,2024,8,369390.0,Stable Salary & Increasing Fixed Expenses,135847,64223.0,51518,115741.0,20106.0,14.8,-0.05,High Risk
U376,2024,9,389496.0,Stable Salary & Increasing Fixed Expenses,135847,64223.0,64161,128384.0,7463.0,5.49,0.0,High Risk
U376,2024,10,396959.0,Stable Salary & Increasing Fixed Expenses,135847,64223.0,59915,124138.0,11709.0,8.62,-0.02,High Risk
U376,2024,11,408668.0,Stable Salary & Increasing Fixed Expenses,135847,64223.0,45278,109501.0,26346.0,19.39,0.01,Medium Risk
U376,2024,12,435014.0,Stable Salary & Increasing Fixed Expenses,135847,64223.0,66468,130691.0,5156.0,3.8,0.01,High Risk
U377,2024,1,249037.0,Stable Salary & Stable Fixed Expenses,248831,111735.0,93027,204762.0,44069.0,17.71,-0.02,Medium Risk
U377,2024,2,293106.0,Stable Salary & Stable Fixed Expenses,248831,111735.0,87606,199341.0,49490.0,19.89,-0.04,Medium Risk
U377,2024,3,342596.0,Stable Salary & Stable Fixed Expenses,248831,111735.0,101495,213230.0,35601.0,14.31,0.0,High Risk
U377,2024,4,378197.0,Stable Salary & Stable Fixed Expenses,248831,111735.0,110377,222112.0,26719.0,10.74,0.04,High Risk
U377,2024,5,404916.0,Stable Salary & Stable Fixed Expenses,248831,111735.0,112025,223760.0,25071.0,10.08,-0.03,High Risk
U377,2024,6,429987.0,Stable Salary & Stable Fixed Expenses,248831,111735.0,75185,186920.0,61911.0,24.88,0.04,Medium Risk
U377,2024,7,491898.0,Stable Salary & Stable Fixed Expenses,248831,111735.0,77749,189484.0,59347.0,23.85,0.05,Medium Risk
U377,2024,8,551245.0,Stable Salary & Stable Fixed Expenses,248831,111735.0,96169,207904.0,40927.0,16.45,-0.02,Medium Risk
U377,2024,9,592172.0,Stable Salary & Stable Fixed Expenses,248831,111735.0,136241,247976.0,855.0,0.34,0.01,High Risk
U377,2024,10,593027.0,Stable Salary & Stable Fixed Expenses,248831,111735.0,78709,190444.0,58387.0,23.46,0.04,Medium Risk
U377,2024,11,651414.0,Stable Salary & Stable Fixed Expenses,248831,111735.0,120308,232043.0,16788.0,6.75,0.01,High Risk
U377,2024,12,668202.0,Stable Salary & Stable Fixed Expenses,248831,111735.0,80910,192645.0,56186.0,22.58,-0.03,Medium Risk
U378,2024,1,250000.0,Salary Increases & Fixed Expenses Remain Stable,275824,69769.0,81301,151070.0,124754.0,45.23,-0.02,Low Risk
U378,2024,2,374754.0,Salary Increases & Fixed Expenses Remain Stable,275824,69769.0,68424,138193.0,137631.0,49.9,-0.03,Low Risk
U378,2024,3,512385.0,Salary Increases & Fixed Expenses Remain Stable,275824,69769.0,83770,153539.0,122285.0,44.33,-0.04,Low Risk
U378,2024,4,634670.0,Salary Increases & Fixed Expenses Remain Stable,275824,69769.0,70224,139993.0,135831.0,49.25,-0.04,Low Risk
U378,2024,5,770501.0,Salary Increases & Fixed Expenses Remain Stable,286336,69769.0,83223,152992.0,133344.0,46.57,0.04,Low Risk
U378,2024,6,903845.0,Salary Increases & Fixed Expenses Remain Stable,286336,69769.0,74806,144575.0,141761.0,49.51,0.04,Low Risk
U378,2024,7,1045606.0,Salary Increases & Fixed Expenses Remain Stable,286336,69769.0,80428,150197.0,136139.0,47.55,-0.02,Low Risk
U378,2024,8,1181745.0,Salary Increases & Fixed Expenses Remain Stable,286336,69769.0,77341,147110.0,139226.0,48.62,0.04,Low Risk
U378,2024,9,1320971.0,Salary Increases & Fixed Expenses Remain Stable,286336,69769.0,71904,141673.0,144663.0,50.52,-0.02,Low Risk
U378,2024,10,1465634.0,Salary Increases & Fixed Expenses Remain Stable,286336,69769.0,74729,144498.0,141838.0,49.54,-0.03,Low Risk
U378,2024,11,1607472.0,Salary Increases & Fixed Expenses Remain Stable,286336,69769.0,91807,161576.0,124760.0,43.57,0.04,Low Risk
U378,2024,12,1732232.0,Salary Increases & Fixed Expenses Remain Stable,286336,69769.0,96833,166602.0,119734.0,41.82,-0.02,Low Risk
U379,2024,1,225700.0,Stable Salary & Stable Fixed Expenses,225608,104868.0,84932,189800.0,35808.0,15.87,-0.04,Medium Risk
U379,2024,2,261508.0,Stable Salary & Stable Fixed Expenses,225608,104868.0,89553,194421.0,31187.0,13.82,0.04,High Risk
U379,2024,3,292695.0,Stable Salary & Stable Fixed Expenses,225608,104868.0,127104,231972.0,-6364.0,-2.82,-0.02,High Risk
U379,2024,4,286331.0,Stable Salary & Stable Fixed Expenses,225608,104868.0,69682,174550.0,51058.0,22.63,0.02,Medium Risk
U379,2024,5,337389.0,Stable Salary & Stable Fixed Expenses,225608,104868.0,90912,195780.0,29828.0,13.22,-0.05,High Risk
U379,2024,6,367217.0,Stable Salary & Stable Fixed Expenses,225608,104868.0,96522,201390.0,24218.0,10.73,0.03,High Risk
U379,2024,7,391435.0,Stable Salary & Stable Fixed Expenses,225608,104868.0,76362,181230.0,44378.0,19.67,0.02,Medium Risk
U379,2024,8,435813.0,Stable Salary & Stable Fixed Expenses,225608,104868.0,102723,207591.0,18017.0,7.99,0.02,High Risk
U379,2024,9,453830.0,Stable Salary & Stable Fixed Expenses,225608,104868.0,85031,189899.0,35709.0,15.83,0.04,Medium Risk
U379,2024,10,489539.0,Stable Salary & Stable Fixed Expenses,225608,104868.0,120010,224878.0,730.0,0.32,0.0,High Risk
U379,2024,11,490269.0,Stable Salary & Stable Fixed Expenses,225608,104868.0,85239,190107.0,35501.0,15.74,-0.03,Medium Risk
U379,2024,12,525770.0,Stable Salary & Stable Fixed Expenses,225608,104868.0,119340,224208.0,1400.0,0.62,-0.03,High Risk
U380,2024,1,202356.0,Salary Increases & Fixed Expenses Remain Stable,178814,68848.0,61417,130265.0,48549.0,27.15,-0.01,Low Risk
U380,2024,2,250905.0,Salary Increases & Fixed Expenses Remain Stable,178814,68848.0,81056,149904.0,28910.0,16.17,0.04,Medium Risk
U380,2024,3,279815.0,Salary Increases & Fixed Expenses Remain Stable,178814,68848.0,61043,129891.0,48923.0,27.36,0.05,Low Risk
U380,2024,4,328738.0,Salary Increases & Fixed Expenses Remain Stable,204566,68848.0,85600,154448.0,50118.0,24.5,0.04,Medium Risk
U380,2024,5,378856.0,Salary Increases & Fixed Expenses Remain Stable,204566,68848.0,98008,166856.0,37710.0,18.43,-0.03,Medium Risk
U380,2024,6,416566.0,Salary Increases & Fixed Expenses Remain Stable,204566,68848.0,63529,132377.0,72189.0,35.29,0.03,Low Risk
U380,2024,7,488755.0,Salary Increases & Fixed Expenses Remain Stable,204566,68848.0,63862,132710.0,71856.0,35.13,-0.03,Low Risk
U380,2024,8,560611.0,Salary Increases & Fixed Expenses Remain Stable,204566,68848.0,68215,137063.0,67503.0,33.0,-0.05,Low Risk
U380,2024,9,628114.0,Salary Increases & Fixed Expenses Remain Stable,204566,68848.0,86796,155644.0,48922.0,23.92,-0.01,Medium Risk
U380,2024,10,677036.0,Salary Increases & Fixed Expenses Remain Stable,204566,68848.0,63940,132788.0,71778.0,35.09,-0.01,Low Risk
U380,2024,11,748814.0,Salary Increases & Fixed Expenses Remain Stable,204566,68848.0,79647,148495.0,56071.0,27.41,-0.05,Low Risk
U380,2024,12,804885.0,Salary Increases & Fixed Expenses Remain Stable,204566,68848.0,64450,133298.0,71268.0,34.84,0.01,Low Risk
U381,2024,1,157989.0,Salary Increases & Fixed Expenses Increase,98313,24949.0,27880,52829.0,45484.0,46.26,0.02,Low Risk
U381,2024,2,203473.0,Salary Increases & Fixed Expenses Increase,98313,24949.0,23707,48656.0,49657.0,50.51,0.04,Low Risk
U381,2024,3,253130.0,Salary Increases & Fixed Expenses Increase,98313,24949.0,23775,48724.0,49589.0,50.44,0.0,Low Risk
U381,2024,4,302719.0,Salary Increases & Fixed Expenses Increase,98313,24949.0,23837,48786.0,49527.0,50.38,0.03,Low Risk
U381,2024,5,352246.0,Salary Increases & Fixed Expenses Increase,98313,24949.0,28775,53724.0,44589.0,45.35,-0.03,Low Risk
U381,2024,6,396835.0,Salary Increases & Fixed Expenses Increase,98313,25510.0,22890,48400.0,49913.0,50.77,-0.03,Low Risk
U381,2024,7,446748.0,Salary Increases & Fixed Expenses Increase,98313,25510.0,21309,46819.0,51494.0,52.38,0.04,Low Risk
U381,2024,8,498242.0,Salary Increases & Fixed Expenses Increase,119945,25510.0,30775,56285.0,63660.0,53.07,0.01,Low Risk
U381,2024,9,561902.0,Salary Increases & Fixed Expenses Increase,119945,25510.0,37842,63352.0,56593.0,47.18,0.03,Low Risk
U381,2024,10,618495.0,Salary Increases & Fixed Expenses Increase,119945,25510.0,25026,50536.0,69409.0,57.87,-0.03,Low Risk
U381,2024,11,687904.0,Salary Increases & Fixed Expenses Increase,119945,25510.0,26197,51707.0,68238.0,56.89,0.04,Low Risk
U381,2024,12,756142.0,Salary Increases & Fixed Expenses Increase,119945,26616.0,25868,52484.0,67461.0,56.24,0.03,Low Risk
U382,2024,1,244924.0,Stable Salary & Stable Fixed Expenses,202314,100520.0,57874,158394.0,43920.0,21.71,-0.02,Medium Risk
U382,2024,2,288844.0,Stable Salary & Stable Fixed Expenses,202314,100520.0,47404,147924.0,54390.0,26.88,-0.01,Low Risk
U382,2024,3,343234.0,Stable Salary & Stable Fixed Expenses,202314,100520.0,43115,143635.0,58679.0,29.0,0.05,Low Risk
U382,2024,4,401913.0,Stable Salary & Stable Fixed Expenses,202314,100520.0,52795,153315.0,48999.0,24.22,-0.02,Medium Risk
U382,2024,5,450912.0,Stable Salary & Stable Fixed Expenses,202314,100520.0,57370,157890.0,44424.0,21.96,0.01,Medium Risk
U382,2024,6,495336.0,Stable Salary & Stable Fixed Expenses,202314,100520.0,51347,151867.0,50447.0,24.94,-0.0,Medium Risk
U382,2024,7,545783.0,Stable Salary & Stable Fixed Expenses,202314,100520.0,41379,141899.0,60415.0,29.86,0.01,Low Risk
U382,2024,8,606198.0,Stable Salary & Stable Fixed Expenses,202314,100520.0,51112,151632.0,50682.0,25.05,0.01,Low Risk
U382,2024,9,656880.0,Stable Salary & Stable Fixed Expenses,202314,100520.0,53161,153681.0,48633.0,24.04,0.04,Medium Risk
U382,2024,10,705513.0,Stable Salary & Stable Fixed Expenses,202314,100520.0,47502,148022.0,54292.0,26.84,0.03,Low Risk
U382,2024,11,759805.0,Stable Salary & Stable Fixed Expenses,202314,100520.0,58121,158641.0,43673.0,21.59,0.02,Medium Risk
U382,2024,12,803478.0,Stable Salary & Stable Fixed Expenses,202314,100520.0,59207,159727.0,42587.0,21.05,0.0,Medium Risk
U383,2024,1,250000.0,Stable Salary & Stable Fixed Expenses,273164,78789.0,97715,176504.0,96660.0,35.39,-0.01,Low Risk
U383,2024,2,346660.0,Stable Salary & Stable Fixed Expenses,273164,78789.0,103015,181804.0,91360.0,33.45,-0.01,Low Risk
U383,2024,3,438020.0,Stable Salary & Stable Fixed Expenses,273164,78789.0,133157,211946.0,61218.0,22.41,-0.05,Medium Risk
U383,2024,4,499238.0,Stable Salary & Stable Fixed Expenses,273164,78789.0,126314,205103.0,68061.0,24.92,0.01,Medium Risk
U383,2024,5,567299.0,Stable Salary & Stable Fixed Expenses,273164,78789.0,94015,172804.0,100360.0,36.74,0.02,Low Risk
U383,2024,6,667659.0,Stable Salary & Stable Fixed Expenses,273164,78789.0,131859,210648.0,62516.0,22.89,0.03,Medium Risk
U383,2024,7,730175.0,Stable Salary & Stable Fixed Expenses,273164,78789.0,126810,205599.0,67565.0,24.73,-0.03,Medium Risk
U383,2024,8,797740.0,Stable Salary & Stable Fixed Expenses,273164,78789.0,106853,185642.0,87522.0,32.04,0.04,Low Risk
U383,2024,9,885262.0,Stable Salary & Stable Fixed Expenses,273164,78789.0,98635,177424.0,95740.0,35.05,0.0,Low Risk
U383,2024,10,981002.0,Stable Salary & Stable Fixed Expenses,273164,78789.0,140837,219626.0,53538.0,19.6,0.03,Medium Risk
U383,2024,11,1034540.0,Stable Salary & Stable Fixed Expenses,273164,78789.0,135691,214480.0,58684.0,21.48,0.03,Medium Risk
U383,2024,12,1093224.0,Stable Salary & Stable Fixed Expenses,273164,78789.0,115736,194525.0,78639.0,28.79,-0.02,Low Risk
U384,2024,1,168661.0,Salary Increases & Fixed Expenses Remain Stable,121572,68210.0,29403,97613.0,23959.0,19.71,-0.02,Medium Risk
U384,2024,2,192620.0,Salary Increases & Fixed Expenses Remain Stable,121572,68210.0,27378,95588.0,25984.0,21.37,-0.04,Medium Risk
U384,2024,3,218604.0,Salary Increases & Fixed Expenses Remain Stable,151013,68210.0,31630,99840.0,51173.0,33.89,0.03,Low Risk
U384,2024,4,269777.0,Salary Increases & Fixed Expenses Remain Stable,151013,68210.0,39602,107812.0,43201.0,28.61,0.04,Low Risk
U384,2024,5,312978.0,Salary Increases & Fixed Expenses Remain Stable,151013,68210.0,32751,100961.0,50052.0,33.14,-0.0,Low Risk
U384,2024,6,363030.0,Salary Increases & Fixed Expenses Remain Stable,151013,68210.0,38164,106374.0,44639.0,29.56,-0.01,Low Risk
U384,2024,7,407669.0,Salary Increases & Fixed Expenses Remain Stable,151013,68210.0,34766,102976.0,48037.0,31.81,0.01,Low Risk
U384,2024,8,455706.0,Salary Increases & Fixed Expenses Remain Stable,151013,68210.0,44082,112292.0,38721.0,25.64,-0.04,Low Risk
U384,2024,9,494427.0,Salary Increases & Fixed Expenses Remain Stable,151013,68210.0,40560,108770.0,42243.0,27.97,0.05,Low Risk
U384,2024,10,536670.0,Salary Increases & Fixed Expenses Remain Stable,151013,68210.0,37382,105592.0,45421.0,30.08,0.04,Low Risk
U384,2024,11,582091.0,Salary Increases & Fixed Expenses Remain Stable,151013,68210.0,46573,114783.0,36230.0,23.99,-0.02,Medium Risk
U384,2024,12,618321.0,Salary Increases & Fixed Expenses Remain Stable,151013,68210.0,44707,112917.0,38096.0,25.23,0.01,Low Risk
U385,2024,1,122210.0,Salary Increases & Fixed Expenses Increase,106548,63875.0,31793,95668.0,10880.0,10.21,0.05,High Risk
U385,2024,2,133090.0,Salary Increases & Fixed Expenses Increase,106548,63875.0,21692,85567.0,20981.0,19.69,-0.03,Medium Risk
U385,2024,3,154071.0,Salary Increases & Fixed Expenses Increase,132563,63875.0,37958,101833.0,30730.0,23.18,-0.01,Medium Risk
U385,2024,4,184801.0,Salary Increases & Fixed Expenses Increase,132563,63875.0,36692,100567.0,31996.0,24.14,-0.01,Medium Risk
U385,2024,5,216797.0,Salary Increases & Fixed Expenses Increase,132563,63875.0,31998,95873.0,36690.0,27.68,-0.03,Low Risk
U385,2024,6,253487.0,Salary Increases & Fixed Expenses Increase,132563,63875.0,35902,99777.0,32786.0,24.73,-0.0,Medium Risk
U385,2024,7,286273.0,Salary Increases & Fixed Expenses Increase,132563,63875.0,31690,95565.0,36998.0,27.91,0.04,Low Risk
U385,2024,8,323271.0,Salary Increases & Fixed Expenses Increase,132563,63875.0,36527,100402.0,32161.0,24.26,-0.04,Medium Risk
U385,2024,9,355432.0,Salary Increases & Fixed Expenses Increase,132563,63875.0,28176,92051.0,40512.0,30.56,0.04,Low Risk
U385,2024,10,395944.0,Salary Increases & Fixed Expenses Increase,132563,63875.0,32787,96662.0,35901.0,27.08,0.03,Low Risk
U385,2024,11,431845.0,Salary Increases & Fixed Expenses Increase,132563,63875.0,36781,100656.0,31907.0,24.07,0.02,Medium Risk
U385,2024,12,463752.0,Salary Increases & Fixed Expenses Increase,132563,63875.0,32202,96077.0,36486.0,27.52,-0.05,Low Risk
U386,2024,1,241812.0,Stable Salary & Increasing Fixed Expenses,215552,68197.0,94330,162527.0,53025.0,24.6,0.04,Medium Risk
U386,2024,2,294837.0,Stable Salary & Increasing Fixed Expenses,215552,68197.0,91114,159311.0,56241.0,26.09,0.01,Low Risk
U386,2024,3,351078.0,Stable Salary & Increasing Fixed Expenses,215552,68197.0,83138,151335.0,64217.0,29.79,-0.04,Low Risk
U386,2024,4,415295.0,Stable Salary & Increasing Fixed Expenses,215552,68197.0,98353,166550.0,49002.0,22.73,-0.04,Medium Risk
U386,2024,5,464297.0,Stable Salary & Increasing Fixed Expenses,215552,68197.0,75593,143790.0,71762.0,33.29,0.0,Low Risk
U386,2024,6,536059.0,Stable Salary & Increasing Fixed Expenses,215552,68197.0,100227,168424.0,47128.0,21.86,0.01,Medium Risk
U386,2024,7,583187.0,Stable Salary & Increasing Fixed Expenses,215552,68197.0,105184,173381.0,42171.0,19.56,-0.0,Medium Risk
U386,2024,8,625358.0,Stable Salary & Increasing Fixed Expenses,215552,68197.0,72116,140313.0,75239.0,34.91,-0.04,Low Risk
U386,2024,9,700597.0,Stable Salary & Increasing Fixed Expenses,215552,68197.0,75857,144054.0,71498.0,33.17,-0.04,Low Risk
U386,2024,10,772095.0,Stable Salary & Increasing Fixed Expenses,215552,68197.0,67121,135318.0,80234.0,37.22,0.04,Low Risk
U386,2024,11,852329.0,Stable Salary & Increasing Fixed Expenses,215552,68197.0,105674,173871.0,41681.0,19.34,-0.01,Medium Risk
U386,2024,12,894010.0,Stable Salary & Increasing Fixed Expenses,215552,68197.0,85728,153925.0,61627.0,28.59,0.01,Low Risk
U387,2024,1,235973.0,Salary Increases & Fixed Expenses Remain Stable,165587,69507.0,88521,158028.0,7559.0,4.56,0.04,High Risk
U387,2024,2,243532.0,Salary Increases & Fixed Expenses Remain Stable,165587,69507.0,112391,181898.0,-16311.0,-9.85,0.03,High Risk
U387,2024,3,227221.0,Salary Increases & Fixed Expenses Remain Stable,165587,69507.0,115713,185220.0,-19633.0,-11.86,0.04,High Risk
U387,2024,4,207588.0,Salary Increases & Fixed Expenses Remain Stable,183453,69507.0,94146,163653.0,19800.0,10.79,0.02,High Risk
U387,2024,5,227388.0,Salary Increases & Fixed Expenses Remain Stable,183453,69507.0,127167,196674.0,-13221.0,-7.21,-0.04,High Risk
U387,2024,6,214167.0,Salary Increases & Fixed Expenses Remain Stable,183453,69507.0,94264,163771.0,19682.0,10.73,-0.03,High Risk
U387,2024,7,233849.0,Salary Increases & Fixed Expenses Remain Stable,183453,69507.0,121401,190908.0,-7455.0,-4.06,0.0,High Risk
U387,2024,8,226394.0,Salary Increases & Fixed Expenses Remain Stable,183453,69507.0,110685,180192.0,3261.0,1.78,-0.04,High Risk
U387,2024,9,229655.0,Salary Increases & Fixed Expenses Remain Stable,183453,69507.0,117170,186677.0,-3224.0,-1.76,0.02,High Risk
U387,2024,10,226431.0,Salary Increases & Fixed Expenses Remain Stable,183453,69507.0,138795,208302.0,-24849.0,-13.55,0.02,High Risk
U387,2024,11,201582.0,Salary Increases & Fixed Expenses Remain Stable,183453,69507.0,135123,204630.0,-21177.0,-11.54,0.03,High Risk
U387,2024,12,180405.0,Salary Increases & Fixed Expenses Remain Stable,183453,69507.0,111374,180881.0,2572.0,1.4,-0.02,High Risk
U388,2024,1,244475.0,Stable Salary & Stable Fixed Expenses,234304,100877.0,142473,243350.0,-9046.0,-3.86,-0.01,High Risk
U388,2024,2,235429.0,Stable Salary & Stable Fixed Expenses,234304,100877.0,136332,237209.0,-2905.0,-1.24,-0.01,High Risk
U388,2024,3,232524.0,Stable Salary & Stable Fixed Expenses,234304,100877.0,145372,246249.0,-11945.0,-5.1,0.04,High Risk
U388,2024,4,220579.0,Stable Salary & Stable Fixed Expenses,234304,100877.0,140963,241840.0,-7536.0,-3.22,0.01,High Risk
U388,2024,5,213043.0,Stable Salary & Stable Fixed Expenses,234304,100877.0,138587,239464.0,-5160.0,-2.2,-0.05,High Risk
U388,2024,6,207883.0,Stable Salary & Stable Fixed Expenses,234304,100877.0,132813,233690.0,614.0,0.26,-0.01,High Risk
U388,2024,7,208497.0,Stable Salary & Stable Fixed Expenses,234304,100877.0,130223,231100.0,3204.0,1.37,0.04,High Risk
U388,2024,8,211701.0,Stable Salary & Stable Fixed Expenses,234304,100877.0,143172,244049.0,-9745.0,-4.16,0.01,High Risk
U388,2024,9,201956.0,Stable Salary & Stable Fixed Expenses,234304,100877.0,175969,276846.0,-42542.0,-18.16,0.02,High Risk
U388,2024,10,159414.0,Stable Salary & Stable Fixed Expenses,234304,100877.0,176967,277844.0,-43540.0,-18.58,-0.0,High Risk
U388,2024,11,115874.0,Stable Salary & Stable Fixed Expenses,234304,100877.0,150050,250927.0,-16623.0,-7.09,-0.04,High Risk
U388,2024,12,99251.0,Stable Salary & Stable Fixed Expenses,234304,100877.0,169606,270483.0,-36179.0,-15.44,-0.0,High Risk
U389,2024,1,230806.0,Salary Increases & Fixed Expenses Increase,72922,29232.0,46820,76052.0,-3130.0,-4.29,0.02,High Risk
U389,2024,2,227676.0,Salary Increases & Fixed Expenses Increase,72922,29232.0,38542,67774.0,5148.0,7.06,0.0,High Risk
U389,2024,3,232824.0,Salary Increases & Fixed Expenses Increase,89386,29232.0,52576,81808.0,7578.0,8.48,0.04,High Risk
U389,2024,4,240402.0,Salary Increases & Fixed Expenses Increase,89386,29232.0,48725,77957.0,11429.0,12.79,-0.04,High Risk
U389,2024,5,251831.0,Salary Increases & Fixed Expenses Increase,89386,29232.0,50292,79524.0,9862.0,11.03,0.01,High Risk
U389,2024,6,261693.0,Salary Increases & Fixed Expenses Increase,89386,29232.0,53814,83046.0,6340.0,7.09,0.01,High Risk
U389,2024,7,268033.0,Salary Increases & Fixed Expenses Increase,89386,29232.0,53958,83190.0,6196.0,6.93,0.05,High Risk
U389,2024,8,274229.0,Salary Increases & Fixed Expenses Increase,89386,29232.0,61744,90976.0,-1590.0,-1.78,0.02,High Risk
U389,2024,9,272639.0,Salary Increases & Fixed Expenses Increase,89386,29232.0,66945,96177.0,-6791.0,-7.6,0.02,High Risk
U389,2024,10,265848.0,Salary Increases & Fixed Expenses Increase,89386,29232.0,45054,74286.0,15100.0,16.89,-0.03,Medium Risk
U389,2024,11,280948.0,Salary Increases & Fixed Expenses Increase,89386,29232.0,65116,94348.0,-4962.0,-5.55,0.01,High Risk
U389,2024,12,275986.0,Salary Increases & Fixed Expenses Increase,89386,29232.0,56776,86008.0,3378.0,3.78,-0.04,High Risk
U390,2024,1,176681.0,Stable Salary & Stable Fixed Expenses,21440,11342.0,5650,16992.0,4448.0,20.75,0.02,Medium Risk
U390,2024,2,181129.0,Stable Salary & Stable Fixed Expenses,21440,11342.0,4958,16300.0,5140.0,23.97,0.04,Medium Risk
U390,2024,3,186269.0,Stable Salary & Stable Fixed Expenses,21440,11342.0,6095,17437.0,4003.0,18.67,0.04,Medium Risk
U390,2024,4,190272.0,Stable Salary & Stable Fixed Expenses,21440,11342.0,6131,17473.0,3967.0,18.5,-0.04,Medium Risk
U390,2024,5,194239.0,Stable Salary & Stable Fixed Expenses,21440,11342.0,5832,17174.0,4266.0,19.9,0.05,Medium Risk
U390,2024,6,198505.0,Stable Salary & Stable Fixed Expenses,21440,11342.0,5972,17314.0,4126.0,19.24,0.0,Medium Risk
U390,2024,7,202631.0,Stable Salary & Stable Fixed Expenses,21440,11342.0,4560,15902.0,5538.0,25.83,-0.02,Low Risk
U390,2024,8,208169.0,Stable Salary & Stable Fixed Expenses,21440,11342.0,5838,17180.0,4260.0,19.87,0.03,Medium Risk
U390,2024,9,212429.0,Stable Salary & Stable Fixed Expenses,21440,11342.0,6615,17957.0,3483.0,16.25,0.01,Medium Risk
U390,2024,10,215912.0,Stable Salary & Stable Fixed Expenses,21440,11342.0,5273,16615.0,4825.0,22.5,-0.01,Medium Risk
U390,2024,11,220737.0,Stable Salary & Stable Fixed Expenses,21440,11342.0,6526,17868.0,3572.0,16.66,-0.03,Medium Risk
U390,2024,12,224309.0,Stable Salary & Stable Fixed Expenses,21440,11342.0,4484,15826.0,5614.0,26.18,-0.01,Low Risk
U391,2024,1,66544.0,Salary Increases & Fixed Expenses Remain Stable,63955,25776.0,19628,45404.0,18551.0,29.01,-0.05,Low Risk
U391,2024,2,85095.0,Salary Increases & Fixed Expenses Remain Stable,63955,25776.0,24019,49795.0,14160.0,22.14,-0.03,Medium Risk
U391,2024,3,99255.0,Salary Increases & Fixed Expenses Remain Stable,63955,25776.0,30058,55834.0,8121.0,12.7,-0.0,High Risk
U391,2024,4,107376.0,Salary Increases & Fixed Expenses Remain Stable,63955,25776.0,21785,47561.0,16394.0,25.63,0.04,Low Risk
U391,2024,5,123770.0,Salary Increases & Fixed Expenses Remain Stable,75167,25776.0,37244,63020.0,12147.0,16.16,-0.02,Medium Risk
U391,2024,6,135917.0,Salary Increases & Fixed Expenses Remain Stable,75167,25776.0,25763,51539.0,23628.0,31.43,-0.03,Low Risk
U391,2024,7,159545.0,Salary Increases & Fixed Expenses Remain Stable,75167,25776.0,32399,58175.0,16992.0,22.61,0.04,Medium Risk
U391,2024,8,176537.0,Salary Increases & Fixed Expenses Remain Stable,75167,25776.0,33269,59045.0,16122.0,21.45,-0.04,Medium Risk
U391,2024,9,192659.0,Salary Increases & Fixed Expenses Remain Stable,75167,25776.0,37489,63265.0,11902.0,15.83,0.02,Medium Risk
U391,2024,10,204561.0,Salary Increases & Fixed Expenses Remain Stable,75167,25776.0,24346,50122.0,25045.0,33.32,-0.03,Low Risk
U391,2024,11,229606.0,Salary Increases & Fixed Expenses Remain Stable,75167,25776.0,26191,51967.0,23200.0,30.86,-0.02,Low Risk
U391,2024,12,252806.0,Salary Increases & Fixed Expenses Remain Stable,75167,25776.0,24634,50410.0,24757.0,32.94,-0.04,Low Risk
U392,2024,1,250000.0,Salary Increases & Fixed Expenses Remain Stable,299469,113688.0,161437,275125.0,24344.0,8.13,0.04,High Risk
U392,2024,2,274344.0,Salary Increases & Fixed Expenses Remain Stable,299469,113688.0,173000,286688.0,12781.0,4.27,-0.04,High Risk
U392,2024,3,287125.0,Salary Increases & Fixed Expenses Remain Stable,299469,113688.0,166534,280222.0,19247.0,6.43,-0.03,High Risk
U392,2024,4,306372.0,Salary Increases & Fixed Expenses Remain Stable,299469,113688.0,180976,294664.0,4805.0,1.6,-0.05,High Risk
U392,2024,5,311177.0,Salary Increases & Fixed Expenses Remain Stable,304946,113688.0,194992,308680.0,-3734.0,-1.22,-0.02,High Risk
U392,2024,6,307443.0,Salary Increases & Fixed Expenses Remain Stable,304946,113688.0,183062,296750.0,8196.0,2.69,0.01,High Risk
U392,2024,7,315639.0,Salary Increases & Fixed Expenses Remain Stable,304946,113688.0,172517,286205.0,18741.0,6.15,-0.05,High Risk
U392,2024,8,334380.0,Salary Increases & Fixed Expenses Remain Stable,304946,113688.0,181849,295537.0,9409.0,3.09,0.03,High Risk
U392,2024,9,343789.0,Salary Increases & Fixed Expenses Remain Stable,304946,113688.0,198292,311980.0,-7034.0,-2.31,-0.03,High Risk
U392,2024,10,336755.0,Salary Increases & Fixed Expenses Remain Stable,304946,113688.0,203369,317057.0,-12111.0,-3.97,0.01,High Risk
U392,2024,11,324644.0,Salary Increases & Fixed Expenses Remain Stable,304946,113688.0,163825,277513.0,27433.0,9.0,0.01,High Risk
U392,2024,12,352077.0,Salary Increases & Fixed Expenses Remain Stable,304946,113688.0,156698,270386.0,34560.0,11.33,0.03,High Risk
U393,2024,1,237013.0,Stable Salary & Decreasing Fixed Expenses,212843,73604.0,57567,131171.0,81672.0,38.37,-0.02,Low Risk
U393,2024,2,318685.0,Stable Salary & Decreasing Fixed Expenses,212843,73604.0,57649,131253.0,81590.0,38.33,-0.05,Low Risk
U393,2024,3,400275.0,Stable Salary & Decreasing Fixed Expenses,212843,73604.0,42970,116574.0,96269.0,45.23,-0.01,Low Risk
U393,2024,4,496544.0,Stable Salary & Decreasing Fixed Expenses,212843,73604.0,48862,122466.0,90377.0,42.46,0.04,Low Risk
U393,2024,5,586921.0,Stable Salary & Decreasing Fixed Expenses,212843,73604.0,48670,122274.0,90569.0,42.55,0.0,Low Risk
U393,2024,6,677490.0,Stable Salary & Decreasing Fixed Expenses,212843,73604.0,63243,136847.0,75996.0,35.71,-0.05,Low Risk
U393,2024,7,753486.0,Stable Salary & Decreasing Fixed Expenses,212843,73604.0,53993,127597.0,85246.0,40.05,-0.0,Low Risk
U393,2024,8,838732.0,Stable Salary & Decreasing Fixed Expenses,212843,73604.0,44807,118411.0,94432.0,44.37,-0.02,Low Risk
U393,2024,9,933164.0,Stable Salary & Decreasing Fixed Expenses,212843,73604.0,55576,129180.0,83663.0,39.31,-0.03,Low Risk
U393,2024,10,1016827.0,Stable Salary & Decreasing Fixed Expenses,212843,73604.0,55591,129195.0,83648.0,39.3,0.0,Low Risk
U393,2024,11,1100475.0,Stable Salary & Decreasing Fixed Expenses,212843,73604.0,62371,135975.0,76868.0,36.11,-0.01,Low Risk
U393,2024,12,1177343.0,Stable Salary & Decreasing Fixed Expenses,212843,73604.0,46254,119858.0,92985.0,43.69,-0.02,Low Risk
U394,2024,1,250000.0,Salary Increases & Fixed Expenses Increase,298412,87039.0,77541,164580.0,133832.0,44.85,-0.03,Low Risk
U394,2024,2,383832.0,Salary Increases & Fixed Expenses Increase,298412,88113.0,65031,153144.0,145268.0,48.68,0.01,Low Risk
U394,2024,3,529100.0,Salary Increases & Fixed Expenses Increase,298412,88113.0,67271,155384.0,143028.0,47.93,0.04,Low Risk
U394,2024,4,672128.0,Salary Increases & Fixed Expenses Increase,298412,88113.0,88063,176176.0,122236.0,40.96,-0.04,Low Risk
U394,2024,5,794364.0,Salary Increases & Fixed Expenses Increase,317316,89259.0,75400,164659.0,152657.0,48.11,-0.03,Low Risk
U394,2024,6,947021.0,Salary Increases & Fixed Expenses Increase,317316,89259.0,86597,175856.0,141460.0,44.58,0.02,Low Risk
U394,2024,7,1088481.0,Salary Increases & Fixed Expenses Increase,317316,89259.0,83624,172883.0,144433.0,45.52,-0.0,Low Risk
U394,2024,8,1232914.0,Salary Increases & Fixed Expenses Increase,317316,89259.0,72516,161775.0,155541.0,49.02,0.0,Low Risk
U394,2024,9,1388455.0,Salary Increases & Fixed Expenses Increase,317316,90550.0,63651,154201.0,163115.0,51.4,-0.01,Low Risk
U394,2024,10,1551570.0,Salary Increases & Fixed Expenses Increase,317316,90550.0,85562,176112.0,141204.0,44.5,0.04,Low Risk
U394,2024,11,1692774.0,Salary Increases & Fixed Expenses Increase,317316,90550.0,75862,166412.0,150904.0,47.56,0.03,Low Risk
U394,2024,12,1843678.0,Salary Increases & Fixed Expenses Increase,317316,90550.0,71380,161930.0,155386.0,48.97,-0.03,Low Risk
U395,2024,1,242930.0,Salary Increases & Fixed Expenses Increase,202939,82045.0,51767,133812.0,69127.0,34.06,0.0,Low Risk
U395,2024,2,312057.0,Salary Increases & Fixed Expenses Increase,202939,82045.0,47412,129457.0,73482.0,36.21,-0.03,Low Risk
U395,2024,3,385539.0,Salary Increases & Fixed Expenses Increase,231903,82045.0,67427,149472.0,82431.0,35.55,0.02,Low Risk
U395,2024,4,467970.0,Salary Increases & Fixed Expenses Increase,231903,82045.0,60778,142823.0,89080.0,38.41,-0.03,Low Risk
U395,2024,5,557050.0,Salary Increases & Fixed Expenses Increase,231903,82045.0,62081,144126.0,87777.0,37.85,0.05,Low Risk
U395,2024,6,644827.0,Salary Increases & Fixed Expenses Increase,231903,82045.0,50744,132789.0,99114.0,42.74,-0.04,Low Risk
U395,2024,7,743941.0,Salary Increases & Fixed Expenses Increase,231903,82045.0,58704,140749.0,91154.0,39.31,0.03,Low Risk
U395,2024,8,835095.0,Salary Increases & Fixed Expenses Increase,231903,82045.0,67875,149920.0,81983.0,35.35,0.03,Low Risk
U395,2024,9,917078.0,Salary Increases & Fixed Expenses Increase,231903,83367.0,73071,156438.0,75465.0,32.54,-0.03,Low Risk
U395,2024,10,992543.0,Salary Increases & Fixed Expenses Increase,231903,84372.0,48599,132971.0,98932.0,42.66,0.0,Low Risk
U395,2024,11,1091475.0,Salary Increases & Fixed Expenses Increase,231903,84372.0,53461,137833.0,94070.0,40.56,-0.0,Low Risk
U395,2024,12,1185545.0,Salary Increases & Fixed Expenses Increase,231903,84372.0,50389,134761.0,97142.0,41.89,0.03,Low Risk
U396,2024,1,217907.0,Salary Increases & Fixed Expenses Remain Stable,190473,52107.0,61446,113553.0,76920.0,40.38,-0.0,Low Risk
U396,2024,2,294827.0,Salary Increases & Fixed Expenses Remain Stable,190473,52107.0,84213,136320.0,54153.0,28.43,-0.05,Low Risk
U396,2024,3,348980.0,Salary Increases & Fixed Expenses Remain Stable,217644,52107.0,69764,121871.0,95773.0,44.0,-0.03,Low Risk
U396,2024,4,444753.0,Salary Increases & Fixed Expenses Remain Stable,217644,52107.0,76420,128527.0,89117.0,40.95,-0.02,Low Risk
U396,2024,5,533870.0,Salary Increases & Fixed Expenses Remain Stable,217644,52107.0,68520,120627.0,97017.0,44.58,0.04,Low Risk
U396,2024,6,630887.0,Salary Increases & Fixed Expenses Remain Stable,217644,52107.0,71934,124041.0,93603.0,43.01,0.03,Low Risk
U396,2024,7,724490.0,Salary Increases & Fixed Expenses Remain Stable,217644,52107.0,70687,122794.0,94850.0,43.58,0.03,Low Risk
U396,2024,8,819340.0,Salary Increases & Fixed Expenses Remain Stable,217644,52107.0,89053,141160.0,76484.0,35.14,0.03,Low Risk
U396,2024,9,895824.0,Salary Increases & Fixed Expenses Remain Stable,217644,52107.0,80364,132471.0,85173.0,39.13,0.02,Low Risk
U396,2024,10,980997.0,Salary Increases & Fixed Expenses Remain Stable,217644,52107.0,66761,118868.0,98776.0,45.38,0.01,Low Risk
U396,2024,11,1079773.0,Salary Increases & Fixed Expenses Remain Stable,217644,52107.0,89116,141223.0,76421.0,35.11,-0.02,Low Risk
U396,2024,12,1156194.0,Salary Increases & Fixed Expenses Remain Stable,217644,52107.0,88978,141085.0,76559.0,35.18,0.04,Low Risk
U397,2024,1,250000.0,Salary Increases & Fixed Expenses Remain Stable,285222,78651.0,115633,194284.0,90938.0,31.88,-0.02,Low Risk
U397,2024,2,340938.0,Salary Increases & Fixed Expenses Remain Stable,285222,78651.0,86436,165087.0,120135.0,42.12,-0.05,Low Risk
U397,2024,3,461073.0,Salary Increases & Fixed Expenses Remain Stable,285222,78651.0,115810,194461.0,90761.0,31.82,0.03,Low Risk
U397,2024,4,551834.0,Salary Increases & Fixed Expenses Remain Stable,285222,78651.0,89639,168290.0,116932.0,41.0,-0.01,Low Risk
U397,2024,5,668766.0,Salary Increases & Fixed Expenses Remain Stable,285222,78651.0,120546,199197.0,86025.0,30.16,0.01,Low Risk
U397,2024,6,754791.0,Salary Increases & Fixed Expenses Remain Stable,308174,78651.0,125343,203994.0,104180.0,33.81,0.04,Low Risk
U397,2024,7,858971.0,Salary Increases & Fixed Expenses Remain Stable,308174,78651.0,118425,197076.0,111098.0,36.05,-0.03,Low Risk
U397,2024,8,970069.0,Salary Increases & Fixed Expenses Remain Stable,308174,78651.0,97024,175675.0,132499.0,42.99,-0.02,Low Risk
U397,2024,9,1102568.0,Salary Increases & Fixed Expenses Remain Stable,308174,78651.0,131034,209685.0,98489.0,31.96,-0.0,Low Risk
U397,2024,10,1201057.0,Salary Increases & Fixed Expenses Remain Stable,308174,78651.0,122554,201205.0,106969.0,34.71,-0.01,Low Risk
U397,2024,11,1308026.0,Salary Increases & Fixed Expenses Remain Stable,308174,78651.0,166676,245327.0,62847.0,20.39,0.04,Medium Risk
U397,2024,12,1370873.0,Salary Increases & Fixed Expenses Remain Stable,308174,78651.0,142324,220975.0,87199.0,28.3,-0.0,Low Risk
U398,2024,1,117958.0,Salary Increases & Fixed Expenses Increase,76962,26531.0,17391,43922.0,33040.0,42.93,-0.01,Low Risk
U398,2024,2,150998.0,Salary Increases & Fixed Expenses Increase,76962,26531.0,19523,46054.0,30908.0,40.16,0.04,Low Risk
U398,2024,3,181906.0,Salary Increases & Fixed Expenses Increase,76962,26531.0,17111,43642.0,33320.0,43.29,0.04,Low Risk
U398,2024,4,215226.0,Salary Increases & Fixed Expenses Increase,76962,26531.0,17513,44044.0,32918.0,42.77,0.05,Low Risk
U398,2024,5,248144.0,Salary Increases & Fixed Expenses Increase,100979,26531.0,27386,53917.0,47062.0,46.61,0.02,Low Risk
U398,2024,6,295206.0,Salary Increases & Fixed Expenses Increase,100979,26531.0,24830,51361.0,49618.0,49.14,-0.01,Low Risk
U398,2024,7,344824.0,Salary Increases & Fixed Expenses Increase,100979,26531.0,20572,47103.0,53876.0,53.35,-0.02,Low Risk
U398,2024,8,398700.0,Salary Increases & Fixed Expenses Increase,100979,26531.0,21826,48357.0,52622.0,52.11,-0.04,Low Risk
U398,2024,9,451322.0,Salary Increases & Fixed Expenses Increase,100979,28197.0,31523,59720.0,41259.0,40.86,-0.03,Low Risk
U398,2024,10,492581.0,Salary Increases & Fixed Expenses Increase,100979,28197.0,21341,49538.0,51441.0,50.94,0.02,Low Risk
U398,2024,11,544022.0,Salary Increases & Fixed Expenses Increase,100979,28197.0,31318,59515.0,41464.0,41.06,-0.02,Low Risk
U398,2024,12,585486.0,Salary Increases & Fixed Expenses Increase,100979,28197.0,23388,51585.0,49394.0,48.92,-0.04,Low Risk
U399,2024,1,250000.0,Salary Increases & Fixed Expenses Remain Stable,257545,114947.0,62692,177639.0,79906.0,31.03,-0.05,Low Risk
U399,2024,2,329906.0,Salary Increases & Fixed Expenses Remain Stable,257545,114947.0,76892,191839.0,65706.0,25.51,0.02,Low Risk
U399,2024,3,395612.0,Salary Increases & Fixed Expenses Remain Stable,257545,114947.0,58675,173622.0,83923.0,32.59,0.02,Low Risk
U399,2024,4,479535.0,Salary Increases & Fixed Expenses Remain Stable,257545,114947.0,69666,184613.0,72932.0,28.32,0.02,Low Risk
U399,2024,5,552467.0,Salary Increases & Fixed Expenses Remain Stable,279557,114947.0,71627,186574.0,92983.0,33.26,-0.04,Low Risk
U399,2024,6,645450.0,Salary Increases & Fixed Expenses Remain Stable,279557,114947.0,75161,190108.0,89449.0,32.0,0.03,Low Risk
U399,2024,7,734899.0,Salary Increases & Fixed Expenses Remain Stable,279557,114947.0,77556,192503.0,87054.0,31.14,0.01,Low Risk
U399,2024,8,821953.0,Salary Increases & Fixed Expenses Remain Stable,279557,114947.0,78117,193064.0,86493.0,30.94,0.04,Low Risk
U399,2024,9,908446.0,Salary Increases & Fixed Expenses Remain Stable,279557,114947.0,78506,193453.0,86104.0,30.8,-0.03,Low Risk
U399,2024,10,994550.0,Salary Increases & Fixed Expenses Remain Stable,279557,114947.0,81082,196029.0,83528.0,29.88,-0.03,Low Risk
U399,2024,11,1078078.0,Salary Increases & Fixed Expenses Remain Stable,279557,114947.0,76286,191233.0,88324.0,31.59,-0.01,Low Risk
U399,2024,12,1166402.0,Salary Increases & Fixed Expenses Remain Stable,279557,114947.0,68554,183501.0,96056.0,34.36,-0.02,Low Risk
U400,2024,1,246308.0,Salary Increases & Fixed Expenses Decrease,245149,107307.0,105744,213051.0,32098.0,13.09,-0.03,High Risk
U400,2024,2,278406.0,Salary Increases & Fixed Expenses Decrease,245149,107307.0,90938,198245.0,46904.0,19.13,0.01,Medium Risk
U400,2024,3,325310.0,Salary Increases & Fixed Expenses Decrease,245149,106268.0,122183,228451.0,16698.0,6.81,-0.03,High Risk
U400,2024,4,342008.0,Salary Increases & Fixed Expenses Decrease,245149,106268.0,114584,220852.0,24297.0,9.91,0.03,High Risk
U400,2024,5,366305.0,Salary Increases & Fixed Expenses Decrease,245149,106268.0,108021,214289.0,30860.0,12.59,0.03,High Risk
U400,2024,6,397165.0,Salary Increases & Fixed Expenses Decrease,251535,106268.0,112220,218488.0,33047.0,13.14,-0.02,High Risk
U400,2024,7,430212.0,Salary Increases & Fixed Expenses Decrease,251535,106268.0,84876,191144.0,60391.0,24.01,-0.01,Medium Risk
U400,2024,8,490603.0,Salary Increases & Fixed Expenses Decrease,251535,106268.0,95818,202086.0,49449.0,19.66,-0.01,Medium Risk
U400,2024,9,540052.0,Salary Increases & Fixed Expenses Decrease,251535,106268.0,125943,232211.0,19324.0,7.68,-0.03,High Risk
U400,2024,10,559376.0,Salary Increases & Fixed Expenses Decrease,251535,106268.0,107574,213842.0,37693.0,14.99,0.02,High Risk
U400,2024,11,597069.0,Salary Increases & Fixed Expenses Decrease,251535,106268.0,127651,233919.0,17616.0,7.0,-0.04,High Risk
U400,2024,12,614685.0,Salary Increases & Fixed Expenses Decrease,251535,106268.0,77164,183432.0,68103.0,27.07,0.03,Low Risk
U401,2024,1,140004.0,Stable Salary & Increasing Fixed Expenses,42421,18427.0,20575,39002.0,3419.0,8.06,-0.01,High Risk
U401,2024,2,143423.0,Stable Salary & Increasing Fixed Expenses,42421,18427.0,19266,37693.0,4728.0,11.15,-0.01,High Risk
U401,2024,3,148151.0,Stable Salary & Increasing Fixed Expenses,42421,18427.0,20036,38463.0,3958.0,9.33,0.03,High Risk
U401,2024,4,152109.0,Stable Salary & Increasing Fixed Expenses,42421,20038.0,15937,35975.0,6446.0,15.2,-0.0,Medium Risk
U401,2024,5,158555.0,Stable Salary & Increasing Fixed Expenses,42421,21652.0,18123,39775.0,2646.0,6.24,0.04,High Risk
U401,2024,6,161201.0,Stable Salary & Increasing Fixed Expenses,42421,21652.0,18952,40604.0,1817.0,4.28,-0.03,High Risk
U401,2024,7,163018.0,Stable Salary & Increasing Fixed Expenses,42421,21652.0,17745,39397.0,3024.0,7.13,-0.04,High Risk
U401,2024,8,166042.0,Stable Salary & Increasing Fixed Expenses,42421,21652.0,14591,36243.0,6178.0,14.56,0.02,High Risk
U401,2024,9,172220.0,Stable Salary & Increasing Fixed Expenses,42421,21652.0,17804,39456.0,2965.0,6.99,0.05,High Risk
U401,2024,10,175185.0,Stable Salary & Increasing Fixed Expenses,42421,21652.0,14817,36469.0,5952.0,14.03,-0.03,High Risk
U401,2024,11,181137.0,Stable Salary & Increasing Fixed Expenses,42421,22997.0,18871,41868.0,553.0,1.3,-0.03,High Risk
U401,2024,12,181690.0,Stable Salary & Increasing Fixed Expenses,42421,22997.0,21123,44120.0,-1699.0,-4.01,-0.0,High Risk
U402,2024,1,244992.0,Stable Salary & Increasing Fixed Expenses,176376,49010.0,66048,115058.0,61318.0,34.77,-0.03,Low Risk
U402,2024,2,306310.0,Stable Salary & Increasing Fixed Expenses,176376,49010.0,75870,124880.0,51496.0,29.2,-0.03,Low Risk
U402,2024,3,357806.0,Stable Salary & Increasing Fixed Expenses,176376,49010.0,73664,122674.0,53702.0,30.45,0.01,Low Risk
U402,2024,4,411508.0,Stable Salary & Increasing Fixed Expenses,176376,49010.0,58634,107644.0,68732.0,38.97,0.01,Low Risk
U402,2024,5,480240.0,Stable Salary & Increasing Fixed Expenses,176376,50589.0,66077,116666.0,59710.0,33.85,0.05,Low Risk
U402,2024,6,539950.0,Stable Salary & Increasing Fixed Expenses,176376,50589.0,58634,109223.0,67153.0,38.07,0.04,Low Risk
U402,2024,7,607103.0,Stable Salary & Increasing Fixed Expenses,176376,50589.0,83925,134514.0,41862.0,23.73,-0.03,Medium Risk
U402,2024,8,648965.0,Stable Salary & Increasing Fixed Expenses,176376,50589.0,69847,120436.0,55940.0,31.72,-0.04,Low Risk
U402,2024,9,704905.0,Stable Salary & Increasing Fixed Expenses,176376,50589.0,83068,133657.0,42719.0,24.22,-0.01,Medium Risk
U402,2024,10,747624.0,Stable Salary & Increasing Fixed Expenses,176376,50589.0,64427,115016.0,61360.0,34.79,-0.02,Low Risk
U402,2024,11,808984.0,Stable Salary & Increasing Fixed Expenses,176376,50589.0,54861,105450.0,70926.0,40.21,0.05,Low Risk
U402,2024,12,879910.0,Stable Salary & Increasing Fixed Expenses,176376,50589.0,55933,106522.0,69854.0,39.61,-0.02,Low Risk
U403,2024,1,250000.0,Salary Increases & Fixed Expenses Increase,269216,79458.0,91926,171384.0,97832.0,36.34,0.04,Low Risk
U403,2024,2,347832.0,Salary Increases & Fixed Expenses Increase,269216,79458.0,130372,209830.0,59386.0,22.06,0.05,Medium Risk
U403,2024,3,407218.0,Salary Increases & Fixed Expenses Increase,269216,79458.0,125249,204707.0,64509.0,23.96,-0.05,Medium Risk
U403,2024,4,471727.0,Salary Increases & Fixed Expenses Increase,269216,79458.0,118976,198434.0,70782.0,26.29,0.05,Low Risk
U403,2024,5,542509.0,Salary Increases & Fixed Expenses Increase,269216,79458.0,93941,173399.0,95817.0,35.59,-0.02,Low Risk
U403,2024,6,638326.0,Salary Increases & Fixed Expenses Increase,269216,79458.0,109553,189011.0,80205.0,29.79,0.0,Low Risk
U403,2024,7,718531.0,Salary Increases & Fixed Expenses Increase,269216,79458.0,126872,206330.0,62886.0,23.36,-0.02,Medium Risk
U403,2024,8,781417.0,Salary Increases & Fixed Expenses Increase,276368,79458.0,104995,184453.0,91915.0,33.26,-0.04,Low Risk
U403,2024,9,873332.0,Salary Increases & Fixed Expenses Increase,276368,81203.0,146177,227380.0,48988.0,17.73,-0.01,Medium Risk
U403,2024,10,922320.0,Salary Increases & Fixed Expenses Increase,276368,81203.0,99476,180679.0,95689.0,34.62,-0.01,Low Risk
U403,2024,11,1018009.0,Salary Increases & Fixed Expenses Increase,276368,81203.0,140282,221485.0,54883.0,19.86,-0.01,Medium Risk
U403,2024,12,1072892.0,Salary Increases & Fixed Expenses Increase,276368,82715.0,87906,170621.0,105747.0,38.26,0.03,Low Risk
U404,2024,1,244113.0,Salary Increases & Fixed Expenses Remain Stable,225197,62753.0,68224,130977.0,94220.0,41.84,-0.01,Low Risk
U404,2024,2,338333.0,Salary Increases & Fixed Expenses Remain Stable,225197,62753.0,104381,167134.0,58063.0,25.78,0.01,Low Risk
U404,2024,3,396396.0,Salary Increases & Fixed Expenses Remain Stable,225197,62753.0,85966,148719.0,76478.0,33.96,-0.03,Low Risk
U404,2024,4,472874.0,Salary Increases & Fixed Expenses Remain Stable,225197,62753.0,105771,168524.0,56673.0,25.17,-0.04,Low Risk
U404,2024,5,529547.0,Salary Increases & Fixed Expenses Remain Stable,225197,62753.0,74304,137057.0,88140.0,39.14,-0.02,Low Risk
U404,2024,6,617687.0,Salary Increases & Fixed Expenses Remain Stable,225197,62753.0,76091,138844.0,86353.0,38.35,0.02,Low Risk
U404,2024,7,704040.0,Salary Increases & Fixed Expenses Remain Stable,240026,62753.0,97997,160750.0,79276.0,33.03,-0.02,Low Risk
U404,2024,8,783316.0,Salary Increases & Fixed Expenses Remain Stable,240026,62753.0,97958,160711.0,79315.0,33.04,-0.03,Low Risk
U404,2024,9,862631.0,Salary Increases & Fixed Expenses Remain Stable,240026,62753.0,88335,151088.0,88938.0,37.05,0.03,Low Risk
U404,2024,10,951569.0,Salary Increases & Fixed Expenses Remain Stable,240026,62753.0,100667,163420.0,76606.0,31.92,-0.04,Low Risk
U404,2024,11,1028175.0,Salary Increases & Fixed Expenses Remain Stable,240026,62753.0,110457,173210.0,66816.0,27.84,-0.05,Low Risk
U404,2024,12,1094991.0,Salary Increases & Fixed Expenses Remain Stable,240026,62753.0,107245,169998.0,70028.0,29.18,0.03,Low Risk
U405,2024,1,249093.0,Salary Increases & Fixed Expenses Remain Stable,238293,97702.0,71160,168862.0,69431.0,29.14,0.0,Low Risk
U405,2024,2,318524.0,Salary Increases & Fixed Expenses Remain Stable,238293,97702.0,59544,157246.0,81047.0,34.01,0.02,Low Risk
U405,2024,3,399571.0,Salary Increases & Fixed Expenses Remain Stable,238293,97702.0,65173,162875.0,75418.0,31.65,-0.02,Low Risk
U405,2024,4,474989.0,Salary Increases & Fixed Expenses Remain Stable,238293,97702.0,66760,164462.0,73831.0,30.98,0.01,Low Risk
U405,2024,5,548820.0,Salary Increases & Fixed Expenses Remain Stable,238293,97702.0,53991,151693.0,86600.0,36.34,0.03,Low Risk
U405,2024,6,635420.0,Salary Increases & Fixed Expenses Remain Stable,267701,97702.0,64518,162220.0,105481.0,39.4,-0.01,Low Risk
U405,2024,7,740901.0,Salary Increases & Fixed Expenses Remain Stable,267701,97702.0,61274,158976.0,108725.0,40.61,0.02,Low Risk
U405,2024,8,849626.0,Salary Increases & Fixed Expenses Remain Stable,267701,97702.0,78894,176596.0,91105.0,34.03,0.0,Low Risk
U405,2024,9,940731.0,Salary Increases & Fixed Expenses Remain Stable,267701,97702.0,68707,166409.0,101292.0,37.84,-0.02,Low Risk
U405,2024,10,1042023.0,Salary Increases & Fixed Expenses Remain Stable,267701,97702.0,91182,188884.0,78817.0,29.44,0.05,Low Risk
U405,2024,11,1120840.0,Salary Increases & Fixed Expenses Remain Stable,267701,97702.0,87182,184884.0,82817.0,30.94,0.03,Low Risk
U405,2024,12,1203657.0,Salary Increases & Fixed Expenses Remain Stable,267701,97702.0,83217,180919.0,86782.0,32.42,0.04,Low Risk
U406,2024,1,250000.0,Stable Salary & Decreasing Fixed Expenses,269541,63081.0,184437,247518.0,22023.0,8.17,0.04,High Risk
U406,2024,2,272023.0,Stable Salary & Decreasing Fixed Expenses,269541,63081.0,182889,245970.0,23571.0,8.74,-0.05,High Risk
U406,2024,3,295594.0,Stable Salary & Decreasing Fixed Expenses,269541,63081.0,185800,248881.0,20660.0,7.66,-0.05,High Risk
U406,2024,4,316254.0,Stable Salary & Decreasing Fixed Expenses,269541,63081.0,178201,241282.0,28259.0,10.48,0.03,High Risk
U406,2024,5,344513.0,Stable Salary & Decreasing Fixed Expenses,269541,63081.0,162471,225552.0,43989.0,16.32,0.0,Medium Risk
U406,2024,6,388502.0,Stable Salary & Decreasing Fixed Expenses,269541,63081.0,186493,249574.0,19967.0,7.41,0.03,High Risk
U406,2024,7,408469.0,Stable Salary & Decreasing Fixed Expenses,269541,63081.0,187471,250552.0,18989.0,7.04,-0.02,High Risk
U406,2024,8,427458.0,Stable Salary & Decreasing Fixed Expenses,269541,63081.0,160001,223082.0,46459.0,17.24,-0.01,Medium Risk
U406,2024,9,473917.0,Stable Salary & Decreasing Fixed Expenses,269541,63081.0,196936,260017.0,9524.0,3.53,-0.02,High Risk
U406,2024,10,483441.0,Stable Salary & Decreasing Fixed Expenses,269541,63081.0,207473,270554.0,-1013.0,-0.38,0.04,High Risk
U406,2024,11,482428.0,Stable Salary & Decreasing Fixed Expenses,269541,63081.0,174660,237741.0,31800.0,11.8,-0.0,High Risk
U406,2024,12,514228.0,Stable Salary & Decreasing Fixed Expenses,269541,63081.0,196949,260030.0,9511.0,3.53,0.01,High Risk
U407,2024,1,250000.0,Stable Salary & Stable Fixed Expenses,270958,110401.0,55155,165556.0,105402.0,38.9,0.01,Low Risk
U407,2024,2,355402.0,Stable Salary & Stable Fixed Expenses,270958,110401.0,78040,188441.0,82517.0,30.45,0.0,Low Risk
U407,2024,3,437919.0,Stable Salary & Stable Fixed Expenses,270958,110401.0,60835,171236.0,99722.0,36.8,-0.04,Low Risk
U407,2024,4,537641.0,Stable Salary & Stable Fixed Expenses,270958,110401.0,65760,176161.0,94797.0,34.99,0.01,Low Risk
U407,2024,5,632438.0,Stable Salary & Stable Fixed Expenses,270958,110401.0,68262,178663.0,92295.0,34.06,-0.01,Low Risk
U407,2024,6,724733.0,Stable Salary & Stable Fixed Expenses,270958,110401.0,54851,165252.0,105706.0,39.01,0.01,Low Risk
U407,2024,7,830439.0,Stable Salary & Stable Fixed Expenses,270958,110401.0,60254,170655.0,100303.0,37.02,-0.01,Low Risk
U407,2024,8,930742.0,Stable Salary & Stable Fixed Expenses,270958,110401.0,74740,185141.0,85817.0,31.67,0.04,Low Risk
U407,2024,9,1016559.0,Stable Salary & Stable Fixed Expenses,270958,110401.0,69687,180088.0,90870.0,33.54,0.04,Low Risk
U407,2024,10,1107429.0,Stable Salary & Stable Fixed Expenses,270958,110401.0,75821,186222.0,84736.0,31.27,0.01,Low Risk
U407,2024,11,1192165.0,Stable Salary & Stable Fixed Expenses,270958,110401.0,78176,188577.0,82381.0,30.4,0.02,Low Risk
U407,2024,12,1274546.0,Stable Salary & Stable Fixed Expenses,270958,110401.0,66892,177293.0,93665.0,34.57,-0.01,Low Risk
U408,2024,1,184595.0,Salary Increases & Fixed Expenses Remain Stable,175993,56729.0,45812,102541.0,73452.0,41.74,-0.04,Low Risk
U408,2024,2,258047.0,Salary Increases & Fixed Expenses Remain Stable,175993,56729.0,47101,103830.0,72163.0,41.0,-0.04,Low Risk
U408,2024,3,330210.0,Salary Increases & Fixed Expenses Remain Stable,175993,56729.0,35998,92727.0,83266.0,47.31,-0.04,Low Risk
U408,2024,4,413476.0,Salary Increases & Fixed Expenses Remain Stable,175993,56729.0,49053,105782.0,70211.0,39.89,0.05,Low Risk
U408,2024,5,483687.0,Salary Increases & Fixed Expenses Remain Stable,200751,56729.0,43715,100444.0,100307.0,49.97,0.03,Low Risk
U408,2024,6,583994.0,Salary Increases & Fixed Expenses Remain Stable,200751,56729.0,59566,116295.0,84456.0,42.07,0.0,Low Risk
U408,2024,7,668450.0,Salary Increases & Fixed Expenses Remain Stable,200751,56729.0,45233,101962.0,98789.0,49.21,0.04,Low Risk
U408,2024,8,767239.0,Salary Increases & Fixed Expenses Remain Stable,200751,56729.0,42974,99703.0,101048.0,50.33,-0.04,Low Risk
U408,2024,9,868287.0,Salary Increases & Fixed Expenses Remain Stable,200751,56729.0,53601,110330.0,90421.0,45.04,0.04,Low Risk
U408,2024,10,958708.0,Salary Increases & Fixed Expenses Remain Stable,200751,56729.0,45127,101856.0,98895.0,49.26,0.01,Low Risk
U408,2024,11,1057603.0,Salary Increases & Fixed Expenses Remain Stable,200751,56729.0,52923,109652.0,91099.0,45.38,0.02,Low Risk
U408,2024,12,1148702.0,Salary Increases & Fixed Expenses Remain Stable,200751,56729.0,44748,101477.0,99274.0,49.45,-0.03,Low Risk
U409,2024,1,202465.0,Salary Increases & Fixed Expenses Remain Stable,90078,37913.0,43574,81487.0,8591.0,9.54,0.02,High Risk
U409,2024,2,211056.0,Salary Increases & Fixed Expenses Remain Stable,90078,37913.0,28572,66485.0,23593.0,26.19,-0.02,Low Risk
U409,2024,3,234649.0,Salary Increases & Fixed Expenses Remain Stable,90078,37913.0,35793,73706.0,16372.0,18.18,0.02,Medium Risk
U409,2024,4,251021.0,Salary Increases & Fixed Expenses Remain Stable,90078,37913.0,40466,78379.0,11699.0,12.99,0.01,High Risk
U409,2024,5,262720.0,Salary Increases & Fixed Expenses Remain Stable,90078,37913.0,28790,66703.0,23375.0,25.95,-0.0,Low Risk
U409,2024,6,286095.0,Salary Increases & Fixed Expenses Remain Stable,90078,37913.0,33986,71899.0,18179.0,20.18,0.0,Medium Risk
U409,2024,7,304274.0,Salary Increases & Fixed Expenses Remain Stable,102903,37913.0,44534,82447.0,20456.0,19.88,0.04,Medium Risk
U409,2024,8,324730.0,Salary Increases & Fixed Expenses Remain Stable,102903,37913.0,50191,88104.0,14799.0,14.38,0.02,High Risk
U409,2024,9,339529.0,Salary Increases & Fixed Expenses Remain Stable,102903,37913.0,45544,83457.0,19446.0,18.9,0.03,Medium Risk
U409,2024,10,358975.0,Salary Increases & Fixed Expenses Remain Stable,102903,37913.0,53921,91834.0,11069.0,10.76,-0.01,High Risk
U409,2024,11,370044.0,Salary Increases & Fixed Expenses Remain Stable,102903,37913.0,48774,86687.0,16216.0,15.76,0.03,Medium Risk
U409,2024,12,386260.0,Salary Increases & Fixed Expenses Remain Stable,102903,37913.0,51493,89406.0,13497.0,13.12,-0.03,High Risk
U410,2024,1,224654.0,Salary Increases & Fixed Expenses Increase,130193,78535.0,84176,162711.0,-32518.0,-24.98,-0.03,High Risk
U410,2024,2,192136.0,Salary Increases & Fixed Expenses Increase,130193,78535.0,87512,166047.0,-35854.0,-27.54,0.0,High Risk
U410,2024,3,156282.0,Salary Increases & Fixed Expenses Increase,130193,78535.0,81496,160031.0,-29838.0,-22.92,0.02,High Risk
U410,2024,4,126444.0,Salary Increases & Fixed Expenses Increase,154835,79429.0,102116,181545.0,-26710.0,-17.25,0.04,High Risk
U410,2024,5,99734.0,Salary Increases & Fixed Expenses Increase,154835,79429.0,98841,178270.0,-23435.0,-15.14,-0.0,High Risk
U410,2024,6,76299.0,Salary Increases & Fixed Expenses Increase,154835,79429.0,105729,185158.0,-30323.0,-19.58,0.04,High Risk
U410,2024,7,45976.0,Salary Increases & Fixed Expenses Increase,154835,79429.0,100259,179688.0,-24853.0,-16.05,-0.02,High Risk
U410,2024,8,21123.0,Salary Increases & Fixed Expenses Increase,154835,80132.0,92814,172946.0,-18111.0,-11.7,-0.02,High Risk
U410,2024,9,3012.0,Salary Increases & Fixed Expenses Increase,154835,80132.0,79923,160055.0,-5220.0,-3.37,0.03,High Risk
U410,2024,10,-2208.0,Salary Increases & Fixed Expenses Increase,154835,80132.0,92996,173128.0,-18293.0,-11.81,0.03,High Risk
U410,2024,11,-20501.0,Salary Increases & Fixed Expenses Increase,154835,80132.0,89567,169699.0,-14864.0,-9.6,0.01,High Risk
U410,2024,12,-35365.0,Salary Increases & Fixed Expenses Increase,154835,80132.0,97111,177243.0,-22408.0,-14.47,0.03,High Risk
U411,2024,1,250000.0,Stable Salary & Increasing Fixed Expenses,265714,72038.0,78595,150633.0,115081.0,43.31,0.01,Low Risk
U411,2024,2,365081.0,Stable Salary & Increasing Fixed Expenses,265714,72038.0,73584,145622.0,120092.0,45.2,-0.01,Low Risk
U411,2024,3,485173.0,Stable Salary & Increasing Fixed Expenses,265714,72038.0,59702,131740.0,133974.0,50.42,-0.02,Low Risk
U411,2024,4,619147.0,Stable Salary & Increasing Fixed Expenses,265714,72038.0,77012,149050.0,116664.0,43.91,-0.03,Low Risk
U411,2024,5,735811.0,Stable Salary & Increasing Fixed Expenses,265714,72038.0,68401,140439.0,125275.0,47.15,0.03,Low Risk
U411,2024,6,861086.0,Stable Salary & Increasing Fixed Expenses,265714,72038.0,64881,136919.0,128795.0,48.47,0.0,Low Risk
U411,2024,7,989881.0,Stable Salary & Increasing Fixed Expenses,265714,72038.0,69561,141599.0,124115.0,46.71,0.04,Low Risk
U411,2024,8,1113996.0,Stable Salary & Increasing Fixed Expenses,265714,72038.0,74342,146380.0,119334.0,44.91,-0.02,Low Risk
U411,2024,9,1233330.0,Stable Salary & Increasing Fixed Expenses,265714,72038.0,55848,127886.0,137828.0,51.87,-0.04,Low Risk
U411,2024,10,1371158.0,Stable Salary & Increasing Fixed Expenses,265714,72038.0,66292,138330.0,127384.0,47.94,-0.02,Low Risk
U411,2024,11,1498542.0,Stable Salary & Increasing Fixed Expenses,265714,72038.0,63686,135724.0,129990.0,48.92,-0.04,Low Risk
U411,2024,12,1628532.0,Stable Salary & Increasing Fixed Expenses,265714,72038.0,67823,139861.0,125853.0,47.36,-0.02,Low Risk
U412,2024,1,250000.0,Stable Salary & Decreasing Fixed Expenses,294231,92013.0,64946,156959.0,137272.0,46.65,-0.05,Low Risk
U412,2024,2,387272.0,Stable Salary & Decreasing Fixed Expenses,294231,92013.0,65328,157341.0,136890.0,46.52,0.01,Low Risk
U412,2024,3,524162.0,Stable Salary & Decreasing Fixed Expenses,294231,92013.0,84664,176677.0,117554.0,39.95,0.02,Low Risk
U412,2024,4,641716.0,Stable Salary & Decreasing Fixed Expenses,294231,92013.0,86485,178498.0,115733.0,39.33,-0.04,Low Risk
U412,2024,5,757449.0,Stable Salary & Decreasing Fixed Expenses,294231,92013.0,85488,177501.0,116730.0,39.67,0.03,Low Risk
U412,2024,6,874179.0,Stable Salary & Decreasing Fixed Expenses,294231,92013.0,60868,152881.0,141350.0,48.04,0.02,Low Risk
U412,2024,7,1015529.0,Stable Salary & Decreasing Fixed Expenses,294231,92013.0,72313,164326.0,129905.0,44.15,0.03,Low Risk
U412,2024,8,1145434.0,Stable Salary & Decreasing Fixed Expenses,294231,92013.0,88108,180121.0,114110.0,38.78,0.04,Low Risk
U412,2024,9,1259544.0,Stable Salary & Decreasing Fixed Expenses,294231,92013.0,62855,154868.0,139363.0,47.37,-0.02,Low Risk
U412,2024,10,1398907.0,Stable Salary & Decreasing Fixed Expenses,294231,92013.0,99157,191170.0,103061.0,35.03,0.03,Low Risk
U412,2024,11,1501968.0,Stable Salary & Decreasing Fixed Expenses,294231,92013.0,76302,168315.0,125916.0,42.79,0.02,Low Risk
U412,2024,12,1627884.0,Stable Salary & Decreasing Fixed Expenses,294231,92013.0,91973,183986.0,110245.0,37.47,-0.01,Low Risk
U413,2024,1,198760.0,Stable Salary & Increasing Fixed Expenses,68764,35437.0,33002,68439.0,325.0,0.47,0.05,High Risk
U413,2024,2,199085.0,Stable Salary & Increasing Fixed Expenses,68764,35437.0,26317,61754.0,7010.0,10.19,-0.02,High Risk
U413,2024,3,206095.0,Stable Salary & Increasing Fixed Expenses,68764,35437.0,23389,58826.0,9938.0,14.45,-0.01,High Risk
U413,2024,4,216033.0,Stable Salary & Increasing Fixed Expenses,68764,35437.0,23383,58820.0,9944.0,14.46,-0.04,High Risk
U413,2024,5,225977.0,Stable Salary & Increasing Fixed Expenses,68764,35437.0,23675,59112.0,9652.0,14.04,-0.0,High Risk
U413,2024,6,235629.0,Stable Salary & Increasing Fixed Expenses,68764,35437.0,24397,59834.0,8930.0,12.99,0.0,High Risk
U413,2024,7,244559.0,Stable Salary & Increasing Fixed Expenses,68764,35437.0,20881,56318.0,12446.0,18.1,0.03,Medium Risk
U413,2024,8,257005.0,Stable Salary & Increasing Fixed Expenses,68764,35437.0,21759,57196.0,11568.0,16.82,0.03,Medium Risk
U413,2024,9,268573.0,Stable Salary & Increasing Fixed Expenses,68764,36467.0,23835,60302.0,8462.0,12.31,-0.03,High Risk
U413,2024,10,277035.0,Stable Salary & Increasing Fixed Expenses,68764,37867.0,20845,58712.0,10052.0,14.62,-0.01,High Risk
U413,2024,11,287087.0,Stable Salary & Increasing Fixed Expenses,68764,37867.0,27991,65858.0,2906.0,4.23,0.04,High Risk
U413,2024,12,289993.0,Stable Salary & Increasing Fixed Expenses,68764,37867.0,31971,69838.0,-1074.0,-1.56,0.04,High Risk
U414,2024,1,250000.0,Salary Increases & Fixed Expenses Remain Stable,277202,115844.0,133472,249316.0,27886.0,10.06,0.04,High Risk
U414,2024,2,277886.0,Salary Increases & Fixed Expenses Remain Stable,277202,115844.0,95337,211181.0,66021.0,23.82,0.04,Medium Risk
U414,2024,3,343907.0,Salary Increases & Fixed Expenses Remain Stable,299833,115844.0,133763,249607.0,50226.0,16.75,0.05,Medium Risk
U414,2024,4,394133.0,Salary Increases & Fixed Expenses Remain Stable,299833,115844.0,99068,214912.0,84921.0,28.32,-0.02,Low Risk
U414,2024,5,479054.0,Salary Increases & Fixed Expenses Remain Stable,299833,115844.0,129096,244940.0,54893.0,18.31,0.02,Medium Risk
U414,2024,6,533947.0,Salary Increases & Fixed Expenses Remain Stable,299833,115844.0,119141,234985.0,64848.0,21.63,-0.03,Medium Risk
U414,2024,7,598795.0,Salary Increases & Fixed Expenses Remain Stable,299833,115844.0,101569,217413.0,82420.0,27.49,0.05,Low Risk
U414,2024,8,681215.0,Salary Increases & Fixed Expenses Remain Stable,299833,115844.0,117535,233379.0,66454.0,22.16,0.05,Medium Risk
U414,2024,9,747669.0,Salary Increases & Fixed Expenses Remain Stable,299833,115844.0,157029,272873.0,26960.0,8.99,-0.04,High Risk
U414,2024,10,774629.0,Salary Increases & Fixed Expenses Remain Stable,299833,115844.0,96019,211863.0,87970.0,29.34,0.02,Low Risk
U414,2024,11,862599.0,Salary Increases & Fixed Expenses Remain Stable,299833,115844.0,145760,261604.0,38229.0,12.75,-0.03,High Risk
U414,2024,12,900828.0,Salary Increases & Fixed Expenses Remain Stable,299833,115844.0,115375,231219.0,68614.0,22.88,-0.01,Medium Risk
U415,2024,1,250000.0,Stable Salary & Increasing Fixed Expenses,260409,111521.0,98860,210381.0,50028.0,19.21,0.05,Medium Risk
U415,2024,2,300028.0,Stable Salary & Increasing Fixed Expenses,260409,112512.0,97127,209639.0,50770.0,19.5,-0.02,Medium Risk
U415,2024,3,350798.0,Stable Salary & Increasing Fixed Expenses,260409,112512.0,109772,222284.0,38125.0,14.64,-0.03,High Risk
U415,2024,4,388923.0,Stable Salary & Increasing Fixed Expenses,260409,112512.0,94152,206664.0,53745.0,20.64,-0.01,Medium Risk
U415,2024,5,442668.0,Stable Salary & Increasing Fixed Expenses,260409,112512.0,121419,233931.0,26478.0,10.17,-0.05,High Risk
U415,2024,6,469146.0,Stable Salary & Increasing Fixed Expenses,260409,112512.0,124636,237148.0,23261.0,8.93,-0.02,High Risk
U415,2024,7,492407.0,Stable Salary & Increasing Fixed Expenses,260409,114345.0,83830,198175.0,62234.0,23.9,0.03,Medium Risk
U415,2024,8,554641.0,Stable Salary & Increasing Fixed Expenses,260409,114345.0,110829,225174.0,35235.0,13.53,0.01,High Risk
U415,2024,9,589876.0,Stable Salary & Increasing Fixed Expenses,260409,115811.0,148804,264615.0,-4206.0,-1.62,-0.03,High Risk
U415,2024,10,585670.0,Stable Salary & Increasing Fixed Expenses,260409,115811.0,87342,203153.0,57256.0,21.99,-0.03,Medium Risk
U415,2024,11,642926.0,Stable Salary & Increasing Fixed Expenses,260409,117423.0,138434,255857.0,4552.0,1.75,-0.02,High Risk
U415,2024,12,647478.0,Stable Salary & Increasing Fixed Expenses,260409,119384.0,114179,233563.0,26846.0,10.31,0.03,High Risk
U416,2024,1,244079.0,Stable Salary & Stable Fixed Expenses,143674,67088.0,50946,118034.0,25640.0,17.85,0.04,Medium Risk
U416,2024,2,269719.0,Stable Salary & Stable Fixed Expenses,143674,67088.0,48811,115899.0,27775.0,19.33,0.02,Medium Risk
U416,2024,3,297494.0,Stable Salary & Stable Fixed Expenses,143674,67088.0,66476,133564.0,10110.0,7.04,-0.04,High Risk
U416,2024,4,307604.0,Stable Salary & Stable Fixed Expenses,143674,67088.0,48442,115530.0,28144.0,19.59,0.02,Medium Risk
U416,2024,5,335748.0,Stable Salary & Stable Fixed Expenses,143674,67088.0,49540,116628.0,27046.0,18.82,0.0,Medium Risk
U416,2024,6,362794.0,Stable Salary & Stable Fixed Expenses,143674,67088.0,56824,123912.0,19762.0,13.75,-0.02,High Risk
U416,2024,7,382556.0,Stable Salary & Stable Fixed Expenses,143674,67088.0,43674,110762.0,32912.0,22.91,-0.04,Medium Risk
U416,2024,8,415468.0,Stable Salary & Stable Fixed Expenses,143674,67088.0,58309,125397.0,18277.0,12.72,-0.03,High Risk
U416,2024,9,433745.0,Stable Salary & Stable Fixed Expenses,143674,67088.0,66243,133331.0,10343.0,7.2,-0.04,High Risk
U416,2024,10,444088.0,Stable Salary & Stable Fixed Expenses,143674,67088.0,49173,116261.0,27413.0,19.08,0.02,Medium Risk
U416,2024,11,471501.0,Stable Salary & Stable Fixed Expenses,143674,67088.0,53266,120354.0,23320.0,16.23,0.04,Medium Risk
U416,2024,12,494821.0,Stable Salary & Stable Fixed Expenses,143674,67088.0,60884,127972.0,15702.0,10.93,-0.04,High Risk
U417,2024,1,65839.0,Stable Salary & Increasing Fixed Expenses,43136,18726.0,23922,42648.0,488.0,1.13,-0.04,High Risk
U417,2024,2,66327.0,Stable Salary & Increasing Fixed Expenses,43136,18726.0,23954,42680.0,456.0,1.06,-0.01,High Risk
U417,2024,3,66783.0,Stable Salary & Increasing Fixed Expenses,43136,18726.0,26179,44905.0,-1769.0,-4.1,0.03,High Risk
U417,2024,4,65014.0,Stable Salary & Increasing Fixed Expenses,43136,18726.0,28888,47614.0,-4478.0,-10.38,0.03,High Risk
U417,2024,5,60536.0,Stable Salary & Increasing Fixed Expenses,43136,18726.0,25400,44126.0,-990.0,-2.3,0.02,High Risk
U417,2024,6,59546.0,Stable Salary & Increasing Fixed Expenses,43136,18726.0,26778,45504.0,-2368.0,-5.49,0.05,High Risk
U417,2024,7,57178.0,Stable Salary & Increasing Fixed Expenses,43136,18726.0,24176,42902.0,234.0,0.54,0.03,High Risk
U417,2024,8,57412.0,Stable Salary & Increasing Fixed Expenses,43136,18726.0,25706,44432.0,-1296.0,-3.0,0.02,High Risk
U417,2024,9,56116.0,Stable Salary & Increasing Fixed Expenses,43136,18726.0,31763,50489.0,-7353.0,-17.05,-0.03,High Risk
U417,2024,10,48763.0,Stable Salary & Increasing Fixed Expenses,43136,19368.0,24089,43457.0,-321.0,-0.74,0.04,High Risk
U417,2024,11,48442.0,Stable Salary & Increasing Fixed Expenses,43136,19368.0,27043,46411.0,-3275.0,-7.59,-0.03,High Risk
U417,2024,12,45167.0,Stable Salary & Increasing Fixed Expenses,43136,19368.0,27288,46656.0,-3520.0,-8.16,0.03,High Risk
U418,2024,1,239434.0,Stable Salary & Increasing Fixed Expenses,235228,82632.0,104116,186748.0,48480.0,20.61,0.01,Medium Risk
U418,2024,2,287914.0,Stable Salary & Increasing Fixed Expenses,235228,82632.0,111826,194458.0,40770.0,17.33,0.0,Medium Risk
U418,2024,3,328684.0,Stable Salary & Increasing Fixed Expenses,235228,82632.0,80496,163128.0,72100.0,30.65,-0.0,Low Risk
U418,2024,4,400784.0,Stable Salary & Increasing Fixed Expenses,235228,82632.0,88546,171178.0,64050.0,27.23,0.03,Low Risk
U418,2024,5,464834.0,Stable Salary & Increasing Fixed Expenses,235228,82632.0,103542,186174.0,49054.0,20.85,-0.02,Medium Risk
U418,2024,6,513888.0,Stable Salary & Increasing Fixed Expenses,235228,82632.0,99833,182465.0,52763.0,22.43,0.02,Medium Risk
U418,2024,7,566651.0,Stable Salary & Increasing Fixed Expenses,235228,82632.0,105929,188561.0,46667.0,19.84,0.01,Medium Risk
U418,2024,8,613318.0,Stable Salary & Increasing Fixed Expenses,235228,82632.0,93518,176150.0,59078.0,25.12,-0.01,Low Risk
U418,2024,9,672396.0,Stable Salary & Increasing Fixed Expenses,235228,82632.0,77808,160440.0,74788.0,31.79,-0.03,Low Risk
U418,2024,10,747184.0,Stable Salary & Increasing Fixed Expenses,235228,82632.0,105060,187692.0,47536.0,20.21,-0.03,Medium Risk
U418,2024,11,794720.0,Stable Salary & Increasing Fixed Expenses,235228,82632.0,95160,177792.0,57436.0,24.42,-0.04,Medium Risk
U418,2024,12,852156.0,Stable Salary & Increasing Fixed Expenses,235228,82632.0,78917,161549.0,73679.0,31.32,0.0,Low Risk
U419,2024,1,232988.0,Salary Increases & Fixed Expenses Increase,222650,69145.0,108175,177320.0,45330.0,20.36,-0.01,Medium Risk
U419,2024,2,278318.0,Salary Increases & Fixed Expenses Increase,222650,69145.0,94358,163503.0,59147.0,26.57,-0.02,Low Risk
U419,2024,3,337465.0,Salary Increases & Fixed Expenses Increase,222650,71066.0,77031,148097.0,74553.0,33.48,0.01,Low Risk
U419,2024,4,412018.0,Salary Increases & Fixed Expenses Increase,250975,71066.0,90098,161164.0,89811.0,35.78,-0.05,Low Risk
U419,2024,5,501829.0,Salary Increases & Fixed Expenses Increase,250975,71066.0,119823,190889.0,60086.0,23.94,0.04,Medium Risk
U419,2024,6,561915.0,Salary Increases & Fixed Expenses Increase,250975,71066.0,92308,163374.0,87601.0,34.9,0.04,Low Risk
U419,2024,7,649516.0,Salary Increases & Fixed Expenses Increase,250975,71066.0,77458,148524.0,102451.0,40.82,-0.02,Low Risk
U419,2024,8,751967.0,Salary Increases & Fixed Expenses Increase,250975,71066.0,110507,181573.0,69402.0,27.65,-0.04,Low Risk
U419,2024,9,821369.0,Salary Increases & Fixed Expenses Increase,250975,71066.0,100818,171884.0,79091.0,31.51,0.03,Low Risk
U419,2024,10,900460.0,Salary Increases & Fixed Expenses Increase,250975,71066.0,124976,196042.0,54933.0,21.89,-0.01,Medium Risk
U419,2024,11,955393.0,Salary Increases & Fixed Expenses Increase,250975,71925.0,97689,169614.0,81361.0,32.42,-0.02,Low Risk
U419,2024,12,1036754.0,Salary Increases & Fixed Expenses Increase,250975,72564.0,95126,167690.0,83285.0,33.18,-0.01,Low Risk
U420,2024,1,164816.0,Salary Increases & Fixed Expenses Increase,63755,36507.0,29124,65631.0,-1876.0,-2.94,0.05,High Risk
U420,2024,2,162940.0,Salary Increases & Fixed Expenses Increase,63755,36507.0,21841,58348.0,5407.0,8.48,-0.02,High Risk
U420,2024,3,168347.0,Salary Increases & Fixed Expenses Increase,63755,36507.0,22292,58799.0,4956.0,7.77,-0.02,High Risk
U420,2024,4,173303.0,Salary Increases & Fixed Expenses Increase,63755,37851.0,21902,59753.0,4002.0,6.28,-0.04,High Risk
U420,2024,5,177305.0,Salary Increases & Fixed Expenses Increase,63755,37851.0,21957,59808.0,3947.0,6.19,-0.02,High Risk
U420,2024,6,181252.0,Salary Increases & Fixed Expenses Increase,63755,37851.0,25235,63086.0,669.0,1.05,0.05,High Risk
U420,2024,7,181921.0,Salary Increases & Fixed Expenses Increase,63755,37851.0,28873,66724.0,-2969.0,-4.66,0.02,High Risk
U420,2024,8,178952.0,Salary Increases & Fixed Expenses Increase,89080,37851.0,41039,78890.0,10190.0,11.44,0.05,High Risk
U420,2024,9,189142.0,Salary Increases & Fixed Expenses Increase,89080,37851.0,36046,73897.0,15183.0,17.04,0.0,Medium Risk
U420,2024,10,204325.0,Salary Increases & Fixed Expenses Increase,89080,37851.0,28141,65992.0,23088.0,25.92,0.03,Low Risk
U420,2024,11,227413.0,Salary Increases & Fixed Expenses Increase,89080,37851.0,46136,83987.0,5093.0,5.72,-0.02,High Risk
U420,2024,12,232506.0,Salary Increases & Fixed Expenses Increase,89080,37851.0,31870,69721.0,19359.0,21.73,0.02,Medium Risk
U421,2024,1,250000.0,Stable Salary & Increasing Fixed Expenses,266526,109776.0,65534,175310.0,91216.0,34.22,0.04,Low Risk
U421,2024,2,341216.0,Stable Salary & Increasing Fixed Expenses,266526,109776.0,68923,178699.0,87827.0,32.95,-0.03,Low Risk
U421,2024,3,429043.0,Stable Salary & Increasing Fixed Expenses,266526,109776.0,74399,184175.0,82351.0,30.9,0.01,Low Risk
U421,2024,4,511394.0,Stable Salary & Increasing Fixed Expenses,266526,109776.0,66635,176411.0,90115.0,33.81,-0.02,Low Risk
U421,2024,5,601509.0,Stable Salary & Increasing Fixed Expenses,266526,109776.0,78036,187812.0,78714.0,29.53,-0.02,Low Risk
U421,2024,6,680223.0,Stable Salary & Increasing Fixed Expenses,266526,109776.0,67069,176845.0,89681.0,33.65,-0.02,Low Risk
U421,2024,7,769904.0,Stable Salary & Increasing Fixed Expenses,266526,109776.0,73639,183415.0,83111.0,31.18,-0.01,Low Risk
U421,2024,8,853015.0,Stable Salary & Increasing Fixed Expenses,266526,109776.0,63945,173721.0,92805.0,34.82,0.03,Low Risk
U421,2024,9,945820.0,Stable Salary & Increasing Fixed Expenses,266526,109776.0,89209,198985.0,67541.0,25.34,-0.03,Low Risk
U421,2024,10,1013361.0,Stable Salary & Increasing Fixed Expenses,266526,109776.0,67793,177569.0,88957.0,33.38,-0.02,Low Risk
U421,2024,11,1102318.0,Stable Salary & Increasing Fixed Expenses,266526,109776.0,89398,199174.0,67352.0,25.27,-0.03,Low Risk
U421,2024,12,1169670.0,Stable Salary & Increasing Fixed Expenses,266526,109776.0,60726,170502.0,96024.0,36.03,-0.05,Low Risk
U422,2024,1,177635.0,Stable Salary & Stable Fixed Expenses,142378,77715.0,46195,123910.0,18468.0,12.97,-0.0,High Risk
U422,2024,2,196103.0,Stable Salary & Stable Fixed Expenses,142378,77715.0,54128,131843.0,10535.0,7.4,-0.03,High Risk
U422,2024,3,206638.0,Stable Salary & Stable Fixed Expenses,142378,77715.0,57553,135268.0,7110.0,4.99,0.03,High Risk
U422,2024,4,213748.0,Stable Salary & Stable Fixed Expenses,142378,77715.0,51917,129632.0,12746.0,8.95,0.05,High Risk
U422,2024,5,226494.0,Stable Salary & Stable Fixed Expenses,142378,77715.0,58957,136672.0,5706.0,4.01,0.03,High Risk
U422,2024,6,232200.0,Stable Salary & Stable Fixed Expenses,142378,77715.0,51363,129078.0,13300.0,9.34,-0.04,High Risk
U422,2024,7,245500.0,Stable Salary & Stable Fixed Expenses,142378,77715.0,65481,143196.0,-818.0,-0.57,-0.04,High Risk
U422,2024,8,244682.0,Stable Salary & Stable Fixed Expenses,142378,77715.0,56553,134268.0,8110.0,5.7,0.01,High Risk
U422,2024,9,252792.0,Stable Salary & Stable Fixed Expenses,142378,77715.0,54848,132563.0,9815.0,6.89,0.02,High Risk
U422,2024,10,262607.0,Stable Salary & Stable Fixed Expenses,142378,77715.0,60519,138234.0,4144.0,2.91,0.02,High Risk
U422,2024,11,266751.0,Stable Salary & Stable Fixed Expenses,142378,77715.0,57174,134889.0,7489.0,5.26,-0.04,High Risk
U422,2024,12,274240.0,Stable Salary & Stable Fixed Expenses,142378,77715.0,50594,128309.0,14069.0,9.88,-0.01,High Risk
U423,2024,1,164553.0,Stable Salary & Increasing Fixed Expenses,85996,37555.0,20940,58495.0,27501.0,31.98,0.04,Low Risk
U423,2024,2,192054.0,Stable Salary & Increasing Fixed Expenses,85996,37555.0,25261,62816.0,23180.0,26.95,0.0,Low Risk
U423,2024,3,215234.0,Stable Salary & Increasing Fixed Expenses,85996,37555.0,26995,64550.0,21446.0,24.94,-0.0,Medium Risk
U423,2024,4,236680.0,Stable Salary & Increasing Fixed Expenses,85996,37555.0,19418,56973.0,29023.0,33.75,0.03,Low Risk
U423,2024,5,265703.0,Stable Salary & Increasing Fixed Expenses,85996,37555.0,20429,57984.0,28012.0,32.57,-0.03,Low Risk
U423,2024,6,293715.0,Stable Salary & Increasing Fixed Expenses,85996,37555.0,24940,62495.0,23501.0,27.33,-0.04,Low Risk
U423,2024,7,317216.0,Stable Salary & Increasing Fixed Expenses,85996,37555.0,23865,61420.0,24576.0,28.58,-0.03,Low Risk
U423,2024,8,341792.0,Stable Salary & Increasing Fixed Expenses,85996,37555.0,19559,57114.0,28882.0,33.59,0.03,Low Risk
U423,2024,9,370674.0,Stable Salary & Increasing Fixed Expenses,85996,37555.0,21267,58822.0,27174.0,31.6,-0.03,Low Risk
U423,2024,10,397848.0,Stable Salary & Increasing Fixed Expenses,85996,37555.0,28653,66208.0,19788.0,23.01,-0.02,Medium Risk
U423,2024,11,417636.0,Stable Salary & Increasing Fixed Expenses,85996,37555.0,24859,62414.0,23582.0,27.42,0.0,Low Risk
U423,2024,12,441218.0,Stable Salary & Increasing Fixed Expenses,85996,37555.0,22586,60141.0,25855.0,30.07,-0.05,Low Risk
U424,2024,1,126875.0,Salary Increases & Fixed Expenses Increase,58775,35537.0,13293,48830.0,9945.0,16.92,-0.04,Medium Risk
U424,2024,2,136820.0,Salary Increases & Fixed Expenses Increase,58775,35537.0,14507,50044.0,8731.0,14.85,-0.05,High Risk
U424,2024,3,145551.0,Salary Increases & Fixed Expenses Increase,58775,35537.0,13846,49383.0,9392.0,15.98,-0.03,Medium Risk
U424,2024,4,154943.0,Salary Increases & Fixed Expenses Increase,77803,36357.0,22328,58685.0,19118.0,24.57,-0.02,Medium Risk
U424,2024,5,174061.0,Salary Increases & Fixed Expenses Increase,77803,36357.0,23006,59363.0,18440.0,23.7,0.04,Medium Risk
U424,2024,6,192501.0,Salary Increases & Fixed Expenses Increase,77803,36357.0,15865,52222.0,25581.0,32.88,0.04,Low Risk
U424,2024,7,218082.0,Salary Increases & Fixed Expenses Increase,77803,36357.0,22295,58652.0,19151.0,24.61,0.01,Medium Risk
U424,2024,8,237233.0,Salary Increases & Fixed Expenses Increase,77803,36357.0,20288,56645.0,21158.0,27.19,0.03,Low Risk
U424,2024,9,258391.0,Salary Increases & Fixed Expenses Increase,77803,36357.0,22254,58611.0,19192.0,24.67,-0.05,Medium Risk
U424,2024,10,277583.0,Salary Increases & Fixed Expenses Increase,77803,36357.0,21862,58219.0,19584.0,25.17,0.04,Low Risk
U424,2024,11,297167.0,Salary Increases & Fixed Expenses Increase,77803,37077.0,20122,57199.0,20604.0,26.48,-0.02,Low Risk
U424,2024,12,317771.0,Salary Increases & Fixed Expenses Increase,77803,38011.0,18233,56244.0,21559.0,27.71,0.01,Low Risk
U425,2024,1,250000.0,Salary Increases & Fixed Expenses Remain Stable,262196,107298.0,117646,224944.0,37252.0,14.21,0.03,High Risk
U425,2024,2,287252.0,Salary Increases & Fixed Expenses Remain Stable,262196,107298.0,123174,230472.0,31724.0,12.1,-0.05,High Risk
U425,2024,3,318976.0,Salary Increases & Fixed Expenses Remain Stable,262196,107298.0,106898,214196.0,48000.0,18.31,0.0,Medium Risk
U425,2024,4,366976.0,Salary Increases & Fixed Expenses Remain Stable,262196,107298.0,112597,219895.0,42301.0,16.13,0.02,Medium Risk
U425,2024,5,409277.0,Salary Increases & Fixed Expenses Remain Stable,271432,107298.0,84654,191952.0,79480.0,29.28,0.03,Low Risk
U425,2024,6,488757.0,Salary Increases & Fixed Expenses Remain Stable,271432,107298.0,125866,233164.0,38268.0,14.1,-0.03,High Risk
U425,2024,7,527025.0,Salary Increases & Fixed Expenses Remain Stable,271432,107298.0,91988,199286.0,72146.0,26.58,0.02,Low Risk
U425,2024,8,599171.0,Salary Increases & Fixed Expenses Remain Stable,271432,107298.0,92616,199914.0,71518.0,26.35,0.04,Low Risk
U425,2024,9,670689.0,Salary Increases & Fixed Expenses Remain Stable,271432,107298.0,140201,247499.0,23933.0,8.82,-0.05,High Risk
U425,2024,10,694622.0,Salary Increases & Fixed Expenses Remain Stable,271432,107298.0,135526,242824.0,28608.0,10.54,-0.02,High Risk
U425,2024,11,723230.0,Salary Increases & Fixed Expenses Remain Stable,271432,107298.0,131794,239092.0,32340.0,11.91,0.03,High Risk
U425,2024,12,755570.0,Salary Increases & Fixed Expenses Remain Stable,271432,107298.0,145870,253168.0,18264.0,6.73,0.05,High Risk
U426,2024,1,102120.0,Salary Increases & Fixed Expenses Remain Stable,90161,25659.0,44922,70581.0,19580.0,21.72,-0.0,Medium Risk
U426,2024,2,121700.0,Salary Increases & Fixed Expenses Remain Stable,90161,25659.0,29884,55543.0,34618.0,38.4,-0.05,Low Risk
U426,2024,3,156318.0,Salary Increases & Fixed Expenses Remain Stable,90161,25659.0,44999,70658.0,19503.0,21.63,-0.04,Medium Risk
U426,2024,4,175821.0,Salary Increases & Fixed Expenses Remain Stable,104355,25659.0,52055,77714.0,26641.0,25.53,0.04,Low Risk
U426,2024,5,202462.0,Salary Increases & Fixed Expenses Remain Stable,104355,25659.0,49820,75479.0,28876.0,27.67,0.01,Low Risk
U426,2024,6,231338.0,Salary Increases & Fixed Expenses Remain Stable,104355,25659.0,49948,75607.0,28748.0,27.55,0.04,Low Risk
U426,2024,7,260086.0,Salary Increases & Fixed Expenses Remain Stable,104355,25659.0,34566,60225.0,44130.0,42.29,-0.02,Low Risk
U426,2024,8,304216.0,Salary Increases & Fixed Expenses Remain Stable,104355,25659.0,50555,76214.0,28141.0,26.97,0.0,Low Risk
U426,2024,9,332357.0,Salary Increases & Fixed Expenses Remain Stable,104355,25659.0,48595,74254.0,30101.0,28.84,0.01,Low Risk
U426,2024,10,362458.0,Salary Increases & Fixed Expenses Remain Stable,104355,25659.0,47727,73386.0,30969.0,29.68,-0.03,Low Risk
U426,2024,11,393427.0,Salary Increases & Fixed Expenses Remain Stable,104355,25659.0,43136,68795.0,35560.0,34.08,-0.04,Low Risk
U426,2024,12,428987.0,Salary Increases & Fixed Expenses Remain Stable,104355,25659.0,48573,74232.0,30123.0,28.87,0.01,Low Risk
U427,2024,1,238901.0,Salary Increases & Fixed Expenses Remain Stable,141690,67344.0,48979,116323.0,25367.0,17.9,0.04,Medium Risk
U427,2024,2,264268.0,Salary Increases & Fixed Expenses Remain Stable,141690,67344.0,66739,134083.0,7607.0,5.37,-0.02,High Risk
U427,2024,3,271875.0,Salary Increases & Fixed Expenses Remain Stable,141690,67344.0,46314,113658.0,28032.0,19.78,-0.03,Medium Risk
U427,2024,4,299907.0,Salary Increases & Fixed Expenses Remain Stable,160177,67344.0,56927,124271.0,35906.0,22.42,0.03,Medium Risk
U427,2024,5,335813.0,Salary Increases & Fixed Expenses Remain Stable,160177,67344.0,77284,144628.0,15549.0,9.71,0.05,High Risk
U427,2024,6,351362.0,Salary Increases & Fixed Expenses Remain Stable,160177,67344.0,51703,119047.0,41130.0,25.68,0.04,Low Risk
U427,2024,7,392492.0,Salary Increases & Fixed Expenses Remain Stable,160177,67344.0,71295,138639.0,21538.0,13.45,0.03,High Risk
U427,2024,8,414030.0,Salary Increases & Fixed Expenses Remain Stable,160177,67344.0,55936,123280.0,36897.0,23.04,-0.05,Medium Risk
U427,2024,9,450927.0,Salary Increases & Fixed Expenses Remain Stable,160177,67344.0,56715,124059.0,36118.0,22.55,-0.0,Medium Risk
U427,2024,10,487045.0,Salary Increases & Fixed Expenses Remain Stable,160177,67344.0,79371,146715.0,13462.0,8.4,0.02,High Risk
U427,2024,11,500507.0,Salary Increases & Fixed Expenses Remain Stable,160177,67344.0,83337,150681.0,9496.0,5.93,0.01,High Risk
U427,2024,12,510003.0,Salary Increases & Fixed Expenses Remain Stable,160177,67344.0,70389,137733.0,22444.0,14.01,0.04,High Risk
U428,2024,1,180561.0,Salary Increases & Fixed Expenses Increase,130345,42831.0,31103,73934.0,56411.0,43.28,0.02,Low Risk
U428,2024,2,236972.0,Salary Increases & Fixed Expenses Increase,130345,42831.0,28513,71344.0,59001.0,45.27,0.0,Low Risk
U428,2024,3,295973.0,Salary Increases & Fixed Expenses Increase,130345,42831.0,37132,79963.0,50382.0,38.65,-0.01,Low Risk
U428,2024,4,346355.0,Salary Increases & Fixed Expenses Increase,130345,42831.0,26464,69295.0,61050.0,46.84,0.04,Low Risk
U428,2024,5,407405.0,Salary Increases & Fixed Expenses Increase,130345,42831.0,26536,69367.0,60978.0,46.78,-0.01,Low Risk
U428,2024,6,468383.0,Salary Increases & Fixed Expenses Increase,152053,43813.0,36407,80220.0,71833.0,47.24,-0.02,Low Risk
U428,2024,7,540216.0,Salary Increases & Fixed Expenses Increase,152053,45242.0,34054,79296.0,72757.0,47.85,-0.01,Low Risk
U428,2024,8,612973.0,Salary Increases & Fixed Expenses Increase,152053,45242.0,43188,88430.0,63623.0,41.84,-0.01,Low Risk
U428,2024,9,676596.0,Salary Increases & Fixed Expenses Increase,152053,45242.0,39904,85146.0,66907.0,44.0,-0.03,Low Risk
U428,2024,10,743503.0,Salary Increases & Fixed Expenses Increase,152053,47076.0,47559,94635.0,57418.0,37.76,-0.03,Low Risk
U428,2024,11,800921.0,Salary Increases & Fixed Expenses Increase,152053,47076.0,48703,95779.0,56274.0,37.01,0.04,Low Risk
U428,2024,12,857195.0,Salary Increases & Fixed Expenses Increase,152053,47076.0,49400,96476.0,55577.0,36.55,-0.04,Low Risk
U429,2024,1,250000.0,Salary Increases & Fixed Expenses Remain Stable,275474,60857.0,78185,139042.0,136432.0,49.53,-0.04,Low Risk
U429,2024,2,386432.0,Salary Increases & Fixed Expenses Remain Stable,275474,60857.0,66649,127506.0,147968.0,53.71,-0.01,Low Risk
U429,2024,3,534400.0,Salary Increases & Fixed Expenses Remain Stable,275474,60857.0,69083,129940.0,145534.0,52.83,-0.01,Low Risk
U429,2024,4,679934.0,Salary Increases & Fixed Expenses Remain Stable,301228,60857.0,81871,142728.0,158500.0,52.62,-0.0,Low Risk
U429,2024,5,838434.0,Salary Increases & Fixed Expenses Remain Stable,301228,60857.0,60612,121469.0,179759.0,59.68,-0.02,Low Risk
U429,2024,6,1018193.0,Salary Increases & Fixed Expenses Remain Stable,301228,60857.0,67402,128259.0,172969.0,57.42,-0.04,Low Risk
U429,2024,7,1191162.0,Salary Increases & Fixed Expenses Remain Stable,301228,60857.0,71473,132330.0,168898.0,56.07,0.0,Low Risk
U429,2024,8,1360060.0,Salary Increases & Fixed Expenses Remain Stable,301228,60857.0,81416,142273.0,158955.0,52.77,-0.02,Low Risk
U429,2024,9,1519015.0,Salary Increases & Fixed Expenses Remain Stable,301228,60857.0,97846,158703.0,142525.0,47.31,-0.02,Low Risk
U429,2024,10,1661540.0,Salary Increases & Fixed Expenses Remain Stable,301228,60857.0,64297,125154.0,176074.0,58.45,-0.0,Low Risk
U429,2024,11,1837614.0,Salary Increases & Fixed Expenses Remain Stable,301228,60857.0,97117,157974.0,143254.0,47.56,-0.04,Low Risk
U429,2024,12,1980868.0,Salary Increases & Fixed Expenses Remain Stable,301228,60857.0,61607,122464.0,178764.0,59.35,0.03,Low Risk
U430,2024,1,250000.0,Stable Salary & Decreasing Fixed Expenses,296742,73430.0,83783,157213.0,139529.0,47.02,0.0,Low Risk
U430,2024,2,389529.0,Stable Salary & Decreasing Fixed Expenses,296742,73430.0,71736,145166.0,151576.0,51.08,-0.01,Low Risk
U430,2024,3,541105.0,Stable Salary & Decreasing Fixed Expenses,296742,73430.0,88871,162301.0,134441.0,45.31,-0.02,Low Risk
U430,2024,4,675546.0,Stable Salary & Decreasing Fixed Expenses,296742,73430.0,61873,135303.0,161439.0,54.4,-0.02,Low Risk
U430,2024,5,836985.0,Stable Salary & Decreasing Fixed Expenses,296742,73430.0,72231,145661.0,151081.0,50.91,-0.03,Low Risk
U430,2024,6,988066.0,Stable Salary & Decreasing Fixed Expenses,296742,73430.0,60281,133711.0,163031.0,54.94,-0.04,Low Risk
U430,2024,7,1151097.0,Stable Salary & Decreasing Fixed Expenses,296742,72023.0,62650,134673.0,162069.0,54.62,-0.01,Low Risk
U430,2024,8,1313166.0,Stable Salary & Decreasing Fixed Expenses,296742,72023.0,59929,131952.0,164790.0,55.53,0.03,Low Risk
U430,2024,9,1477956.0,Stable Salary & Decreasing Fixed Expenses,296742,72023.0,77727,149750.0,146992.0,49.54,0.02,Low Risk
U430,2024,10,1624948.0,Stable Salary & Decreasing Fixed Expenses,296742,72023.0,88884,160907.0,135835.0,45.78,-0.05,Low Risk
U430,2024,11,1760783.0,Stable Salary & Decreasing Fixed Expenses,296742,72023.0,99464,171487.0,125255.0,42.21,-0.05,Low Risk
U430,2024,12,1886038.0,Stable Salary & Decreasing Fixed Expenses,296742,72023.0,99835,171858.0,124884.0,42.09,-0.04,Low Risk
U431,2024,1,250000.0,Stable Salary & Stable Fixed Expenses,250254,76400.0,51978,128378.0,121876.0,48.7,0.02,Low Risk
U431,2024,2,371876.0,Stable Salary & Stable Fixed Expenses,250254,76400.0,65309,141709.0,108545.0,43.37,0.0,Low Risk
U431,2024,3,480421.0,Stable Salary & Stable Fixed Expenses,250254,76400.0,50804,127204.0,123050.0,49.17,-0.04,Low Risk
U431,2024,4,603471.0,Stable Salary & Stable Fixed Expenses,250254,76400.0,66708,143108.0,107146.0,42.81,-0.03,Low Risk
U431,2024,5,710617.0,Stable Salary & Stable Fixed Expenses,250254,76400.0,55297,131697.0,118557.0,47.37,0.04,Low Risk
U431,2024,6,829174.0,Stable Salary & Stable Fixed Expenses,250254,76400.0,68922,145322.0,104932.0,41.93,-0.03,Low Risk
U431,2024,7,934106.0,Stable Salary & Stable Fixed Expenses,250254,76400.0,71874,148274.0,101980.0,40.75,-0.02,Low Risk
U431,2024,8,1036086.0,Stable Salary & Stable Fixed Expenses,250254,76400.0,57529,133929.0,116325.0,46.48,0.01,Low Risk
U431,2024,9,1152411.0,Stable Salary & Stable Fixed Expenses,250254,76400.0,59864,136264.0,113990.0,45.55,0.0,Low Risk
U431,2024,10,1266401.0,Stable Salary & Stable Fixed Expenses,250254,76400.0,65273,141673.0,108581.0,43.39,0.01,Low Risk
U431,2024,11,1374982.0,Stable Salary & Stable Fixed Expenses,250254,76400.0,78322,154722.0,95532.0,38.17,-0.05,Low Risk
U431,2024,12,1470514.0,Stable Salary & Stable Fixed Expenses,250254,76400.0,66446,142846.0,107408.0,42.92,-0.0,Low Risk
U432,2024,1,145509.0,Salary Increases & Fixed Expenses Increase,50991,36171.0,10856,47027.0,3964.0,7.77,-0.04,High Risk
U432,2024,2,149473.0,Salary Increases & Fixed Expenses Increase,50991,36171.0,14161,50332.0,659.0,1.29,0.04,High Risk
U432,2024,3,150132.0,Salary Increases & Fixed Expenses Increase,50991,36171.0,12717,48888.0,2103.0,4.12,-0.02,High Risk
U432,2024,4,152235.0,Salary Increases & Fixed Expenses Increase,50991,36171.0,13355,49526.0,1465.0,2.87,0.04,High Risk
U432,2024,5,153700.0,Salary Increases & Fixed Expenses Increase,76416,36171.0,22045,58216.0,18200.0,23.82,0.01,Medium Risk
U432,2024,6,171900.0,Salary Increases & Fixed Expenses Increase,76416,36171.0,20030,56201.0,20215.0,26.45,0.02,Low Risk
U432,2024,7,192115.0,Salary Increases & Fixed Expenses Increase,76416,36171.0,17697,53868.0,22548.0,29.51,-0.01,Low Risk
U432,2024,8,214663.0,Salary Increases & Fixed Expenses Increase,76416,37869.0,21416,59285.0,17131.0,22.42,0.03,Medium Risk
U432,2024,9,231794.0,Salary Increases & Fixed Expenses Increase,76416,38767.0,18143,56910.0,19506.0,25.53,0.04,Low Risk
U432,2024,10,251300.0,Salary Increases & Fixed Expenses Increase,76416,38767.0,24848,63615.0,12801.0,16.75,-0.04,Medium Risk
U432,2024,11,264101.0,Salary Increases & Fixed Expenses Increase,76416,38767.0,20199,58966.0,17450.0,22.84,0.05,Medium Risk
U432,2024,12,281551.0,Salary Increases & Fixed Expenses Increase,76416,38767.0,18146,56913.0,19503.0,25.52,-0.05,Low Risk
U433,2024,1,181896.0,Salary Increases & Fixed Expenses Increase,138894,50100.0,61437,111537.0,27357.0,19.7,-0.0,Medium Risk
U433,2024,2,209253.0,Salary Increases & Fixed Expenses Increase,138894,50100.0,57075,107175.0,31719.0,22.84,-0.04,Medium Risk
U433,2024,3,240972.0,Salary Increases & Fixed Expenses Increase,138894,50100.0,61142,111242.0,27652.0,19.91,-0.04,Medium Risk
U433,2024,4,268624.0,Salary Increases & Fixed Expenses Increase,138894,50100.0,47171,97271.0,41623.0,29.97,0.02,Low Risk
U433,2024,5,310247.0,Salary Increases & Fixed Expenses Increase,162087,51256.0,58495,109751.0,52336.0,32.29,-0.04,Low Risk
U433,2024,6,362583.0,Salary Increases & Fixed Expenses Increase,162087,51256.0,74923,126179.0,35908.0,22.15,0.02,Medium Risk
U433,2024,7,398491.0,Salary Increases & Fixed Expenses Increase,162087,51256.0,63123,114379.0,47708.0,29.43,-0.02,Low Risk
U433,2024,8,446199.0,Salary Increases & Fixed Expenses Increase,162087,53202.0,76156,129358.0,32729.0,20.19,-0.02,Medium Risk
U433,2024,9,478928.0,Salary Increases & Fixed Expenses Increase,162087,53202.0,85662,138864.0,23223.0,14.33,0.03,High Risk
U433,2024,10,502151.0,Salary Increases & Fixed Expenses Increase,162087,53202.0,74505,127707.0,34380.0,21.21,-0.02,Medium Risk
U433,2024,11,536531.0,Salary Increases & Fixed Expenses Increase,162087,53202.0,73397,126599.0,35488.0,21.89,-0.05,Medium Risk
U433,2024,12,572019.0,Salary Increases & Fixed Expenses Increase,162087,53202.0,53320,106522.0,55565.0,34.28,0.04,Low Risk
U434,2024,1,242136.0,Salary Increases & Fixed Expenses Increase,240848,64665.0,84223,148888.0,91960.0,38.18,-0.01,Low Risk
U434,2024,2,334096.0,Salary Increases & Fixed Expenses Increase,240848,64665.0,118412,183077.0,57771.0,23.99,0.01,Medium Risk
U434,2024,3,391867.0,Salary Increases & Fixed Expenses Increase,250799,64665.0,99172,163837.0,86962.0,34.67,-0.02,Low Risk
U434,2024,4,478829.0,Salary Increases & Fixed Expenses Increase,250799,64665.0,91824,156489.0,94310.0,37.6,0.01,Low Risk
U434,2024,5,573139.0,Salary Increases & Fixed Expenses Increase,250799,66643.0,82805,149448.0,101351.0,40.41,0.05,Low Risk
U434,2024,6,674490.0,Salary Increases & Fixed Expenses Increase,250799,66643.0,96610,163253.0,87546.0,34.91,-0.02,Low Risk
U434,2024,7,762036.0,Salary Increases & Fixed Expenses Increase,250799,66643.0,82878,149521.0,101278.0,40.38,-0.02,Low Risk
U434,2024,8,863314.0,Salary Increases & Fixed Expenses Increase,250799,66643.0,104819,171462.0,79337.0,31.63,0.01,Low Risk
U434,2024,9,942651.0,Salary Increases & Fixed Expenses Increase,250799,66643.0,122175,188818.0,61981.0,24.71,-0.05,Medium Risk
U434,2024,10,1004632.0,Salary Increases & Fixed Expenses Increase,250799,68536.0,130693,199229.0,51570.0,20.56,-0.04,Medium Risk
U434,2024,11,1056202.0,Salary Increases & Fixed Expenses Increase,250799,68536.0,105376,173912.0,76887.0,30.66,-0.02,Low Risk
U434,2024,12,1133089.0,Salary Increases & Fixed Expenses Increase,250799,68536.0,121182,189718.0,61081.0,24.35,-0.01,Medium Risk
U435,2024,1,147610.0,Salary Increases & Fixed Expenses Decrease,139467,74060.0,66827,140887.0,-1420.0,-1.02,0.0,High Risk
U435,2024,2,146190.0,Salary Increases & Fixed Expenses Decrease,139467,74060.0,46351,120411.0,19056.0,13.66,-0.01,High Risk
U435,2024,3,165246.0,Salary Increases & Fixed Expenses Decrease,139467,74060.0,67480,141540.0,-2073.0,-1.49,-0.02,High Risk
U435,2024,4,163173.0,Salary Increases & Fixed Expenses Decrease,139467,74060.0,62715,136775.0,2692.0,1.93,0.03,High Risk
U435,2024,5,165865.0,Salary Increases & Fixed Expenses Decrease,139467,74060.0,47271,121331.0,18136.0,13.0,-0.05,High Risk
U435,2024,6,184001.0,Salary Increases & Fixed Expenses Decrease,139467,74060.0,44205,118265.0,21202.0,15.2,0.02,Medium Risk
U435,2024,7,205203.0,Salary Increases & Fixed Expenses Decrease,147657,74060.0,62712,136772.0,10885.0,7.37,-0.01,High Risk
U435,2024,8,216088.0,Salary Increases & Fixed Expenses Decrease,147657,74060.0,56376,130436.0,17221.0,11.66,0.03,High Risk
U435,2024,9,233309.0,Salary Increases & Fixed Expenses Decrease,147657,74060.0,77110,151170.0,-3513.0,-2.38,-0.02,High Risk
U435,2024,10,229796.0,Salary Increases & Fixed Expenses Decrease,147657,74060.0,66420,140480.0,7177.0,4.86,-0.02,High Risk
U435,2024,11,236973.0,Salary Increases & Fixed Expenses Decrease,147657,73193.0,56253,129446.0,18211.0,12.33,0.0,High Risk
U435,2024,12,255184.0,Salary Increases & Fixed Expenses Decrease,147657,73193.0,70904,144097.0,3560.0,2.41,0.02,High Risk
U436,2024,1,226064.0,Salary Increases & Fixed Expenses Remain Stable,154165,45889.0,93498,139387.0,14778.0,9.59,0.02,High Risk
U436,2024,2,240842.0,Salary Increases & Fixed Expenses Remain Stable,154165,45889.0,88236,134125.0,20040.0,13.0,0.01,High Risk
U436,2024,3,260882.0,Salary Increases & Fixed Expenses Remain Stable,154165,45889.0,119525,165414.0,-11249.0,-7.3,0.01,High Risk
U436,2024,4,249633.0,Salary Increases & Fixed Expenses Remain Stable,164981,45889.0,83294,129183.0,35798.0,21.7,-0.03,Medium Risk
U436,2024,5,285431.0,Salary Increases & Fixed Expenses Remain Stable,164981,45889.0,106344,152233.0,12748.0,7.73,0.0,High Risk
U436,2024,6,298179.0,Salary Increases & Fixed Expenses Remain Stable,164981,45889.0,95629,141518.0,23463.0,14.22,0.0,High Risk
U436,2024,7,321642.0,Salary Increases & Fixed Expenses Remain Stable,164981,45889.0,100358,146247.0,18734.0,11.36,-0.04,High Risk
U436,2024,8,340376.0,Salary Increases & Fixed Expenses Remain Stable,164981,45889.0,97557,143446.0,21535.0,13.05,-0.0,High Risk
U436,2024,9,361911.0,Salary Increases & Fixed Expenses Remain Stable,164981,45889.0,113390,159279.0,5702.0,3.46,0.01,High Risk
U436,2024,10,367613.0,Salary Increases & Fixed Expenses Remain Stable,164981,45889.0,142679,188568.0,-23587.0,-14.3,0.02,High Risk
U436,2024,11,344026.0,Salary Increases & Fixed Expenses Remain Stable,164981,45889.0,125312,171201.0,-6220.0,-3.77,0.05,High Risk
U436,2024,12,337806.0,Salary Increases & Fixed Expenses Remain Stable,164981,45889.0,137398,183287.0,-18306.0,-11.1,-0.03,High Risk
U437,2024,1,246213.0,Salary Increases & Fixed Expenses Remain Stable,243783,107216.0,81045,188261.0,55522.0,22.78,0.04,Medium Risk
U437,2024,2,301735.0,Salary Increases & Fixed Expenses Remain Stable,243783,107216.0,102173,209389.0,34394.0,14.11,-0.0,High Risk
U437,2024,3,336129.0,Salary Increases & Fixed Expenses Remain Stable,243783,107216.0,103552,210768.0,33015.0,13.54,0.05,High Risk
U437,2024,4,369144.0,Salary Increases & Fixed Expenses Remain Stable,243783,107216.0,100368,207584.0,36199.0,14.85,0.03,High Risk
U437,2024,5,405343.0,Salary Increases & Fixed Expenses Remain Stable,243783,107216.0,88258,195474.0,48309.0,19.82,0.04,Medium Risk
U437,2024,6,453652.0,Salary Increases & Fixed Expenses Remain Stable,243783,107216.0,93933,201149.0,42634.0,17.49,0.04,Medium Risk
U437,2024,7,496286.0,Salary Increases & Fixed Expenses Remain Stable,243783,107216.0,85425,192641.0,51142.0,20.98,0.03,Medium Risk
U437,2024,8,547428.0,Salary Increases & Fixed Expenses Remain Stable,257103,107216.0,124015,231231.0,25872.0,10.06,0.03,High Risk
U437,2024,9,573300.0,Salary Increases & Fixed Expenses Remain Stable,257103,107216.0,125932,233148.0,23955.0,9.32,-0.03,High Risk
U437,2024,10,597255.0,Salary Increases & Fixed Expenses Remain Stable,257103,107216.0,115550,222766.0,34337.0,13.36,-0.01,High Risk
U437,2024,11,631592.0,Salary Increases & Fixed Expenses Remain Stable,257103,107216.0,130330,237546.0,19557.0,7.61,-0.01,High Risk
U437,2024,12,651149.0,Salary Increases & Fixed Expenses Remain Stable,257103,107216.0,107252,214468.0,42635.0,16.58,-0.03,Medium Risk
U438,2024,1,128220.0,Salary Increases & Fixed Expenses Remain Stable,29603,17894.0,9785,27679.0,1924.0,6.5,0.0,High Risk
U438,2024,2,130144.0,Salary Increases & Fixed Expenses Remain Stable,29603,17894.0,12559,30453.0,-850.0,-2.87,0.02,High Risk
U438,2024,3,129294.0,Salary Increases & Fixed Expenses Remain Stable,29603,17894.0,13352,31246.0,-1643.0,-5.55,-0.02,High Risk
U438,2024,4,127651.0,Salary Increases & Fixed Expenses Remain Stable,29603,17894.0,12104,29998.0,-395.0,-1.33,0.04,High Risk
U438,2024,5,127256.0,Salary Increases & Fixed Expenses Remain Stable,29603,17894.0,11132,29026.0,577.0,1.95,-0.0,High Risk
U438,2024,6,127833.0,Salary Increases & Fixed Expenses Remain Stable,29603,17894.0,8962,26856.0,2747.0,9.28,0.05,High Risk
U438,2024,7,130580.0,Salary Increases & Fixed Expenses Remain Stable,29603,17894.0,14247,32141.0,-2538.0,-8.57,0.04,High Risk
U438,2024,8,128042.0,Salary Increases & Fixed Expenses Remain Stable,56426,17894.0,21802,39696.0,16730.0,29.65,-0.04,Low Risk
U438,2024,9,144772.0,Salary Increases & Fixed Expenses Remain Stable,56426,17894.0,29375,47269.0,9157.0,16.23,0.02,Medium Risk
U438,2024,10,153929.0,Salary Increases & Fixed Expenses Remain Stable,56426,17894.0,17782,35676.0,20750.0,36.77,-0.01,Low Risk
U438,2024,11,174679.0,Salary Increases & Fixed Expenses Remain Stable,56426,17894.0,21241,39135.0,17291.0,30.64,-0.04,Low Risk
U438,2024,12,191970.0,Salary Increases & Fixed Expenses Remain Stable,56426,17894.0,24049,41943.0,14483.0,25.67,0.01,Low Risk
U439,2024,1,250000.0,Stable Salary & Stable Fixed Expenses,256100,68881.0,176014,244895.0,11205.0,4.38,-0.02,High Risk
U439,2024,2,261205.0,Stable Salary & Stable Fixed Expenses,256100,68881.0,162874,231755.0,24345.0,9.51,-0.02,High Risk
U439,2024,3,285550.0,Stable Salary & Stable Fixed Expenses,256100,68881.0,158786,227667.0,28433.0,11.1,0.01,High Risk
U439,2024,4,313983.0,Stable Salary & Stable Fixed Expenses,256100,68881.0,131446,200327.0,55773.0,21.78,-0.04,Medium Risk
U439,2024,5,369756.0,Stable Salary & Stable Fixed Expenses,256100,68881.0,177185,246066.0,10034.0,3.92,0.02,High Risk
U439,2024,6,379790.0,Stable Salary & Stable Fixed Expenses,256100,68881.0,162704,231585.0,24515.0,9.57,0.02,High Risk
U439,2024,7,404305.0,Stable Salary & Stable Fixed Expenses,256100,68881.0,168516,237397.0,18703.0,7.3,-0.02,High Risk
U439,2024,8,423008.0,Stable Salary & Stable Fixed Expenses,256100,68881.0,152866,221747.0,34353.0,13.41,0.04,High Risk
U439,2024,9,457361.0,Stable Salary & Stable Fixed Expenses,256100,68881.0,144321,213202.0,42898.0,16.75,0.04,Medium Risk
U439,2024,10,500259.0,Stable Salary & Stable Fixed Expenses,256100,68881.0,161170,230051.0,26049.0,10.17,-0.01,High Risk
U439,2024,11,526308.0,Stable Salary & Stable Fixed Expenses,256100,68881.0,142336,211217.0,44883.0,17.53,-0.05,Medium Risk
U439,2024,12,571191.0,Stable Salary & Stable Fixed Expenses,256100,68881.0,131155,200036.0,56064.0,21.89,0.0,Medium Risk
U440,2024,1,191622.0,Salary Increases & Fixed Expenses Increase,124392,79887.0,41068,120955.0,3437.0,2.76,0.04,High Risk
U440,2024,2,195059.0,Salary Increases & Fixed Expenses Increase,124392,79887.0,60221,140108.0,-15716.0,-12.63,0.03,High Risk
U440,2024,3,179343.0,Salary Increases & Fixed Expenses Increase,124392,79887.0,70337,150224.0,-25832.0,-20.77,0.02,High Risk
U440,2024,4,153511.0,Salary Increases & Fixed Expenses Increase,124392,79887.0,41184,121071.0,3321.0,2.67,0.01,High Risk
U440,2024,5,156832.0,Salary Increases & Fixed Expenses Increase,152379,79887.0,50366,130253.0,22126.0,14.52,0.02,High Risk
U440,2024,6,178958.0,Salary Increases & Fixed Expenses Increase,152379,80975.0,72756,153731.0,-1352.0,-0.89,-0.03,High Risk
U440,2024,7,177606.0,Salary Increases & Fixed Expenses Increase,152379,80975.0,61334,142309.0,10070.0,6.61,-0.02,High Risk
U440,2024,8,187676.0,Salary Increases & Fixed Expenses Increase,152379,80975.0,52459,133434.0,18945.0,12.43,-0.05,High Risk
U440,2024,9,206621.0,Salary Increases & Fixed Expenses Increase,152379,82051.0,67341,149392.0,2987.0,1.96,0.03,High Risk
U440,2024,10,209608.0,Salary Increases & Fixed Expenses Increase,152379,82051.0,78831,160882.0,-8503.0,-5.58,0.02,High Risk
U440,2024,11,201105.0,Salary Increases & Fixed Expenses Increase,152379,82051.0,85439,167490.0,-15111.0,-9.92,-0.05,High Risk
U440,2024,12,185994.0,Salary Increases & Fixed Expenses Increase,152379,82051.0,83353,165404.0,-13025.0,-8.55,-0.01,High Risk
U441,2024,1,249465.0,Stable Salary & Stable Fixed Expenses,248200,108851.0,51270,160121.0,88079.0,35.49,0.01,Low Risk
U441,2024,2,337544.0,Stable Salary & Stable Fixed Expenses,248200,108851.0,56676,165527.0,82673.0,33.31,-0.05,Low Risk
U441,2024,3,420217.0,Stable Salary & Stable Fixed Expenses,248200,108851.0,56766,165617.0,82583.0,33.27,0.01,Low Risk
U441,2024,4,502800.0,Stable Salary & Stable Fixed Expenses,248200,108851.0,57293,166144.0,82056.0,33.06,0.02,Low Risk
U441,2024,5,584856.0,Stable Salary & Stable Fixed Expenses,248200,108851.0,71148,179999.0,68201.0,27.48,0.05,Low Risk
U441,2024,6,653057.0,Stable Salary & Stable Fixed Expenses,248200,108851.0,61122,169973.0,78227.0,31.52,-0.02,Low Risk
U441,2024,7,731284.0,Stable Salary & Stable Fixed Expenses,248200,108851.0,61940,170791.0,77409.0,31.19,0.01,Low Risk
U441,2024,8,808693.0,Stable Salary & Stable Fixed Expenses,248200,108851.0,58247,167098.0,81102.0,32.68,0.04,Low Risk
U441,2024,9,889795.0,Stable Salary & Stable Fixed Expenses,248200,108851.0,51053,159904.0,88296.0,35.57,0.0,Low Risk
U441,2024,10,978091.0,Stable Salary & Stable Fixed Expenses,248200,108851.0,66796,175647.0,72553.0,29.23,-0.03,Low Risk
U441,2024,11,1050644.0,Stable Salary & Stable Fixed Expenses,248200,108851.0,65741,174592.0,73608.0,29.66,0.03,Low Risk
U441,2024,12,1124252.0,Stable Salary & Stable Fixed Expenses,248200,108851.0,60446,169297.0,78903.0,31.79,0.04,Low Risk
U442,2024,1,250000.0,Salary Increases & Fixed Expenses Increase,274704,101253.0,62518,163771.0,110933.0,40.38,0.0,Low Risk
U442,2024,2,360933.0,Salary Increases & Fixed Expenses Increase,274704,101253.0,57455,158708.0,115996.0,42.23,-0.05,Low Risk
U442,2024,3,476929.0,Salary Increases & Fixed Expenses Increase,303693,102604.0,86060,188664.0,115029.0,37.88,0.03,Low Risk
U442,2024,4,591958.0,Salary Increases & Fixed Expenses Increase,303693,102604.0,65222,167826.0,135867.0,44.74,0.02,Low Risk
U442,2024,5,727825.0,Salary Increases & Fixed Expenses Increase,303693,102604.0,63135,165739.0,137954.0,45.43,0.04,Low Risk
U442,2024,6,865779.0,Salary Increases & Fixed Expenses Increase,303693,102604.0,88773,191377.0,112316.0,36.98,-0.01,Low Risk
U442,2024,7,978095.0,Salary Increases & Fixed Expenses Increase,303693,104592.0,65147,169739.0,133954.0,44.11,0.01,Low Risk
U442,2024,8,1112049.0,Salary Increases & Fixed Expenses Increase,303693,104592.0,71028,175620.0,128073.0,42.17,-0.04,Low Risk
U442,2024,9,1240122.0,Salary Increases & Fixed Expenses Increase,303693,104592.0,81706,186298.0,117395.0,38.66,0.04,Low Risk
U442,2024,10,1357517.0,Salary Increases & Fixed Expenses Increase,303693,104592.0,90248,194840.0,108853.0,35.84,-0.01,Low Risk
U442,2024,11,1466370.0,Salary Increases & Fixed Expenses Increase,303693,104592.0,75410,180002.0,123691.0,40.73,0.05,Low Risk
U442,2024,12,1590061.0,Salary Increases & Fixed Expenses Increase,303693,104592.0,67801,172393.0,131300.0,43.23,-0.01,Low Risk
U443,2024,1,184684.0,Salary Increases & Fixed Expenses Increase,40393,19662.0,21864,41526.0,-1133.0,-2.8,0.03,High Risk
U443,2024,2,183551.0,Salary Increases & Fixed Expenses Increase,40393,19662.0,23910,43572.0,-3179.0,-7.87,0.04,High Risk
U443,2024,3,180372.0,Salary Increases & Fixed Expenses Increase,46615,19662.0,28829,48491.0,-1876.0,-4.02,-0.04,High Risk
U443,2024,4,178496.0,Salary Increases & Fixed Expenses Increase,46615,19662.0,31154,50816.0,-4201.0,-9.01,-0.0,High Risk
U443,2024,5,174295.0,Salary Increases & Fixed Expenses Increase,46615,20346.0,26904,47250.0,-635.0,-1.36,0.04,High Risk
U443,2024,6,173660.0,Salary Increases & Fixed Expenses Increase,46615,20346.0,29836,50182.0,-3567.0,-7.65,0.05,High Risk
U443,2024,7,170093.0,Salary Increases & Fixed Expenses Increase,46615,20346.0,32380,52726.0,-6111.0,-13.11,-0.01,High Risk
U443,2024,8,163982.0,Salary Increases & Fixed Expenses Increase,46615,21051.0,29010,50061.0,-3446.0,-7.39,-0.04,High Risk
U443,2024,9,160536.0,Salary Increases & Fixed Expenses Increase,46615,21051.0,32134,53185.0,-6570.0,-14.09,0.02,High Risk
U443,2024,10,153966.0,Salary Increases & Fixed Expenses Increase,46615,21051.0,23775,44826.0,1789.0,3.84,-0.01,High Risk
U443,2024,11,155755.0,Salary Increases & Fixed Expenses Increase,46615,22575.0,30194,52769.0,-6154.0,-13.2,-0.02,High Risk
U443,2024,12,149601.0,Salary Increases & Fixed Expenses Increase,46615,23161.0,26595,49756.0,-3141.0,-6.74,-0.02,High Risk
U444,2024,1,214621.0,Salary Increases & Fixed Expenses Decrease,193154,54489.0,119897,174386.0,18768.0,9.72,0.01,High Risk
U444,2024,2,233389.0,Salary Increases & Fixed Expenses Decrease,193154,54489.0,104259,158748.0,34406.0,17.81,-0.03,Medium Risk
U444,2024,3,267795.0,Salary Increases & Fixed Expenses Decrease,193154,54489.0,102105,156594.0,36560.0,18.93,0.02,Medium Risk
U444,2024,4,304355.0,Salary Increases & Fixed Expenses Decrease,200471,54489.0,126879,181368.0,19103.0,9.53,0.0,High Risk
U444,2024,5,323458.0,Salary Increases & Fixed Expenses Decrease,200471,54489.0,108207,162696.0,37775.0,18.84,0.01,Medium Risk
U444,2024,6,361233.0,Salary Increases & Fixed Expenses Decrease,200471,54489.0,131610,186099.0,14372.0,7.17,0.05,High Risk
U444,2024,7,375605.0,Salary Increases & Fixed Expenses Decrease,200471,54489.0,100601,155090.0,45381.0,22.64,0.04,Medium Risk
U444,2024,8,420986.0,Salary Increases & Fixed Expenses Decrease,200471,54489.0,135216,189705.0,10766.0,5.37,-0.03,High Risk
U444,2024,9,431752.0,Salary Increases & Fixed Expenses Decrease,200471,54489.0,149000,203489.0,-3018.0,-1.51,0.04,High Risk
U444,2024,10,428734.0,Salary Increases & Fixed Expenses Decrease,200471,54489.0,140054,194543.0,5928.0,2.96,-0.03,High Risk
U444,2024,11,434662.0,Salary Increases & Fixed Expenses Decrease,200471,54489.0,112126,166615.0,33856.0,16.89,-0.02,Medium Risk
U444,2024,12,468518.0,Salary Increases & Fixed Expenses Decrease,200471,54489.0,114330,168819.0,31652.0,15.79,-0.03,Medium Risk
U445,2024,1,204695.0,Salary Increases & Fixed Expenses Remain Stable,51821,35587.0,28109,63696.0,-11875.0,-22.92,0.0,High Risk
U445,2024,2,192820.0,Salary Increases & Fixed Expenses Remain Stable,51821,35587.0,32501,68088.0,-16267.0,-31.39,0.0,High Risk
U445,2024,3,176553.0,Salary Increases & Fixed Expenses Remain Stable,51821,35587.0,33923,69510.0,-17689.0,-34.13,-0.01,High Risk
U445,2024,4,158864.0,Salary Increases & Fixed Expenses Remain Stable,66364,35587.0,39001,74588.0,-8224.0,-12.39,0.05,High Risk
U445,2024,5,150640.0,Salary Increases & Fixed Expenses Remain Stable,66364,35587.0,45902,81489.0,-15125.0,-22.79,-0.02,High Risk
U445,2024,6,135515.0,Salary Increases & Fixed Expenses Remain Stable,66364,35587.0,44087,79674.0,-13310.0,-20.06,-0.05,High Risk
U445,2024,7,122205.0,Salary Increases & Fixed Expenses Remain Stable,66364,35587.0,42158,77745.0,-11381.0,-17.15,-0.03,High Risk
U445,2024,8,110824.0,Salary Increases & Fixed Expenses Remain Stable,66364,35587.0,43189,78776.0,-12412.0,-18.7,0.01,High Risk
U445,2024,9,98412.0,Salary Increases & Fixed Expenses Remain Stable,66364,35587.0,38831,74418.0,-8054.0,-12.14,0.03,High Risk
U445,2024,10,90358.0,Salary Increases & Fixed Expenses Remain Stable,66364,35587.0,57863,93450.0,-27086.0,-40.81,0.04,High Risk
U445,2024,11,63272.0,Salary Increases & Fixed Expenses Remain Stable,66364,35587.0,52536,88123.0,-21759.0,-32.79,-0.05,High Risk
U445,2024,12,41513.0,Salary Increases & Fixed Expenses Remain Stable,66364,35587.0,39215,74802.0,-8438.0,-12.71,-0.03,High Risk
U446,2024,1,146668.0,Stable Salary & Increasing Fixed Expenses,108261,46328.0,68766,115094.0,-6833.0,-6.31,0.01,High Risk
U446,2024,2,139835.0,Stable Salary & Increasing Fixed Expenses,108261,46328.0,58898,105226.0,3035.0,2.8,-0.01,High Risk
U446,2024,3,142870.0,Stable Salary & Increasing Fixed Expenses,108261,46328.0,55427,101755.0,6506.0,6.01,-0.02,High Risk
U446,2024,4,149376.0,Stable Salary & Increasing Fixed Expenses,108261,46328.0,55201,101529.0,6732.0,6.22,-0.05,High Risk
U446,2024,5,156108.0,Stable Salary & Increasing Fixed Expenses,108261,46328.0,64636,110964.0,-2703.0,-2.5,-0.03,High Risk
U446,2024,6,153405.0,Stable Salary & Increasing Fixed Expenses,108261,47115.0,67941,115056.0,-6795.0,-6.28,0.04,High Risk
U446,2024,7,146610.0,Stable Salary & Increasing Fixed Expenses,108261,47115.0,65937,113052.0,-4791.0,-4.43,-0.03,High Risk
U446,2024,8,141819.0,Stable Salary & Increasing Fixed Expenses,108261,47115.0,69067,116182.0,-7921.0,-7.32,0.02,High Risk
U446,2024,9,133898.0,Stable Salary & Increasing Fixed Expenses,108261,47115.0,82134,129249.0,-20988.0,-19.39,-0.02,High Risk
U446,2024,10,112910.0,Stable Salary & Increasing Fixed Expenses,108261,47115.0,61372,108487.0,-226.0,-0.21,0.04,High Risk
U446,2024,11,112684.0,Stable Salary & Increasing Fixed Expenses,108261,47115.0,69672,116787.0,-8526.0,-7.88,0.04,High Risk
U446,2024,12,104158.0,Stable Salary & Increasing Fixed Expenses,108261,47115.0,60562,107677.0,584.0,0.54,-0.0,High Risk
U447,2024,1,232588.0,Salary Increases & Fixed Expenses Increase,128748,57450.0,50330,107780.0,20968.0,16.29,-0.0,Medium Risk
U447,2024,2,253556.0,Salary Increases & Fixed Expenses Increase,128748,57450.0,60890,118340.0,10408.0,8.08,0.05,High Risk
U447,2024,3,263964.0,Salary Increases & Fixed Expenses Increase,128748,57450.0,63942,121392.0,7356.0,5.71,0.03,High Risk
U447,2024,4,271320.0,Salary Increases & Fixed Expenses Increase,135197,57450.0,42320,99770.0,35427.0,26.2,0.05,Low Risk
U447,2024,5,306747.0,Salary Increases & Fixed Expenses Increase,135197,57450.0,51863,109313.0,25884.0,19.15,0.01,Medium Risk
U447,2024,6,332631.0,Salary Increases & Fixed Expenses Increase,135197,58502.0,65785,124287.0,10910.0,8.07,0.01,High Risk
U447,2024,7,343541.0,Salary Increases & Fixed Expenses Increase,135197,58502.0,44373,102875.0,32322.0,23.91,0.01,Medium Risk
U447,2024,8,375863.0,Salary Increases & Fixed Expenses Increase,135197,58502.0,59778,118280.0,16917.0,12.51,-0.03,High Risk
U447,2024,9,392780.0,Salary Increases & Fixed Expenses Increase,135197,60011.0,57486,117497.0,17700.0,13.09,0.02,High Risk
U447,2024,10,410480.0,Salary Increases & Fixed Expenses Increase,135197,60011.0,72428,132439.0,2758.0,2.04,-0.05,High Risk
U447,2024,11,413238.0,Salary Increases & Fixed Expenses Increase,135197,60011.0,65909,125920.0,9277.0,6.86,-0.01,High Risk
U447,2024,12,422515.0,Salary Increases & Fixed Expenses Increase,135197,60011.0,52060,112071.0,23126.0,17.11,-0.04,Medium Risk
U448,2024,1,214005.0,Salary Increases & Fixed Expenses Increase,212983,81484.0,56688,138172.0,74811.0,35.13,0.01,Low Risk
U448,2024,2,288816.0,Salary Increases & Fixed Expenses Increase,212983,81484.0,47402,128886.0,84097.0,39.49,-0.0,Low Risk
U448,2024,3,372913.0,Salary Increases & Fixed Expenses Increase,212983,81484.0,58102,139586.0,73397.0,34.46,-0.04,Low Risk
U448,2024,4,446310.0,Salary Increases & Fixed Expenses Increase,212983,81484.0,61643,143127.0,69856.0,32.8,0.01,Low Risk
U448,2024,5,516166.0,Salary Increases & Fixed Expenses Increase,212983,81484.0,46041,127525.0,85458.0,40.12,0.04,Low Risk
U448,2024,6,601624.0,Salary Increases & Fixed Expenses Increase,218238,81484.0,60734,142218.0,76020.0,34.83,-0.01,Low Risk
U448,2024,7,677644.0,Salary Increases & Fixed Expenses Increase,218238,81484.0,58026,139510.0,78728.0,36.07,-0.01,Low Risk
U448,2024,8,756372.0,Salary Increases & Fixed Expenses Increase,218238,81484.0,64168,145652.0,72586.0,33.26,0.03,Low Risk
U448,2024,9,828958.0,Salary Increases & Fixed Expenses Increase,218238,81484.0,48512,129996.0,88242.0,40.43,0.02,Low Risk
U448,2024,10,917200.0,Salary Increases & Fixed Expenses Increase,218238,81484.0,71416,152900.0,65338.0,29.94,0.01,Low Risk
U448,2024,11,982538.0,Salary Increases & Fixed Expenses Increase,218238,81484.0,68143,149627.0,68611.0,31.44,0.03,Low Risk
U448,2024,12,1051149.0,Salary Increases & Fixed Expenses Increase,218238,81484.0,79640,161124.0,57114.0,26.17,-0.0,Low Risk
U449,2024,1,215726.0,Stable Salary & Stable Fixed Expenses,169443,52224.0,61080,113304.0,56139.0,33.13,0.01,Low Risk
U449,2024,2,271865.0,Stable Salary & Stable Fixed Expenses,169443,52224.0,76721,128945.0,40498.0,23.9,0.02,Medium Risk
U449,2024,3,312363.0,Stable Salary & Stable Fixed Expenses,169443,52224.0,80799,133023.0,36420.0,21.49,-0.01,Medium Risk
U449,2024,4,348783.0,Stable Salary & Stable Fixed Expenses,169443,52224.0,80699,132923.0,36520.0,21.55,0.04,Medium Risk
U449,2024,5,385303.0,Stable Salary & Stable Fixed Expenses,169443,52224.0,56133,108357.0,61086.0,36.05,0.05,Low Risk
U449,2024,6,446389.0,Stable Salary & Stable Fixed Expenses,169443,52224.0,63323,115547.0,53896.0,31.81,0.01,Low Risk
U449,2024,7,500285.0,Stable Salary & Stable Fixed Expenses,169443,52224.0,56062,108286.0,61157.0,36.09,0.03,Low Risk
U449,2024,8,561442.0,Stable Salary & Stable Fixed Expenses,169443,52224.0,77990,130214.0,39229.0,23.15,0.03,Medium Risk
U449,2024,9,600671.0,Stable Salary & Stable Fixed Expenses,169443,52224.0,59288,111512.0,57931.0,34.19,0.04,Low Risk
U449,2024,10,658602.0,Stable Salary & Stable Fixed Expenses,169443,52224.0,82315,134539.0,34904.0,20.6,0.03,Medium Risk
U449,2024,11,693506.0,Stable Salary & Stable Fixed Expenses,169443,52224.0,90173,142397.0,27046.0,15.96,-0.03,Medium Risk
U449,2024,12,720552.0,Stable Salary & Stable Fixed Expenses,169443,52224.0,70254,122478.0,46965.0,27.72,0.01,Low Risk
U450,2024,1,218269.0,Salary Increases & Fixed Expenses Increase,134500,77920.0,36436,114356.0,20144.0,14.98,0.05,High Risk
U450,2024,2,238413.0,Salary Increases & Fixed Expenses Increase,134500,77920.0,38268,116188.0,18312.0,13.61,-0.05,High Risk
U450,2024,3,256725.0,Salary Increases & Fixed Expenses Increase,159063,77920.0,32503,110423.0,48640.0,30.58,-0.03,Low Risk
U450,2024,4,305365.0,Salary Increases & Fixed Expenses Increase,159063,77920.0,42566,120486.0,38577.0,24.25,0.02,Medium Risk
U450,2024,5,343942.0,Salary Increases & Fixed Expenses Increase,159063,77920.0,40869,118789.0,40274.0,25.32,0.04,Low Risk
U450,2024,6,384216.0,Salary Increases & Fixed Expenses Increase,159063,77920.0,39812,117732.0,41331.0,25.98,0.01,Low Risk
U450,2024,7,425547.0,Salary Increases & Fixed Expenses Increase,159063,77920.0,37193,115113.0,43950.0,27.63,0.03,Low Risk
U450,2024,8,469497.0,Salary Increases & Fixed Expenses Increase,159063,77920.0,33621,111541.0,47522.0,29.88,-0.05,Low Risk
U450,2024,9,517019.0,Salary Increases & Fixed Expenses Increase,159063,79559.0,50384,129943.0,29120.0,18.31,-0.04,Medium Risk
U450,2024,10,546139.0,Salary Increases & Fixed Expenses Increase,159063,79559.0,47093,126652.0,32411.0,20.38,-0.03,Medium Risk
U450,2024,11,578550.0,Salary Increases & Fixed Expenses Increase,159063,79559.0,49348,128907.0,30156.0,18.96,0.01,Medium Risk
U450,2024,12,608706.0,Salary Increases & Fixed Expenses Increase,159063,79559.0,33430,112989.0,46074.0,28.97,-0.03,Low Risk
U451,2024,1,135222.0,Salary Increases & Fixed Expenses Remain Stable,124383,70946.0,46034,116980.0,7403.0,5.95,-0.05,High Risk
U451,2024,2,142625.0,Salary Increases & Fixed Expenses Remain Stable,124383,70946.0,41078,112024.0,12359.0,9.94,0.05,High Risk
U451,2024,3,154984.0,Salary Increases & Fixed Expenses Remain Stable,124383,70946.0,56969,127915.0,-3532.0,-2.84,-0.02,High Risk
U451,2024,4,151452.0,Salary Increases & Fixed Expenses Remain Stable,124383,70946.0,38189,109135.0,15248.0,12.26,-0.0,High Risk
U451,2024,5,166700.0,Salary Increases & Fixed Expenses Remain Stable,152646,70946.0,72370,143316.0,9330.0,6.11,-0.02,High Risk
U451,2024,6,176030.0,Salary Increases & Fixed Expenses Remain Stable,152646,70946.0,52863,123809.0,28837.0,18.89,0.04,Medium Risk
U451,2024,7,204867.0,Salary Increases & Fixed Expenses Remain Stable,152646,70946.0,53726,124672.0,27974.0,18.33,0.01,Medium Risk
U451,2024,8,232841.0,Salary Increases & Fixed Expenses Remain Stable,152646,70946.0,59608,130554.0,22092.0,14.47,-0.01,High Risk
U451,2024,9,254933.0,Salary Increases & Fixed Expenses Remain Stable,152646,70946.0,70446,141392.0,11254.0,7.37,-0.02,High Risk
U451,2024,10,266187.0,Salary Increases & Fixed Expenses Remain Stable,152646,70946.0,68430,139376.0,13270.0,8.69,0.05,High Risk
U451,2024,11,279457.0,Salary Increases & Fixed Expenses Remain Stable,152646,70946.0,48916,119862.0,32784.0,21.48,-0.04,Medium Risk
U451,2024,12,312241.0,Salary Increases & Fixed Expenses Remain Stable,152646,70946.0,74490,145436.0,7210.0,4.72,0.01,High Risk
U452,2024,1,238646.0,Salary Increases & Fixed Expenses Remain Stable,93134,35391.0,30124,65515.0,27619.0,29.66,-0.04,Low Risk
U452,2024,2,266265.0,Salary Increases & Fixed Expenses Remain Stable,93134,35391.0,36591,71982.0,21152.0,22.71,-0.03,Medium Risk
U452,2024,3,287417.0,Salary Increases & Fixed Expenses Remain Stable,93134,35391.0,42400,77791.0,15343.0,16.47,-0.02,Medium Risk
U452,2024,4,302760.0,Salary Increases & Fixed Expenses Remain Stable,93134,35391.0,42163,77554.0,15580.0,16.73,-0.02,Medium Risk
U452,2024,5,318340.0,Salary Increases & Fixed Expenses Remain Stable,93134,35391.0,33622,69013.0,24121.0,25.9,0.02,Low Risk
U452,2024,6,342461.0,Salary Increases & Fixed Expenses Remain Stable,122227,35391.0,38246,73637.0,48590.0,39.75,0.04,Low Risk
U452,2024,7,391051.0,Salary Increases & Fixed Expenses Remain Stable,122227,35391.0,39718,75109.0,47118.0,38.55,0.05,Low Risk
U452,2024,8,438169.0,Salary Increases & Fixed Expenses Remain Stable,122227,35391.0,53751,89142.0,33085.0,27.07,-0.01,Low Risk
U452,2024,9,471254.0,Salary Increases & Fixed Expenses Remain Stable,122227,35391.0,52739,88130.0,34097.0,27.9,-0.03,Low Risk
U452,2024,10,505351.0,Salary Increases & Fixed Expenses Remain Stable,122227,35391.0,47470,82861.0,39366.0,32.21,-0.01,Low Risk
U452,2024,11,544717.0,Salary Increases & Fixed Expenses Remain Stable,122227,35391.0,62013,97404.0,24823.0,20.31,0.01,Medium Risk
U452,2024,12,569540.0,Salary Increases & Fixed Expenses Remain Stable,122227,35391.0,43720,79111.0,43116.0,35.28,-0.02,Low Risk
U453,2024,1,248743.0,Salary Increases & Fixed Expenses Increase,91275,26812.0,41923,68735.0,22540.0,24.69,0.05,Medium Risk
U453,2024,2,271283.0,Salary Increases & Fixed Expenses Increase,91275,26812.0,33536,60348.0,30927.0,33.88,0.02,Low Risk
U453,2024,3,302210.0,Salary Increases & Fixed Expenses Increase,120655,26812.0,57297,84109.0,36546.0,30.29,-0.0,Low Risk
U453,2024,4,338756.0,Salary Increases & Fixed Expenses Increase,120655,26812.0,42917,69729.0,50926.0,42.21,-0.03,Low Risk
U453,2024,5,389682.0,Salary Increases & Fixed Expenses Increase,120655,26812.0,39292,66104.0,54551.0,45.21,0.05,Low Risk
U453,2024,6,444233.0,Salary Increases & Fixed Expenses Increase,120655,26812.0,49565,76377.0,44278.0,36.7,0.04,Low Risk
U453,2024,7,488511.0,Salary Increases & Fixed Expenses Increase,120655,28477.0,53162,81639.0,39016.0,32.34,0.01,Low Risk
U453,2024,8,527527.0,Salary Increases & Fixed Expenses Increase,120655,28477.0,59648,88125.0,32530.0,26.96,0.04,Low Risk
U453,2024,9,560057.0,Salary Increases & Fixed Expenses Increase,120655,28477.0,42095,70572.0,50083.0,41.51,-0.01,Low Risk
U453,2024,10,610140.0,Salary Increases & Fixed Expenses Increase,120655,28477.0,37193,65670.0,54985.0,45.57,-0.05,Low Risk
U453,2024,11,665125.0,Salary Increases & Fixed Expenses Increase,120655,28477.0,41775,70252.0,50403.0,41.77,0.0,Low Risk
U453,2024,12,715528.0,Salary Increases & Fixed Expenses Increase,120655,28477.0,40517,68994.0,51661.0,42.82,0.04,Low Risk
U454,2024,1,212232.0,Salary Increases & Fixed Expenses Remain Stable,200800,98696.0,43544,142240.0,58560.0,29.16,-0.03,Low Risk
U454,2024,2,270792.0,Salary Increases & Fixed Expenses Remain Stable,200800,98696.0,50827,149523.0,51277.0,25.54,0.02,Low Risk
U454,2024,3,322069.0,Salary Increases & Fixed Expenses Remain Stable,227154,98696.0,60181,158877.0,68277.0,30.06,0.01,Low Risk
U454,2024,4,390346.0,Salary Increases & Fixed Expenses Remain Stable,227154,98696.0,51159,149855.0,77299.0,34.03,0.01,Low Risk
U454,2024,5,467645.0,Salary Increases & Fixed Expenses Remain Stable,227154,98696.0,67685,166381.0,60773.0,26.75,-0.05,Low Risk
U454,2024,6,528418.0,Salary Increases & Fixed Expenses Remain Stable,227154,98696.0,50876,149572.0,77582.0,34.15,0.01,Low Risk
U454,2024,7,606000.0,Salary Increases & Fixed Expenses Remain Stable,227154,98696.0,51672,150368.0,76786.0,33.8,0.03,Low Risk
U454,2024,8,682786.0,Salary Increases & Fixed Expenses Remain Stable,227154,98696.0,56389,155085.0,72069.0,31.73,0.02,Low Risk
U454,2024,9,754855.0,Salary Increases & Fixed Expenses Remain Stable,227154,98696.0,66856,165552.0,61602.0,27.12,-0.04,Low Risk
U454,2024,10,816457.0,Salary Increases & Fixed Expenses Remain Stable,227154,98696.0,55159,153855.0,73299.0,32.27,0.02,Low Risk
U454,2024,11,889756.0,Salary Increases & Fixed Expenses Remain Stable,227154,98696.0,54801,153497.0,73657.0,32.43,0.04,Low Risk
U454,2024,12,963413.0,Salary Increases & Fixed Expenses Remain Stable,227154,98696.0,46492,145188.0,81966.0,36.08,0.02,Low Risk
U455,2024,1,244804.0,Stable Salary & Stable Fixed Expenses,200062,75160.0,90558,165718.0,34344.0,17.17,-0.03,Medium Risk
U455,2024,2,279148.0,Stable Salary & Stable Fixed Expenses,200062,75160.0,91276,166436.0,33626.0,16.81,-0.04,Medium Risk
U455,2024,3,312774.0,Stable Salary & Stable Fixed Expenses,200062,75160.0,103083,178243.0,21819.0,10.91,0.03,High Risk
U455,2024,4,334593.0,Stable Salary & Stable Fixed Expenses,200062,75160.0,81840,157000.0,43062.0,21.52,-0.03,Medium Risk
U455,2024,5,377655.0,Stable Salary & Stable Fixed Expenses,200062,75160.0,72144,147304.0,52758.0,26.37,-0.03,Low Risk
U455,2024,6,430413.0,Stable Salary & Stable Fixed Expenses,200062,75160.0,83699,158859.0,41203.0,20.6,0.04,Medium Risk
U455,2024,7,471616.0,Stable Salary & Stable Fixed Expenses,200062,75160.0,95012,170172.0,29890.0,14.94,-0.02,High Risk
U455,2024,8,501506.0,Stable Salary & Stable Fixed Expenses,200062,75160.0,74667,149827.0,50235.0,25.11,-0.04,Low Risk
U455,2024,9,551741.0,Stable Salary & Stable Fixed Expenses,200062,75160.0,90895,166055.0,34007.0,17.0,-0.03,Medium Risk
U455,2024,10,585748.0,Stable Salary & Stable Fixed Expenses,200062,75160.0,103889,179049.0,21013.0,10.5,0.01,High Risk
U455,2024,11,606761.0,Stable Salary & Stable Fixed Expenses,200062,75160.0,83602,158762.0,41300.0,20.64,-0.04,Medium Risk
U455,2024,12,648061.0,Stable Salary & Stable Fixed Expenses,200062,75160.0,79860,155020.0,45042.0,22.51,-0.04,Medium Risk
U456,2024,1,250000.0,Stable Salary & Stable Fixed Expenses,250333,64760.0,165116,229876.0,20457.0,8.17,0.0,High Risk
U456,2024,2,270457.0,Stable Salary & Stable Fixed Expenses,250333,64760.0,151568,216328.0,34005.0,13.58,0.05,High Risk
U456,2024,3,304462.0,Stable Salary & Stable Fixed Expenses,250333,64760.0,174810,239570.0,10763.0,4.3,0.03,High Risk
U456,2024,4,315225.0,Stable Salary & Stable Fixed Expenses,250333,64760.0,157658,222418.0,27915.0,11.15,-0.0,High Risk
U456,2024,5,343140.0,Stable Salary & Stable Fixed Expenses,250333,64760.0,172242,237002.0,13331.0,5.33,-0.02,High Risk
U456,2024,6,356471.0,Stable Salary & Stable Fixed Expenses,250333,64760.0,149340,214100.0,36233.0,14.47,-0.05,High Risk
U456,2024,7,392704.0,Stable Salary & Stable Fixed Expenses,250333,64760.0,133087,197847.0,52486.0,20.97,0.04,Medium Risk
U456,2024,8,445190.0,Stable Salary & Stable Fixed Expenses,250333,64760.0,168971,233731.0,16602.0,6.63,0.0,High Risk
U456,2024,9,461792.0,Stable Salary & Stable Fixed Expenses,250333,64760.0,134650,199410.0,50923.0,20.34,-0.03,Medium Risk
U456,2024,10,512715.0,Stable Salary & Stable Fixed Expenses,250333,64760.0,170036,234796.0,15537.0,6.21,-0.04,High Risk
U456,2024,11,528252.0,Stable Salary & Stable Fixed Expenses,250333,64760.0,155126,219886.0,30447.0,12.16,-0.0,High Risk
U456,2024,12,558699.0,Stable Salary & Stable Fixed Expenses,250333,64760.0,183232,247992.0,2341.0,0.94,0.04,High Risk
U457,2024,1,250000.0,Salary Increases & Fixed Expenses Increase,258726,74081.0,97178,171259.0,87467.0,33.81,0.05,Low Risk
U457,2024,2,337467.0,Salary Increases & Fixed Expenses Increase,258726,74081.0,92380,166461.0,92265.0,35.66,0.04,Low Risk
U457,2024,3,429732.0,Salary Increases & Fixed Expenses Increase,258726,74081.0,126748,200829.0,57897.0,22.38,-0.03,Medium Risk
U457,2024,4,487629.0,Salary Increases & Fixed Expenses Increase,258726,74081.0,94800,168881.0,89845.0,34.73,-0.02,Low Risk
U457,2024,5,577474.0,Salary Increases & Fixed Expenses Increase,258726,74851.0,94035,168886.0,89840.0,34.72,-0.05,Low Risk
U457,2024,6,667314.0,Salary Increases & Fixed Expenses Increase,258726,74851.0,123899,198750.0,59976.0,23.18,0.01,Medium Risk
U457,2024,7,727290.0,Salary Increases & Fixed Expenses Increase,258726,76436.0,88816,165252.0,93474.0,36.13,-0.04,Low Risk
U457,2024,8,820764.0,Salary Increases & Fixed Expenses Increase,287287,76436.0,100561,176997.0,110290.0,38.39,0.03,Low Risk
U457,2024,9,931054.0,Salary Increases & Fixed Expenses Increase,287287,76436.0,113969,190405.0,96882.0,33.72,-0.04,Low Risk
U457,2024,10,1027936.0,Salary Increases & Fixed Expenses Increase,287287,76436.0,127056,203492.0,83795.0,29.17,0.05,Low Risk
U457,2024,11,1111731.0,Salary Increases & Fixed Expenses Increase,287287,76436.0,110165,186601.0,100686.0,35.05,0.04,Low Risk
U457,2024,12,1212417.0,Salary Increases & Fixed Expenses Increase,287287,76436.0,171422,247858.0,39429.0,13.72,0.04,High Risk
U458,2024,1,208917.0,Stable Salary & Stable Fixed Expenses,126168,66042.0,51060,117102.0,9066.0,7.19,0.02,High Risk
U458,2024,2,217983.0,Stable Salary & Stable Fixed Expenses,126168,66042.0,41213,107255.0,18913.0,14.99,-0.03,High Risk
U458,2024,3,236896.0,Stable Salary & Stable Fixed Expenses,126168,66042.0,65883,131925.0,-5757.0,-4.56,-0.03,High Risk
U458,2024,4,231139.0,Stable Salary & Stable Fixed Expenses,126168,66042.0,55827,121869.0,4299.0,3.41,0.02,High Risk
U458,2024,5,235438.0,Stable Salary & Stable Fixed Expenses,126168,66042.0,49952,115994.0,10174.0,8.06,0.01,High Risk
U458,2024,6,245612.0,Stable Salary & Stable Fixed Expenses,126168,66042.0,55058,121100.0,5068.0,4.02,-0.01,High Risk
U458,2024,7,250680.0,Stable Salary & Stable Fixed Expenses,126168,66042.0,57370,123412.0,2756.0,2.18,-0.0,High Risk
U458,2024,8,253436.0,Stable Salary & Stable Fixed Expenses,126168,66042.0,46083,112125.0,14043.0,11.13,-0.01,High Risk
U458,2024,9,267479.0,Stable Salary & Stable Fixed Expenses,126168,66042.0,41867,107909.0,18259.0,14.47,0.03,High Risk
U458,2024,10,285738.0,Stable Salary & Stable Fixed Expenses,126168,66042.0,60992,127034.0,-866.0,-0.69,0.04,High Risk
U458,2024,11,284872.0,Stable Salary & Stable Fixed Expenses,126168,66042.0,61114,127156.0,-988.0,-0.78,-0.04,High Risk
U458,2024,12,283884.0,Stable Salary & Stable Fixed Expenses,126168,66042.0,56347,122389.0,3779.0,3.0,0.03,High Risk
U459,2024,1,245206.0,Salary Increases & Fixed Expenses Remain Stable,29838,10553.0,10712,21265.0,8573.0,28.73,-0.04,Low Risk
U459,2024,2,253779.0,Salary Increases & Fixed Expenses Remain Stable,29838,10553.0,11314,21867.0,7971.0,26.71,0.01,Low Risk
U459,2024,3,261750.0,Salary Increases & Fixed Expenses Remain Stable,29838,10553.0,11131,21684.0,8154.0,27.33,-0.05,Low Risk
U459,2024,4,269904.0,Salary Increases & Fixed Expenses Remain Stable,29838,10553.0,12409,22962.0,6876.0,23.04,-0.01,Medium Risk
U459,2024,5,276780.0,Salary Increases & Fixed Expenses Remain Stable,29838,10553.0,12304,22857.0,6981.0,23.4,0.05,Medium Risk
U459,2024,6,283761.0,Salary Increases & Fixed Expenses Remain Stable,42635,10553.0,18986,29539.0,13096.0,30.72,0.0,Low Risk
U459,2024,7,296857.0,Salary Increases & Fixed Expenses Remain Stable,42635,10553.0,14167,24720.0,17915.0,42.02,-0.02,Low Risk
U459,2024,8,314772.0,Salary Increases & Fixed Expenses Remain Stable,42635,10553.0,16946,27499.0,15136.0,35.5,-0.04,Low Risk
U459,2024,9,329908.0,Salary Increases & Fixed Expenses Remain Stable,42635,10553.0,23086,33639.0,8996.0,21.1,0.03,Medium Risk
U459,2024,10,338904.0,Salary Increases & Fixed Expenses Remain Stable,42635,10553.0,21279,31832.0,10803.0,25.34,0.0,Low Risk
U459,2024,11,349707.0,Salary Increases & Fixed Expenses Remain Stable,42635,10553.0,23294,33847.0,8788.0,20.61,-0.04,Medium Risk
U459,2024,12,358495.0,Salary Increases & Fixed Expenses Remain Stable,42635,10553.0,21016,31569.0,11066.0,25.96,0.01,Low Risk
U460,2024,1,250000.0,Salary Increases & Fixed Expenses Remain Stable,281775,65263.0,136156,201419.0,80356.0,28.52,0.0,Low Risk
U460,2024,2,330356.0,Salary Increases & Fixed Expenses Remain Stable,281775,65263.0,132226,197489.0,84286.0,29.91,-0.05,Low Risk
U460,2024,3,414642.0,Salary Increases & Fixed Expenses Remain Stable,281775,65263.0,89999,155262.0,126513.0,44.9,-0.04,Low Risk
U460,2024,4,541155.0,Salary Increases & Fixed Expenses Remain Stable,281775,65263.0,130354,195617.0,86158.0,30.58,0.02,Low Risk
U460,2024,5,627313.0,Salary Increases & Fixed Expenses Remain Stable,303198,65263.0,141114,206377.0,96821.0,31.93,0.0,Low Risk
U460,2024,6,724134.0,Salary Increases & Fixed Expenses Remain Stable,303198,65263.0,91350,156613.0,146585.0,48.35,-0.01,Low Risk
U460,2024,7,870719.0,Salary Increases & Fixed Expenses Remain Stable,303198,65263.0,92482,157745.0,145453.0,47.97,0.0,Low Risk
U460,2024,8,1016172.0,Salary Increases & Fixed Expenses Remain Stable,303198,65263.0,115381,180644.0,122554.0,40.42,0.01,Low Risk
U460,2024,9,1138726.0,Salary Increases & Fixed Expenses Remain Stable,303198,65263.0,171177,236440.0,66758.0,22.02,-0.02,Medium Risk
U460,2024,10,1205484.0,Salary Increases & Fixed Expenses Remain Stable,303198,65263.0,126498,191761.0,111437.0,36.75,-0.02,Low Risk
U460,2024,11,1316921.0,Salary Increases & Fixed Expenses Remain Stable,303198,65263.0,154933,220196.0,83002.0,27.38,-0.03,Low Risk
U460,2024,12,1399923.0,Salary Increases & Fixed Expenses Remain Stable,303198,65263.0,103548,168811.0,134387.0,44.32,0.05,Low Risk
U461,2024,1,204637.0,Salary Increases & Fixed Expenses Remain Stable,112709,48784.0,68816,117600.0,-4891.0,-4.34,-0.02,High Risk
U461,2024,2,199746.0,Salary Increases & Fixed Expenses Remain Stable,112709,48784.0,78105,126889.0,-14180.0,-12.58,0.04,High Risk
U461,2024,3,185566.0,Salary Increases & Fixed Expenses Remain Stable,112709,48784.0,80892,129676.0,-16967.0,-15.05,-0.03,High Risk
U461,2024,4,168599.0,Salary Increases & Fixed Expenses Remain Stable,112709,48784.0,64140,112924.0,-215.0,-0.19,-0.03,High Risk
U461,2024,5,168384.0,Salary Increases & Fixed Expenses Remain Stable,112709,48784.0,78422,127206.0,-14497.0,-12.86,0.03,High Risk
U461,2024,6,153887.0,Salary Increases & Fixed Expenses Remain Stable,118526,48784.0,74378,123162.0,-4636.0,-3.91,-0.01,High Risk
U461,2024,7,149251.0,Salary Increases & Fixed Expenses Remain Stable,118526,48784.0,61790,110574.0,7952.0,6.71,-0.02,High Risk
U461,2024,8,157203.0,Salary Increases & Fixed Expenses Remain Stable,118526,48784.0,65837,114621.0,3905.0,3.29,-0.01,High Risk
U461,2024,9,161108.0,Salary Increases & Fixed Expenses Remain Stable,118526,48784.0,90542,139326.0,-20800.0,-17.55,0.03,High Risk
U461,2024,10,140308.0,Salary Increases & Fixed Expenses Remain Stable,118526,48784.0,102035,150819.0,-32293.0,-27.25,0.03,High Risk
U461,2024,11,108015.0,Salary Increases & Fixed Expenses Remain Stable,118526,48784.0,78209,126993.0,-8467.0,-7.14,-0.04,High Risk
U461,2024,12,99548.0,Salary Increases & Fixed Expenses Remain Stable,118526,48784.0,96999,145783.0,-27257.0,-23.0,0.05,High Risk
U462,2024,1,139597.0,Salary Increases & Fixed Expenses Remain Stable,33398,19488.0,11373,30861.0,2537.0,7.6,0.02,High Risk
U462,2024,2,142134.0,Salary Increases & Fixed Expenses Remain Stable,33398,19488.0,10988,30476.0,2922.0,8.75,-0.04,High Risk
U462,2024,3,145056.0,Salary Increases & Fixed Expenses Remain Stable,55247,19488.0,25234,44722.0,10525.0,19.05,0.04,Medium Risk
U462,2024,4,155581.0,Salary Increases & Fixed Expenses Remain Stable,55247,19488.0,24569,44057.0,11190.0,20.25,-0.04,Medium Risk
U462,2024,5,166771.0,Salary Increases & Fixed Expenses Remain Stable,55247,19488.0,26083,45571.0,9676.0,17.51,-0.01,Medium Risk
U462,2024,6,176447.0,Salary Increases & Fixed Expenses Remain Stable,55247,19488.0,23192,42680.0,12567.0,22.75,0.04,Medium Risk
U462,2024,7,189014.0,Salary Increases & Fixed Expenses Remain Stable,55247,19488.0,24163,43651.0,11596.0,20.99,0.03,Medium Risk
U462,2024,8,200610.0,Salary Increases & Fixed Expenses Remain Stable,55247,19488.0,22943,42431.0,12816.0,23.2,0.05,Medium Risk
U462,2024,9,213426.0,Salary Increases & Fixed Expenses Remain Stable,55247,19488.0,23304,42792.0,12455.0,22.54,0.03,Medium Risk
U462,2024,10,225881.0,Salary Increases & Fixed Expenses Remain Stable,55247,19488.0,25899,45387.0,9860.0,17.85,-0.02,Medium Risk
U462,2024,11,235741.0,Salary Increases & Fixed Expenses Remain Stable,55247,19488.0,21202,40690.0,14557.0,26.35,-0.01,Low Risk
U462,2024,12,250298.0,Salary Increases & Fixed Expenses Remain Stable,55247,19488.0,28977,48465.0,6782.0,12.28,0.02,High Risk
U463,2024,1,250000.0,Salary Increases & Fixed Expenses Increase,288819,77833.0,101278,179111.0,109708.0,37.99,0.03,Low Risk
U463,2024,2,359708.0,Salary Increases & Fixed Expenses Increase,288819,79053.0,140309,219362.0,69457.0,24.05,-0.04,Medium Risk
U463,2024,3,429165.0,Salary Increases & Fixed Expenses Increase,288819,79053.0,124130,203183.0,85636.0,29.65,0.01,Low Risk
U463,2024,4,514801.0,Salary Increases & Fixed Expenses Increase,300707,80825.0,141760,222585.0,78122.0,25.98,-0.04,Low Risk
U463,2024,5,592923.0,Salary Increases & Fixed Expenses Increase,300707,80825.0,94771,175596.0,125111.0,41.61,0.02,Low Risk
U463,2024,6,718034.0,Salary Increases & Fixed Expenses Increase,300707,80825.0,102951,183776.0,116931.0,38.89,-0.02,Low Risk
U463,2024,7,834965.0,Salary Increases & Fixed Expenses Increase,300707,80825.0,145711,226536.0,74171.0,24.67,-0.02,Medium Risk
U463,2024,8,909136.0,Salary Increases & Fixed Expenses Increase,300707,80825.0,111584,192409.0,108298.0,36.01,-0.03,Low Risk
U463,2024,9,1017434.0,Salary Increases & Fixed Expenses Increase,300707,80825.0,160342,241167.0,59540.0,19.8,-0.02,Medium Risk
U463,2024,10,1076974.0,Salary Increases & Fixed Expenses Increase,300707,80825.0,130880,211705.0,89002.0,29.6,0.03,Low Risk
U463,2024,11,1165976.0,Salary Increases & Fixed Expenses Increase,300707,80825.0,155274,236099.0,64608.0,21.49,-0.01,Medium Risk
U463,2024,12,1230584.0,Salary Increases & Fixed Expenses Increase,300707,81394.0,155488,236882.0,63825.0,21.22,0.03,Medium Risk
U464,2024,1,231524.0,Stable Salary & Increasing Fixed Expenses,180889,51044.0,62738,113782.0,67107.0,37.1,-0.0,Low Risk
U464,2024,2,298631.0,Stable Salary & Increasing Fixed Expenses,180889,51044.0,64968,116012.0,64877.0,35.87,0.01,Low Risk
U464,2024,3,363508.0,Stable Salary & Increasing Fixed Expenses,180889,51044.0,88747,139791.0,41098.0,22.72,0.01,Medium Risk
U464,2024,4,404606.0,Stable Salary & Increasing Fixed Expenses,180889,51044.0,62561,113605.0,67284.0,37.2,-0.01,Low Risk
U464,2024,5,471890.0,Stable Salary & Increasing Fixed Expenses,180889,51044.0,77531,128575.0,52314.0,28.92,0.04,Low Risk
U464,2024,6,524204.0,Stable Salary & Increasing Fixed Expenses,180889,51044.0,83242,134286.0,46603.0,25.76,0.02,Low Risk
U464,2024,7,570807.0,Stable Salary & Increasing Fixed Expenses,180889,52082.0,61191,113273.0,67616.0,37.38,0.03,Low Risk
U464,2024,8,638423.0,Stable Salary & Increasing Fixed Expenses,180889,53564.0,67914,121478.0,59411.0,32.84,0.05,Low Risk
U464,2024,9,697834.0,Stable Salary & Increasing Fixed Expenses,180889,53564.0,62291,115855.0,65034.0,35.95,0.01,Low Risk
U464,2024,10,762868.0,Stable Salary & Increasing Fixed Expenses,180889,53564.0,77478,131042.0,49847.0,27.56,0.02,Low Risk
U464,2024,11,812715.0,Stable Salary & Increasing Fixed Expenses,180889,53564.0,88458,142022.0,38867.0,21.49,0.02,Medium Risk
U464,2024,12,851582.0,Stable Salary & Increasing Fixed Expenses,180889,53564.0,79558,133122.0,47767.0,26.41,0.01,Low Risk
U465,2024,1,220815.0,Salary Increases & Fixed Expenses Increase,149173,66472.0,34345,100817.0,48356.0,32.42,0.02,Low Risk
U465,2024,2,269171.0,Salary Increases & Fixed Expenses Increase,149173,66472.0,38299,104771.0,44402.0,29.77,-0.01,Low Risk
U465,2024,3,313573.0,Salary Increases & Fixed Expenses Increase,149173,66472.0,38810,105282.0,43891.0,29.42,0.03,Low Risk
U465,2024,4,357464.0,Salary Increases & Fixed Expenses Increase,149173,67665.0,37445,105110.0,44063.0,29.54,0.04,Low Risk
U465,2024,5,401527.0,Salary Increases & Fixed Expenses Increase,149173,67665.0,30166,97831.0,51342.0,34.42,-0.05,Low Risk
U465,2024,6,452869.0,Salary Increases & Fixed Expenses Increase,149173,67665.0,40467,108132.0,41041.0,27.51,0.0,Low Risk
U465,2024,7,493910.0,Salary Increases & Fixed Expenses Increase,176754,67665.0,42881,110546.0,66208.0,37.46,-0.03,Low Risk
U465,2024,8,560118.0,Salary Increases & Fixed Expenses Increase,176754,67665.0,41610,109275.0,67479.0,38.18,-0.03,Low Risk
U465,2024,9,627597.0,Salary Increases & Fixed Expenses Increase,176754,67665.0,51004,118669.0,58085.0,32.86,-0.02,Low Risk
U465,2024,10,685682.0,Salary Increases & Fixed Expenses Increase,176754,67665.0,63479,131144.0,45610.0,25.8,0.02,Low Risk
U465,2024,11,731292.0,Salary Increases & Fixed Expenses Increase,176754,67665.0,55371,123036.0,53718.0,30.39,0.01,Low Risk
U465,2024,12,785010.0,Salary Increases & Fixed Expenses Increase,176754,67665.0,59401,127066.0,49688.0,28.11,0.01,Low Risk
U466,2024,1,250000.0,Salary Increases & Fixed Expenses Remain Stable,293231,100224.0,107584,207808.0,85423.0,29.13,-0.0,Low Risk
U466,2024,2,335423.0,Salary Increases & Fixed Expenses Remain Stable,293231,100224.0,128559,228783.0,64448.0,21.98,-0.04,Medium Risk
U466,2024,3,399871.0,Salary Increases & Fixed Expenses Remain Stable,293231,100224.0,137708,237932.0,55299.0,18.86,0.02,Medium Risk
U466,2024,4,455170.0,Salary Increases & Fixed Expenses Remain Stable,293231,100224.0,100058,200282.0,92949.0,31.7,-0.01,Low Risk
U466,2024,5,548119.0,Salary Increases & Fixed Expenses Remain Stable,293231,100224.0,102670,202894.0,90337.0,30.81,0.01,Low Risk
U466,2024,6,638456.0,Salary Increases & Fixed Expenses Remain Stable,319245,100224.0,112098,212322.0,106923.0,33.49,0.03,Low Risk
U466,2024,7,745379.0,Salary Increases & Fixed Expenses Remain Stable,319245,100224.0,126885,227109.0,92136.0,28.86,0.05,Low Risk
U466,2024,8,837515.0,Salary Increases & Fixed Expenses Remain Stable,319245,100224.0,131572,231796.0,87449.0,27.39,0.04,Low Risk
U466,2024,9,924964.0,Salary Increases & Fixed Expenses Remain Stable,319245,100224.0,175499,275723.0,43522.0,13.63,0.0,High Risk
U466,2024,10,968486.0,Salary Increases & Fixed Expenses Remain Stable,319245,100224.0,186523,286747.0,32498.0,10.18,-0.0,High Risk
U466,2024,11,1000984.0,Salary Increases & Fixed Expenses Remain Stable,319245,100224.0,126227,226451.0,92794.0,29.07,-0.02,Low Risk
U466,2024,12,1093778.0,Salary Increases & Fixed Expenses Remain Stable,319245,100224.0,157321,257545.0,61700.0,19.33,-0.02,Medium Risk
U467,2024,1,250000.0,Stable Salary & Increasing Fixed Expenses,279476,78788.0,81472,160260.0,119216.0,42.66,0.01,Low Risk
U467,2024,2,369216.0,Stable Salary & Increasing Fixed Expenses,279476,78788.0,80722,159510.0,119966.0,42.93,0.04,Low Risk
U467,2024,3,489182.0,Stable Salary & Increasing Fixed Expenses,279476,78788.0,75654,154442.0,125034.0,44.74,0.01,Low Risk
U467,2024,4,614216.0,Stable Salary & Increasing Fixed Expenses,279476,79889.0,57677,137566.0,141910.0,50.78,0.0,Low Risk
U467,2024,5,756126.0,Stable Salary & Increasing Fixed Expenses,279476,79889.0,71486,151375.0,128101.0,45.84,0.02,Low Risk
U467,2024,6,884227.0,Stable Salary & Increasing Fixed Expenses,279476,81024.0,55951,136975.0,142501.0,50.99,-0.05,Low Risk
U467,2024,7,1026728.0,Stable Salary & Increasing Fixed Expenses,279476,82370.0,77162,159532.0,119944.0,42.92,0.02,Low Risk
U467,2024,8,1146672.0,Stable Salary & Increasing Fixed Expenses,279476,82370.0,83285,165655.0,113821.0,40.73,0.05,Low Risk
U467,2024,9,1260493.0,Stable Salary & Increasing Fixed Expenses,279476,82370.0,68877,151247.0,128229.0,45.88,-0.04,Low Risk
U467,2024,10,1388722.0,Stable Salary & Increasing Fixed Expenses,279476,82370.0,79694,162064.0,117412.0,42.01,0.02,Low Risk
U467,2024,11,1506134.0,Stable Salary & Increasing Fixed Expenses,279476,82370.0,62019,144389.0,135087.0,48.34,-0.03,Low Risk
U467,2024,12,1641221.0,Stable Salary & Increasing Fixed Expenses,279476,82370.0,63038,145408.0,134068.0,47.97,-0.03,Low Risk
U468,2024,1,243677.0,Stable Salary & Stable Fixed Expenses,241554,70388.0,75410,145798.0,95756.0,39.64,-0.0,Low Risk
U468,2024,2,339433.0,Stable Salary & Stable Fixed Expenses,241554,70388.0,113597,183985.0,57569.0,23.83,-0.04,Medium Risk
U468,2024,3,397002.0,Stable Salary & Stable Fixed Expenses,241554,70388.0,114591,184979.0,56575.0,23.42,0.04,Medium Risk
U468,2024,4,453577.0,Stable Salary & Stable Fixed Expenses,241554,70388.0,92287,162675.0,78879.0,32.65,-0.01,Low Risk
U468,2024,5,532456.0,Stable Salary & Stable Fixed Expenses,241554,70388.0,94310,164698.0,76856.0,31.82,0.03,Low Risk
U468,2024,6,609312.0,Stable Salary & Stable Fixed Expenses,241554,70388.0,97230,167618.0,73936.0,30.61,0.02,Low Risk
U468,2024,7,683248.0,Stable Salary & Stable Fixed Expenses,241554,70388.0,78071,148459.0,93095.0,38.54,0.05,Low Risk
U468,2024,8,776343.0,Stable Salary & Stable Fixed Expenses,241554,70388.0,94949,165337.0,76217.0,31.55,0.05,Low Risk
U468,2024,9,852560.0,Stable Salary & Stable Fixed Expenses,241554,70388.0,118873,189261.0,52293.0,21.65,0.04,Medium Risk
U468,2024,10,904853.0,Stable Salary & Stable Fixed Expenses,241554,70388.0,88065,158453.0,83101.0,34.4,-0.03,Low Risk
U468,2024,11,987954.0,Stable Salary & Stable Fixed Expenses,241554,70388.0,107316,177704.0,63850.0,26.43,0.01,Low Risk
U468,2024,12,1051804.0,Stable Salary & Stable Fixed Expenses,241554,70388.0,130649,201037.0,40517.0,16.77,0.03,Medium Risk
U469,2024,1,245246.0,Salary Increases & Fixed Expenses Remain Stable,180013,67393.0,96594,163987.0,16026.0,8.9,0.03,High Risk
U469,2024,2,261272.0,Salary Increases & Fixed Expenses Remain Stable,180013,67393.0,99892,167285.0,12728.0,7.07,-0.0,High Risk
U469,2024,3,274000.0,Salary Increases & Fixed Expenses Remain Stable,180013,67393.0,98026,165419.0,14594.0,8.11,0.04,High Risk
U469,2024,4,288594.0,Salary Increases & Fixed Expenses Remain Stable,180013,67393.0,104175,171568.0,8445.0,4.69,0.01,High Risk
U469,2024,5,297039.0,Salary Increases & Fixed Expenses Remain Stable,180013,67393.0,122169,189562.0,-9549.0,-5.3,-0.02,High Risk
U469,2024,6,287490.0,Salary Increases & Fixed Expenses Remain Stable,180013,67393.0,125975,193368.0,-13355.0,-7.42,-0.01,High Risk
U469,2024,7,274135.0,Salary Increases & Fixed Expenses Remain Stable,180013,67393.0,109533,176926.0,3087.0,1.71,-0.02,High Risk
U469,2024,8,277222.0,Salary Increases & Fixed Expenses Remain Stable,187204,67393.0,104977,172370.0,14834.0,7.92,-0.02,High Risk
U469,2024,9,292056.0,Salary Increases & Fixed Expenses Remain Stable,187204,67393.0,117933,185326.0,1878.0,1.0,0.03,High Risk
U469,2024,10,293934.0,Salary Increases & Fixed Expenses Remain Stable,187204,67393.0,104326,171719.0,15485.0,8.27,-0.03,High Risk
U469,2024,11,309419.0,Salary Increases & Fixed Expenses Remain Stable,187204,67393.0,142663,210056.0,-22852.0,-12.21,0.04,High Risk
U469,2024,12,286567.0,Salary Increases & Fixed Expenses Remain Stable,187204,67393.0,115733,183126.0,4078.0,2.18,-0.05,High Risk
U470,2024,1,249620.0,Salary Increases & Fixed Expenses Decrease,180235,75220.0,74889,150109.0,30126.0,16.71,-0.01,Medium Risk
U470,2024,2,279746.0,Salary Increases & Fixed Expenses Decrease,180235,75220.0,75043,150263.0,29972.0,16.63,-0.01,Medium Risk
U470,2024,3,309718.0,Salary Increases & Fixed Expenses Decrease,180235,75220.0,101006,176226.0,4009.0,2.22,-0.04,High Risk
U470,2024,4,313727.0,Salary Increases & Fixed Expenses Decrease,187894,75220.0,62721,137941.0,49953.0,26.59,0.05,Low Risk
U470,2024,5,363680.0,Salary Increases & Fixed Expenses Decrease,187894,75220.0,60555,135775.0,52119.0,27.74,0.01,Low Risk
U470,2024,6,415799.0,Salary Increases & Fixed Expenses Decrease,187894,75220.0,73358,148578.0,39316.0,20.92,0.05,Medium Risk
U470,2024,7,455115.0,Salary Increases & Fixed Expenses Decrease,187894,75220.0,59087,134307.0,53587.0,28.52,-0.02,Low Risk
U470,2024,8,508702.0,Salary Increases & Fixed Expenses Decrease,187894,75220.0,77130,152350.0,35544.0,18.92,0.04,Medium Risk
U470,2024,9,544246.0,Salary Increases & Fixed Expenses Decrease,187894,75220.0,64200,139420.0,48474.0,25.8,-0.03,Low Risk
U470,2024,10,592720.0,Salary Increases & Fixed Expenses Decrease,187894,75220.0,69737,144957.0,42937.0,22.85,-0.04,Medium Risk
U470,2024,11,635657.0,Salary Increases & Fixed Expenses Decrease,187894,75220.0,91469,166689.0,21205.0,11.29,-0.04,High Risk
U470,2024,12,656862.0,Salary Increases & Fixed Expenses Decrease,187894,75220.0,98707,173927.0,13967.0,7.43,0.01,High Risk
U471,2024,1,219876.0,Stable Salary & Stable Fixed Expenses,162027,67975.0,39170,107145.0,54882.0,33.87,0.03,Low Risk
U471,2024,2,274758.0,Stable Salary & Stable Fixed Expenses,162027,67975.0,46867,114842.0,47185.0,29.12,0.01,Low Risk
U471,2024,3,321943.0,Stable Salary & Stable Fixed Expenses,162027,67975.0,39688,107663.0,54364.0,33.55,0.04,Low Risk
U471,2024,4,376307.0,Stable Salary & Stable Fixed Expenses,162027,67975.0,42369,110344.0,51683.0,31.9,-0.05,Low Risk
U471,2024,5,427990.0,Stable Salary & Stable Fixed Expenses,162027,67975.0,32439,100414.0,61613.0,38.03,-0.05,Low Risk
U471,2024,6,489603.0,Stable Salary & Stable Fixed Expenses,162027,67975.0,41638,109613.0,52414.0,32.35,-0.04,Low Risk
U471,2024,7,542017.0,Stable Salary & Stable Fixed Expenses,162027,67975.0,32900,100875.0,61152.0,37.74,0.04,Low Risk
U471,2024,8,603169.0,Stable Salary & Stable Fixed Expenses,162027,67975.0,33880,101855.0,60172.0,37.14,-0.01,Low Risk
U471,2024,9,663341.0,Stable Salary & Stable Fixed Expenses,162027,67975.0,37647,105622.0,56405.0,34.81,0.04,Low Risk
U471,2024,10,719746.0,Stable Salary & Stable Fixed Expenses,162027,67975.0,39949,107924.0,54103.0,33.39,0.05,Low Risk
U471,2024,11,773849.0,Stable Salary & Stable Fixed Expenses,162027,67975.0,49850,117825.0,44202.0,27.28,-0.03,Low Risk
U471,2024,12,818051.0,Stable Salary & Stable Fixed Expenses,162027,67975.0,34233,102208.0,59819.0,36.92,0.04,Low Risk
U472,2024,1,204254.0,Salary Increases & Fixed Expenses Increase,200473,88190.0,69685,157875.0,42598.0,21.25,0.04,Medium Risk
U472,2024,2,246852.0,Salary Increases & Fixed Expenses Increase,200473,88190.0,76486,164676.0,35797.0,17.86,-0.03,Medium Risk
U472,2024,3,282649.0,Salary Increases & Fixed Expenses Increase,200473,88190.0,92628,180818.0,19655.0,9.8,0.05,High Risk
U472,2024,4,302304.0,Salary Increases & Fixed Expenses Increase,200473,88190.0,67161,155351.0,45122.0,22.51,-0.04,Medium Risk
U472,2024,5,347426.0,Salary Increases & Fixed Expenses Increase,200473,88190.0,89964,178154.0,22319.0,11.13,0.01,High Risk
U472,2024,6,369745.0,Salary Increases & Fixed Expenses Increase,200473,88190.0,80066,168256.0,32217.0,16.07,-0.03,Medium Risk
U472,2024,7,401962.0,Salary Increases & Fixed Expenses Increase,200473,88190.0,74804,162994.0,37479.0,18.7,0.0,Medium Risk
U472,2024,8,439441.0,Salary Increases & Fixed Expenses Increase,215555,89895.0,82553,172448.0,43107.0,20.0,-0.02,Medium Risk
U472,2024,9,482548.0,Salary Increases & Fixed Expenses Increase,215555,89895.0,83392,173287.0,42268.0,19.61,-0.02,Medium Risk
U472,2024,10,524816.0,Salary Increases & Fixed Expenses Increase,215555,91339.0,87569,178908.0,36647.0,17.0,0.03,Medium Risk
U472,2024,11,561463.0,Salary Increases & Fixed Expenses Increase,215555,91339.0,98746,190085.0,25470.0,11.82,-0.01,High Risk
U472,2024,12,586933.0,Salary Increases & Fixed Expenses Increase,215555,91339.0,105662,197001.0,18554.0,8.61,0.04,High Risk
U473,2024,1,205726.0,Stable Salary & Stable Fixed Expenses,132594,55307.0,77511,132818.0,-224.0,-0.17,-0.04,High Risk
U473,2024,2,205502.0,Stable Salary & Stable Fixed Expenses,132594,55307.0,83318,138625.0,-6031.0,-4.55,-0.03,High Risk
U473,2024,3,199471.0,Stable Salary & Stable Fixed Expenses,132594,55307.0,78289,133596.0,-1002.0,-0.76,-0.04,High Risk
U473,2024,4,198469.0,Stable Salary & Stable Fixed Expenses,132594,55307.0,70522,125829.0,6765.0,5.1,-0.02,High Risk
U473,2024,5,205234.0,Stable Salary & Stable Fixed Expenses,132594,55307.0,81301,136608.0,-4014.0,-3.03,0.02,High Risk
U473,2024,6,201220.0,Stable Salary & Stable Fixed Expenses,132594,55307.0,79506,134813.0,-2219.0,-1.67,-0.05,High Risk
U473,2024,7,199001.0,Stable Salary & Stable Fixed Expenses,132594,55307.0,79513,134820.0,-2226.0,-1.68,-0.0,High Risk
U473,2024,8,196775.0,Stable Salary & Stable Fixed Expenses,132594,55307.0,69549,124856.0,7738.0,5.84,0.01,High Risk
U473,2024,9,204513.0,Stable Salary & Stable Fixed Expenses,132594,55307.0,82681,137988.0,-5394.0,-4.07,-0.01,High Risk
U473,2024,10,199119.0,Stable Salary & Stable Fixed Expenses,132594,55307.0,88583,143890.0,-11296.0,-8.52,0.02,High Risk
U473,2024,11,187823.0,Stable Salary & Stable Fixed Expenses,132594,55307.0,69707,125014.0,7580.0,5.72,-0.03,High Risk
U473,2024,12,195403.0,Stable Salary & Stable Fixed Expenses,132594,55307.0,92603,147910.0,-15316.0,-11.55,-0.0,High Risk
U474,2024,1,174414.0,Stable Salary & Stable Fixed Expenses,106283,43721.0,72544,116265.0,-9982.0,-9.39,-0.03,High Risk
U474,2024,2,164432.0,Stable Salary & Stable Fixed Expenses,106283,43721.0,55076,98797.0,7486.0,7.04,0.04,High Risk
U474,2024,3,171918.0,Stable Salary & Stable Fixed Expenses,106283,43721.0,74101,117822.0,-11539.0,-10.86,0.01,High Risk
U474,2024,4,160379.0,Stable Salary & Stable Fixed Expenses,106283,43721.0,65902,109623.0,-3340.0,-3.14,0.02,High Risk
U474,2024,5,157039.0,Stable Salary & Stable Fixed Expenses,106283,43721.0,68470,112191.0,-5908.0,-5.56,0.04,High Risk
U474,2024,6,151131.0,Stable Salary & Stable Fixed Expenses,106283,43721.0,73284,117005.0,-10722.0,-10.09,0.04,High Risk
U474,2024,7,140409.0,Stable Salary & Stable Fixed Expenses,106283,43721.0,69740,113461.0,-7178.0,-6.75,-0.01,High Risk
U474,2024,8,133231.0,Stable Salary & Stable Fixed Expenses,106283,43721.0,64614,108335.0,-2052.0,-1.93,-0.02,High Risk
U474,2024,9,131179.0,Stable Salary & Stable Fixed Expenses,106283,43721.0,61136,104857.0,1426.0,1.34,0.03,High Risk
U474,2024,10,132605.0,Stable Salary & Stable Fixed Expenses,106283,43721.0,65972,109693.0,-3410.0,-3.21,0.01,High Risk
U474,2024,11,129195.0,Stable Salary & Stable Fixed Expenses,106283,43721.0,73692,117413.0,-11130.0,-10.47,0.02,High Risk
U474,2024,12,118065.0,Stable Salary & Stable Fixed Expenses,106283,43721.0,65434,109155.0,-2872.0,-2.7,-0.03,High Risk
U475,2024,1,250000.0,Salary Increases & Fixed Expenses Remain Stable,262359,75968.0,70146,146114.0,116245.0,44.31,0.01,Low Risk
U475,2024,2,366245.0,Salary Increases & Fixed Expenses Remain Stable,262359,75968.0,57964,133932.0,128427.0,48.95,0.01,Low Risk
U475,2024,3,494672.0,Salary Increases & Fixed Expenses Remain Stable,291714,75968.0,80540,156508.0,135206.0,46.35,0.01,Low Risk
U475,2024,4,629878.0,Salary Increases & Fixed Expenses Remain Stable,291714,75968.0,85419,161387.0,130327.0,44.68,-0.04,Low Risk
U475,2024,5,760205.0,Salary Increases & Fixed Expenses Remain Stable,291714,75968.0,79588,155556.0,136158.0,46.68,-0.02,Low Risk
U475,2024,6,896363.0,Salary Increases & Fixed Expenses Remain Stable,291714,75968.0,60008,135976.0,155738.0,53.39,0.01,Low Risk
U475,2024,7,1052101.0,Salary Increases & Fixed Expenses Remain Stable,291714,75968.0,62111,138079.0,153635.0,52.67,0.02,Low Risk
U475,2024,8,1205736.0,Salary Increases & Fixed Expenses Remain Stable,291714,75968.0,66321,142289.0,149425.0,51.22,0.01,Low Risk
U475,2024,9,1355161.0,Salary Increases & Fixed Expenses Remain Stable,291714,75968.0,66470,142438.0,149276.0,51.17,0.0,Low Risk
U475,2024,10,1504437.0,Salary Increases & Fixed Expenses Remain Stable,291714,75968.0,63436,139404.0,152310.0,52.21,0.02,Low Risk
U475,2024,11,1656747.0,Salary Increases & Fixed Expenses Remain Stable,291714,75968.0,88543,164511.0,127203.0,43.61,0.01,Low Risk
U475,2024,12,1783950.0,Salary Increases & Fixed Expenses Remain Stable,291714,75968.0,66980,142948.0,148766.0,51.0,0.01,Low Risk
U476,2024,1,142047.0,Salary Increases & Fixed Expenses Increase,120858,55346.0,49779,105125.0,15733.0,13.02,-0.01,High Risk
U476,2024,2,157780.0,Salary Increases & Fixed Expenses Increase,120858,55346.0,48354,103700.0,17158.0,14.2,0.02,High Risk
U476,2024,3,174938.0,Salary Increases & Fixed Expenses Increase,120858,55346.0,43328,98674.0,22184.0,18.36,0.04,Medium Risk
U476,2024,4,197122.0,Salary Increases & Fixed Expenses Increase,120858,55346.0,56807,112153.0,8705.0,7.2,-0.01,High Risk
U476,2024,5,205827.0,Salary Increases & Fixed Expenses Increase,120858,56531.0,54100,110631.0,10227.0,8.46,-0.01,High Risk
U476,2024,6,216054.0,Salary Increases & Fixed Expenses Increase,120858,57199.0,47927,105126.0,15732.0,13.02,-0.03,High Risk
U476,2024,7,231786.0,Salary Increases & Fixed Expenses Increase,134958,57199.0,63001,120200.0,14758.0,10.94,-0.01,High Risk
U476,2024,8,246544.0,Salary Increases & Fixed Expenses Increase,134958,57199.0,66456,123655.0,11303.0,8.38,0.02,High Risk
U476,2024,9,257847.0,Salary Increases & Fixed Expenses Increase,134958,58639.0,47296,105935.0,29023.0,21.51,-0.03,Medium Risk
U476,2024,10,286870.0,Salary Increases & Fixed Expenses Increase,134958,59625.0,64252,123877.0,11081.0,8.21,0.04,High Risk
U476,2024,11,297951.0,Salary Increases & Fixed Expenses Increase,134958,59625.0,55103,114728.0,20230.0,14.99,0.05,High Risk
U476,2024,12,318181.0,Salary Increases & Fixed Expenses Increase,134958,59625.0,57193,116818.0,18140.0,13.44,-0.03,High Risk
U477,2024,1,147497.0,Stable Salary & Stable Fixed Expenses,65441,37436.0,15521,52957.0,12484.0,19.08,-0.04,Medium Risk
U477,2024,2,159981.0,Stable Salary & Stable Fixed Expenses,65441,37436.0,19019,56455.0,8986.0,13.73,0.02,High Risk
U477,2024,3,168967.0,Stable Salary & Stable Fixed Expenses,65441,37436.0,16935,54371.0,11070.0,16.92,0.0,Medium Risk
U477,2024,4,180037.0,Stable Salary & Stable Fixed Expenses,65441,37436.0,14265,51701.0,13740.0,21.0,0.03,Medium Risk
U477,2024,5,193777.0,Stable Salary & Stable Fixed Expenses,65441,37436.0,14371,51807.0,13634.0,20.83,0.05,Medium Risk
U477,2024,6,207411.0,Stable Salary & Stable Fixed Expenses,65441,37436.0,16896,54332.0,11109.0,16.98,-0.01,Medium Risk
U477,2024,7,218520.0,Stable Salary & Stable Fixed Expenses,65441,37436.0,17988,55424.0,10017.0,15.31,-0.02,Medium Risk
U477,2024,8,228537.0,Stable Salary & Stable Fixed Expenses,65441,37436.0,13620,51056.0,14385.0,21.98,0.01,Medium Risk
U477,2024,9,242922.0,Stable Salary & Stable Fixed Expenses,65441,37436.0,19451,56887.0,8554.0,13.07,-0.01,High Risk
U477,2024,10,251476.0,Stable Salary & Stable Fixed Expenses,65441,37436.0,15379,52815.0,12626.0,19.29,0.01,Medium Risk
U477,2024,11,264102.0,Stable Salary & Stable Fixed Expenses,65441,37436.0,18541,55977.0,9464.0,14.46,0.04,High Risk
U477,2024,12,273566.0,Stable Salary & Stable Fixed Expenses,65441,37436.0,14890,52326.0,13115.0,20.04,-0.05,Medium Risk
U478,2024,1,243624.0,Salary Increases & Fixed Expenses Increase,239949,90791.0,55548,146339.0,93610.0,39.01,0.0,Low Risk
U478,2024,2,337234.0,Salary Increases & Fixed Expenses Increase,239949,90791.0,68400,159191.0,80758.0,33.66,0.04,Low Risk
U478,2024,3,417992.0,Salary Increases & Fixed Expenses Increase,269892,90791.0,64538,155329.0,114563.0,42.45,-0.01,Low Risk
U478,2024,4,532555.0,Salary Increases & Fixed Expenses Increase,269892,92632.0,55326,147958.0,121934.0,45.18,0.05,Low Risk
U478,2024,5,654489.0,Salary Increases & Fixed Expenses Increase,269892,92632.0,62879,155511.0,114381.0,42.38,-0.03,Low Risk
U478,2024,6,768870.0,Salary Increases & Fixed Expenses Increase,269892,92632.0,60730,153362.0,116530.0,43.18,0.01,Low Risk
U478,2024,7,885400.0,Salary Increases & Fixed Expenses Increase,269892,92632.0,76480,169112.0,100780.0,37.34,0.03,Low Risk
U478,2024,8,986180.0,Salary Increases & Fixed Expenses Increase,269892,92632.0,69947,162579.0,107313.0,39.76,0.02,Low Risk
U478,2024,9,1093493.0,Salary Increases & Fixed Expenses Increase,269892,94232.0,63811,158043.0,111849.0,41.44,0.01,Low Risk
U478,2024,10,1205342.0,Salary Increases & Fixed Expenses Increase,269892,94232.0,76549,170781.0,99111.0,36.72,0.04,Low Risk
U478,2024,11,1304453.0,Salary Increases & Fixed Expenses Increase,269892,94232.0,65842,160074.0,109818.0,40.69,-0.04,Low Risk
U478,2024,12,1414271.0,Salary Increases & Fixed Expenses Increase,269892,94232.0,55596,149828.0,120064.0,44.49,0.04,Low Risk
U479,2024,1,205113.0,Stable Salary & Stable Fixed Expenses,202518,103529.0,88304,191833.0,10685.0,5.28,-0.0,High Risk
U479,2024,2,215798.0,Stable Salary & Stable Fixed Expenses,202518,103529.0,91939,195468.0,7050.0,3.48,0.01,High Risk
U479,2024,3,222848.0,Stable Salary & Stable Fixed Expenses,202518,103529.0,70731,174260.0,28258.0,13.95,0.02,High Risk
U479,2024,4,251106.0,Stable Salary & Stable Fixed Expenses,202518,103529.0,92604,196133.0,6385.0,3.15,-0.0,High Risk
U479,2024,5,257491.0,Stable Salary & Stable Fixed Expenses,202518,103529.0,65762,169291.0,33227.0,16.41,0.03,Medium Risk
U479,2024,6,290718.0,Stable Salary & Stable Fixed Expenses,202518,103529.0,86807,190336.0,12182.0,6.02,0.02,High Risk
U479,2024,7,302900.0,Stable Salary & Stable Fixed Expenses,202518,103529.0,96114,199643.0,2875.0,1.42,0.01,High Risk
U479,2024,8,305775.0,Stable Salary & Stable Fixed Expenses,202518,103529.0,80207,183736.0,18782.0,9.27,0.05,High Risk
U479,2024,9,324557.0,Stable Salary & Stable Fixed Expenses,202518,103529.0,82869,186398.0,16120.0,7.96,-0.01,High Risk
U479,2024,10,340677.0,Stable Salary & Stable Fixed Expenses,202518,103529.0,82144,185673.0,16845.0,8.32,0.01,High Risk
U479,2024,11,357522.0,Stable Salary & Stable Fixed Expenses,202518,103529.0,87842,191371.0,11147.0,5.5,0.0,High Risk
U479,2024,12,368669.0,Stable Salary & Stable Fixed Expenses,202518,103529.0,85545,189074.0,13444.0,6.64,0.05,High Risk
U480,2024,1,241488.0,Salary Increases & Fixed Expenses Increase,231256,64981.0,122547,187528.0,43728.0,18.91,0.02,Medium Risk
U480,2024,2,285216.0,Salary Increases & Fixed Expenses Increase,231256,64981.0,138583,203564.0,27692.0,11.97,-0.03,High Risk
U480,2024,3,312908.0,Salary Increases & Fixed Expenses Increase,231256,64981.0,194914,259895.0,-28639.0,-12.38,0.0,High Risk
U480,2024,4,284269.0,Salary Increases & Fixed Expenses Increase,231256,64981.0,129943,194924.0,36332.0,15.71,0.0,Medium Risk
U480,2024,5,320601.0,Salary Increases & Fixed Expenses Increase,252361,64981.0,166906,231887.0,20474.0,8.11,-0.02,High Risk
U480,2024,6,341075.0,Salary Increases & Fixed Expenses Increase,252361,64981.0,164341,229322.0,23039.0,9.13,-0.03,High Risk
U480,2024,7,364114.0,Salary Increases & Fixed Expenses Increase,252361,64981.0,162119,227100.0,25261.0,10.01,-0.01,High Risk
U480,2024,8,389375.0,Salary Increases & Fixed Expenses Increase,252361,64981.0,150028,215009.0,37352.0,14.8,0.04,High Risk
U480,2024,9,426727.0,Salary Increases & Fixed Expenses Increase,252361,64981.0,190048,255029.0,-2668.0,-1.06,-0.02,High Risk
U480,2024,10,424059.0,Salary Increases & Fixed Expenses Increase,252361,64981.0,208157,273138.0,-20777.0,-8.23,-0.03,High Risk
U480,2024,11,403282.0,Salary Increases & Fixed Expenses Increase,252361,66323.0,140001,206324.0,46037.0,18.24,0.03,Medium Risk
U480,2024,12,449319.0,Salary Increases & Fixed Expenses Increase,252361,68129.0,168209,236338.0,16023.0,6.35,-0.03,High Risk
U481,2024,1,250000.0,Stable Salary & Stable Fixed Expenses,289113,71383.0,105987,177370.0,111743.0,38.65,0.04,Low Risk
U481,2024,2,361743.0,Stable Salary & Stable Fixed Expenses,289113,71383.0,93522,164905.0,124208.0,42.96,-0.04,Low Risk
U481,2024,3,485951.0,Stable Salary & Stable Fixed Expenses,289113,71383.0,95322,166705.0,122408.0,42.34,0.01,Low Risk
U481,2024,4,608359.0,Stable Salary & Stable Fixed Expenses,289113,71383.0,117661,189044.0,100069.0,34.61,-0.04,Low Risk
U481,2024,5,708428.0,Stable Salary & Stable Fixed Expenses,289113,71383.0,95036,166419.0,122694.0,42.44,0.04,Low Risk
U481,2024,6,831122.0,Stable Salary & Stable Fixed Expenses,289113,71383.0,126455,197838.0,91275.0,31.57,0.01,Low Risk
U481,2024,7,922397.0,Stable Salary & Stable Fixed Expenses,289113,71383.0,132353,203736.0,85377.0,29.53,0.0,Low Risk
U481,2024,8,1007774.0,Stable Salary & Stable Fixed Expenses,289113,71383.0,95921,167304.0,121809.0,42.13,-0.04,Low Risk
U481,2024,9,1129583.0,Stable Salary & Stable Fixed Expenses,289113,71383.0,123247,194630.0,94483.0,32.68,0.01,Low Risk
U481,2024,10,1224066.0,Stable Salary & Stable Fixed Expenses,289113,71383.0,117101,188484.0,100629.0,34.81,0.02,Low Risk
U481,2024,11,1324695.0,Stable Salary & Stable Fixed Expenses,289113,71383.0,120955,192338.0,96775.0,33.47,0.03,Low Risk
U481,2024,12,1421470.0,Stable Salary & Stable Fixed Expenses,289113,71383.0,88260,159643.0,129470.0,44.78,-0.01,Low Risk
U482,2024,1,76020.0,Salary Increases & Fixed Expenses Remain Stable,20782,19513.0,10255,29768.0,-8986.0,-43.24,-0.04,High Risk
U482,2024,2,67034.0,Salary Increases & Fixed Expenses Remain Stable,20782,19513.0,6409,25922.0,-5140.0,-24.73,-0.05,High Risk
U482,2024,3,61894.0,Salary Increases & Fixed Expenses Remain Stable,20782,19513.0,9567,29080.0,-8298.0,-39.93,0.04,High Risk
U482,2024,4,53596.0,Salary Increases & Fixed Expenses Remain Stable,20782,19513.0,6873,26386.0,-5604.0,-26.97,-0.04,High Risk
U482,2024,5,47992.0,Salary Increases & Fixed Expenses Remain Stable,20782,19513.0,6584,26097.0,-5315.0,-25.58,0.04,High Risk
U482,2024,6,42677.0,Salary Increases & Fixed Expenses Remain Stable,20782,19513.0,9536,29049.0,-8267.0,-39.78,-0.0,High Risk
U482,2024,7,34410.0,Salary Increases & Fixed Expenses Remain Stable,42666,19513.0,18479,37992.0,4674.0,10.95,-0.01,High Risk
U482,2024,8,39084.0,Salary Increases & Fixed Expenses Remain Stable,42666,19513.0,15791,35304.0,7362.0,17.25,0.04,Medium Risk
U482,2024,9,46446.0,Salary Increases & Fixed Expenses Remain Stable,42666,19513.0,19915,39428.0,3238.0,7.59,-0.03,High Risk
U482,2024,10,49684.0,Salary Increases & Fixed Expenses Remain Stable,42666,19513.0,16372,35885.0,6781.0,15.89,0.01,Medium Risk
U482,2024,11,56465.0,Salary Increases & Fixed Expenses Remain Stable,42666,19513.0,16525,36038.0,6628.0,15.53,-0.02,Medium Risk
U482,2024,12,63093.0,Salary Increases & Fixed Expenses Remain Stable,42666,19513.0,13341,32854.0,9812.0,23.0,-0.04,Medium Risk
U483,2024,1,138281.0,Salary Increases & Fixed Expenses Decrease,41864,12441.0,14632,27073.0,14791.0,35.33,-0.04,Low Risk
U483,2024,2,153072.0,Salary Increases & Fixed Expenses Decrease,41864,12441.0,17149,29590.0,12274.0,29.32,0.04,Low Risk
U483,2024,3,165346.0,Salary Increases & Fixed Expenses Decrease,41864,12441.0,20222,32663.0,9201.0,21.98,-0.02,Medium Risk
U483,2024,4,174547.0,Salary Increases & Fixed Expenses Decrease,47099,12441.0,21900,34341.0,12758.0,27.09,0.04,Low Risk
U483,2024,5,187305.0,Salary Increases & Fixed Expenses Decrease,47099,12441.0,15402,27843.0,19256.0,40.88,0.0,Low Risk
U483,2024,6,206561.0,Salary Increases & Fixed Expenses Decrease,47099,12441.0,16600,29041.0,18058.0,38.34,0.04,Low Risk
U483,2024,7,224619.0,Salary Increases & Fixed Expenses Decrease,47099,11563.0,19458,31021.0,16078.0,34.14,0.02,Low Risk
U483,2024,8,240697.0,Salary Increases & Fixed Expenses Decrease,47099,11563.0,23269,34832.0,12267.0,26.05,0.01,Low Risk
U483,2024,9,252964.0,Salary Increases & Fixed Expenses Decrease,47099,11563.0,22661,34224.0,12875.0,27.34,0.0,Low Risk
U483,2024,10,265839.0,Salary Increases & Fixed Expenses Decrease,47099,11563.0,19170,30733.0,16366.0,34.75,-0.0,Low Risk
U483,2024,11,282205.0,Salary Increases & Fixed Expenses Decrease,47099,11563.0,20647,32210.0,14889.0,31.61,-0.04,Low Risk
U483,2024,12,297094.0,Salary Increases & Fixed Expenses Decrease,47099,11563.0,22204,33767.0,13332.0,28.31,-0.03,Low Risk
U484,2024,1,247240.0,Salary Increases & Fixed Expenses Remain Stable,242183,82858.0,71861,154719.0,87464.0,36.11,0.01,Low Risk
U484,2024,2,334704.0,Salary Increases & Fixed Expenses Remain Stable,242183,82858.0,66650,149508.0,92675.0,38.27,0.01,Low Risk
U484,2024,3,427379.0,Salary Increases & Fixed Expenses Remain Stable,249552,82858.0,88693,171551.0,78001.0,31.26,-0.03,Low Risk
U484,2024,4,505380.0,Salary Increases & Fixed Expenses Remain Stable,249552,82858.0,56313,139171.0,110381.0,44.23,0.05,Low Risk
U484,2024,5,615761.0,Salary Increases & Fixed Expenses Remain Stable,249552,82858.0,51036,133894.0,115658.0,46.35,0.04,Low Risk
U484,2024,6,731419.0,Salary Increases & Fixed Expenses Remain Stable,249552,82858.0,60072,142930.0,106622.0,42.73,0.05,Low Risk
U484,2024,7,838041.0,Salary Increases & Fixed Expenses Remain Stable,249552,82858.0,56086,138944.0,110608.0,44.32,-0.01,Low Risk
U484,2024,8,948649.0,Salary Increases & Fixed Expenses Remain Stable,249552,82858.0,58637,141495.0,108057.0,43.3,-0.02,Low Risk
U484,2024,9,1056706.0,Salary Increases & Fixed Expenses Remain Stable,249552,82858.0,73202,156060.0,93492.0,37.46,0.01,Low Risk
U484,2024,10,1150198.0,Salary Increases & Fixed Expenses Remain Stable,249552,82858.0,85958,168816.0,80736.0,32.35,-0.05,Low Risk
U484,2024,11,1230934.0,Salary Increases & Fixed Expenses Remain Stable,249552,82858.0,72612,155470.0,94082.0,37.7,0.01,Low Risk
U484,2024,12,1325016.0,Salary Increases & Fixed Expenses Remain Stable,249552,82858.0,78292,161150.0,88402.0,35.42,-0.02,Low Risk
U485,2024,1,185526.0,Salary Increases & Fixed Expenses Decrease,83774,32917.0,17597,50514.0,33260.0,39.7,-0.0,Low Risk
U485,2024,2,218786.0,Salary Increases & Fixed Expenses Decrease,83774,32917.0,22459,55376.0,28398.0,33.9,-0.03,Low Risk
U485,2024,3,247184.0,Salary Increases & Fixed Expenses Decrease,95484,32332.0,26307,58639.0,36845.0,38.59,-0.01,Low Risk
U485,2024,4,284029.0,Salary Increases & Fixed Expenses Decrease,95484,32332.0,20549,52881.0,42603.0,44.62,0.02,Low Risk
U485,2024,5,326632.0,Salary Increases & Fixed Expenses Decrease,95484,30453.0,20629,51082.0,44402.0,46.5,0.04,Low Risk
U485,2024,6,371034.0,Salary Increases & Fixed Expenses Decrease,95484,30453.0,26069,56522.0,38962.0,40.8,0.05,Low Risk
U485,2024,7,409996.0,Salary Increases & Fixed Expenses Decrease,95484,30453.0,21397,51850.0,43634.0,45.7,-0.03,Low Risk
U485,2024,8,453630.0,Salary Increases & Fixed Expenses Decrease,95484,30453.0,22288,52741.0,42743.0,44.76,0.0,Low Risk
U485,2024,9,496373.0,Salary Increases & Fixed Expenses Decrease,95484,30453.0,28114,58567.0,36917.0,38.66,0.03,Low Risk
U485,2024,10,533290.0,Salary Increases & Fixed Expenses Decrease,95484,30453.0,20649,51102.0,44382.0,46.48,-0.04,Low Risk
U485,2024,11,577672.0,Salary Increases & Fixed Expenses Decrease,95484,30453.0,27419,57872.0,37612.0,39.39,-0.01,Low Risk
U485,2024,12,615284.0,Salary Increases & Fixed Expenses Decrease,95484,30453.0,23931,54384.0,41100.0,43.04,0.02,Low Risk
U486,2024,1,243049.0,Salary Increases & Fixed Expenses Decrease,35223,14383.0,16788,31171.0,4052.0,11.5,-0.03,High Risk
U486,2024,2,247101.0,Salary Increases & Fixed Expenses Decrease,35223,12944.7,13272,26216.7,9006.3,25.57,0.03,Low Risk
U486,2024,3,256107.3,Salary Increases & Fixed Expenses Decrease,35223,12944.7,12089,25033.7,10189.3,28.93,-0.04,Low Risk
U486,2024,4,266296.6,Salary Increases & Fixed Expenses Decrease,35223,12944.7,11825,24769.7,10453.3,29.68,0.0,Low Risk
U486,2024,5,276749.89999999997,Salary Increases & Fixed Expenses Decrease,59868,12944.7,25632,38576.7,21291.300000000003,35.56,0.05,Low Risk
U486,2024,6,298041.19999999995,Salary Increases & Fixed Expenses Decrease,59868,12944.7,22286,35230.7,24637.300000000003,41.15,-0.0,Low Risk
U486,2024,7,322678.49999999994,Salary Increases & Fixed Expenses Decrease,59868,11650.230000000001,24481,36131.23,23736.769999999997,39.65,-0.0,Low Risk
U486,2024,8,346415.26999999996,Salary Increases & Fixed Expenses Decrease,59868,11650.230000000001,24607,36257.23,23610.769999999997,39.44,-0.03,Low Risk
U486,2024,9,370026.04,Salary Increases & Fixed Expenses Decrease,59868,11650.230000000001,18145,29795.230000000003,30072.769999999997,50.23,-0.04,Low Risk
U486,2024,10,400098.81,Salary Increases & Fixed Expenses Decrease,59868,11650.230000000001,20832,32482.230000000003,27385.769999999997,45.74,-0.03,Low Risk
U486,2024,11,427484.58,Salary Increases & Fixed Expenses Decrease,59868,11650.230000000001,27600,39250.23,20617.769999999997,34.44,0.03,Low Risk
U486,2024,12,448102.35000000003,Salary Increases & Fixed Expenses Decrease,59868,11650.230000000001,26643,38293.23,21574.769999999997,36.04,0.04,Low Risk
U487,2024,1,250000.0,Stable Salary & Increasing Fixed Expenses,288111,89570.0,91793,181363.0,106748.0,37.05,-0.02,Low Risk
U487,2024,2,356748.0,Stable Salary & Increasing Fixed Expenses,288111,89570.0,143588,233158.0,54953.0,19.07,0.02,Medium Risk
U487,2024,3,411701.0,Stable Salary & Increasing Fixed Expenses,288111,89570.0,137272,226842.0,61269.0,21.27,0.03,Medium Risk
U487,2024,4,472970.0,Stable Salary & Increasing Fixed Expenses,288111,89570.0,88323,177893.0,110218.0,38.26,-0.01,Low Risk
U487,2024,5,583188.0,Stable Salary & Increasing Fixed Expenses,288111,89570.0,91743,181313.0,106798.0,37.07,-0.02,Low Risk
U487,2024,6,689986.0,Stable Salary & Increasing Fixed Expenses,288111,89570.0,117954,207524.0,80587.0,27.97,0.01,Low Risk
U487,2024,7,770573.0,Stable Salary & Increasing Fixed Expenses,288111,89570.0,143127,232697.0,55414.0,19.23,0.03,Medium Risk
U487,2024,8,825987.0,Stable Salary & Increasing Fixed Expenses,288111,89570.0,110139,199709.0,88402.0,30.68,0.05,Low Risk
U487,2024,9,914389.0,Stable Salary & Increasing Fixed Expenses,288111,89570.0,152228,241798.0,46313.0,16.07,0.0,Medium Risk
U487,2024,10,960702.0,Stable Salary & Increasing Fixed Expenses,288111,89570.0,148478,238048.0,50063.0,17.38,-0.04,Medium Risk
U487,2024,11,1010765.0,Stable Salary & Increasing Fixed Expenses,288111,89570.0,116882,206452.0,81659.0,28.34,-0.02,Low Risk
U487,2024,12,1092424.0,Stable Salary & Increasing Fixed Expenses,288111,89570.0,157914,247484.0,40627.0,14.1,-0.03,High Risk
U488,2024,1,145308.0,Salary Increases & Fixed Expenses Remain Stable,102248,44669.0,61308,105977.0,-3729.0,-3.65,-0.03,High Risk
U488,2024,2,141579.0,Salary Increases & Fixed Expenses Remain Stable,102248,44669.0,58455,103124.0,-876.0,-0.86,-0.01,High Risk
U488,2024,3,140703.0,Salary Increases & Fixed Expenses Remain Stable,102248,44669.0,64354,109023.0,-6775.0,-6.63,0.04,High Risk
U488,2024,4,133928.0,Salary Increases & Fixed Expenses Remain Stable,125604,44669.0,76340,121009.0,4595.0,3.66,0.05,High Risk
U488,2024,5,138523.0,Salary Increases & Fixed Expenses Remain Stable,125604,44669.0,80503,125172.0,432.0,0.34,-0.03,High Risk
U488,2024,6,138955.0,Salary Increases & Fixed Expenses Remain Stable,125604,44669.0,83260,127929.0,-2325.0,-1.85,-0.02,High Risk
U488,2024,7,136630.0,Salary Increases & Fixed Expenses Remain Stable,125604,44669.0,79976,124645.0,959.0,0.76,0.03,High Risk
U488,2024,8,137589.0,Salary Increases & Fixed Expenses Remain Stable,125604,44669.0,64252,108921.0,16683.0,13.28,0.04,High Risk
U488,2024,9,154272.0,Salary Increases & Fixed Expenses Remain Stable,125604,44669.0,94060,138729.0,-13125.0,-10.45,-0.01,High Risk
U488,2024,10,141147.0,Salary Increases & Fixed Expenses Remain Stable,125604,44669.0,90378,135047.0,-9443.0,-7.52,0.01,High Risk
U488,2024,11,131704.0,Salary Increases & Fixed Expenses Remain Stable,125604,44669.0,73185,117854.0,7750.0,6.17,0.02,High Risk
U488,2024,12,139454.0,Salary Increases & Fixed Expenses Remain Stable,125604,44669.0,103793,148462.0,-22858.0,-18.2,-0.03,High Risk
U489,2024,1,247796.0,Salary Increases & Fixed Expenses Increase,163526,56929.0,89940,146869.0,16657.0,10.19,-0.02,High Risk
U489,2024,2,264453.0,Salary Increases & Fixed Expenses Increase,163526,56929.0,92545,149474.0,14052.0,8.59,0.04,High Risk
U489,2024,3,278505.0,Salary Increases & Fixed Expenses Increase,163526,56929.0,110787,167716.0,-4190.0,-2.56,0.02,High Risk
U489,2024,4,274315.0,Salary Increases & Fixed Expenses Increase,163526,56929.0,87797,144726.0,18800.0,11.5,-0.0,High Risk
U489,2024,5,293115.0,Salary Increases & Fixed Expenses Increase,163526,56929.0,94805,151734.0,11792.0,7.21,-0.05,High Risk
U489,2024,6,304907.0,Salary Increases & Fixed Expenses Increase,163526,56929.0,106304,163233.0,293.0,0.18,0.03,High Risk
U489,2024,7,305200.0,Salary Increases & Fixed Expenses Increase,180848,56929.0,108378,165307.0,15541.0,8.59,0.02,High Risk
U489,2024,8,320741.0,Salary Increases & Fixed Expenses Increase,180848,56929.0,91068,147997.0,32851.0,18.16,0.04,Medium Risk
U489,2024,9,353592.0,Salary Increases & Fixed Expenses Increase,180848,56929.0,124016,180945.0,-97.0,-0.05,-0.01,High Risk
U489,2024,10,353495.0,Salary Increases & Fixed Expenses Increase,180848,57742.0,127221,184963.0,-4115.0,-2.28,0.04,High Risk
U489,2024,11,349380.0,Salary Increases & Fixed Expenses Increase,180848,57742.0,114890,172632.0,8216.0,4.54,0.04,High Risk
U489,2024,12,357596.0,Salary Increases & Fixed Expenses Increase,180848,58688.0,108797,167485.0,13363.0,7.39,0.02,High Risk
U490,2024,1,167906.0,Salary Increases & Fixed Expenses Increase,109738,72081.0,38144,110225.0,-487.0,-0.44,-0.02,High Risk
U490,2024,2,167419.0,Salary Increases & Fixed Expenses Increase,109738,72924.0,34448,107372.0,2366.0,2.16,0.04,High Risk
U490,2024,3,169785.0,Salary Increases & Fixed Expenses Increase,109738,72924.0,61064,133988.0,-24250.0,-22.1,-0.04,High Risk
U490,2024,4,145535.0,Salary Increases & Fixed Expenses Increase,109738,72924.0,53720,126644.0,-16906.0,-15.41,0.0,High Risk
U490,2024,5,128629.0,Salary Increases & Fixed Expenses Increase,109738,72924.0,47646,120570.0,-10832.0,-9.87,-0.03,High Risk
U490,2024,6,117797.0,Salary Increases & Fixed Expenses Increase,109738,72924.0,54705,127629.0,-17891.0,-16.3,0.02,High Risk
U490,2024,7,99906.0,Salary Increases & Fixed Expenses Increase,109738,72924.0,49128,122052.0,-12314.0,-11.22,0.04,High Risk
U490,2024,8,87592.0,Salary Increases & Fixed Expenses Increase,138907,72924.0,58789,131713.0,7194.0,5.18,0.03,High Risk
U490,2024,9,94786.0,Salary Increases & Fixed Expenses Increase,138907,72924.0,72985,145909.0,-7002.0,-5.04,0.03,High Risk
U490,2024,10,87784.0,Salary Increases & Fixed Expenses Increase,138907,72924.0,56687,129611.0,9296.0,6.69,0.04,High Risk
U490,2024,11,97080.0,Salary Increases & Fixed Expenses Increase,138907,72924.0,66416,139340.0,-433.0,-0.31,0.01,High Risk
U490,2024,12,96647.0,Salary Increases & Fixed Expenses Increase,138907,72924.0,50831,123755.0,15152.0,10.91,0.03,High Risk
U491,2024,1,250000.0,Stable Salary & Decreasing Fixed Expenses,284347,62756.0,67531,130287.0,154060.0,54.18,0.04,Low Risk
U491,2024,2,404060.0,Stable Salary & Decreasing Fixed Expenses,284347,62756.0,79648,142404.0,141943.0,49.92,0.04,Low Risk
U491,2024,3,546003.0,Stable Salary & Decreasing Fixed Expenses,284347,62756.0,75422,138178.0,146169.0,51.41,0.02,Low Risk
U491,2024,4,692172.0,Stable Salary & Decreasing Fixed Expenses,284347,62756.0,57540,120296.0,164051.0,57.69,0.03,Low Risk
U491,2024,5,856223.0,Stable Salary & Decreasing Fixed Expenses,284347,62756.0,67628,130384.0,153963.0,54.15,-0.04,Low Risk
U491,2024,6,1010186.0,Stable Salary & Decreasing Fixed Expenses,284347,62756.0,71410,134166.0,150181.0,52.82,-0.0,Low Risk
U491,2024,7,1160367.0,Stable Salary & Decreasing Fixed Expenses,284347,62756.0,77608,140364.0,143983.0,50.64,0.03,Low Risk
U491,2024,8,1304350.0,Stable Salary & Decreasing Fixed Expenses,284347,62756.0,73083,135839.0,148508.0,52.23,-0.02,Low Risk
U491,2024,9,1452858.0,Stable Salary & Decreasing Fixed Expenses,284347,62756.0,73119,135875.0,148472.0,52.22,0.01,Low Risk
U491,2024,10,1601330.0,Stable Salary & Decreasing Fixed Expenses,284347,62756.0,73674,136430.0,147917.0,52.02,-0.04,Low Risk
U491,2024,11,1749247.0,Stable Salary & Decreasing Fixed Expenses,284347,62756.0,81523,144279.0,140068.0,49.26,0.04,Low Risk
U491,2024,12,1889315.0,Stable Salary & Decreasing Fixed Expenses,284347,61396.0,82900,144296.0,140051.0,49.25,0.03,Low Risk
U492,2024,1,176089.0,Stable Salary & Stable Fixed Expenses,168893,76013.0,66946,142959.0,25934.0,15.36,-0.03,Medium Risk
U492,2024,2,202023.0,Stable Salary & Stable Fixed Expenses,168893,76013.0,63507,139520.0,29373.0,17.39,0.02,Medium Risk
U492,2024,3,231396.0,Stable Salary & Stable Fixed Expenses,168893,76013.0,97991,174004.0,-5111.0,-3.03,0.04,High Risk
U492,2024,4,226285.0,Stable Salary & Stable Fixed Expenses,168893,76013.0,63625,139638.0,29255.0,17.32,0.02,Medium Risk
U492,2024,5,255540.0,Stable Salary & Stable Fixed Expenses,168893,76013.0,50687,126700.0,42193.0,24.98,-0.03,Medium Risk
U492,2024,6,297733.0,Stable Salary & Stable Fixed Expenses,168893,76013.0,67272,143285.0,25608.0,15.16,0.02,Medium Risk
U492,2024,7,323341.0,Stable Salary & Stable Fixed Expenses,168893,76013.0,75762,151775.0,17118.0,10.14,0.04,High Risk
U492,2024,8,340459.0,Stable Salary & Stable Fixed Expenses,168893,76013.0,83405,159418.0,9475.0,5.61,0.03,High Risk
U492,2024,9,349934.0,Stable Salary & Stable Fixed Expenses,168893,76013.0,66461,142474.0,26419.0,15.64,-0.03,Medium Risk
U492,2024,10,376353.0,Stable Salary & Stable Fixed Expenses,168893,76013.0,72335,148348.0,20545.0,12.16,-0.04,High Risk
U492,2024,11,396898.0,Stable Salary & Stable Fixed Expenses,168893,76013.0,75676,151689.0,17204.0,10.19,-0.05,High Risk
U492,2024,12,414102.0,Stable Salary & Stable Fixed Expenses,168893,76013.0,87391,163404.0,5489.0,3.25,-0.01,High Risk
U493,2024,1,222136.0,Stable Salary & Stable Fixed Expenses,37972,14839.0,14031,28870.0,9102.0,23.97,0.02,Medium Risk
U493,2024,2,231238.0,Stable Salary & Stable Fixed Expenses,37972,14839.0,17671,32510.0,5462.0,14.38,-0.02,High Risk
U493,2024,3,236700.0,Stable Salary & Stable Fixed Expenses,37972,14839.0,15449,30288.0,7684.0,20.24,0.03,Medium Risk
U493,2024,4,244384.0,Stable Salary & Stable Fixed Expenses,37972,14839.0,12579,27418.0,10554.0,27.79,-0.03,Low Risk
U493,2024,5,254938.0,Stable Salary & Stable Fixed Expenses,37972,14839.0,14810,29649.0,8323.0,21.92,-0.02,Medium Risk
U493,2024,6,263261.0,Stable Salary & Stable Fixed Expenses,37972,14839.0,18299,33138.0,4834.0,12.73,-0.01,High Risk
U493,2024,7,268095.0,Stable Salary & Stable Fixed Expenses,37972,14839.0,11562,26401.0,11571.0,30.47,0.04,Low Risk
U493,2024,8,279666.0,Stable Salary & Stable Fixed Expenses,37972,14839.0,13064,27903.0,10069.0,26.52,0.05,Low Risk
U493,2024,9,289735.0,Stable Salary & Stable Fixed Expenses,37972,14839.0,18929,33768.0,4204.0,11.07,0.03,High Risk
U493,2024,10,293939.0,Stable Salary & Stable Fixed Expenses,37972,14839.0,17221,32060.0,5912.0,15.57,-0.01,Medium Risk
U493,2024,11,299851.0,Stable Salary & Stable Fixed Expenses,37972,14839.0,15534,30373.0,7599.0,20.01,0.04,Medium Risk
U493,2024,12,307450.0,Stable Salary & Stable Fixed Expenses,37972,14839.0,19929,34768.0,3204.0,8.44,0.04,High Risk
U494,2024,1,250000.0,Stable Salary & Stable Fixed Expenses,297064,117557.0,71987,189544.0,107520.0,36.19,0.0,Low Risk
U494,2024,2,357520.0,Stable Salary & Stable Fixed Expenses,297064,117557.0,76569,194126.0,102938.0,34.65,-0.04,Low Risk
U494,2024,3,460458.0,Stable Salary & Stable Fixed Expenses,297064,117557.0,89013,206570.0,90494.0,30.46,-0.01,Low Risk
U494,2024,4,550952.0,Stable Salary & Stable Fixed Expenses,297064,117557.0,84494,202051.0,95013.0,31.98,-0.05,Low Risk
U494,2024,5,645965.0,Stable Salary & Stable Fixed Expenses,297064,117557.0,67368,184925.0,112139.0,37.75,0.03,Low Risk
U494,2024,6,758104.0,Stable Salary & Stable Fixed Expenses,297064,117557.0,82051,199608.0,97456.0,32.81,-0.04,Low Risk
U494,2024,7,855560.0,Stable Salary & Stable Fixed Expenses,297064,117557.0,59845,177402.0,119662.0,40.28,0.02,Low Risk
U494,2024,8,975222.0,Stable Salary & Stable Fixed Expenses,297064,117557.0,67201,184758.0,112306.0,37.81,-0.01,Low Risk
U494,2024,9,1087528.0,Stable Salary & Stable Fixed Expenses,297064,117557.0,93738,211295.0,85769.0,28.87,0.01,Low Risk
U494,2024,10,1173297.0,Stable Salary & Stable Fixed Expenses,297064,117557.0,112237,229794.0,67270.0,22.64,0.02,Medium Risk
U494,2024,11,1240567.0,Stable Salary & Stable Fixed Expenses,297064,117557.0,81454,199011.0,98053.0,33.01,0.03,Low Risk
U494,2024,12,1338620.0,Stable Salary & Stable Fixed Expenses,297064,117557.0,90044,207601.0,89463.0,30.12,0.02,Low Risk
U495,2024,1,231741.0,Stable Salary & Stable Fixed Expenses,214715,103509.0,106919,210428.0,4287.0,2.0,-0.01,High Risk
U495,2024,2,236028.0,Stable Salary & Stable Fixed Expenses,214715,103509.0,89123,192632.0,22083.0,10.28,-0.05,High Risk
U495,2024,3,258111.0,Stable Salary & Stable Fixed Expenses,214715,103509.0,106416,209925.0,4790.0,2.23,-0.0,High Risk
U495,2024,4,262901.0,Stable Salary & Stable Fixed Expenses,214715,103509.0,106624,210133.0,4582.0,2.13,0.02,High Risk
U495,2024,5,267483.0,Stable Salary & Stable Fixed Expenses,214715,103509.0,66985,170494.0,44221.0,20.6,0.0,Medium Risk
U495,2024,6,311704.0,Stable Salary & Stable Fixed Expenses,214715,103509.0,87037,190546.0,24169.0,11.26,0.01,High Risk
U495,2024,7,335873.0,Stable Salary & Stable Fixed Expenses,214715,103509.0,64917,168426.0,46289.0,21.56,0.05,Medium Risk
U495,2024,8,382162.0,Stable Salary & Stable Fixed Expenses,214715,103509.0,64862,168371.0,46344.0,21.58,-0.01,Medium Risk
U495,2024,9,428506.0,Stable Salary & Stable Fixed Expenses,214715,103509.0,80131,183640.0,31075.0,14.47,0.04,High Risk
U495,2024,10,459581.0,Stable Salary & Stable Fixed Expenses,214715,103509.0,67156,170665.0,44050.0,20.52,-0.02,Medium Risk
U495,2024,11,503631.0,Stable Salary & Stable Fixed Expenses,214715,103509.0,72320,175829.0,38886.0,18.11,0.0,Medium Risk
U495,2024,12,542517.0,Stable Salary & Stable Fixed Expenses,214715,103509.0,87554,191063.0,23652.0,11.02,0.0,High Risk
U496,2024,1,244579.0,Salary Increases & Fixed Expenses Increase,183902,56693.0,80767,137460.0,46442.0,25.25,0.01,Low Risk
U496,2024,2,291021.0,Salary Increases & Fixed Expenses Increase,183902,56693.0,63644,120337.0,63565.0,34.56,0.03,Low Risk
U496,2024,3,354586.0,Salary Increases & Fixed Expenses Increase,183902,56693.0,98646,155339.0,28563.0,15.53,-0.01,Medium Risk
U496,2024,4,383149.0,Salary Increases & Fixed Expenses Increase,183902,56693.0,59454,116147.0,67755.0,36.84,0.02,Low Risk
U496,2024,5,450904.0,Salary Increases & Fixed Expenses Increase,205273,56693.0,80124,136817.0,68456.0,33.35,0.02,Low Risk
U496,2024,6,519360.0,Salary Increases & Fixed Expenses Increase,205273,57971.0,96377,154348.0,50925.0,24.81,0.05,Medium Risk
U496,2024,7,570285.0,Salary Increases & Fixed Expenses Increase,205273,57971.0,98968,156939.0,48334.0,23.55,-0.04,Medium Risk
U496,2024,8,618619.0,Salary Increases & Fixed Expenses Increase,205273,57971.0,93161,151132.0,54141.0,26.38,-0.04,Low Risk
U496,2024,9,672760.0,Salary Increases & Fixed Expenses Increase,205273,58879.0,91111,149990.0,55283.0,26.93,-0.04,Low Risk
U496,2024,10,728043.0,Salary Increases & Fixed Expenses Increase,205273,58879.0,91984,150863.0,54410.0,26.51,0.01,Low Risk
U496,2024,11,782453.0,Salary Increases & Fixed Expenses Increase,205273,58879.0,97439,156318.0,48955.0,23.85,0.02,Medium Risk
U496,2024,12,831408.0,Salary Increases & Fixed Expenses Increase,205273,58879.0,91724,150603.0,54670.0,26.63,-0.03,Low Risk
U497,2024,1,176922.0,Stable Salary & Stable Fixed Expenses,155455,67606.0,45082,112688.0,42767.0,27.51,0.03,Low Risk
U497,2024,2,219689.0,Stable Salary & Stable Fixed Expenses,155455,67606.0,32729,100335.0,55120.0,35.46,0.04,Low Risk
U497,2024,3,274809.0,Stable Salary & Stable Fixed Expenses,155455,67606.0,44310,111916.0,43539.0,28.01,0.02,Low Risk
U497,2024,4,318348.0,Stable Salary & Stable Fixed Expenses,155455,67606.0,31492,99098.0,56357.0,36.25,-0.0,Low Risk
U497,2024,5,374705.0,Stable Salary & Stable Fixed Expenses,155455,67606.0,32153,99759.0,55696.0,35.83,0.05,Low Risk
U497,2024,6,430401.0,Stable Salary & Stable Fixed Expenses,155455,67606.0,40358,107964.0,47491.0,30.55,0.03,Low Risk
U497,2024,7,477892.0,Stable Salary & Stable Fixed Expenses,155455,67606.0,35561,103167.0,52288.0,33.64,-0.02,Low Risk
U497,2024,8,530180.0,Stable Salary & Stable Fixed Expenses,155455,67606.0,40538,108144.0,47311.0,30.43,-0.01,Low Risk
U497,2024,9,577491.0,Stable Salary & Stable Fixed Expenses,155455,67606.0,34279,101885.0,53570.0,34.46,-0.02,Low Risk
U497,2024,10,631061.0,Stable Salary & Stable Fixed Expenses,155455,67606.0,37864,105470.0,49985.0,32.15,0.04,Low Risk
U497,2024,11,681046.0,Stable Salary & Stable Fixed Expenses,155455,67606.0,39078,106684.0,48771.0,31.37,-0.04,Low Risk
U497,2024,12,729817.0,Stable Salary & Stable Fixed Expenses,155455,67606.0,43685,111291.0,44164.0,28.41,-0.03,Low Risk
U498,2024,1,204955.0,Stable Salary & Increasing Fixed Expenses,117310,53122.0,27401,80523.0,36787.0,31.36,-0.01,Low Risk
U498,2024,2,241742.0,Stable Salary & Increasing Fixed Expenses,117310,53122.0,25812,78934.0,38376.0,32.71,-0.02,Low Risk
U498,2024,3,280118.0,Stable Salary & Increasing Fixed Expenses,117310,53122.0,29617,82739.0,34571.0,29.47,-0.01,Low Risk
U498,2024,4,314689.0,Stable Salary & Increasing Fixed Expenses,117310,53122.0,29166,82288.0,35022.0,29.85,-0.0,Low Risk
U498,2024,5,349711.0,Stable Salary & Increasing Fixed Expenses,117310,53122.0,28819,81941.0,35369.0,30.15,0.01,Low Risk
U498,2024,6,385080.0,Stable Salary & Increasing Fixed Expenses,117310,53122.0,29428,82550.0,34760.0,29.63,-0.0,Low Risk
U498,2024,7,419840.0,Stable Salary & Increasing Fixed Expenses,117310,53122.0,29126,82248.0,35062.0,29.89,-0.04,Low Risk
U498,2024,8,454902.0,Stable Salary & Increasing Fixed Expenses,117310,53122.0,25996,79118.0,38192.0,32.56,0.03,Low Risk
U498,2024,9,493094.0,Stable Salary & Increasing Fixed Expenses,117310,54639.0,32010,86649.0,30661.0,26.14,0.02,Low Risk
U498,2024,10,523755.0,Stable Salary & Increasing Fixed Expenses,117310,54639.0,37272,91911.0,25399.0,21.65,0.04,Medium Risk
U498,2024,11,549154.0,Stable Salary & Increasing Fixed Expenses,117310,56545.0,27793,84338.0,32972.0,28.11,-0.02,Low Risk
U498,2024,12,582126.0,Stable Salary & Increasing Fixed Expenses,117310,56545.0,41978,98523.0,18787.0,16.01,-0.0,Medium Risk
U499,2024,1,168408.0,Stable Salary & Increasing Fixed Expenses,131859,64257.0,74676,138933.0,-7074.0,-5.36,-0.02,High Risk
U499,2024,2,161334.0,Stable Salary & Increasing Fixed Expenses,131859,64257.0,85228,149485.0,-17626.0,-13.37,0.05,High Risk
U499,2024,3,143708.0,Stable Salary & Increasing Fixed Expenses,131859,64257.0,72584,136841.0,-4982.0,-3.78,0.04,High Risk
U499,2024,4,138726.0,Stable Salary & Increasing Fixed Expenses,131859,65243.0,91867,157110.0,-25251.0,-19.15,-0.03,High Risk
U499,2024,5,113475.0,Stable Salary & Increasing Fixed Expenses,131859,65243.0,69351,134594.0,-2735.0,-2.07,-0.01,High Risk
U499,2024,6,110740.0,Stable Salary & Increasing Fixed Expenses,131859,65243.0,79345,144588.0,-12729.0,-9.65,0.03,High Risk
U499,2024,7,98011.0,Stable Salary & Increasing Fixed Expenses,131859,65243.0,76497,141740.0,-9881.0,-7.49,0.02,High Risk
U499,2024,8,88130.0,Stable Salary & Increasing Fixed Expenses,131859,65243.0,69486,134729.0,-2870.0,-2.18,0.01,High Risk
U499,2024,9,85260.0,Stable Salary & Increasing Fixed Expenses,131859,67175.0,101477,168652.0,-36793.0,-27.9,0.05,High Risk
U499,2024,10,48467.0,Stable Salary & Increasing Fixed Expenses,131859,67175.0,86269,153444.0,-21585.0,-16.37,0.02,High Risk
U499,2024,11,26882.0,Stable Salary & Increasing Fixed Expenses,131859,67175.0,102665,169840.0,-37981.0,-28.8,-0.01,High Risk
U499,2024,12,-11099.0,Stable Salary & Increasing Fixed Expenses,131859,67175.0,80354,147529.0,-15670.0,-11.88,0.01,High Risk
U500,2024,1,31395.0,Stable Salary & Stable Fixed Expenses,25286,19333.0,12625,31958.0,-6672.0,-26.39,-0.03,High Risk
U500,2024,2,24723.0,Stable Salary & Stable Fixed Expenses,25286,19333.0,10163,29496.0,-4210.0,-16.65,0.05,High Risk
U500,2024,3,20513.0,Stable Salary & Stable Fixed Expenses,25286,19333.0,10032,29365.0,-4079.0,-16.13,-0.03,High Risk
U500,2024,4,16434.0,Stable Salary & Stable Fixed Expenses,25286,19333.0,8682,28015.0,-2729.0,-10.79,0.04,High Risk
U500,2024,5,13705.0,Stable Salary & Stable Fixed Expenses,25286,19333.0,8036,27369.0,-2083.0,-8.24,-0.01,High Risk
U500,2024,6,11622.0,Stable Salary & Stable Fixed Expenses,25286,19333.0,12132,31465.0,-6179.0,-24.44,-0.03,High Risk
U500,2024,7,5443.0,Stable Salary & Stable Fixed Expenses,25286,19333.0,11666,30999.0,-5713.0,-22.59,0.01,High Risk
U500,2024,8,-270.0,Stable Salary & Stable Fixed Expenses,25286,19333.0,7807,27140.0,-1854.0,-7.33,0.01,High Risk
U500,2024,9,-2124.0,Stable Salary & Stable Fixed Expenses,25286,19333.0,13074,32407.0,-7121.0,-28.16,-0.03,High Risk
U500,2024,10,-9245.0,Stable Salary & Stable Fixed Expenses,25286,19333.0,15577,34910.0,-9624.0,-38.06,-0.03,High Risk
U500,2024,11,-18869.0,Stable Salary & Stable Fixed Expenses,25286,19333.0,10435,29768.0,-4482.0,-17.73,0.02,High Risk
U500,2024,12,-23351.0,Stable Salary & Stable Fixed Expenses,25286,19333.0,14993,34326.0,-9040.0,-35.75,0.04,High Risk
U501,2024,1,231830.0,Salary Increases & Fixed Expenses Decrease,112944,54416.0,52660,107076.0,5868.0,5.2,0.01,High Risk
U501,2024,2,237698.0,Salary Increases & Fixed Expenses Decrease,112944,54416.0,44989,99405.0,13539.0,11.99,-0.04,High Risk
U501,2024,3,251237.0,Salary Increases & Fixed Expenses Decrease,112944,54416.0,66168,120584.0,-7640.0,-6.76,-0.01,High Risk
U501,2024,4,243597.0,Salary Increases & Fixed Expenses Decrease,133469,54416.0,44090,98506.0,34963.0,26.2,0.05,Low Risk
U501,2024,5,278560.0,Salary Increases & Fixed Expenses Decrease,133469,54416.0,53266,107682.0,25787.0,19.32,0.01,Medium Risk
U501,2024,6,304347.0,Salary Increases & Fixed Expenses Decrease,133469,52660.0,56777,109437.0,24032.0,18.01,-0.01,Medium Risk
U501,2024,7,328379.0,Salary Increases & Fixed Expenses Decrease,133469,52660.0,49562,102222.0,31247.0,23.41,-0.01,Medium Risk
U501,2024,8,359626.0,Salary Increases & Fixed Expenses Decrease,133469,52660.0,44077,96737.0,36732.0,27.52,-0.04,Low Risk
U501,2024,9,396358.0,Salary Increases & Fixed Expenses Decrease,133469,52660.0,55921,108581.0,24888.0,18.65,-0.03,Medium Risk
U501,2024,10,421246.0,Salary Increases & Fixed Expenses Decrease,133469,52660.0,50573,103233.0,30236.0,22.65,-0.03,Medium Risk
U501,2024,11,451482.0,Salary Increases & Fixed Expenses Decrease,133469,52660.0,56180,108840.0,24629.0,18.45,-0.03,Medium Risk
U501,2024,12,476111.0,Salary Increases & Fixed Expenses Decrease,133469,52660.0,62840,115500.0,17969.0,13.46,-0.01,High Risk
U502,2024,1,191329.0,Salary Increases & Fixed Expenses Increase,114016,62445.0,25298,87743.0,26273.0,23.04,-0.03,Medium Risk
U502,2024,2,217602.0,Salary Increases & Fixed Expenses Increase,114016,63102.0,27765,90867.0,23149.0,20.3,-0.02,Medium Risk
U502,2024,3,240751.0,Salary Increases & Fixed Expenses Increase,114016,64708.0,35473,100181.0,13835.0,12.13,0.03,High Risk
U502,2024,4,254586.0,Salary Increases & Fixed Expenses Increase,114016,64708.0,28074,92782.0,21234.0,18.62,-0.02,Medium Risk
U502,2024,5,275820.0,Salary Increases & Fixed Expenses Increase,129613,64708.0,27007,91715.0,37898.0,29.24,-0.04,Low Risk
U502,2024,6,313718.0,Salary Increases & Fixed Expenses Increase,129613,64708.0,28466,93174.0,36439.0,28.11,-0.04,Low Risk
U502,2024,7,350157.0,Salary Increases & Fixed Expenses Increase,129613,64708.0,35451,100159.0,29454.0,22.72,0.03,Medium Risk
U502,2024,8,379611.0,Salary Increases & Fixed Expenses Increase,129613,64708.0,31720,96428.0,33185.0,25.6,-0.01,Low Risk
U502,2024,9,412796.0,Salary Increases & Fixed Expenses Increase,129613,64708.0,36936,101644.0,27969.0,21.58,0.02,Medium Risk
U502,2024,10,440765.0,Salary Increases & Fixed Expenses Increase,129613,66210.0,38784,104994.0,24619.0,18.99,-0.05,Medium Risk
U502,2024,11,465384.0,Salary Increases & Fixed Expenses Increase,129613,66210.0,43016,109226.0,20387.0,15.73,-0.0,Medium Risk
U502,2024,12,485771.0,Salary Increases & Fixed Expenses Increase,129613,66210.0,39117,105327.0,24286.0,18.74,0.05,Medium Risk
U503,2024,1,240601.0,Stable Salary & Stable Fixed Expenses,50489,29330.0,27128,56458.0,-5969.0,-11.82,-0.02,High Risk
U503,2024,2,234632.0,Stable Salary & Stable Fixed Expenses,50489,29330.0,29308,58638.0,-8149.0,-16.14,-0.02,High Risk
U503,2024,3,226483.0,Stable Salary & Stable Fixed Expenses,50489,29330.0,37575,66905.0,-16416.0,-32.51,-0.05,High Risk
U503,2024,4,210067.0,Stable Salary & Stable Fixed Expenses,50489,29330.0,26122,55452.0,-4963.0,-9.83,0.02,High Risk
U503,2024,5,205104.0,Stable Salary & Stable Fixed Expenses,50489,29330.0,28502,57832.0,-7343.0,-14.54,-0.02,High Risk
U503,2024,6,197761.0,Stable Salary & Stable Fixed Expenses,50489,29330.0,25887,55217.0,-4728.0,-9.36,-0.01,High Risk
U503,2024,7,193033.0,Stable Salary & Stable Fixed Expenses,50489,29330.0,34834,64164.0,-13675.0,-27.09,-0.02,High Risk
U503,2024,8,179358.0,Stable Salary & Stable Fixed Expenses,50489,29330.0,31062,60392.0,-9903.0,-19.61,-0.01,High Risk
U503,2024,9,169455.0,Stable Salary & Stable Fixed Expenses,50489,29330.0,27376,56706.0,-6217.0,-12.31,0.03,High Risk
U503,2024,10,163238.0,Stable Salary & Stable Fixed Expenses,50489,29330.0,33452,62782.0,-12293.0,-24.35,0.04,High Risk
U503,2024,11,150945.0,Stable Salary & Stable Fixed Expenses,50489,29330.0,32428,61758.0,-11269.0,-22.32,0.01,High Risk
U503,2024,12,139676.0,Stable Salary & Stable Fixed Expenses,50489,29330.0,44727,74057.0,-23568.0,-46.68,-0.04,High Risk
U504,2024,1,231264.0,Stable Salary & Stable Fixed Expenses,183127,65869.0,85611,151480.0,31647.0,17.28,-0.01,Medium Risk
U504,2024,2,262911.0,Stable Salary & Stable Fixed Expenses,183127,65869.0,62138,128007.0,55120.0,30.1,-0.02,Low Risk
U504,2024,3,318031.0,Stable Salary & Stable Fixed Expenses,183127,65869.0,56669,122538.0,60589.0,33.09,0.0,Low Risk
U504,2024,4,378620.0,Stable Salary & Stable Fixed Expenses,183127,65869.0,87089,152958.0,30169.0,16.47,-0.01,Medium Risk
U504,2024,5,408789.0,Stable Salary & Stable Fixed Expenses,183127,65869.0,60058,125927.0,57200.0,31.24,-0.04,Low Risk
U504,2024,6,465989.0,Stable Salary & Stable Fixed Expenses,183127,65869.0,57746,123615.0,59512.0,32.5,-0.02,Low Risk
U504,2024,7,525501.0,Stable Salary & Stable Fixed Expenses,183127,65869.0,62559,128428.0,54699.0,29.87,-0.02,Low Risk
U504,2024,8,580200.0,Stable Salary & Stable Fixed Expenses,183127,65869.0,77834,143703.0,39424.0,21.53,0.02,Medium Risk
U504,2024,9,619624.0,Stable Salary & Stable Fixed Expenses,183127,65869.0,78417,144286.0,38841.0,21.21,0.05,Medium Risk
U504,2024,10,658465.0,Stable Salary & Stable Fixed Expenses,183127,65869.0,69527,135396.0,47731.0,26.06,0.04,Low Risk
U504,2024,11,706196.0,Stable Salary & Stable Fixed Expenses,183127,65869.0,88978,154847.0,28280.0,15.44,-0.0,Medium Risk
U504,2024,12,734476.0,Stable Salary & Stable Fixed Expenses,183127,65869.0,74108,139977.0,43150.0,23.56,-0.04,Medium Risk
U505,2024,1,250000.0,Stable Salary & Decreasing Fixed Expenses,276625,104175.0,72005,176180.0,100445.0,36.31,0.04,Low Risk
U505,2024,2,350445.0,Stable Salary & Decreasing Fixed Expenses,276625,104175.0,73928,178103.0,98522.0,35.62,0.05,Low Risk
U505,2024,3,448967.0,Stable Salary & Decreasing Fixed Expenses,276625,104175.0,91814,195989.0,80636.0,29.15,0.03,Low Risk
U505,2024,4,529603.0,Stable Salary & Decreasing Fixed Expenses,276625,104175.0,70664,174839.0,101786.0,36.8,-0.03,Low Risk
U505,2024,5,631389.0,Stable Salary & Decreasing Fixed Expenses,276625,104175.0,69151,173326.0,103299.0,37.34,0.01,Low Risk
U505,2024,6,734688.0,Stable Salary & Decreasing Fixed Expenses,276625,104175.0,75098,179273.0,97352.0,35.19,-0.04,Low Risk
U505,2024,7,832040.0,Stable Salary & Decreasing Fixed Expenses,276625,102780.0,68166,170946.0,105679.0,38.2,-0.01,Low Risk
U505,2024,8,937719.0,Stable Salary & Decreasing Fixed Expenses,276625,102780.0,73902,176682.0,99943.0,36.13,-0.04,Low Risk
U505,2024,9,1037662.0,Stable Salary & Decreasing Fixed Expenses,276625,102780.0,77420,180200.0,96425.0,34.86,-0.03,Low Risk
U505,2024,10,1134087.0,Stable Salary & Decreasing Fixed Expenses,276625,102780.0,91301,194081.0,82544.0,29.84,-0.03,Low Risk
U505,2024,11,1216631.0,Stable Salary & Decreasing Fixed Expenses,276625,102780.0,79911,182691.0,93934.0,33.96,0.01,Low Risk
U505,2024,12,1310565.0,Stable Salary & Decreasing Fixed Expenses,276625,101057.0,89428,190485.0,86140.0,31.14,-0.03,Low Risk
U506,2024,1,181871.0,Salary Increases & Fixed Expenses Increase,160885,64594.0,79303,143897.0,16988.0,10.56,-0.04,High Risk
U506,2024,2,198859.0,Salary Increases & Fixed Expenses Increase,160885,64594.0,48968,113562.0,47323.0,29.41,-0.02,Low Risk
U506,2024,3,246182.0,Salary Increases & Fixed Expenses Increase,160885,64594.0,67070,131664.0,29221.0,18.16,0.01,Medium Risk
U506,2024,4,275403.0,Salary Increases & Fixed Expenses Increase,160885,64594.0,58500,123094.0,37791.0,23.49,0.0,Medium Risk
U506,2024,5,313194.0,Salary Increases & Fixed Expenses Increase,160885,64594.0,78840,143434.0,17451.0,10.85,-0.0,High Risk
U506,2024,6,330645.0,Salary Increases & Fixed Expenses Increase,160885,66510.0,65905,132415.0,28470.0,17.7,-0.05,Medium Risk
U506,2024,7,359115.0,Salary Increases & Fixed Expenses Increase,182552,66510.0,56073,122583.0,59969.0,32.85,-0.02,Low Risk
U506,2024,8,419084.0,Salary Increases & Fixed Expenses Increase,182552,67714.0,71021,138735.0,43817.0,24.0,0.02,Medium Risk
U506,2024,9,462901.0,Salary Increases & Fixed Expenses Increase,182552,67714.0,58120,125834.0,56718.0,31.07,0.05,Low Risk
U506,2024,10,519619.0,Salary Increases & Fixed Expenses Increase,182552,69226.0,67513,136739.0,45813.0,25.1,-0.01,Low Risk
U506,2024,11,565432.0,Salary Increases & Fixed Expenses Increase,182552,69226.0,55354,124580.0,57972.0,31.76,-0.0,Low Risk
U506,2024,12,623404.0,Salary Increases & Fixed Expenses Increase,182552,69226.0,69726,138952.0,43600.0,23.88,0.03,Medium Risk
U507,2024,1,119320.0,Salary Increases & Fixed Expenses Decrease,119106,67321.0,35684,103005.0,16101.0,13.52,-0.04,High Risk
U507,2024,2,135421.0,Salary Increases & Fixed Expenses Decrease,119106,67321.0,25397,92718.0,26388.0,22.16,0.0,Medium Risk
U507,2024,3,161809.0,Salary Increases & Fixed Expenses Decrease,119106,67321.0,24020,91341.0,27765.0,23.31,0.01,Medium Risk
U507,2024,4,189574.0,Salary Increases & Fixed Expenses Decrease,119106,67321.0,32698,100019.0,19087.0,16.03,-0.01,Medium Risk
U507,2024,5,208661.0,Salary Increases & Fixed Expenses Decrease,119106,67321.0,24070,91391.0,27715.0,23.27,-0.03,Medium Risk
U507,2024,6,236376.0,Salary Increases & Fixed Expenses Decrease,119106,67321.0,31246,98567.0,20539.0,17.24,0.02,Medium Risk
U507,2024,7,256915.0,Salary Increases & Fixed Expenses Decrease,119106,67321.0,35072,102393.0,16713.0,14.03,-0.03,High Risk
U507,2024,8,273628.0,Salary Increases & Fixed Expenses Decrease,131170,67321.0,27188,94509.0,36661.0,27.95,0.01,Low Risk
U507,2024,9,310289.0,Salary Increases & Fixed Expenses Decrease,131170,67321.0,40081,107402.0,23768.0,18.12,-0.0,Medium Risk
U507,2024,10,334057.0,Salary Increases & Fixed Expenses Decrease,131170,67321.0,33257,100578.0,30592.0,23.32,0.01,Medium Risk
U507,2024,11,364649.0,Salary Increases & Fixed Expenses Decrease,131170,67321.0,37179,104500.0,26670.0,20.33,-0.02,Medium Risk
U507,2024,12,391319.0,Salary Increases & Fixed Expenses Decrease,131170,67321.0,33425,100746.0,30424.0,23.19,-0.03,Medium Risk
U508,2024,1,92830.0,Stable Salary & Increasing Fixed Expenses,77675,26851.0,21464,48315.0,29360.0,37.8,0.02,Low Risk
U508,2024,2,122190.0,Stable Salary & Increasing Fixed Expenses,77675,26851.0,18036,44887.0,32788.0,42.21,-0.04,Low Risk
U508,2024,3,154978.0,Stable Salary & Increasing Fixed Expenses,77675,26851.0,18900,45751.0,31924.0,41.1,0.02,Low Risk
U508,2024,4,186902.0,Stable Salary & Increasing Fixed Expenses,77675,26851.0,20131,46982.0,30693.0,39.51,0.02,Low Risk
U508,2024,5,217595.0,Stable Salary & Increasing Fixed Expenses,77675,26851.0,22754,49605.0,28070.0,36.14,-0.01,Low Risk
U508,2024,6,245665.0,Stable Salary & Increasing Fixed Expenses,77675,26851.0,19407,46258.0,31417.0,40.45,-0.03,Low Risk
U508,2024,7,277082.0,Stable Salary & Increasing Fixed Expenses,77675,26851.0,16175,43026.0,34649.0,44.61,0.04,Low Risk
U508,2024,8,311731.0,Stable Salary & Increasing Fixed Expenses,77675,26851.0,20286,47137.0,30538.0,39.32,-0.02,Low Risk
U508,2024,9,342269.0,Stable Salary & Increasing Fixed Expenses,77675,26851.0,18863,45714.0,31961.0,41.15,0.05,Low Risk
U508,2024,10,374230.0,Stable Salary & Increasing Fixed Expenses,77675,26851.0,20072,46923.0,30752.0,39.59,-0.03,Low Risk
U508,2024,11,404982.0,Stable Salary & Increasing Fixed Expenses,77675,26851.0,17876,44727.0,32948.0,42.42,-0.04,Low Risk
U508,2024,12,437930.0,Stable Salary & Increasing Fixed Expenses,77675,26851.0,27257,54108.0,23567.0,30.34,-0.01,Low Risk
U509,2024,1,242802.0,Stable Salary & Stable Fixed Expenses,26241,17287.0,10660,27947.0,-1706.0,-6.5,0.03,High Risk
U509,2024,2,241096.0,Stable Salary & Stable Fixed Expenses,26241,17287.0,12848,30135.0,-3894.0,-14.84,0.03,High Risk
U509,2024,3,237202.0,Stable Salary & Stable Fixed Expenses,26241,17287.0,11902,29189.0,-2948.0,-11.23,0.04,High Risk
U509,2024,4,234254.0,Stable Salary & Stable Fixed Expenses,26241,17287.0,9053,26340.0,-99.0,-0.38,0.05,High Risk
U509,2024,5,234155.0,Stable Salary & Stable Fixed Expenses,26241,17287.0,9228,26515.0,-274.0,-1.04,0.01,High Risk
U509,2024,6,233881.0,Stable Salary & Stable Fixed Expenses,26241,17287.0,12655,29942.0,-3701.0,-14.1,-0.02,High Risk
U509,2024,7,230180.0,Stable Salary & Stable Fixed Expenses,26241,17287.0,8585,25872.0,369.0,1.41,0.04,High Risk
U509,2024,8,230549.0,Stable Salary & Stable Fixed Expenses,26241,17287.0,11093,28380.0,-2139.0,-8.15,-0.04,High Risk
U509,2024,9,228410.0,Stable Salary & Stable Fixed Expenses,26241,17287.0,12765,30052.0,-3811.0,-14.52,0.02,High Risk
U509,2024,10,224599.0,Stable Salary & Stable Fixed Expenses,26241,17287.0,12487,29774.0,-3533.0,-13.46,0.02,High Risk
U509,2024,11,221066.0,Stable Salary & Stable Fixed Expenses,26241,17287.0,8975,26262.0,-21.0,-0.08,-0.03,High Risk
U509,2024,12,221045.0,Stable Salary & Stable Fixed Expenses,26241,17287.0,12958,30245.0,-4004.0,-15.26,-0.04,High Risk
U510,2024,1,250000.0,Salary Increases & Fixed Expenses Remain Stable,294516,99911.0,86573,186484.0,108032.0,36.68,-0.0,Low Risk
U510,2024,2,358032.0,Salary Increases & Fixed Expenses Remain Stable,294516,99911.0,82573,182484.0,112032.0,38.04,-0.02,Low Risk
U510,2024,3,470064.0,Salary Increases & Fixed Expenses Remain Stable,294516,99911.0,70885,170796.0,123720.0,42.01,0.01,Low Risk
U510,2024,4,593784.0,Salary Increases & Fixed Expenses Remain Stable,294516,99911.0,78943,178854.0,115662.0,39.27,-0.01,Low Risk
U510,2024,5,709446.0,Salary Increases & Fixed Expenses Remain Stable,322686,99911.0,68807,168718.0,153968.0,47.71,-0.03,Low Risk
U510,2024,6,863414.0,Salary Increases & Fixed Expenses Remain Stable,322686,99911.0,84214,184125.0,138561.0,42.94,-0.03,Low Risk
U510,2024,7,1001975.0,Salary Increases & Fixed Expenses Remain Stable,322686,99911.0,86213,186124.0,136562.0,42.32,-0.01,Low Risk
U510,2024,8,1138537.0,Salary Increases & Fixed Expenses Remain Stable,322686,99911.0,74182,174093.0,148593.0,46.05,-0.05,Low Risk
U510,2024,9,1287130.0,Salary Increases & Fixed Expenses Remain Stable,322686,99911.0,72480,172391.0,150295.0,46.58,0.05,Low Risk
U510,2024,10,1437425.0,Salary Increases & Fixed Expenses Remain Stable,322686,99911.0,66613,166524.0,156162.0,48.39,-0.01,Low Risk
U510,2024,11,1593587.0,Salary Increases & Fixed Expenses Remain Stable,322686,99911.0,82616,182527.0,140159.0,43.44,-0.01,Low Risk
U510,2024,12,1733746.0,Salary Increases & Fixed Expenses Remain Stable,322686,99911.0,68489,168400.0,154286.0,47.81,-0.04,Low Risk
U511,2024,1,231780.0,Stable Salary & Decreasing Fixed Expenses,208694,113638.0,57363,171001.0,37693.0,18.06,0.03,Medium Risk
U511,2024,2,269473.0,Stable Salary & Decreasing Fixed Expenses,208694,113638.0,52840,166478.0,42216.0,20.23,0.02,Medium Risk
U511,2024,3,311689.0,Stable Salary & Decreasing Fixed Expenses,208694,113638.0,60775,174413.0,34281.0,16.43,-0.05,Medium Risk
U511,2024,4,345970.0,Stable Salary & Decreasing Fixed Expenses,208694,112466.0,46630,159096.0,49598.0,23.77,-0.02,Medium Risk
U511,2024,5,395568.0,Stable Salary & Decreasing Fixed Expenses,208694,111570.0,56643,168213.0,40481.0,19.4,-0.02,Medium Risk
U511,2024,6,436049.0,Stable Salary & Decreasing Fixed Expenses,208694,111570.0,53190,164760.0,43934.0,21.05,-0.01,Medium Risk
U511,2024,7,479983.0,Stable Salary & Decreasing Fixed Expenses,208694,111570.0,58719,170289.0,38405.0,18.4,-0.02,Medium Risk
U511,2024,8,518388.0,Stable Salary & Decreasing Fixed Expenses,208694,111570.0,53070,164640.0,44054.0,21.11,-0.01,Medium Risk
U511,2024,9,562442.0,Stable Salary & Decreasing Fixed Expenses,208694,109779.0,50207,159986.0,48708.0,23.34,0.04,Medium Risk
U511,2024,10,611150.0,Stable Salary & Decreasing Fixed Expenses,208694,109779.0,51456,161235.0,47459.0,22.74,0.03,Medium Risk
U511,2024,11,658609.0,Stable Salary & Decreasing Fixed Expenses,208694,109779.0,59212,168991.0,39703.0,19.02,-0.0,Medium Risk
U511,2024,12,698312.0,Stable Salary & Decreasing Fixed Expenses,208694,109779.0,48211,157990.0,50704.0,24.3,0.03,Medium Risk
U512,2024,1,243625.0,Salary Increases & Fixed Expenses Increase,239993,74016.0,65210,139226.0,100767.0,41.99,-0.01,Low Risk
U512,2024,2,344392.0,Salary Increases & Fixed Expenses Increase,239993,74016.0,61389,135405.0,104588.0,43.58,0.0,Low Risk
U512,2024,3,448980.0,Salary Increases & Fixed Expenses Increase,239993,74016.0,52667,126683.0,113310.0,47.21,0.04,Low Risk
U512,2024,4,562290.0,Salary Increases & Fixed Expenses Increase,239993,75106.0,62334,137440.0,102553.0,42.73,0.01,Low Risk
U512,2024,5,664843.0,Salary Increases & Fixed Expenses Increase,239993,75106.0,54953,130059.0,109934.0,45.81,0.03,Low Risk
U512,2024,6,774777.0,Salary Increases & Fixed Expenses Increase,239993,76228.0,67070,143298.0,96695.0,40.29,-0.01,Low Risk
U512,2024,7,871472.0,Salary Increases & Fixed Expenses Increase,239993,78010.0,56708,134718.0,105275.0,43.87,0.02,Low Risk
U512,2024,8,976747.0,Salary Increases & Fixed Expenses Increase,269526,79624.0,69076,148700.0,120826.0,44.83,-0.01,Low Risk
U512,2024,9,1097573.0,Salary Increases & Fixed Expenses Increase,269526,79624.0,77447,157071.0,112455.0,41.72,-0.02,Low Risk
U512,2024,10,1210028.0,Salary Increases & Fixed Expenses Increase,269526,79624.0,58313,137937.0,131589.0,48.82,0.02,Low Risk
U512,2024,11,1341617.0,Salary Increases & Fixed Expenses Increase,269526,79624.0,81397,161021.0,108505.0,40.26,0.04,Low Risk
U512,2024,12,1450122.0,Salary Increases & Fixed Expenses Increase,269526,79624.0,57319,136943.0,132583.0,49.19,0.03,Low Risk
U513,2024,1,202102.0,Salary Increases & Fixed Expenses Increase,50117,33231.0,19951,53182.0,-3065.0,-6.12,-0.04,High Risk
U513,2024,2,199037.0,Salary Increases & Fixed Expenses Increase,50117,33231.0,17674,50905.0,-788.0,-1.57,-0.03,High Risk
U513,2024,3,198249.0,Salary Increases & Fixed Expenses Increase,50117,33231.0,25521,58752.0,-8635.0,-17.23,0.02,High Risk
U513,2024,4,189614.0,Salary Increases & Fixed Expenses Increase,64049,33231.0,28898,62129.0,1920.0,3.0,0.05,High Risk
U513,2024,5,191534.0,Salary Increases & Fixed Expenses Increase,64049,33231.0,30945,64176.0,-127.0,-0.2,-0.02,High Risk
U513,2024,6,191407.0,Salary Increases & Fixed Expenses Increase,64049,33231.0,26444,59675.0,4374.0,6.83,0.02,High Risk
U513,2024,7,195781.0,Salary Increases & Fixed Expenses Increase,64049,33231.0,19675,52906.0,11143.0,17.4,0.03,Medium Risk
U513,2024,8,206924.0,Salary Increases & Fixed Expenses Increase,64049,33231.0,31086,64317.0,-268.0,-0.42,-0.01,High Risk
U513,2024,9,206656.0,Salary Increases & Fixed Expenses Increase,64049,33231.0,32706,65937.0,-1888.0,-2.95,0.04,High Risk
U513,2024,10,204768.0,Salary Increases & Fixed Expenses Increase,64049,35141.0,32080,67221.0,-3172.0,-4.95,-0.01,High Risk
U513,2024,11,201596.0,Salary Increases & Fixed Expenses Increase,64049,35141.0,27822,62963.0,1086.0,1.7,-0.04,High Risk
U513,2024,12,202682.0,Salary Increases & Fixed Expenses Increase,64049,36839.0,38162,75001.0,-10952.0,-17.1,0.02,High Risk
U514,2024,1,215056.0,Salary Increases & Fixed Expenses Increase,204762,112569.0,49846,162415.0,42347.0,20.68,-0.0,Medium Risk
U514,2024,2,257403.0,Salary Increases & Fixed Expenses Increase,204762,113917.0,55127,169044.0,35718.0,17.44,0.03,Medium Risk
U514,2024,3,293121.0,Salary Increases & Fixed Expenses Increase,204762,113917.0,54906,168823.0,35939.0,17.55,-0.02,Medium Risk
U514,2024,4,329060.0,Salary Increases & Fixed Expenses Increase,234266,114432.0,59547,173979.0,60287.0,25.73,-0.04,Low Risk
U514,2024,5,389347.0,Salary Increases & Fixed Expenses Increase,234266,114432.0,69802,184234.0,50032.0,21.36,-0.02,Medium Risk
U514,2024,6,439379.0,Salary Increases & Fixed Expenses Increase,234266,114432.0,62635,177067.0,57199.0,24.42,0.05,Medium Risk
U514,2024,7,496578.0,Salary Increases & Fixed Expenses Increase,234266,114432.0,47806,162238.0,72028.0,30.75,0.02,Low Risk
U514,2024,8,568606.0,Salary Increases & Fixed Expenses Increase,234266,114432.0,64151,178583.0,55683.0,23.77,-0.04,Medium Risk
U514,2024,9,624289.0,Salary Increases & Fixed Expenses Increase,234266,115291.0,57220,172511.0,61755.0,26.36,-0.04,Low Risk
U514,2024,10,686044.0,Salary Increases & Fixed Expenses Increase,234266,115291.0,67251,182542.0,51724.0,22.08,-0.03,Medium Risk
U514,2024,11,737768.0,Salary Increases & Fixed Expenses Increase,234266,115291.0,59942,175233.0,59033.0,25.2,-0.02,Low Risk
U514,2024,12,796801.0,Salary Increases & Fixed Expenses Increase,234266,115291.0,69633,184924.0,49342.0,21.06,0.04,Medium Risk
U515,2024,1,237857.0,Salary Increases & Fixed Expenses Remain Stable,206782,77742.0,64911,142653.0,64129.0,31.01,-0.04,Low Risk
U515,2024,2,301986.0,Salary Increases & Fixed Expenses Remain Stable,206782,77742.0,65801,143543.0,63239.0,30.58,0.04,Low Risk
U515,2024,3,365225.0,Salary Increases & Fixed Expenses Remain Stable,206782,77742.0,88806,166548.0,40234.0,19.46,0.04,Medium Risk
U515,2024,4,405459.0,Salary Increases & Fixed Expenses Remain Stable,206782,77742.0,82174,159916.0,46866.0,22.66,0.02,Medium Risk
U515,2024,5,452325.0,Salary Increases & Fixed Expenses Remain Stable,206782,77742.0,84231,161973.0,44809.0,21.67,0.05,Medium Risk
U515,2024,6,497134.0,Salary Increases & Fixed Expenses Remain Stable,221145,77742.0,107269,185011.0,36134.0,16.34,0.02,Medium Risk
U515,2024,7,533268.0,Salary Increases & Fixed Expenses Remain Stable,221145,77742.0,97827,175569.0,45576.0,20.61,0.0,Medium Risk
U515,2024,8,578844.0,Salary Increases & Fixed Expenses Remain Stable,221145,77742.0,74514,152256.0,68889.0,31.15,-0.02,Low Risk
U515,2024,9,647733.0,Salary Increases & Fixed Expenses Remain Stable,221145,77742.0,77180,154922.0,66223.0,29.95,0.02,Low Risk
U515,2024,10,713956.0,Salary Increases & Fixed Expenses Remain Stable,221145,77742.0,113252,190994.0,30151.0,13.63,-0.02,High Risk
U515,2024,11,744107.0,Salary Increases & Fixed Expenses Remain Stable,221145,77742.0,92823,170565.0,50580.0,22.87,-0.04,Medium Risk
U515,2024,12,794687.0,Salary Increases & Fixed Expenses Remain Stable,221145,77742.0,108525,186267.0,34878.0,15.77,-0.03,Medium Risk
U516,2024,1,247313.0,Stable Salary & Stable Fixed Expenses,126689,72927.0,70284,143211.0,-16522.0,-13.04,-0.02,High Risk
U516,2024,2,230791.0,Stable Salary & Stable Fixed Expenses,126689,72927.0,69812,142739.0,-16050.0,-12.67,-0.03,High Risk
U516,2024,3,214741.0,Stable Salary & Stable Fixed Expenses,126689,72927.0,84991,157918.0,-31229.0,-24.65,-0.03,High Risk
U516,2024,4,183512.0,Stable Salary & Stable Fixed Expenses,126689,72927.0,72323,145250.0,-18561.0,-14.65,0.02,High Risk
U516,2024,5,164951.0,Stable Salary & Stable Fixed Expenses,126689,72927.0,71937,144864.0,-18175.0,-14.35,-0.03,High Risk
U516,2024,6,146776.0,Stable Salary & Stable Fixed Expenses,126689,72927.0,67640,140567.0,-13878.0,-10.95,-0.0,High Risk
U516,2024,7,132898.0,Stable Salary & Stable Fixed Expenses,126689,72927.0,75694,148621.0,-21932.0,-17.31,-0.04,High Risk
U516,2024,8,110966.0,Stable Salary & Stable Fixed Expenses,126689,72927.0,80393,153320.0,-26631.0,-21.02,0.01,High Risk
U516,2024,9,84335.0,Stable Salary & Stable Fixed Expenses,126689,72927.0,75573,148500.0,-21811.0,-17.22,0.02,High Risk
U516,2024,10,62524.0,Stable Salary & Stable Fixed Expenses,126689,72927.0,64533,137460.0,-10771.0,-8.5,-0.02,High Risk
U516,2024,11,51753.0,Stable Salary & Stable Fixed Expenses,126689,72927.0,70083,143010.0,-16321.0,-12.88,-0.02,High Risk
U516,2024,12,35432.0,Stable Salary & Stable Fixed Expenses,126689,72927.0,87109,160036.0,-33347.0,-26.32,-0.01,High Risk
U517,2024,1,169848.0,Salary Increases & Fixed Expenses Remain Stable,33869,15211.0,17383,32594.0,1275.0,3.76,0.01,High Risk
U517,2024,2,171123.0,Salary Increases & Fixed Expenses Remain Stable,33869,15211.0,21573,36784.0,-2915.0,-8.61,0.03,High Risk
U517,2024,3,168208.0,Salary Increases & Fixed Expenses Remain Stable,61698,15211.0,31960,47171.0,14527.0,23.55,-0.01,Medium Risk
U517,2024,4,182735.0,Salary Increases & Fixed Expenses Remain Stable,61698,15211.0,36369,51580.0,10118.0,16.4,0.01,Medium Risk
U517,2024,5,192853.0,Salary Increases & Fixed Expenses Remain Stable,61698,15211.0,32316,47527.0,14171.0,22.97,0.04,Medium Risk
U517,2024,6,207024.0,Salary Increases & Fixed Expenses Remain Stable,61698,15211.0,42750,57961.0,3737.0,6.06,0.01,High Risk
U517,2024,7,210761.0,Salary Increases & Fixed Expenses Remain Stable,61698,15211.0,34425,49636.0,12062.0,19.55,-0.02,Medium Risk
U517,2024,8,222823.0,Salary Increases & Fixed Expenses Remain Stable,61698,15211.0,39535,54746.0,6952.0,11.27,0.05,High Risk
U517,2024,9,229775.0,Salary Increases & Fixed Expenses Remain Stable,61698,15211.0,41267,56478.0,5220.0,8.46,0.01,High Risk
U517,2024,10,234995.0,Salary Increases & Fixed Expenses Remain Stable,61698,15211.0,38686,53897.0,7801.0,12.64,-0.02,High Risk
U517,2024,11,242796.0,Salary Increases & Fixed Expenses Remain Stable,61698,15211.0,38148,53359.0,8339.0,13.52,-0.04,High Risk
U517,2024,12,251135.0,Salary Increases & Fixed Expenses Remain Stable,61698,15211.0,37245,52456.0,9242.0,14.98,0.01,High Risk
U518,2024,1,196822.0,Stable Salary & Increasing Fixed Expenses,175445,51657.0,66533,118190.0,57255.0,32.63,-0.02,Low Risk
U518,2024,2,254077.0,Stable Salary & Increasing Fixed Expenses,175445,51657.0,58273,109930.0,65515.0,37.34,-0.05,Low Risk
U518,2024,3,319592.0,Stable Salary & Increasing Fixed Expenses,175445,52780.0,70620,123400.0,52045.0,29.66,-0.02,Low Risk
U518,2024,4,371637.0,Stable Salary & Increasing Fixed Expenses,175445,52780.0,82265,135045.0,40400.0,23.03,0.03,Medium Risk
U518,2024,5,412037.0,Stable Salary & Increasing Fixed Expenses,175445,52780.0,62287,115067.0,60378.0,34.41,-0.02,Low Risk
U518,2024,6,472415.0,Stable Salary & Increasing Fixed Expenses,175445,52780.0,71168,123948.0,51497.0,29.35,-0.04,Low Risk
U518,2024,7,523912.0,Stable Salary & Increasing Fixed Expenses,175445,52780.0,68496,121276.0,54169.0,30.88,0.03,Low Risk
U518,2024,8,578081.0,Stable Salary & Increasing Fixed Expenses,175445,52780.0,76197,128977.0,46468.0,26.49,0.01,Low Risk
U518,2024,9,624549.0,Stable Salary & Increasing Fixed Expenses,175445,54643.0,59259,113902.0,61543.0,35.08,-0.05,Low Risk
U518,2024,10,686092.0,Stable Salary & Increasing Fixed Expenses,175445,54643.0,65217,119860.0,55585.0,31.68,0.03,Low Risk
U518,2024,11,741677.0,Stable Salary & Increasing Fixed Expenses,175445,55280.0,98016,153296.0,22149.0,12.62,-0.02,High Risk
U518,2024,12,763826.0,Stable Salary & Increasing Fixed Expenses,175445,55280.0,72284,127564.0,47881.0,27.29,0.04,Low Risk
U519,2024,1,91052.0,Salary Increases & Fixed Expenses Increase,53540,35103.0,23245,58348.0,-4808.0,-8.98,-0.04,High Risk
U519,2024,2,86244.0,Salary Increases & Fixed Expenses Increase,53540,35103.0,19303,54406.0,-866.0,-1.62,-0.03,High Risk
U519,2024,3,85378.0,Salary Increases & Fixed Expenses Increase,53540,35103.0,23441,58544.0,-5004.0,-9.35,-0.04,High Risk
U519,2024,4,80374.0,Salary Increases & Fixed Expenses Increase,53540,36015.0,20661,56676.0,-3136.0,-5.86,-0.03,High Risk
U519,2024,5,77238.0,Salary Increases & Fixed Expenses Increase,80215,36015.0,29667,65682.0,14533.0,18.12,0.03,Medium Risk
U519,2024,6,91771.0,Salary Increases & Fixed Expenses Increase,80215,36015.0,26715,62730.0,17485.0,21.8,-0.03,Medium Risk
U519,2024,7,109256.0,Salary Increases & Fixed Expenses Increase,80215,36803.0,28432,65235.0,14980.0,18.67,0.0,Medium Risk
U519,2024,8,124236.0,Salary Increases & Fixed Expenses Increase,80215,36803.0,24198,61001.0,19214.0,23.95,0.01,Medium Risk
U519,2024,9,143450.0,Salary Increases & Fixed Expenses Increase,80215,36803.0,34192,70995.0,9220.0,11.49,0.04,High Risk
U519,2024,10,152670.0,Salary Increases & Fixed Expenses Increase,80215,36803.0,28027,64830.0,15385.0,19.18,0.01,Medium Risk
U519,2024,11,168055.0,Salary Increases & Fixed Expenses Increase,80215,36803.0,32573,69376.0,10839.0,13.51,0.02,High Risk
U519,2024,12,178894.0,Salary Increases & Fixed Expenses Increase,80215,36803.0,35105,71908.0,8307.0,10.36,-0.01,High Risk
U520,2024,1,250000.0,Stable Salary & Stable Fixed Expenses,289547,82816.0,98099,180915.0,108632.0,37.52,0.05,Low Risk
U520,2024,2,358632.0,Stable Salary & Stable Fixed Expenses,289547,82816.0,130754,213570.0,75977.0,26.24,0.0,Low Risk
U520,2024,3,434609.0,Stable Salary & Stable Fixed Expenses,289547,82816.0,107493,190309.0,99238.0,34.27,-0.03,Low Risk
U520,2024,4,533847.0,Stable Salary & Stable Fixed Expenses,289547,82816.0,108397,191213.0,98334.0,33.96,0.0,Low Risk
U520,2024,5,632181.0,Stable Salary & Stable Fixed Expenses,289547,82816.0,89398,172214.0,117333.0,40.52,0.02,Low Risk
U520,2024,6,749514.0,Stable Salary & Stable Fixed Expenses,289547,82816.0,111354,194170.0,95377.0,32.94,-0.01,Low Risk
U520,2024,7,844891.0,Stable Salary & Stable Fixed Expenses,289547,82816.0,113858,196674.0,92873.0,32.08,0.0,Low Risk
U520,2024,8,937764.0,Stable Salary & Stable Fixed Expenses,289547,82816.0,123597,206413.0,83134.0,28.71,0.04,Low Risk
U520,2024,9,1020898.0,Stable Salary & Stable Fixed Expenses,289547,82816.0,142200,225016.0,64531.0,22.29,-0.04,Medium Risk
U520,2024,10,1085429.0,Stable Salary & Stable Fixed Expenses,289547,82816.0,143960,226776.0,62771.0,21.68,-0.01,Medium Risk
U520,2024,11,1148200.0,Stable Salary & Stable Fixed Expenses,289547,82816.0,103524,186340.0,103207.0,35.64,-0.03,Low Risk
U520,2024,12,1251407.0,Stable Salary & Stable Fixed Expenses,289547,82816.0,104760,187576.0,101971.0,35.22,0.01,Low Risk
U521,2024,1,103011.0,Stable Salary & Stable Fixed Expenses,67671,39094.0,24505,63599.0,4072.0,6.02,0.01,High Risk
U521,2024,2,107083.0,Stable Salary & Stable Fixed Expenses,67671,39094.0,26735,65829.0,1842.0,2.72,0.01,High Risk
U521,2024,3,108925.0,Stable Salary & Stable Fixed Expenses,67671,39094.0,22569,61663.0,6008.0,8.88,0.04,High Risk
U521,2024,4,114933.0,Stable Salary & Stable Fixed Expenses,67671,39094.0,21504,60598.0,7073.0,10.45,0.04,High Risk
U521,2024,5,122006.0,Stable Salary & Stable Fixed Expenses,67671,39094.0,29265,68359.0,-688.0,-1.02,0.02,High Risk
U521,2024,6,121318.0,Stable Salary & Stable Fixed Expenses,67671,39094.0,33098,72192.0,-4521.0,-6.68,0.03,High Risk
U521,2024,7,116797.0,Stable Salary & Stable Fixed Expenses,67671,39094.0,23921,63015.0,4656.0,6.88,0.03,High Risk
U521,2024,8,121453.0,Stable Salary & Stable Fixed Expenses,67671,39094.0,28835,67929.0,-258.0,-0.38,0.02,High Risk
U521,2024,9,121195.0,Stable Salary & Stable Fixed Expenses,67671,39094.0,30575,69669.0,-1998.0,-2.95,0.02,High Risk
U521,2024,10,119197.0,Stable Salary & Stable Fixed Expenses,67671,39094.0,23017,62111.0,5560.0,8.22,0.0,High Risk
U521,2024,11,124757.0,Stable Salary & Stable Fixed Expenses,67671,39094.0,25604,64698.0,2973.0,4.39,-0.02,High Risk
U521,2024,12,127730.0,Stable Salary & Stable Fixed Expenses,67671,39094.0,20659,59753.0,7918.0,11.7,-0.02,High Risk
U522,2024,1,236844.0,Salary Increases & Fixed Expenses Increase,143988,63113.0,83128,146241.0,-2253.0,-1.56,0.02,High Risk
U522,2024,2,234591.0,Salary Increases & Fixed Expenses Increase,143988,63113.0,90608,153721.0,-9733.0,-6.76,-0.03,High Risk
U522,2024,3,224858.0,Salary Increases & Fixed Expenses Increase,143988,63113.0,83568,146681.0,-2693.0,-1.87,-0.05,High Risk
U522,2024,4,222165.0,Salary Increases & Fixed Expenses Increase,143988,63113.0,85129,148242.0,-4254.0,-2.95,-0.02,High Risk
U522,2024,5,217911.0,Salary Increases & Fixed Expenses Increase,143988,63113.0,94292,157405.0,-13417.0,-9.32,0.03,High Risk
U522,2024,6,204494.0,Salary Increases & Fixed Expenses Increase,143988,63113.0,90773,153886.0,-9898.0,-6.87,0.04,High Risk
U522,2024,7,194596.0,Salary Increases & Fixed Expenses Increase,167080,64943.0,90091,155034.0,12046.0,7.21,0.02,High Risk
U522,2024,8,206642.0,Salary Increases & Fixed Expenses Increase,167080,64943.0,109751,174694.0,-7614.0,-4.56,0.02,High Risk
U522,2024,9,199028.0,Salary Increases & Fixed Expenses Increase,167080,64943.0,98362,163305.0,3775.0,2.26,0.03,High Risk
U522,2024,10,202803.0,Salary Increases & Fixed Expenses Increase,167080,64943.0,105812,170755.0,-3675.0,-2.2,0.03,High Risk
U522,2024,11,199128.0,Salary Increases & Fixed Expenses Increase,167080,64943.0,114524,179467.0,-12387.0,-7.41,-0.01,High Risk
U522,2024,12,186741.0,Salary Increases & Fixed Expenses Increase,167080,64943.0,116879,181822.0,-14742.0,-8.82,-0.03,High Risk
U523,2024,1,250000.0,Salary Increases & Fixed Expenses Decrease,253180,100960.0,85945,186905.0,66275.0,26.18,-0.01,Low Risk
U523,2024,2,316275.0,Salary Increases & Fixed Expenses Decrease,253180,100960.0,94556,195516.0,57664.0,22.78,0.03,Medium Risk
U523,2024,3,373939.0,Salary Increases & Fixed Expenses Decrease,253180,100960.0,90001,190961.0,62219.0,24.58,-0.05,Medium Risk
U523,2024,4,436158.0,Salary Increases & Fixed Expenses Decrease,253180,100960.0,108587,209547.0,43633.0,17.23,-0.01,Medium Risk
U523,2024,5,479791.0,Salary Increases & Fixed Expenses Decrease,253180,100960.0,79099,180059.0,73121.0,28.88,0.02,Low Risk
U523,2024,6,552912.0,Salary Increases & Fixed Expenses Decrease,263562,100960.0,82284,183244.0,80318.0,30.47,-0.04,Low Risk
U523,2024,7,633230.0,Salary Increases & Fixed Expenses Decrease,263562,100960.0,127066,228026.0,35536.0,13.48,-0.03,High Risk
U523,2024,8,668766.0,Salary Increases & Fixed Expenses Decrease,263562,100960.0,113195,214155.0,49407.0,18.75,-0.01,Medium Risk
U523,2024,9,718173.0,Salary Increases & Fixed Expenses Decrease,263562,100960.0,128070,229030.0,34532.0,13.1,0.02,High Risk
U523,2024,10,752705.0,Salary Increases & Fixed Expenses Decrease,263562,100960.0,121836,222796.0,40766.0,15.47,0.0,Medium Risk
U523,2024,11,793471.0,Salary Increases & Fixed Expenses Decrease,263562,98996.0,95887,194883.0,68679.0,26.06,-0.01,Low Risk
U523,2024,12,862150.0,Salary Increases & Fixed Expenses Decrease,263562,98996.0,100703,199699.0,63863.0,24.23,-0.02,Medium Risk
U524,2024,1,250000.0,Stable Salary & Stable Fixed Expenses,261274,116716.0,164917,281633.0,-20359.0,-7.79,0.04,High Risk
U524,2024,2,229641.0,Stable Salary & Stable Fixed Expenses,261274,116716.0,171710,288426.0,-27152.0,-10.39,-0.05,High Risk
U524,2024,3,202489.0,Stable Salary & Stable Fixed Expenses,261274,116716.0,176552,293268.0,-31994.0,-12.25,0.03,High Risk
U524,2024,4,170495.0,Stable Salary & Stable Fixed Expenses,261274,116716.0,147250,263966.0,-2692.0,-1.03,-0.02,High Risk
U524,2024,5,167803.0,Stable Salary & Stable Fixed Expenses,261274,116716.0,162812,279528.0,-18254.0,-6.99,-0.02,High Risk
U524,2024,6,149549.0,Stable Salary & Stable Fixed Expenses,261274,116716.0,173479,290195.0,-28921.0,-11.07,-0.05,High Risk
U524,2024,7,120628.0,Stable Salary & Stable Fixed Expenses,261274,116716.0,133603,250319.0,10955.0,4.19,0.03,High Risk
U524,2024,8,131583.0,Stable Salary & Stable Fixed Expenses,261274,116716.0,139041,255757.0,5517.0,2.11,-0.05,High Risk
U524,2024,9,137100.0,Stable Salary & Stable Fixed Expenses,261274,116716.0,202577,319293.0,-58019.0,-22.21,-0.02,High Risk
U524,2024,10,79081.0,Stable Salary & Stable Fixed Expenses,261274,116716.0,142838,259554.0,1720.0,0.66,0.01,High Risk
U524,2024,11,80801.0,Stable Salary & Stable Fixed Expenses,261274,116716.0,174679,291395.0,-30121.0,-11.53,-0.02,High Risk
U524,2024,12,50680.0,Stable Salary & Stable Fixed Expenses,261274,116716.0,179724,296440.0,-35166.0,-13.46,-0.02,High Risk
U525,2024,1,185894.0,Salary Increases & Fixed Expenses Remain Stable,79356,37104.0,23270,60374.0,18982.0,23.92,-0.04,Medium Risk
U525,2024,2,204876.0,Salary Increases & Fixed Expenses Remain Stable,79356,37104.0,21865,58969.0,20387.0,25.69,-0.04,Low Risk
U525,2024,3,225263.0,Salary Increases & Fixed Expenses Remain Stable,79356,37104.0,22250,59354.0,20002.0,25.21,-0.03,Low Risk
U525,2024,4,245265.0,Salary Increases & Fixed Expenses Remain Stable,79356,37104.0,18570,55674.0,23682.0,29.84,0.01,Low Risk
U525,2024,5,268947.0,Salary Increases & Fixed Expenses Remain Stable,86488,37104.0,24317,61421.0,25067.0,28.98,0.05,Low Risk
U525,2024,6,294014.0,Salary Increases & Fixed Expenses Remain Stable,86488,37104.0,19359,56463.0,30025.0,34.72,-0.03,Low Risk
U525,2024,7,324039.0,Salary Increases & Fixed Expenses Remain Stable,86488,37104.0,18831,55935.0,30553.0,35.33,-0.03,Low Risk
U525,2024,8,354592.0,Salary Increases & Fixed Expenses Remain Stable,86488,37104.0,21473,58577.0,27911.0,32.27,-0.04,Low Risk
U525,2024,9,382503.0,Salary Increases & Fixed Expenses Remain Stable,86488,37104.0,22908,60012.0,26476.0,30.61,-0.05,Low Risk
U525,2024,10,408979.0,Salary Increases & Fixed Expenses Remain Stable,86488,37104.0,22011,59115.0,27373.0,31.65,-0.01,Low Risk
U525,2024,11,436352.0,Salary Increases & Fixed Expenses Remain Stable,86488,37104.0,21146,58250.0,28238.0,32.65,-0.04,Low Risk
U525,2024,12,464590.0,Salary Increases & Fixed Expenses Remain Stable,86488,37104.0,25127,62231.0,24257.0,28.05,-0.03,Low Risk
U526,2024,1,116821.0,Salary Increases & Fixed Expenses Remain Stable,111292,50312.0,22584,72896.0,38396.0,34.5,-0.03,Low Risk
U526,2024,2,155217.0,Salary Increases & Fixed Expenses Remain Stable,111292,50312.0,27460,77772.0,33520.0,30.12,0.03,Low Risk
U526,2024,3,188737.0,Salary Increases & Fixed Expenses Remain Stable,119535,50312.0,27421,77733.0,41802.0,34.97,-0.02,Low Risk
U526,2024,4,230539.0,Salary Increases & Fixed Expenses Remain Stable,119535,50312.0,25809,76121.0,43414.0,36.32,0.04,Low Risk
U526,2024,5,273953.0,Salary Increases & Fixed Expenses Remain Stable,119535,50312.0,25625,75937.0,43598.0,36.47,0.03,Low Risk
U526,2024,6,317551.0,Salary Increases & Fixed Expenses Remain Stable,119535,50312.0,27288,77600.0,41935.0,35.08,-0.02,Low Risk
U526,2024,7,359486.0,Salary Increases & Fixed Expenses Remain Stable,119535,50312.0,34514,84826.0,34709.0,29.04,-0.0,Low Risk
U526,2024,8,394195.0,Salary Increases & Fixed Expenses Remain Stable,119535,50312.0,30405,80717.0,38818.0,32.47,0.03,Low Risk
U526,2024,9,433013.0,Salary Increases & Fixed Expenses Remain Stable,119535,50312.0,32790,83102.0,36433.0,30.48,0.01,Low Risk
U526,2024,10,469446.0,Salary Increases & Fixed Expenses Remain Stable,119535,50312.0,30132,80444.0,39091.0,32.7,0.04,Low Risk
U526,2024,11,508537.0,Salary Increases & Fixed Expenses Remain Stable,119535,50312.0,32278,82590.0,36945.0,30.91,0.03,Low Risk
U526,2024,12,545482.0,Salary Increases & Fixed Expenses Remain Stable,119535,50312.0,34113,84425.0,35110.0,29.37,0.03,Low Risk
U527,2024,1,186591.0,Stable Salary & Stable Fixed Expenses,155335,52741.0,106114,158855.0,-3520.0,-2.27,-0.0,High Risk
U527,2024,2,183071.0,Stable Salary & Stable Fixed Expenses,155335,52741.0,106715,159456.0,-4121.0,-2.65,-0.0,High Risk
U527,2024,3,178950.0,Stable Salary & Stable Fixed Expenses,155335,52741.0,116710,169451.0,-14116.0,-9.09,-0.02,High Risk
U527,2024,4,164834.0,Stable Salary & Stable Fixed Expenses,155335,52741.0,93504,146245.0,9090.0,5.85,0.05,High Risk
U527,2024,5,173924.0,Stable Salary & Stable Fixed Expenses,155335,52741.0,83953,136694.0,18641.0,12.0,-0.01,High Risk
U527,2024,6,192565.0,Stable Salary & Stable Fixed Expenses,155335,52741.0,96455,149196.0,6139.0,3.95,-0.04,High Risk
U527,2024,7,198704.0,Stable Salary & Stable Fixed Expenses,155335,52741.0,93943,146684.0,8651.0,5.57,-0.01,High Risk
U527,2024,8,207355.0,Stable Salary & Stable Fixed Expenses,155335,52741.0,88497,141238.0,14097.0,9.08,-0.04,High Risk
U527,2024,9,221452.0,Stable Salary & Stable Fixed Expenses,155335,52741.0,102261,155002.0,333.0,0.21,0.02,High Risk
U527,2024,10,221785.0,Stable Salary & Stable Fixed Expenses,155335,52741.0,121405,174146.0,-18811.0,-12.11,0.01,High Risk
U527,2024,11,202974.0,Stable Salary & Stable Fixed Expenses,155335,52741.0,95694,148435.0,6900.0,4.44,0.05,High Risk
U527,2024,12,209874.0,Stable Salary & Stable Fixed Expenses,155335,52741.0,116308,169049.0,-13714.0,-8.83,0.03,High Risk
U528,2024,1,240060.0,Salary Increases & Fixed Expenses Remain Stable,123871,62755.0,59441,122196.0,1675.0,1.35,0.02,High Risk
U528,2024,2,241735.0,Salary Increases & Fixed Expenses Remain Stable,123871,62755.0,50895,113650.0,10221.0,8.25,-0.04,High Risk
U528,2024,3,251956.0,Salary Increases & Fixed Expenses Remain Stable,123871,62755.0,70316,133071.0,-9200.0,-7.43,0.01,High Risk
U528,2024,4,242756.0,Salary Increases & Fixed Expenses Remain Stable,123871,62755.0,39354,102109.0,21762.0,17.57,0.02,Medium Risk
U528,2024,5,264518.0,Salary Increases & Fixed Expenses Remain Stable,123871,62755.0,43247,106002.0,17869.0,14.43,0.02,High Risk
U528,2024,6,282387.0,Salary Increases & Fixed Expenses Remain Stable,148033,62755.0,73698,136453.0,11580.0,7.82,-0.04,High Risk
U528,2024,7,293967.0,Salary Increases & Fixed Expenses Remain Stable,148033,62755.0,64179,126934.0,21099.0,14.25,0.01,High Risk
U528,2024,8,315066.0,Salary Increases & Fixed Expenses Remain Stable,148033,62755.0,63213,125968.0,22065.0,14.91,-0.02,High Risk
U528,2024,9,337131.0,Salary Increases & Fixed Expenses Remain Stable,148033,62755.0,59839,122594.0,25439.0,17.18,-0.02,Medium Risk
U528,2024,10,362570.0,Salary Increases & Fixed Expenses Remain Stable,148033,62755.0,81765,144520.0,3513.0,2.37,0.0,High Risk
U528,2024,11,366083.0,Salary Increases & Fixed Expenses Remain Stable,148033,62755.0,55085,117840.0,30193.0,20.4,0.02,Medium Risk
U528,2024,12,396276.0,Salary Increases & Fixed Expenses Remain Stable,148033,62755.0,52728,115483.0,32550.0,21.99,0.04,Medium Risk
U529,2024,1,226620.0,Stable Salary & Stable Fixed Expenses,134094,47625.0,56015,103640.0,30454.0,22.71,-0.01,Medium Risk
U529,2024,2,257074.0,Stable Salary & Stable Fixed Expenses,134094,47625.0,47077,94702.0,39392.0,29.38,-0.02,Low Risk
U529,2024,3,296466.0,Stable Salary & Stable Fixed Expenses,134094,47625.0,74119,121744.0,12350.0,9.21,0.05,High Risk
U529,2024,4,308816.0,Stable Salary & Stable Fixed Expenses,134094,47625.0,62467,110092.0,24002.0,17.9,0.03,Medium Risk
U529,2024,5,332818.0,Stable Salary & Stable Fixed Expenses,134094,47625.0,54375,102000.0,32094.0,23.93,0.03,Medium Risk
U529,2024,6,364912.0,Stable Salary & Stable Fixed Expenses,134094,47625.0,57229,104854.0,29240.0,21.81,0.03,Medium Risk
U529,2024,7,394152.0,Stable Salary & Stable Fixed Expenses,134094,47625.0,65639,113264.0,20830.0,15.53,0.05,Medium Risk
U529,2024,8,414982.0,Stable Salary & Stable Fixed Expenses,134094,47625.0,64960,112585.0,21509.0,16.04,-0.0,Medium Risk
U529,2024,9,436491.0,Stable Salary & Stable Fixed Expenses,134094,47625.0,49332,96957.0,37137.0,27.69,0.01,Low Risk
U529,2024,10,473628.0,Stable Salary & Stable Fixed Expenses,134094,47625.0,75008,122633.0,11461.0,8.55,0.03,High Risk
U529,2024,11,485089.0,Stable Salary & Stable Fixed Expenses,134094,47625.0,59847,107472.0,26622.0,19.85,-0.05,Medium Risk
U529,2024,12,511711.0,Stable Salary & Stable Fixed Expenses,134094,47625.0,66322,113947.0,20147.0,15.02,0.01,Medium Risk
U530,2024,1,128713.0,Salary Increases & Fixed Expenses Increase,76124,25625.0,49078,74703.0,1421.0,1.87,-0.02,High Risk
U530,2024,2,130134.0,Salary Increases & Fixed Expenses Increase,76124,25625.0,46309,71934.0,4190.0,5.5,0.03,High Risk
U530,2024,3,134324.0,Salary Increases & Fixed Expenses Increase,76124,25625.0,43312,68937.0,7187.0,9.44,-0.01,High Risk
U530,2024,4,141511.0,Salary Increases & Fixed Expenses Increase,76124,25625.0,40425,66050.0,10074.0,13.23,-0.01,High Risk
U530,2024,5,151585.0,Salary Increases & Fixed Expenses Increase,76124,25625.0,40463,66088.0,10036.0,13.18,0.02,High Risk
U530,2024,6,161621.0,Salary Increases & Fixed Expenses Increase,76124,25625.0,47946,73571.0,2553.0,3.35,0.04,High Risk
U530,2024,7,164174.0,Salary Increases & Fixed Expenses Increase,86495,26998.0,47132,74130.0,12365.0,14.3,0.01,High Risk
U530,2024,8,176539.0,Salary Increases & Fixed Expenses Increase,86495,28377.0,59750,88127.0,-1632.0,-1.89,0.05,High Risk
U530,2024,9,174907.0,Salary Increases & Fixed Expenses Increase,86495,28377.0,52447,80824.0,5671.0,6.56,0.03,High Risk
U530,2024,10,180578.0,Salary Increases & Fixed Expenses Increase,86495,28377.0,53320,81697.0,4798.0,5.55,-0.05,High Risk
U530,2024,11,185376.0,Salary Increases & Fixed Expenses Increase,86495,28377.0,58964,87341.0,-846.0,-0.98,-0.02,High Risk
U530,2024,12,184530.0,Salary Increases & Fixed Expenses Increase,86495,28377.0,48269,76646.0,9849.0,11.39,-0.03,High Risk
U531,2024,1,172081.0,Stable Salary & Stable Fixed Expenses,106503,51302.0,26566,77868.0,28635.0,26.89,-0.01,Low Risk
U531,2024,2,200716.0,Stable Salary & Stable Fixed Expenses,106503,51302.0,28140,79442.0,27061.0,25.41,-0.03,Low Risk
U531,2024,3,227777.0,Stable Salary & Stable Fixed Expenses,106503,51302.0,26592,77894.0,28609.0,26.86,0.0,Low Risk
U531,2024,4,256386.0,Stable Salary & Stable Fixed Expenses,106503,51302.0,29238,80540.0,25963.0,24.38,-0.01,Medium Risk
U531,2024,5,282349.0,Stable Salary & Stable Fixed Expenses,106503,51302.0,29597,80899.0,25604.0,24.04,0.03,Medium Risk
U531,2024,6,307953.0,Stable Salary & Stable Fixed Expenses,106503,51302.0,26454,77756.0,28747.0,26.99,-0.0,Low Risk
U531,2024,7,336700.0,Stable Salary & Stable Fixed Expenses,106503,51302.0,30917,82219.0,24284.0,22.8,-0.03,Medium Risk
U531,2024,8,360984.0,Stable Salary & Stable Fixed Expenses,106503,51302.0,29632,80934.0,25569.0,24.01,-0.02,Medium Risk
U531,2024,9,386553.0,Stable Salary & Stable Fixed Expenses,106503,51302.0,30448,81750.0,24753.0,23.24,0.03,Medium Risk
U531,2024,10,411306.0,Stable Salary & Stable Fixed Expenses,106503,51302.0,29655,80957.0,25546.0,23.99,0.04,Medium Risk
U531,2024,11,436852.0,Stable Salary & Stable Fixed Expenses,106503,51302.0,27374,78676.0,27827.0,26.13,-0.01,Low Risk
U531,2024,12,464679.0,Stable Salary & Stable Fixed Expenses,106503,51302.0,21773,73075.0,33428.0,31.39,0.01,Low Risk
U532,2024,1,236193.0,Stable Salary & Increasing Fixed Expenses,230846,83680.0,92417,176097.0,54749.0,23.72,0.01,Medium Risk
U532,2024,2,290942.0,Stable Salary & Increasing Fixed Expenses,230846,83680.0,77968,161648.0,69198.0,29.98,-0.04,Low Risk
U532,2024,3,360140.0,Stable Salary & Increasing Fixed Expenses,230846,83680.0,101885,185565.0,45281.0,19.62,0.01,Medium Risk
U532,2024,4,405421.0,Stable Salary & Increasing Fixed Expenses,230846,83680.0,70917,154597.0,76249.0,33.03,0.03,Low Risk
U532,2024,5,481670.0,Stable Salary & Increasing Fixed Expenses,230846,83680.0,77805,161485.0,69361.0,30.05,0.04,Low Risk
U532,2024,6,551031.0,Stable Salary & Increasing Fixed Expenses,230846,83680.0,93255,176935.0,53911.0,23.35,-0.0,Medium Risk
U532,2024,7,604942.0,Stable Salary & Increasing Fixed Expenses,230846,83680.0,99498,183178.0,47668.0,20.65,-0.01,Medium Risk
U532,2024,8,652610.0,Stable Salary & Increasing Fixed Expenses,230846,83680.0,94246,177926.0,52920.0,22.92,0.02,Medium Risk
U532,2024,9,705530.0,Stable Salary & Increasing Fixed Expenses,230846,83680.0,114507,198187.0,32659.0,14.15,0.03,High Risk
U532,2024,10,738189.0,Stable Salary & Increasing Fixed Expenses,230846,85679.0,135171,220850.0,9996.0,4.33,0.02,High Risk
U532,2024,11,748185.0,Stable Salary & Increasing Fixed Expenses,230846,85679.0,96762,182441.0,48405.0,20.97,0.01,Medium Risk
U532,2024,12,796590.0,Stable Salary & Increasing Fixed Expenses,230846,85679.0,133413,219092.0,11754.0,5.09,-0.01,High Risk
U533,2024,1,228573.0,Salary Increases & Fixed Expenses Remain Stable,208572,81479.0,45614,127093.0,81479.0,39.07,-0.04,Low Risk
U533,2024,2,310052.0,Salary Increases & Fixed Expenses Remain Stable,208572,81479.0,49334,130813.0,77759.0,37.28,-0.05,Low Risk
U533,2024,3,387811.0,Salary Increases & Fixed Expenses Remain Stable,208572,81479.0,58863,140342.0,68230.0,32.71,-0.03,Low Risk
U533,2024,4,456041.0,Salary Increases & Fixed Expenses Remain Stable,208572,81479.0,52027,133506.0,75066.0,35.99,0.0,Low Risk
U533,2024,5,531107.0,Salary Increases & Fixed Expenses Remain Stable,208572,81479.0,62257,143736.0,64836.0,31.09,0.01,Low Risk
U533,2024,6,595943.0,Salary Increases & Fixed Expenses Remain Stable,208572,81479.0,57259,138738.0,69834.0,33.48,-0.04,Low Risk
U533,2024,7,665777.0,Salary Increases & Fixed Expenses Remain Stable,208572,81479.0,54968,136447.0,72125.0,34.58,-0.01,Low Risk
U533,2024,8,737902.0,Salary Increases & Fixed Expenses Remain Stable,234712,81479.0,65751,147230.0,87482.0,37.27,0.01,Low Risk
U533,2024,9,825384.0,Salary Increases & Fixed Expenses Remain Stable,234712,81479.0,48977,130456.0,104256.0,44.42,0.05,Low Risk
U533,2024,10,929640.0,Salary Increases & Fixed Expenses Remain Stable,234712,81479.0,57800,139279.0,95433.0,40.66,0.03,Low Risk
U533,2024,11,1025073.0,Salary Increases & Fixed Expenses Remain Stable,234712,81479.0,65331,146810.0,87902.0,37.45,0.01,Low Risk
U533,2024,12,1112975.0,Salary Increases & Fixed Expenses Remain Stable,234712,81479.0,50299,131778.0,102934.0,43.86,-0.02,Low Risk
U534,2024,1,246151.0,Salary Increases & Fixed Expenses Decrease,243452,67358.0,63075,130433.0,113019.0,46.42,-0.05,Low Risk
U534,2024,2,359170.0,Salary Increases & Fixed Expenses Decrease,243452,67358.0,57505,124863.0,118589.0,48.71,-0.01,Low Risk
U534,2024,3,477759.0,Salary Increases & Fixed Expenses Decrease,243452,67358.0,69797,137155.0,106297.0,43.66,-0.02,Low Risk
U534,2024,4,584056.0,Salary Increases & Fixed Expenses Decrease,243452,67358.0,72761,140119.0,103333.0,42.44,0.05,Low Risk
U534,2024,5,687389.0,Salary Increases & Fixed Expenses Decrease,243452,67358.0,59511,126869.0,116583.0,47.89,0.05,Low Risk
U534,2024,6,803972.0,Salary Increases & Fixed Expenses Decrease,257280,67358.0,54855,122213.0,135067.0,52.5,-0.04,Low Risk
U534,2024,7,939039.0,Salary Increases & Fixed Expenses Decrease,257280,67358.0,64742,132100.0,125180.0,48.66,0.04,Low Risk
U534,2024,8,1064219.0,Salary Increases & Fixed Expenses Decrease,257280,67358.0,60356,127714.0,129566.0,50.36,0.04,Low Risk
U534,2024,9,1193785.0,Salary Increases & Fixed Expenses Decrease,257280,67358.0,65501,132859.0,124421.0,48.36,0.02,Low Risk
U534,2024,10,1318206.0,Salary Increases & Fixed Expenses Decrease,257280,67358.0,74148,141506.0,115774.0,45.0,0.01,Low Risk
U534,2024,11,1433980.0,Salary Increases & Fixed Expenses Decrease,257280,67358.0,70673,138031.0,119249.0,46.35,-0.0,Low Risk
U534,2024,12,1553229.0,Salary Increases & Fixed Expenses Decrease,257280,67358.0,57074,124432.0,132848.0,51.64,-0.02,Low Risk
U535,2024,1,173919.0,Stable Salary & Decreasing Fixed Expenses,140080,48182.0,94361,142543.0,-2463.0,-1.76,-0.01,High Risk
U535,2024,2,171456.0,Stable Salary & Decreasing Fixed Expenses,140080,48182.0,83376,131558.0,8522.0,6.08,-0.02,High Risk
U535,2024,3,179978.0,Stable Salary & Decreasing Fixed Expenses,140080,48182.0,110799,158981.0,-18901.0,-13.49,-0.01,High Risk
U535,2024,4,161077.0,Stable Salary & Decreasing Fixed Expenses,140080,48182.0,71721,119903.0,20177.0,14.4,-0.03,High Risk
U535,2024,5,181254.0,Stable Salary & Decreasing Fixed Expenses,140080,48182.0,80603,128785.0,11295.0,8.06,0.02,High Risk
U535,2024,6,192549.0,Stable Salary & Decreasing Fixed Expenses,140080,48182.0,93213,141395.0,-1315.0,-0.94,0.01,High Risk
U535,2024,7,191234.0,Stable Salary & Decreasing Fixed Expenses,140080,48182.0,81429,129611.0,10469.0,7.47,0.04,High Risk
U535,2024,8,201703.0,Stable Salary & Decreasing Fixed Expenses,140080,48182.0,84208,132390.0,7690.0,5.49,0.01,High Risk
U535,2024,9,209393.0,Stable Salary & Decreasing Fixed Expenses,140080,48182.0,94733,142915.0,-2835.0,-2.02,-0.05,High Risk
U535,2024,10,206558.0,Stable Salary & Decreasing Fixed Expenses,140080,48182.0,110131,158313.0,-18233.0,-13.02,0.01,High Risk
U535,2024,11,188325.0,Stable Salary & Decreasing Fixed Expenses,140080,48182.0,82199,130381.0,9699.0,6.92,0.0,High Risk
U535,2024,12,198024.0,Stable Salary & Decreasing Fixed Expenses,140080,48182.0,114139,162321.0,-22241.0,-15.88,-0.02,High Risk
U536,2024,1,168259.0,Stable Salary & Increasing Fixed Expenses,121716,61421.0,72367,133788.0,-12072.0,-9.92,-0.03,High Risk
U536,2024,2,156187.0,Stable Salary & Increasing Fixed Expenses,121716,61421.0,76710,138131.0,-16415.0,-13.49,0.03,High Risk
U536,2024,3,139772.0,Stable Salary & Increasing Fixed Expenses,121716,61421.0,75491,136912.0,-15196.0,-12.48,0.04,High Risk
U536,2024,4,124576.0,Stable Salary & Increasing Fixed Expenses,121716,61421.0,79914,141335.0,-19619.0,-16.12,0.01,High Risk
U536,2024,5,104957.0,Stable Salary & Increasing Fixed Expenses,121716,61421.0,66467,127888.0,-6172.0,-5.07,0.0,High Risk
U536,2024,6,98785.0,Stable Salary & Increasing Fixed Expenses,121716,61421.0,62218,123639.0,-1923.0,-1.58,-0.03,High Risk
U536,2024,7,96862.0,Stable Salary & Increasing Fixed Expenses,121716,61421.0,68213,129634.0,-7918.0,-6.51,0.04,High Risk
U536,2024,8,88944.0,Stable Salary & Increasing Fixed Expenses,121716,61421.0,71613,133034.0,-11318.0,-9.3,-0.02,High Risk
U536,2024,9,77626.0,Stable Salary & Increasing Fixed Expenses,121716,61421.0,91632,153053.0,-31337.0,-25.75,-0.0,High Risk
U536,2024,10,46289.0,Stable Salary & Increasing Fixed Expenses,121716,61924.0,63073,124997.0,-3281.0,-2.7,-0.02,High Risk
U536,2024,11,43008.0,Stable Salary & Increasing Fixed Expenses,121716,61924.0,80553,142477.0,-20761.0,-17.06,-0.02,High Risk
U536,2024,12,22247.0,Stable Salary & Increasing Fixed Expenses,121716,61924.0,75287,137211.0,-15495.0,-12.73,-0.03,High Risk
U537,2024,1,216573.0,Stable Salary & Increasing Fixed Expenses,188178,42655.0,79906,122561.0,65617.0,34.87,-0.02,Low Risk
U537,2024,2,282190.0,Stable Salary & Increasing Fixed Expenses,188178,42655.0,68822,111477.0,76701.0,40.76,-0.01,Low Risk
U537,2024,3,358891.0,Stable Salary & Increasing Fixed Expenses,188178,42655.0,78987,121642.0,66536.0,35.36,0.02,Low Risk
U537,2024,4,425427.0,Stable Salary & Increasing Fixed Expenses,188178,42655.0,94013,136668.0,51510.0,27.37,-0.03,Low Risk
U537,2024,5,476937.0,Stable Salary & Increasing Fixed Expenses,188178,42655.0,64921,107576.0,80602.0,42.83,0.02,Low Risk
U537,2024,6,557539.0,Stable Salary & Increasing Fixed Expenses,188178,42655.0,86965,129620.0,58558.0,31.12,0.01,Low Risk
U537,2024,7,616097.0,Stable Salary & Increasing Fixed Expenses,188178,42655.0,75953,118608.0,69570.0,36.97,0.04,Low Risk
U537,2024,8,685667.0,Stable Salary & Increasing Fixed Expenses,188178,42655.0,63210,105865.0,82313.0,43.74,0.02,Low Risk
U537,2024,9,767980.0,Stable Salary & Increasing Fixed Expenses,188178,42655.0,69459,112114.0,76064.0,40.42,-0.02,Low Risk
U537,2024,10,844044.0,Stable Salary & Increasing Fixed Expenses,188178,44634.0,73841,118475.0,69703.0,37.04,0.04,Low Risk
U537,2024,11,913747.0,Stable Salary & Increasing Fixed Expenses,188178,46455.0,86283,132738.0,55440.0,29.46,-0.05,Low Risk
U537,2024,12,969187.0,Stable Salary & Increasing Fixed Expenses,188178,47056.0,91943,138999.0,49179.0,26.13,-0.0,Low Risk
U538,2024,1,83255.0,Salary Increases & Fixed Expenses Increase,68169,30113.0,17765,47878.0,20291.0,29.77,-0.03,Low Risk
U538,2024,2,103546.0,Salary Increases & Fixed Expenses Increase,68169,30113.0,19688,49801.0,18368.0,26.94,-0.03,Low Risk
U538,2024,3,121914.0,Salary Increases & Fixed Expenses Increase,80575,30113.0,23344,53457.0,27118.0,33.66,0.02,Low Risk
U538,2024,4,149032.0,Salary Increases & Fixed Expenses Increase,80575,30113.0,19822,49935.0,30640.0,38.03,0.02,Low Risk
U538,2024,5,179672.0,Salary Increases & Fixed Expenses Increase,80575,30113.0,22080,52193.0,28382.0,35.22,0.03,Low Risk
U538,2024,6,208054.0,Salary Increases & Fixed Expenses Increase,80575,30113.0,22762,52875.0,27700.0,34.38,-0.02,Low Risk
U538,2024,7,235754.0,Salary Increases & Fixed Expenses Increase,80575,30113.0,19288,49401.0,31174.0,38.69,-0.01,Low Risk
U538,2024,8,266928.0,Salary Increases & Fixed Expenses Increase,80575,30113.0,20060,50173.0,30402.0,37.73,-0.04,Low Risk
U538,2024,9,297330.0,Salary Increases & Fixed Expenses Increase,80575,30113.0,23964,54077.0,26498.0,32.89,-0.04,Low Risk
U538,2024,10,323828.0,Salary Increases & Fixed Expenses Increase,80575,30113.0,18232,48345.0,32230.0,40.0,-0.03,Low Risk
U538,2024,11,356058.0,Salary Increases & Fixed Expenses Increase,80575,30113.0,19633,49746.0,30829.0,38.26,-0.04,Low Risk
U538,2024,12,386887.0,Salary Increases & Fixed Expenses Increase,80575,31955.0,20488,52443.0,28132.0,34.91,0.05,Low Risk
U539,2024,1,250000.0,Stable Salary & Stable Fixed Expenses,269195,65901.0,123712,189613.0,79582.0,29.56,0.02,Low Risk
U539,2024,2,329582.0,Stable Salary & Stable Fixed Expenses,269195,65901.0,116202,182103.0,87092.0,32.35,-0.01,Low Risk
U539,2024,3,416674.0,Stable Salary & Stable Fixed Expenses,269195,65901.0,102491,168392.0,100803.0,37.45,-0.05,Low Risk
U539,2024,4,517477.0,Stable Salary & Stable Fixed Expenses,269195,65901.0,90985,156886.0,112309.0,41.72,0.01,Low Risk
U539,2024,5,629786.0,Stable Salary & Stable Fixed Expenses,269195,65901.0,108549,174450.0,94745.0,35.2,-0.02,Low Risk
U539,2024,6,724531.0,Stable Salary & Stable Fixed Expenses,269195,65901.0,121411,187312.0,81883.0,30.42,0.04,Low Risk
U539,2024,7,806414.0,Stable Salary & Stable Fixed Expenses,269195,65901.0,90047,155948.0,113247.0,42.07,-0.04,Low Risk
U539,2024,8,919661.0,Stable Salary & Stable Fixed Expenses,269195,65901.0,82505,148406.0,120789.0,44.87,0.0,Low Risk
U539,2024,9,1040450.0,Stable Salary & Stable Fixed Expenses,269195,65901.0,112814,178715.0,90480.0,33.61,-0.01,Low Risk
U539,2024,10,1130930.0,Stable Salary & Stable Fixed Expenses,269195,65901.0,119867,185768.0,83427.0,30.99,0.01,Low Risk
U539,2024,11,1214357.0,Stable Salary & Stable Fixed Expenses,269195,65901.0,94018,159919.0,109276.0,40.59,-0.03,Low Risk
U539,2024,12,1323633.0,Stable Salary & Stable Fixed Expenses,269195,65901.0,117391,183292.0,85903.0,31.91,0.04,Low Risk
U540,2024,1,173855.0,Salary Increases & Fixed Expenses Remain Stable,28676,22332.0,6484,28816.0,-140.0,-0.49,0.04,High Risk
U540,2024,2,173715.0,Salary Increases & Fixed Expenses Remain Stable,28676,22332.0,6483,28815.0,-139.0,-0.48,0.01,High Risk
U540,2024,3,173576.0,Salary Increases & Fixed Expenses Remain Stable,28676,22332.0,8014,30346.0,-1670.0,-5.82,0.01,High Risk
U540,2024,4,171906.0,Salary Increases & Fixed Expenses Remain Stable,43829,22332.0,11552,33884.0,9945.0,22.69,0.01,Medium Risk
U540,2024,5,181851.0,Salary Increases & Fixed Expenses Remain Stable,43829,22332.0,11117,33449.0,10380.0,23.68,0.02,Medium Risk
U540,2024,6,192231.0,Salary Increases & Fixed Expenses Remain Stable,43829,22332.0,12502,34834.0,8995.0,20.52,-0.04,Medium Risk
U540,2024,7,201226.0,Salary Increases & Fixed Expenses Remain Stable,43829,22332.0,8932,31264.0,12565.0,28.67,-0.0,Low Risk
U540,2024,8,213791.0,Salary Increases & Fixed Expenses Remain Stable,43829,22332.0,8839,31171.0,12658.0,28.88,-0.0,Low Risk
U540,2024,9,226449.0,Salary Increases & Fixed Expenses Remain Stable,43829,22332.0,11033,33365.0,10464.0,23.87,0.01,Medium Risk
U540,2024,10,236913.0,Salary Increases & Fixed Expenses Remain Stable,43829,22332.0,9984,32316.0,11513.0,26.27,-0.04,Low Risk
U540,2024,11,248426.0,Salary Increases & Fixed Expenses Remain Stable,43829,22332.0,12598,34930.0,8899.0,20.3,-0.01,Medium Risk
U540,2024,12,257325.0,Salary Increases & Fixed Expenses Remain Stable,43829,22332.0,12934,35266.0,8563.0,19.54,0.04,Medium Risk
U541,2024,1,158338.0,Stable Salary & Increasing Fixed Expenses,145510,63689.0,100156,163845.0,-18335.0,-12.6,0.04,High Risk
U541,2024,2,140003.0,Stable Salary & Increasing Fixed Expenses,145510,65114.0,78573,143687.0,1823.0,1.25,-0.03,High Risk
U541,2024,3,141826.0,Stable Salary & Increasing Fixed Expenses,145510,65114.0,109190,174304.0,-28794.0,-19.79,0.03,High Risk
U541,2024,4,113032.0,Stable Salary & Increasing Fixed Expenses,145510,65114.0,86132,151246.0,-5736.0,-3.94,0.05,High Risk
U541,2024,5,107296.0,Stable Salary & Increasing Fixed Expenses,145510,65114.0,83761,148875.0,-3365.0,-2.31,0.02,High Risk
U541,2024,6,103931.0,Stable Salary & Increasing Fixed Expenses,145510,65641.0,84855,150496.0,-4986.0,-3.43,0.05,High Risk
U541,2024,7,98945.0,Stable Salary & Increasing Fixed Expenses,145510,66386.0,87225,153611.0,-8101.0,-5.57,0.04,High Risk
U541,2024,8,90844.0,Stable Salary & Increasing Fixed Expenses,145510,66386.0,96956,163342.0,-17832.0,-12.25,-0.04,High Risk
U541,2024,9,73012.0,Stable Salary & Increasing Fixed Expenses,145510,66386.0,92051,158437.0,-12927.0,-8.88,-0.01,High Risk
U541,2024,10,60085.0,Stable Salary & Increasing Fixed Expenses,145510,66386.0,103886,170272.0,-24762.0,-17.02,-0.02,High Risk
U541,2024,11,35323.0,Stable Salary & Increasing Fixed Expenses,145510,66386.0,96781,163167.0,-17657.0,-12.13,-0.04,High Risk
U541,2024,12,17666.0,Stable Salary & Increasing Fixed Expenses,145510,67734.0,113201,180935.0,-35425.0,-24.35,0.02,High Risk
U542,2024,1,204291.0,Stable Salary & Stable Fixed Expenses,142830,50337.0,46323,96660.0,46170.0,32.33,-0.01,Low Risk
U542,2024,2,250461.0,Stable Salary & Stable Fixed Expenses,142830,50337.0,67723,118060.0,24770.0,17.34,0.04,Medium Risk
U542,2024,3,275231.0,Stable Salary & Stable Fixed Expenses,142830,50337.0,48001,98338.0,44492.0,31.15,-0.03,Low Risk
U542,2024,4,319723.0,Stable Salary & Stable Fixed Expenses,142830,50337.0,43627,93964.0,48866.0,34.21,-0.02,Low Risk
U542,2024,5,368589.0,Stable Salary & Stable Fixed Expenses,142830,50337.0,43705,94042.0,48788.0,34.16,-0.01,Low Risk
U542,2024,6,417377.0,Stable Salary & Stable Fixed Expenses,142830,50337.0,62428,112765.0,30065.0,21.05,-0.02,Medium Risk
U542,2024,7,447442.0,Stable Salary & Stable Fixed Expenses,142830,50337.0,54600,104937.0,37893.0,26.53,0.05,Low Risk
U542,2024,8,485335.0,Stable Salary & Stable Fixed Expenses,142830,50337.0,46956,97293.0,45537.0,31.88,0.05,Low Risk
U542,2024,9,530872.0,Stable Salary & Stable Fixed Expenses,142830,50337.0,68231,118568.0,24262.0,16.99,-0.05,Medium Risk
U542,2024,10,555134.0,Stable Salary & Stable Fixed Expenses,142830,50337.0,63565,113902.0,28928.0,20.25,0.0,Medium Risk
U542,2024,11,584062.0,Stable Salary & Stable Fixed Expenses,142830,50337.0,69178,119515.0,23315.0,16.32,0.01,Medium Risk
U542,2024,12,607377.0,Stable Salary & Stable Fixed Expenses,142830,50337.0,43138,93475.0,49355.0,34.56,0.03,Low Risk
U543,2024,1,228918.0,Salary Increases & Fixed Expenses Increase,143815,52718.0,80333,133051.0,10764.0,7.48,-0.03,High Risk
U543,2024,2,239682.0,Salary Increases & Fixed Expenses Increase,143815,52718.0,91744,144462.0,-647.0,-0.45,0.0,High Risk
U543,2024,3,239035.0,Salary Increases & Fixed Expenses Increase,143815,52718.0,87547,140265.0,3550.0,2.47,-0.03,High Risk
U543,2024,4,242585.0,Salary Increases & Fixed Expenses Increase,143815,53505.0,84471,137976.0,5839.0,4.06,-0.04,High Risk
U543,2024,5,248424.0,Salary Increases & Fixed Expenses Increase,143815,53505.0,95322,148827.0,-5012.0,-3.49,0.01,High Risk
U543,2024,6,243412.0,Salary Increases & Fixed Expenses Increase,143815,53505.0,76305,129810.0,14005.0,9.74,0.04,High Risk
U543,2024,7,257417.0,Salary Increases & Fixed Expenses Increase,172185,53505.0,118850,172355.0,-170.0,-0.1,0.04,High Risk
U543,2024,8,257247.0,Salary Increases & Fixed Expenses Increase,172185,54822.0,99400,154222.0,17963.0,10.43,0.05,High Risk
U543,2024,9,275210.0,Salary Increases & Fixed Expenses Increase,172185,54822.0,92283,147105.0,25080.0,14.57,-0.01,High Risk
U543,2024,10,300290.0,Salary Increases & Fixed Expenses Increase,172185,54822.0,96583,151405.0,20780.0,12.07,0.01,High Risk
U543,2024,11,321070.0,Salary Increases & Fixed Expenses Increase,172185,54822.0,93148,147970.0,24215.0,14.06,-0.03,High Risk
U543,2024,12,345285.0,Salary Increases & Fixed Expenses Increase,172185,54822.0,103000,157822.0,14363.0,8.34,-0.02,High Risk
U544,2024,1,202278.0,Salary Increases & Fixed Expenses Remain Stable,86884,39988.0,20624,60612.0,26272.0,30.24,-0.05,Low Risk
U544,2024,2,228550.0,Salary Increases & Fixed Expenses Remain Stable,86884,39988.0,19532,59520.0,27364.0,31.49,0.05,Low Risk
U544,2024,3,255914.0,Salary Increases & Fixed Expenses Remain Stable,86884,39988.0,21573,61561.0,25323.0,29.15,0.03,Low Risk
U544,2024,4,281237.0,Salary Increases & Fixed Expenses Remain Stable,106684,39988.0,22342,62330.0,44354.0,41.58,-0.03,Low Risk
U544,2024,5,325591.0,Salary Increases & Fixed Expenses Remain Stable,106684,39988.0,23739,63727.0,42957.0,40.27,-0.03,Low Risk
U544,2024,6,368548.0,Salary Increases & Fixed Expenses Remain Stable,106684,39988.0,25447,65435.0,41249.0,38.66,0.0,Low Risk
U544,2024,7,409797.0,Salary Increases & Fixed Expenses Remain Stable,106684,39988.0,26118,66106.0,40578.0,38.04,-0.0,Low Risk
U544,2024,8,450375.0,Salary Increases & Fixed Expenses Remain Stable,106684,39988.0,31823,71811.0,34873.0,32.69,-0.03,Low Risk
U544,2024,9,485248.0,Salary Increases & Fixed Expenses Remain Stable,106684,39988.0,31582,71570.0,35114.0,32.91,0.01,Low Risk
U544,2024,10,520362.0,Salary Increases & Fixed Expenses Remain Stable,106684,39988.0,24720,64708.0,41976.0,39.35,-0.05,Low Risk
U544,2024,11,562338.0,Salary Increases & Fixed Expenses Remain Stable,106684,39988.0,25583,65571.0,41113.0,38.54,-0.03,Low Risk
U544,2024,12,603451.0,Salary Increases & Fixed Expenses Remain Stable,106684,39988.0,28743,68731.0,37953.0,35.58,0.03,Low Risk
U545,2024,1,250000.0,Salary Increases & Fixed Expenses Increase,262346,88795.0,100504,189299.0,73047.0,27.84,-0.02,Low Risk
U545,2024,2,323047.0,Salary Increases & Fixed Expenses Increase,262346,88795.0,90779,179574.0,82772.0,31.55,0.03,Low Risk
U545,2024,3,405819.0,Salary Increases & Fixed Expenses Increase,262346,88795.0,127179,215974.0,46372.0,17.68,0.04,Medium Risk
U545,2024,4,452191.0,Salary Increases & Fixed Expenses Increase,262346,88795.0,95619,184414.0,77932.0,29.71,-0.04,Low Risk
U545,2024,5,530123.0,Salary Increases & Fixed Expenses Increase,262346,88795.0,117777,206572.0,55774.0,21.26,0.03,Medium Risk
U545,2024,6,585897.0,Salary Increases & Fixed Expenses Increase,262346,88795.0,86735,175530.0,86816.0,33.09,-0.03,Low Risk
U545,2024,7,672713.0,Salary Increases & Fixed Expenses Increase,262346,88795.0,86235,175030.0,87316.0,33.28,-0.02,Low Risk
U545,2024,8,760029.0,Salary Increases & Fixed Expenses Increase,271495,88795.0,92906,181701.0,89794.0,33.07,0.03,Low Risk
U545,2024,9,849823.0,Salary Increases & Fixed Expenses Increase,271495,90164.0,96178,186342.0,85153.0,31.36,0.01,Low Risk
U545,2024,10,934976.0,Salary Increases & Fixed Expenses Increase,271495,90164.0,133889,224053.0,47442.0,17.47,-0.01,Medium Risk
U545,2024,11,982418.0,Salary Increases & Fixed Expenses Increase,271495,90164.0,120512,210676.0,60819.0,22.4,0.05,Medium Risk
U545,2024,12,1043237.0,Salary Increases & Fixed Expenses Increase,271495,90164.0,127593,217757.0,53738.0,19.79,-0.03,Medium Risk
U546,2024,1,72008.0,Salary Increases & Fixed Expenses Increase,32443,11005.0,15787,26792.0,5651.0,17.42,-0.05,Medium Risk
U546,2024,2,77659.0,Salary Increases & Fixed Expenses Increase,32443,11715.0,14014,25729.0,6714.0,20.69,0.04,Medium Risk
U546,2024,3,84373.0,Salary Increases & Fixed Expenses Increase,32443,11715.0,13421,25136.0,7307.0,22.52,0.02,Medium Risk
U546,2024,4,91680.0,Salary Increases & Fixed Expenses Increase,32443,11715.0,11931,23646.0,8797.0,27.12,0.02,Low Risk
U546,2024,5,100477.0,Salary Increases & Fixed Expenses Increase,32443,11715.0,15862,27577.0,4866.0,15.0,0.01,High Risk
U546,2024,6,105343.0,Salary Increases & Fixed Expenses Increase,32443,11715.0,15873,27588.0,4855.0,14.96,0.03,High Risk
U546,2024,7,110198.0,Salary Increases & Fixed Expenses Increase,51634,11715.0,20613,32328.0,19306.0,37.39,0.05,Low Risk
U546,2024,8,129504.0,Salary Increases & Fixed Expenses Increase,51634,11715.0,23602,35317.0,16317.0,31.6,0.0,Low Risk
U546,2024,9,145821.0,Salary Increases & Fixed Expenses Increase,51634,11715.0,21523,33238.0,18396.0,35.63,-0.02,Low Risk
U546,2024,10,164217.0,Salary Increases & Fixed Expenses Increase,51634,11715.0,23710,35425.0,16209.0,31.39,0.01,Low Risk
U546,2024,11,180426.0,Salary Increases & Fixed Expenses Increase,51634,11715.0,27545,39260.0,12374.0,23.96,-0.05,Medium Risk
U546,2024,12,192800.0,Salary Increases & Fixed Expenses Increase,51634,13504.0,24306,37810.0,13824.0,26.77,0.03,Low Risk
U547,2024,1,250000.0,Salary Increases & Fixed Expenses Increase,286871,85596.0,73610,159206.0,127665.0,44.5,0.02,Low Risk
U547,2024,2,377665.0,Salary Increases & Fixed Expenses Increase,286871,85596.0,76976,162572.0,124299.0,43.33,0.02,Low Risk
U547,2024,3,501964.0,Salary Increases & Fixed Expenses Increase,286871,86955.0,82092,169047.0,117824.0,41.07,-0.05,Low Risk
U547,2024,4,619788.0,Salary Increases & Fixed Expenses Increase,314738,86955.0,85150,172105.0,142633.0,45.32,-0.03,Low Risk
U547,2024,5,762421.0,Salary Increases & Fixed Expenses Increase,314738,86955.0,88789,175744.0,138994.0,44.16,0.02,Low Risk
U547,2024,6,901415.0,Salary Increases & Fixed Expenses Increase,314738,87874.0,67053,154927.0,159811.0,50.78,-0.01,Low Risk
U547,2024,7,1061226.0,Salary Increases & Fixed Expenses Increase,314738,87874.0,67187,155061.0,159677.0,50.73,-0.01,Low Risk
U547,2024,8,1220903.0,Salary Increases & Fixed Expenses Increase,314738,87874.0,70119,157993.0,156745.0,49.8,-0.01,Low Risk
U547,2024,9,1377648.0,Salary Increases & Fixed Expenses Increase,314738,87874.0,97726,185600.0,129138.0,41.03,-0.04,Low Risk
U547,2024,10,1506786.0,Salary Increases & Fixed Expenses Increase,314738,87874.0,92659,180533.0,134205.0,42.64,-0.01,Low Risk
U547,2024,11,1640991.0,Salary Increases & Fixed Expenses Increase,314738,87874.0,96644,184518.0,130220.0,41.37,0.03,Low Risk
U547,2024,12,1771211.0,Salary Increases & Fixed Expenses Increase,314738,89475.0,105669,195144.0,119594.0,38.0,-0.01,Low Risk
U548,2024,1,250000.0,Salary Increases & Fixed Expenses Increase,277645,108915.0,94386,203301.0,74344.0,26.78,0.05,Low Risk
U548,2024,2,324344.0,Salary Increases & Fixed Expenses Increase,277645,108915.0,113528,222443.0,55202.0,19.88,0.01,Medium Risk
U548,2024,3,379546.0,Salary Increases & Fixed Expenses Increase,277645,108915.0,110540,219455.0,58190.0,20.96,-0.0,Medium Risk
U548,2024,4,437736.0,Salary Increases & Fixed Expenses Increase,277645,108915.0,101121,210036.0,67609.0,24.35,0.0,Medium Risk
U548,2024,5,505345.0,Salary Increases & Fixed Expenses Increase,291629,108915.0,96131,205046.0,86583.0,29.69,-0.04,Low Risk
U548,2024,6,591928.0,Salary Increases & Fixed Expenses Increase,291629,108915.0,106992,215907.0,75722.0,25.97,0.02,Low Risk
U548,2024,7,667650.0,Salary Increases & Fixed Expenses Increase,291629,108915.0,95393,204308.0,87321.0,29.94,0.05,Low Risk
U548,2024,8,754971.0,Salary Increases & Fixed Expenses Increase,291629,108915.0,120389,229304.0,62325.0,21.37,-0.04,Medium Risk
U548,2024,9,817296.0,Salary Increases & Fixed Expenses Increase,291629,108915.0,130760,239675.0,51954.0,17.82,-0.01,Medium Risk
U548,2024,10,869250.0,Salary Increases & Fixed Expenses Increase,291629,108915.0,144340,253255.0,38374.0,13.16,0.01,High Risk
U548,2024,11,907624.0,Salary Increases & Fixed Expenses Increase,291629,110545.0,123625,234170.0,57459.0,19.7,0.03,Medium Risk
U548,2024,12,965083.0,Salary Increases & Fixed Expenses Increase,291629,110545.0,98956,209501.0,82128.0,28.16,-0.03,Low Risk
U549,2024,1,214391.0,Salary Increases & Fixed Expenses Increase,88016,27044.0,27951,54995.0,33021.0,37.52,-0.04,Low Risk
U549,2024,2,247412.0,Salary Increases & Fixed Expenses Increase,88016,27044.0,40502,67546.0,20470.0,23.26,0.03,Medium Risk
U549,2024,3,267882.0,Salary Increases & Fixed Expenses Increase,88016,27044.0,41433,68477.0,19539.0,22.2,0.01,Medium Risk
U549,2024,4,287421.0,Salary Increases & Fixed Expenses Increase,108172,27044.0,51951,78995.0,29177.0,26.97,0.05,Low Risk
U549,2024,5,316598.0,Salary Increases & Fixed Expenses Increase,108172,27044.0,47104,74148.0,34024.0,31.45,0.01,Low Risk
U549,2024,6,350622.0,Salary Increases & Fixed Expenses Increase,108172,27044.0,51305,78349.0,29823.0,27.57,-0.04,Low Risk
U549,2024,7,380445.0,Salary Increases & Fixed Expenses Increase,108172,27044.0,41883,68927.0,39245.0,36.28,-0.01,Low Risk
U549,2024,8,419690.0,Salary Increases & Fixed Expenses Increase,108172,28002.0,51150,79152.0,29020.0,26.83,-0.05,Low Risk
U549,2024,9,448710.0,Salary Increases & Fixed Expenses Increase,108172,29573.0,46568,76141.0,32031.0,29.61,0.01,Low Risk
U549,2024,10,480741.0,Salary Increases & Fixed Expenses Increase,108172,29573.0,39571,69144.0,39028.0,36.08,0.01,Low Risk
U549,2024,11,519769.0,Salary Increases & Fixed Expenses Increase,108172,29573.0,39693,69266.0,38906.0,35.97,-0.0,Low Risk
U549,2024,12,558675.0,Salary Increases & Fixed Expenses Increase,108172,30387.0,49408,79795.0,28377.0,26.23,0.04,Low Risk
U550,2024,1,235623.0,Stable Salary & Stable Fixed Expenses,206399,85591.0,68682,154273.0,52126.0,25.25,0.0,Low Risk
U550,2024,2,287749.0,Stable Salary & Stable Fixed Expenses,206399,85591.0,79314,164905.0,41494.0,20.1,-0.01,Medium Risk
U550,2024,3,329243.0,Stable Salary & Stable Fixed Expenses,206399,85591.0,117305,202896.0,3503.0,1.7,-0.01,High Risk
U550,2024,4,332746.0,Stable Salary & Stable Fixed Expenses,206399,85591.0,65882,151473.0,54926.0,26.61,-0.0,Low Risk
U550,2024,5,387672.0,Stable Salary & Stable Fixed Expenses,206399,85591.0,95937,181528.0,24871.0,12.05,0.05,High Risk
U550,2024,6,412543.0,Stable Salary & Stable Fixed Expenses,206399,85591.0,76148,161739.0,44660.0,21.64,-0.03,Medium Risk
U550,2024,7,457203.0,Stable Salary & Stable Fixed Expenses,206399,85591.0,86136,171727.0,34672.0,16.8,0.04,Medium Risk
U550,2024,8,491875.0,Stable Salary & Stable Fixed Expenses,206399,85591.0,101801,187392.0,19007.0,9.21,-0.01,High Risk
U550,2024,9,510882.0,Stable Salary & Stable Fixed Expenses,206399,85591.0,92964,178555.0,27844.0,13.49,0.02,High Risk
U550,2024,10,538726.0,Stable Salary & Stable Fixed Expenses,206399,85591.0,81576,167167.0,39232.0,19.01,-0.04,Medium Risk
U550,2024,11,577958.0,Stable Salary & Stable Fixed Expenses,206399,85591.0,108265,193856.0,12543.0,6.08,-0.04,High Risk
U550,2024,12,590501.0,Stable Salary & Stable Fixed Expenses,206399,85591.0,98591,184182.0,22217.0,10.76,-0.03,High Risk
U551,2024,1,215842.0,Stable Salary & Stable Fixed Expenses,193550,79191.0,54432,133623.0,59927.0,30.96,0.05,Low Risk
U551,2024,2,275769.0,Stable Salary & Stable Fixed Expenses,193550,79191.0,47064,126255.0,67295.0,34.77,-0.02,Low Risk
U551,2024,3,343064.0,Stable Salary & Stable Fixed Expenses,193550,79191.0,55880,135071.0,58479.0,30.21,-0.01,Low Risk
U551,2024,4,401543.0,Stable Salary & Stable Fixed Expenses,193550,79191.0,53365,132556.0,60994.0,31.51,-0.05,Low Risk
U551,2024,5,462537.0,Stable Salary & Stable Fixed Expenses,193550,79191.0,48846,128037.0,65513.0,33.85,-0.05,Low Risk
U551,2024,6,528050.0,Stable Salary & Stable Fixed Expenses,193550,79191.0,48761,127952.0,65598.0,33.89,-0.02,Low Risk
U551,2024,7,593648.0,Stable Salary & Stable Fixed Expenses,193550,79191.0,40790,119981.0,73569.0,38.01,0.03,Low Risk
U551,2024,8,667217.0,Stable Salary & Stable Fixed Expenses,193550,79191.0,39536,118727.0,74823.0,38.66,-0.02,Low Risk
U551,2024,9,742040.0,Stable Salary & Stable Fixed Expenses,193550,79191.0,54376,133567.0,59983.0,30.99,0.03,Low Risk
U551,2024,10,802023.0,Stable Salary & Stable Fixed Expenses,193550,79191.0,57296,136487.0,57063.0,29.48,-0.04,Low Risk
U551,2024,11,859086.0,Stable Salary & Stable Fixed Expenses,193550,79191.0,44505,123696.0,69854.0,36.09,-0.0,Low Risk
U551,2024,12,928940.0,Stable Salary & Stable Fixed Expenses,193550,79191.0,43902,123093.0,70457.0,36.4,-0.01,Low Risk
U552,2024,1,226576.0,Salary Increases & Fixed Expenses Remain Stable,141507,72543.0,94802,167345.0,-25838.0,-18.26,-0.01,High Risk
U552,2024,2,200738.0,Salary Increases & Fixed Expenses Remain Stable,141507,72543.0,72807,145350.0,-3843.0,-2.72,0.01,High Risk
U552,2024,3,196895.0,Salary Increases & Fixed Expenses Remain Stable,141507,72543.0,81720,154263.0,-12756.0,-9.01,0.01,High Risk
U552,2024,4,184139.0,Salary Increases & Fixed Expenses Remain Stable,141507,72543.0,79644,152187.0,-10680.0,-7.55,-0.02,High Risk
U552,2024,5,173459.0,Salary Increases & Fixed Expenses Remain Stable,141507,72543.0,76882,149425.0,-7918.0,-5.6,0.0,High Risk
U552,2024,6,165541.0,Salary Increases & Fixed Expenses Remain Stable,141507,72543.0,77175,149718.0,-8211.0,-5.8,-0.03,High Risk
U552,2024,7,157330.0,Salary Increases & Fixed Expenses Remain Stable,141507,72543.0,85462,158005.0,-16498.0,-11.66,0.05,High Risk
U552,2024,8,140832.0,Salary Increases & Fixed Expenses Remain Stable,171090,72543.0,89829,162372.0,8718.0,5.1,0.01,High Risk
U552,2024,9,149550.0,Salary Increases & Fixed Expenses Remain Stable,171090,72543.0,97334,169877.0,1213.0,0.71,-0.01,High Risk
U552,2024,10,150763.0,Salary Increases & Fixed Expenses Remain Stable,171090,72543.0,117510,190053.0,-18963.0,-11.08,-0.02,High Risk
U552,2024,11,131800.0,Salary Increases & Fixed Expenses Remain Stable,171090,72543.0,87614,160157.0,10933.0,6.39,0.03,High Risk
U552,2024,12,142733.0,Salary Increases & Fixed Expenses Remain Stable,171090,72543.0,110845,183388.0,-12298.0,-7.19,0.01,High Risk
U553,2024,1,116437.0,Stable Salary & Stable Fixed Expenses,43747,14235.0,20769,35004.0,8743.0,19.99,-0.03,Medium Risk
U553,2024,2,125180.0,Stable Salary & Stable Fixed Expenses,43747,14235.0,17841,32076.0,11671.0,26.68,0.02,Low Risk
U553,2024,3,136851.0,Stable Salary & Stable Fixed Expenses,43747,14235.0,19848,34083.0,9664.0,22.09,-0.02,Medium Risk
U553,2024,4,146515.0,Stable Salary & Stable Fixed Expenses,43747,14235.0,16947,31182.0,12565.0,28.72,0.01,Low Risk
U553,2024,5,159080.0,Stable Salary & Stable Fixed Expenses,43747,14235.0,14307,28542.0,15205.0,34.76,0.0,Low Risk
U553,2024,6,174285.0,Stable Salary & Stable Fixed Expenses,43747,14235.0,20522,34757.0,8990.0,20.55,-0.01,Medium Risk
U553,2024,7,183275.0,Stable Salary & Stable Fixed Expenses,43747,14235.0,16542,30777.0,12970.0,29.65,0.01,Low Risk
U553,2024,8,196245.0,Stable Salary & Stable Fixed Expenses,43747,14235.0,13443,27678.0,16069.0,36.73,0.04,Low Risk
U553,2024,9,212314.0,Stable Salary & Stable Fixed Expenses,43747,14235.0,17336,31571.0,12176.0,27.83,0.01,Low Risk
U553,2024,10,224490.0,Stable Salary & Stable Fixed Expenses,43747,14235.0,20741,34976.0,8771.0,20.05,0.02,Medium Risk
U553,2024,11,233261.0,Stable Salary & Stable Fixed Expenses,43747,14235.0,13492,27727.0,16020.0,36.62,0.03,Low Risk
U553,2024,12,249281.0,Stable Salary & Stable Fixed Expenses,43747,14235.0,19564,33799.0,9948.0,22.74,-0.04,Medium Risk
U554,2024,1,246884.0,Stable Salary & Stable Fixed Expenses,179139,40372.0,43932,84304.0,94835.0,52.94,0.01,Low Risk
U554,2024,2,341719.0,Stable Salary & Stable Fixed Expenses,179139,40372.0,40799,81171.0,97968.0,54.69,0.05,Low Risk
U554,2024,3,439687.0,Stable Salary & Stable Fixed Expenses,179139,40372.0,48359,88731.0,90408.0,50.47,0.03,Low Risk
U554,2024,4,530095.0,Stable Salary & Stable Fixed Expenses,179139,40372.0,38668,79040.0,100099.0,55.88,0.01,Low Risk
U554,2024,5,630194.0,Stable Salary & Stable Fixed Expenses,179139,40372.0,37806,78178.0,100961.0,56.36,0.0,Low Risk
U554,2024,6,731155.0,Stable Salary & Stable Fixed Expenses,179139,40372.0,37960,78332.0,100807.0,56.27,0.04,Low Risk
U554,2024,7,831962.0,Stable Salary & Stable Fixed Expenses,179139,40372.0,40998,81370.0,97769.0,54.58,0.04,Low Risk
U554,2024,8,929731.0,Stable Salary & Stable Fixed Expenses,179139,40372.0,51865,92237.0,86902.0,48.51,0.03,Low Risk
U554,2024,9,1016633.0,Stable Salary & Stable Fixed Expenses,179139,40372.0,45193,85565.0,93574.0,52.24,0.04,Low Risk
U554,2024,10,1110207.0,Stable Salary & Stable Fixed Expenses,179139,40372.0,45371,85743.0,93396.0,52.14,0.01,Low Risk
U554,2024,11,1203603.0,Stable Salary & Stable Fixed Expenses,179139,40372.0,52462,92834.0,86305.0,48.18,-0.04,Low Risk
U554,2024,12,1289908.0,Stable Salary & Stable Fixed Expenses,179139,40372.0,52711,93083.0,86056.0,48.04,-0.01,Low Risk
U555,2024,1,250000.0,Salary Increases & Fixed Expenses Remain Stable,258139,114610.0,57276,171886.0,86253.0,33.41,-0.01,Low Risk
U555,2024,2,336253.0,Salary Increases & Fixed Expenses Remain Stable,258139,114610.0,67709,182319.0,75820.0,29.37,0.02,Low Risk
U555,2024,3,412073.0,Salary Increases & Fixed Expenses Remain Stable,258139,114610.0,72336,186946.0,71193.0,27.58,0.04,Low Risk
U555,2024,4,483266.0,Salary Increases & Fixed Expenses Remain Stable,258139,114610.0,74300,188910.0,69229.0,26.82,0.0,Low Risk
U555,2024,5,552495.0,Salary Increases & Fixed Expenses Remain Stable,258139,114610.0,63817,178427.0,79712.0,30.88,-0.03,Low Risk
U555,2024,6,632207.0,Salary Increases & Fixed Expenses Remain Stable,272553,114610.0,68796,183406.0,89147.0,32.71,0.01,Low Risk
U555,2024,7,721354.0,Salary Increases & Fixed Expenses Remain Stable,272553,114610.0,66135,180745.0,91808.0,33.68,0.02,Low Risk
U555,2024,8,813162.0,Salary Increases & Fixed Expenses Remain Stable,272553,114610.0,60877,175487.0,97066.0,35.61,0.0,Low Risk
U555,2024,9,910228.0,Salary Increases & Fixed Expenses Remain Stable,272553,114610.0,69294,183904.0,88649.0,32.53,-0.05,Low Risk
U555,2024,10,998877.0,Salary Increases & Fixed Expenses Remain Stable,272553,114610.0,95123,209733.0,62820.0,23.05,-0.03,Medium Risk
U555,2024,11,1061697.0,Salary Increases & Fixed Expenses Remain Stable,272553,114610.0,77624,192234.0,80319.0,29.47,0.01,Low Risk
U555,2024,12,1142016.0,Salary Increases & Fixed Expenses Remain Stable,272553,114610.0,82068,196678.0,75875.0,27.84,0.02,Low Risk
U556,2024,1,157789.0,Stable Salary & Stable Fixed Expenses,140120,60947.0,69761,130708.0,9412.0,6.72,0.05,High Risk
U556,2024,2,167201.0,Stable Salary & Stable Fixed Expenses,140120,60947.0,44701,105648.0,34472.0,24.6,-0.01,Medium Risk
U556,2024,3,201673.0,Stable Salary & Stable Fixed Expenses,140120,60947.0,50913,111860.0,28260.0,20.17,0.05,Medium Risk
U556,2024,4,229933.0,Stable Salary & Stable Fixed Expenses,140120,60947.0,63664,124611.0,15509.0,11.07,-0.01,High Risk
U556,2024,5,245442.0,Stable Salary & Stable Fixed Expenses,140120,60947.0,61094,122041.0,18079.0,12.9,0.02,High Risk
U556,2024,6,263521.0,Stable Salary & Stable Fixed Expenses,140120,60947.0,53487,114434.0,25686.0,18.33,-0.0,Medium Risk
U556,2024,7,289207.0,Stable Salary & Stable Fixed Expenses,140120,60947.0,42743,103690.0,36430.0,26.0,-0.02,Low Risk
U556,2024,8,325637.0,Stable Salary & Stable Fixed Expenses,140120,60947.0,64797,125744.0,14376.0,10.26,-0.02,High Risk
U556,2024,9,340013.0,Stable Salary & Stable Fixed Expenses,140120,60947.0,54380,115327.0,24793.0,17.69,-0.03,Medium Risk
U556,2024,10,364806.0,Stable Salary & Stable Fixed Expenses,140120,60947.0,57624,118571.0,21549.0,15.38,-0.04,Medium Risk
U556,2024,11,386355.0,Stable Salary & Stable Fixed Expenses,140120,60947.0,73094,134041.0,6079.0,4.34,-0.02,High Risk
U556,2024,12,392434.0,Stable Salary & Stable Fixed Expenses,140120,60947.0,69139,130086.0,10034.0,7.16,0.04,High Risk
U557,2024,1,171445.0,Stable Salary & Stable Fixed Expenses,122698,47744.0,27635,75379.0,47319.0,38.57,-0.02,Low Risk
U557,2024,2,218764.0,Stable Salary & Stable Fixed Expenses,122698,47744.0,35077,82821.0,39877.0,32.5,0.0,Low Risk
U557,2024,3,258641.0,Stable Salary & Stable Fixed Expenses,122698,47744.0,29803,77547.0,45151.0,36.8,-0.02,Low Risk
U557,2024,4,303792.0,Stable Salary & Stable Fixed Expenses,122698,47744.0,27546,75290.0,47408.0,38.64,-0.03,Low Risk
U557,2024,5,351200.0,Stable Salary & Stable Fixed Expenses,122698,47744.0,30504,78248.0,44450.0,36.23,-0.03,Low Risk
U557,2024,6,395650.0,Stable Salary & Stable Fixed Expenses,122698,47744.0,31298,79042.0,43656.0,35.58,-0.03,Low Risk
U557,2024,7,439306.0,Stable Salary & Stable Fixed Expenses,122698,47744.0,32989,80733.0,41965.0,34.2,0.05,Low Risk
U557,2024,8,481271.0,Stable Salary & Stable Fixed Expenses,122698,47744.0,29876,77620.0,45078.0,36.74,-0.04,Low Risk
U557,2024,9,526349.0,Stable Salary & Stable Fixed Expenses,122698,47744.0,31847,79591.0,43107.0,35.13,0.03,Low Risk
U557,2024,10,569456.0,Stable Salary & Stable Fixed Expenses,122698,47744.0,36200,83944.0,38754.0,31.58,0.02,Low Risk
U557,2024,11,608210.0,Stable Salary & Stable Fixed Expenses,122698,47744.0,31896,79640.0,43058.0,35.09,0.04,Low Risk
U557,2024,12,651268.0,Stable Salary & Stable Fixed Expenses,122698,47744.0,25903,73647.0,49051.0,39.98,0.03,Low Risk
U558,2024,1,186300.0,Stable Salary & Stable Fixed Expenses,49470,13788.0,15004,28792.0,20678.0,41.8,-0.0,Low Risk
U558,2024,2,206978.0,Stable Salary & Stable Fixed Expenses,49470,13788.0,18650,32438.0,17032.0,34.43,-0.01,Low Risk
U558,2024,3,224010.0,Stable Salary & Stable Fixed Expenses,49470,13788.0,21452,35240.0,14230.0,28.76,-0.01,Low Risk
U558,2024,4,238240.0,Stable Salary & Stable Fixed Expenses,49470,13788.0,20761,34549.0,14921.0,30.16,-0.01,Low Risk
U558,2024,5,253161.0,Stable Salary & Stable Fixed Expenses,49470,13788.0,22543,36331.0,13139.0,26.56,-0.0,Low Risk
U558,2024,6,266300.0,Stable Salary & Stable Fixed Expenses,49470,13788.0,21018,34806.0,14664.0,29.64,-0.03,Low Risk
U558,2024,7,280964.0,Stable Salary & Stable Fixed Expenses,49470,13788.0,21630,35418.0,14052.0,28.41,-0.0,Low Risk
U558,2024,8,295016.0,Stable Salary & Stable Fixed Expenses,49470,13788.0,21194,34982.0,14488.0,29.29,0.03,Low Risk
U558,2024,9,309504.0,Stable Salary & Stable Fixed Expenses,49470,13788.0,17204,30992.0,18478.0,37.35,-0.0,Low Risk
U558,2024,10,327982.0,Stable Salary & Stable Fixed Expenses,49470,13788.0,23579,37367.0,12103.0,24.47,-0.01,Medium Risk
U558,2024,11,340085.0,Stable Salary & Stable Fixed Expenses,49470,13788.0,25543,39331.0,10139.0,20.5,-0.05,Medium Risk
U558,2024,12,350224.0,Stable Salary & Stable Fixed Expenses,49470,13788.0,17555,31343.0,18127.0,36.64,0.04,Low Risk
U559,2024,1,235448.0,Salary Increases & Fixed Expenses Increase,182198,63713.0,38232,101945.0,80253.0,44.05,-0.03,Low Risk
U559,2024,2,315701.0,Salary Increases & Fixed Expenses Increase,182198,63713.0,42729,106442.0,75756.0,41.58,-0.04,Low Risk
U559,2024,3,391457.0,Salary Increases & Fixed Expenses Increase,197007,63713.0,46653,110366.0,86641.0,43.98,-0.02,Low Risk
U559,2024,4,478098.0,Salary Increases & Fixed Expenses Increase,197007,63713.0,53838,117551.0,79456.0,40.33,0.02,Low Risk
U559,2024,5,557554.0,Salary Increases & Fixed Expenses Increase,197007,63713.0,57014,120727.0,76280.0,38.72,-0.01,Low Risk
U559,2024,6,633834.0,Salary Increases & Fixed Expenses Increase,197007,63713.0,50188,113901.0,83106.0,42.18,0.02,Low Risk
U559,2024,7,716940.0,Salary Increases & Fixed Expenses Increase,197007,63713.0,52770,116483.0,80524.0,40.87,0.01,Low Risk
U559,2024,8,797464.0,Salary Increases & Fixed Expenses Increase,197007,63713.0,48009,111722.0,85285.0,43.29,0.01,Low Risk
U559,2024,9,882749.0,Salary Increases & Fixed Expenses Increase,197007,64918.0,50651,115569.0,81438.0,41.34,-0.03,Low Risk
U559,2024,10,964187.0,Salary Increases & Fixed Expenses Increase,197007,64918.0,50263,115181.0,81826.0,41.53,0.04,Low Risk
U559,2024,11,1046013.0,Salary Increases & Fixed Expenses Increase,197007,64918.0,51554,116472.0,80535.0,40.88,0.0,Low Risk
U559,2024,12,1126548.0,Salary Increases & Fixed Expenses Increase,197007,64918.0,52694,117612.0,79395.0,40.3,-0.03,Low Risk
U560,2024,1,200524.0,Stable Salary & Stable Fixed Expenses,188757,74506.0,53358,127864.0,60893.0,32.26,-0.04,Low Risk
U560,2024,2,261417.0,Stable Salary & Stable Fixed Expenses,188757,74506.0,42483,116989.0,71768.0,38.02,-0.04,Low Risk
U560,2024,3,333185.0,Stable Salary & Stable Fixed Expenses,188757,74506.0,48728,123234.0,65523.0,34.71,0.01,Low Risk
U560,2024,4,398708.0,Stable Salary & Stable Fixed Expenses,188757,74506.0,40857,115363.0,73394.0,38.88,-0.03,Low Risk
U560,2024,5,472102.0,Stable Salary & Stable Fixed Expenses,188757,74506.0,55767,130273.0,58484.0,30.98,-0.05,Low Risk
U560,2024,6,530586.0,Stable Salary & Stable Fixed Expenses,188757,74506.0,44290,118796.0,69961.0,37.06,-0.01,Low Risk
U560,2024,7,600547.0,Stable Salary & Stable Fixed Expenses,188757,74506.0,40817,115323.0,73434.0,38.9,-0.0,Low Risk
U560,2024,8,673981.0,Stable Salary & Stable Fixed Expenses,188757,74506.0,42908,117414.0,71343.0,37.8,0.02,Low Risk
U560,2024,9,745324.0,Stable Salary & Stable Fixed Expenses,188757,74506.0,60502,135008.0,53749.0,28.48,0.04,Low Risk
U560,2024,10,799073.0,Stable Salary & Stable Fixed Expenses,188757,74506.0,47520,122026.0,66731.0,35.35,-0.02,Low Risk
U560,2024,11,865804.0,Stable Salary & Stable Fixed Expenses,188757,74506.0,54647,129153.0,59604.0,31.58,-0.01,Low Risk
U560,2024,12,925408.0,Stable Salary & Stable Fixed Expenses,188757,74506.0,61383,135889.0,52868.0,28.01,0.03,Low Risk
U561,2024,1,199310.0,Salary Increases & Fixed Expenses Remain Stable,197759,71317.0,122671,193988.0,3771.0,1.91,-0.02,High Risk
U561,2024,2,203081.0,Salary Increases & Fixed Expenses Remain Stable,197759,71317.0,119211,190528.0,7231.0,3.66,0.03,High Risk
U561,2024,3,210312.0,Salary Increases & Fixed Expenses Remain Stable,197759,71317.0,118172,189489.0,8270.0,4.18,0.03,High Risk
U561,2024,4,218582.0,Salary Increases & Fixed Expenses Remain Stable,197759,71317.0,120829,192146.0,5613.0,2.84,-0.02,High Risk
U561,2024,5,224195.0,Salary Increases & Fixed Expenses Remain Stable,197759,71317.0,108494,179811.0,17948.0,9.08,0.02,High Risk
U561,2024,6,242143.0,Salary Increases & Fixed Expenses Remain Stable,197759,71317.0,105478,176795.0,20964.0,10.6,0.01,High Risk
U561,2024,7,263107.0,Salary Increases & Fixed Expenses Remain Stable,197759,71317.0,103361,174678.0,23081.0,11.67,0.04,High Risk
U561,2024,8,286188.0,Salary Increases & Fixed Expenses Remain Stable,204936,71317.0,112565,183882.0,21054.0,10.27,-0.0,High Risk
U561,2024,9,307242.0,Salary Increases & Fixed Expenses Remain Stable,204936,71317.0,124068,195385.0,9551.0,4.66,-0.04,High Risk
U561,2024,10,316793.0,Salary Increases & Fixed Expenses Remain Stable,204936,71317.0,109204,180521.0,24415.0,11.91,0.02,High Risk
U561,2024,11,341208.0,Salary Increases & Fixed Expenses Remain Stable,204936,71317.0,110671,181988.0,22948.0,11.2,-0.04,High Risk
U561,2024,12,364156.0,Salary Increases & Fixed Expenses Remain Stable,204936,71317.0,116970,188287.0,16649.0,8.12,0.05,High Risk
U562,2024,1,244912.0,Salary Increases & Fixed Expenses Remain Stable,244363,119097.0,53063,172160.0,72203.0,29.55,-0.02,Low Risk
U562,2024,2,317115.0,Salary Increases & Fixed Expenses Remain Stable,244363,119097.0,69868,188965.0,55398.0,22.67,0.04,Medium Risk
U562,2024,3,372513.0,Salary Increases & Fixed Expenses Remain Stable,244363,119097.0,57241,176338.0,68025.0,27.84,-0.0,Low Risk
U562,2024,4,440538.0,Salary Increases & Fixed Expenses Remain Stable,244363,119097.0,69461,188558.0,55805.0,22.84,-0.04,Medium Risk
U562,2024,5,496343.0,Salary Increases & Fixed Expenses Remain Stable,244363,119097.0,60169,179266.0,65097.0,26.64,0.03,Low Risk
U562,2024,6,561440.0,Salary Increases & Fixed Expenses Remain Stable,244363,119097.0,61433,180530.0,63833.0,26.12,0.03,Low Risk
U562,2024,7,625273.0,Salary Increases & Fixed Expenses Remain Stable,244363,119097.0,50715,169812.0,74551.0,30.51,-0.05,Low Risk
U562,2024,8,699824.0,Salary Increases & Fixed Expenses Remain Stable,256181,119097.0,59198,178295.0,77886.0,30.4,0.04,Low Risk
U562,2024,9,777710.0,Salary Increases & Fixed Expenses Remain Stable,256181,119097.0,73640,192737.0,63444.0,24.77,-0.02,Medium Risk
U562,2024,10,841154.0,Salary Increases & Fixed Expenses Remain Stable,256181,119097.0,82167,201264.0,54917.0,21.44,-0.02,Medium Risk
U562,2024,11,896071.0,Salary Increases & Fixed Expenses Remain Stable,256181,119097.0,76757,195854.0,60327.0,23.55,0.01,Medium Risk
U562,2024,12,956398.0,Salary Increases & Fixed Expenses Remain Stable,256181,119097.0,65791,184888.0,71293.0,27.83,0.0,Low Risk
U563,2024,1,206345.0,Salary Increases & Fixed Expenses Increase,81916,31411.0,40387,71798.0,10118.0,12.35,0.04,High Risk
U563,2024,2,216463.0,Salary Increases & Fixed Expenses Increase,81916,32381.0,38139,70520.0,11396.0,13.91,0.04,High Risk
U563,2024,3,227859.0,Salary Increases & Fixed Expenses Increase,81916,32381.0,30599,62980.0,18936.0,23.12,-0.05,Medium Risk
U563,2024,4,246795.0,Salary Increases & Fixed Expenses Increase,81916,32381.0,29282,61663.0,20253.0,24.72,0.04,Medium Risk
U563,2024,5,267048.0,Salary Increases & Fixed Expenses Increase,81916,32381.0,25646,58027.0,23889.0,29.16,-0.04,Low Risk
U563,2024,6,290937.0,Salary Increases & Fixed Expenses Increase,81916,32381.0,35632,68013.0,13903.0,16.97,0.04,Medium Risk
U563,2024,7,304840.0,Salary Increases & Fixed Expenses Increase,98901,32381.0,46259,78640.0,20261.0,20.49,0.05,Medium Risk
U563,2024,8,325101.0,Salary Increases & Fixed Expenses Increase,98901,32381.0,46971,79352.0,19549.0,19.77,-0.05,Medium Risk
U563,2024,9,344650.0,Salary Increases & Fixed Expenses Increase,98901,32381.0,49135,81516.0,17385.0,17.58,0.02,Medium Risk
U563,2024,10,362035.0,Salary Increases & Fixed Expenses Increase,98901,34005.0,33667,67672.0,31229.0,31.58,-0.01,Low Risk
U563,2024,11,393264.0,Salary Increases & Fixed Expenses Increase,98901,34875.0,34097,68972.0,29929.0,30.26,-0.05,Low Risk
U563,2024,12,423193.0,Salary Increases & Fixed Expenses Increase,98901,34875.0,42791,77666.0,21235.0,21.47,-0.03,Medium Risk
U564,2024,1,225780.0,Salary Increases & Fixed Expenses Decrease,195635,57112.0,79808,136920.0,58715.0,30.01,-0.04,Low Risk
U564,2024,2,284495.0,Salary Increases & Fixed Expenses Decrease,195635,57112.0,66519,123631.0,72004.0,36.81,0.01,Low Risk
U564,2024,3,356499.0,Salary Increases & Fixed Expenses Decrease,195635,57112.0,70393,127505.0,68130.0,34.83,-0.05,Low Risk
U564,2024,4,424629.0,Salary Increases & Fixed Expenses Decrease,195635,57112.0,96715,153827.0,41808.0,21.37,0.03,Medium Risk
U564,2024,5,466437.0,Salary Increases & Fixed Expenses Decrease,205286,57112.0,97266,154378.0,50908.0,24.8,0.01,Medium Risk
U564,2024,6,517345.0,Salary Increases & Fixed Expenses Decrease,205286,57112.0,70941,128053.0,77233.0,37.62,-0.05,Low Risk
U564,2024,7,594578.0,Salary Increases & Fixed Expenses Decrease,205286,57112.0,71952,129064.0,76222.0,37.13,-0.01,Low Risk
U564,2024,8,670800.0,Salary Increases & Fixed Expenses Decrease,205286,57112.0,73373,130485.0,74801.0,36.44,-0.05,Low Risk
U564,2024,9,745601.0,Salary Increases & Fixed Expenses Decrease,205286,57112.0,108953,166065.0,39221.0,19.11,0.04,Medium Risk
U564,2024,10,784822.0,Salary Increases & Fixed Expenses Decrease,205286,57112.0,82863,139975.0,65311.0,31.81,-0.03,Low Risk
U564,2024,11,850133.0,Salary Increases & Fixed Expenses Decrease,205286,57112.0,83470,140582.0,64704.0,31.52,-0.02,Low Risk
U564,2024,12,914837.0,Salary Increases & Fixed Expenses Decrease,205286,57112.0,101551,158663.0,46623.0,22.71,-0.05,Medium Risk
U565,2024,1,59428.0,Salary Increases & Fixed Expenses Increase,25672,15274.0,8515,23789.0,1883.0,7.33,-0.02,High Risk
U565,2024,2,61311.0,Salary Increases & Fixed Expenses Increase,25672,15274.0,11260,26534.0,-862.0,-3.36,-0.02,High Risk
U565,2024,3,60449.0,Salary Increases & Fixed Expenses Increase,25672,15274.0,7972,23246.0,2426.0,9.45,0.01,High Risk
U565,2024,4,62875.0,Salary Increases & Fixed Expenses Increase,36602,15965.0,13372,29337.0,7265.0,19.85,0.02,Medium Risk
U565,2024,5,70140.0,Salary Increases & Fixed Expenses Increase,36602,17937.0,17780,35717.0,885.0,2.42,0.02,High Risk
U565,2024,6,71025.0,Salary Increases & Fixed Expenses Increase,36602,17937.0,13593,31530.0,5072.0,13.86,0.03,High Risk
U565,2024,7,76097.0,Salary Increases & Fixed Expenses Increase,36602,17937.0,12800,30737.0,5865.0,16.02,-0.03,Medium Risk
U565,2024,8,81962.0,Salary Increases & Fixed Expenses Increase,36602,17937.0,13510,31447.0,5155.0,14.08,0.02,High Risk
U565,2024,9,87117.0,Salary Increases & Fixed Expenses Increase,36602,17937.0,14117,32054.0,4548.0,12.43,-0.01,High Risk
U565,2024,10,91665.0,Salary Increases & Fixed Expenses Increase,36602,17937.0,11639,29576.0,7026.0,19.2,-0.04,Medium Risk
U565,2024,11,98691.0,Salary Increases & Fixed Expenses Increase,36602,17937.0,13746,31683.0,4919.0,13.44,-0.04,High Risk
U565,2024,12,103610.0,Salary Increases & Fixed Expenses Increase,36602,17937.0,15962,33899.0,2703.0,7.38,-0.01,High Risk
U566,2024,1,242167.0,Salary Increases & Fixed Expenses Remain Stable,177667,41811.0,84509,126320.0,51347.0,28.9,-0.0,Low Risk
U566,2024,2,293514.0,Salary Increases & Fixed Expenses Remain Stable,177667,41811.0,58023,99834.0,77833.0,43.81,-0.03,Low Risk
U566,2024,3,371347.0,Salary Increases & Fixed Expenses Remain Stable,177667,41811.0,98505,140316.0,37351.0,21.02,-0.01,Medium Risk
U566,2024,4,408698.0,Salary Increases & Fixed Expenses Remain Stable,177667,41811.0,85557,127368.0,50299.0,28.31,-0.04,Low Risk
U566,2024,5,458997.0,Salary Increases & Fixed Expenses Remain Stable,177667,41811.0,54795,96606.0,81061.0,45.63,0.03,Low Risk
U566,2024,6,540058.0,Salary Increases & Fixed Expenses Remain Stable,183498,41811.0,78441,120252.0,63246.0,34.47,-0.02,Low Risk
U566,2024,7,603304.0,Salary Increases & Fixed Expenses Remain Stable,183498,41811.0,79748,121559.0,61939.0,33.75,0.02,Low Risk
U566,2024,8,665243.0,Salary Increases & Fixed Expenses Remain Stable,183498,41811.0,59114,100925.0,82573.0,45.0,0.02,Low Risk
U566,2024,9,747816.0,Salary Increases & Fixed Expenses Remain Stable,183498,41811.0,71719,113530.0,69968.0,38.13,0.04,Low Risk
U566,2024,10,817784.0,Salary Increases & Fixed Expenses Remain Stable,183498,41811.0,107334,149145.0,34353.0,18.72,-0.05,Medium Risk
U566,2024,11,852137.0,Salary Increases & Fixed Expenses Remain Stable,183498,41811.0,59079,100890.0,82608.0,45.02,0.05,Low Risk
U566,2024,12,934745.0,Salary Increases & Fixed Expenses Remain Stable,183498,41811.0,101372,143183.0,40315.0,21.97,-0.04,Medium Risk
U567,2024,1,250000.0,Salary Increases & Fixed Expenses Increase,287806,99698.0,65151,164849.0,122957.0,42.72,0.0,Low Risk
U567,2024,2,372957.0,Salary Increases & Fixed Expenses Increase,287806,99698.0,64449,164147.0,123659.0,42.97,0.01,Low Risk
U567,2024,3,496616.0,Salary Increases & Fixed Expenses Increase,287806,100712.0,82952,183664.0,104142.0,36.18,0.02,Low Risk
U567,2024,4,600758.0,Salary Increases & Fixed Expenses Increase,305719,100712.0,82108,182820.0,122899.0,40.2,0.05,Low Risk
U567,2024,5,723657.0,Salary Increases & Fixed Expenses Increase,305719,100712.0,80157,180869.0,124850.0,40.84,-0.02,Low Risk
U567,2024,6,848507.0,Salary Increases & Fixed Expenses Increase,305719,100712.0,66575,167287.0,138432.0,45.28,-0.03,Low Risk
U567,2024,7,986939.0,Salary Increases & Fixed Expenses Increase,305719,100712.0,82171,182883.0,122836.0,40.18,-0.03,Low Risk
U567,2024,8,1109775.0,Salary Increases & Fixed Expenses Increase,305719,100712.0,68699,169411.0,136308.0,44.59,0.04,Low Risk
U567,2024,9,1246083.0,Salary Increases & Fixed Expenses Increase,305719,100712.0,73174,173886.0,131833.0,43.12,0.04,Low Risk
U567,2024,10,1377916.0,Salary Increases & Fixed Expenses Increase,305719,100712.0,74373,175085.0,130634.0,42.73,0.04,Low Risk
U567,2024,11,1508550.0,Salary Increases & Fixed Expenses Increase,305719,100712.0,78787,179499.0,126220.0,41.29,0.01,Low Risk
U567,2024,12,1634770.0,Salary Increases & Fixed Expenses Increase,305719,100712.0,81470,182182.0,123537.0,40.41,0.04,Low Risk
U568,2024,1,250000.0,Salary Increases & Fixed Expenses Increase,263491,97331.0,106041,203372.0,60119.0,22.82,-0.05,Medium Risk
U568,2024,2,310119.0,Salary Increases & Fixed Expenses Increase,263491,97331.0,85519,182850.0,80641.0,30.6,-0.02,Low Risk
U568,2024,3,390760.0,Salary Increases & Fixed Expenses Increase,263491,97331.0,122081,219412.0,44079.0,16.73,-0.03,Medium Risk
U568,2024,4,434839.0,Salary Increases & Fixed Expenses Increase,281535,99235.0,135045,234280.0,47255.0,16.78,0.01,Medium Risk
U568,2024,5,482094.0,Salary Increases & Fixed Expenses Increase,281535,101009.0,140129,241138.0,40397.0,14.35,0.02,High Risk
U568,2024,6,522491.0,Salary Increases & Fixed Expenses Increase,281535,101009.0,113526,214535.0,67000.0,23.8,-0.03,Medium Risk
U568,2024,7,589491.0,Salary Increases & Fixed Expenses Increase,281535,101009.0,135197,236206.0,45329.0,16.1,0.03,Medium Risk
U568,2024,8,634820.0,Salary Increases & Fixed Expenses Increase,281535,101009.0,121895,222904.0,58631.0,20.83,-0.04,Medium Risk
U568,2024,9,693451.0,Salary Increases & Fixed Expenses Increase,281535,101009.0,125191,226200.0,55335.0,19.65,0.04,Medium Risk
U568,2024,10,748786.0,Salary Increases & Fixed Expenses Increase,281535,101009.0,138377,239386.0,42149.0,14.97,-0.04,High Risk
U568,2024,11,790935.0,Salary Increases & Fixed Expenses Increase,281535,101009.0,107535,208544.0,72991.0,25.93,0.02,Low Risk
U568,2024,12,863926.0,Salary Increases & Fixed Expenses Increase,281535,101009.0,120823,221832.0,59703.0,21.21,-0.01,Medium Risk
U569,2024,1,250000.0,Salary Increases & Fixed Expenses Increase,289160,86794.0,61420,148214.0,140946.0,48.74,-0.04,Low Risk
U569,2024,2,390946.0,Salary Increases & Fixed Expenses Increase,289160,86794.0,70934,157728.0,131432.0,45.45,-0.01,Low Risk
U569,2024,3,522378.0,Salary Increases & Fixed Expenses Increase,289160,86794.0,72011,158805.0,130355.0,45.08,-0.0,Low Risk
U569,2024,4,652733.0,Salary Increases & Fixed Expenses Increase,289160,87827.0,67035,154862.0,134298.0,46.44,-0.04,Low Risk
U569,2024,5,787031.0,Salary Increases & Fixed Expenses Increase,289160,87827.0,58646,146473.0,142687.0,49.35,0.01,Low Risk
U569,2024,6,929718.0,Salary Increases & Fixed Expenses Increase,289160,87827.0,80248,168075.0,121085.0,41.87,0.04,Low Risk
U569,2024,7,1050803.0,Salary Increases & Fixed Expenses Increase,289160,87827.0,71270,159097.0,130063.0,44.98,0.03,Low Risk
U569,2024,8,1180866.0,Salary Increases & Fixed Expenses Increase,296345,87827.0,81631,169458.0,126887.0,42.82,0.01,Low Risk
U569,2024,9,1307753.0,Salary Increases & Fixed Expenses Increase,296345,87827.0,80419,168246.0,128099.0,43.23,0.02,Low Risk
U569,2024,10,1435852.0,Salary Increases & Fixed Expenses Increase,296345,89471.0,59846,149317.0,147028.0,49.61,-0.05,Low Risk
U569,2024,11,1582880.0,Salary Increases & Fixed Expenses Increase,296345,89471.0,68484,157955.0,138390.0,46.7,-0.0,Low Risk
U569,2024,12,1721270.0,Salary Increases & Fixed Expenses Increase,296345,89471.0,66362,155833.0,140512.0,47.42,-0.04,Low Risk
U570,2024,1,214448.0,Salary Increases & Fixed Expenses Remain Stable,121994,43204.0,83507,126711.0,-4717.0,-3.87,-0.0,High Risk
U570,2024,2,209731.0,Salary Increases & Fixed Expenses Remain Stable,121994,43204.0,76558,119762.0,2232.0,1.83,0.01,High Risk
U570,2024,3,211963.0,Salary Increases & Fixed Expenses Remain Stable,139131,43204.0,77670,120874.0,18257.0,13.12,0.0,High Risk
U570,2024,4,230220.0,Salary Increases & Fixed Expenses Remain Stable,139131,43204.0,84418,127622.0,11509.0,8.27,-0.01,High Risk
U570,2024,5,241729.0,Salary Increases & Fixed Expenses Remain Stable,139131,43204.0,89298,132502.0,6629.0,4.76,-0.04,High Risk
U570,2024,6,248358.0,Salary Increases & Fixed Expenses Remain Stable,139131,43204.0,85308,128512.0,10619.0,7.63,-0.01,High Risk
U570,2024,7,258977.0,Salary Increases & Fixed Expenses Remain Stable,139131,43204.0,80193,123397.0,15734.0,11.31,0.02,High Risk
U570,2024,8,274711.0,Salary Increases & Fixed Expenses Remain Stable,139131,43204.0,96213,139417.0,-286.0,-0.21,-0.03,High Risk
U570,2024,9,274425.0,Salary Increases & Fixed Expenses Remain Stable,139131,43204.0,82097,125301.0,13830.0,9.94,-0.01,High Risk
U570,2024,10,288255.0,Salary Increases & Fixed Expenses Remain Stable,139131,43204.0,72322,115526.0,23605.0,16.97,-0.02,Medium Risk
U570,2024,11,311860.0,Salary Increases & Fixed Expenses Remain Stable,139131,43204.0,104044,147248.0,-8117.0,-5.83,0.0,High Risk
U570,2024,12,303743.0,Salary Increases & Fixed Expenses Remain Stable,139131,43204.0,87826,131030.0,8101.0,5.82,-0.01,High Risk
U571,2024,1,233639.0,Salary Increases & Fixed Expenses Increase,166019,52977.0,68401,121378.0,44641.0,26.89,0.03,Low Risk
U571,2024,2,278280.0,Salary Increases & Fixed Expenses Increase,166019,52977.0,68704,121681.0,44338.0,26.71,-0.02,Low Risk
U571,2024,3,322618.0,Salary Increases & Fixed Expenses Increase,166019,54820.0,67069,121889.0,44130.0,26.58,-0.04,Low Risk
U571,2024,4,366748.0,Salary Increases & Fixed Expenses Increase,172458,54820.0,62228,117048.0,55410.0,32.13,-0.05,Low Risk
U571,2024,5,422158.0,Salary Increases & Fixed Expenses Increase,172458,54820.0,72882,127702.0,44756.0,25.95,0.03,Low Risk
U571,2024,6,466914.0,Salary Increases & Fixed Expenses Increase,172458,56511.0,86055,142566.0,29892.0,17.33,-0.01,Medium Risk
U571,2024,7,496806.0,Salary Increases & Fixed Expenses Increase,172458,56511.0,78693,135204.0,37254.0,21.6,-0.03,Medium Risk
U571,2024,8,534060.0,Salary Increases & Fixed Expenses Increase,172458,56511.0,51968,108479.0,63979.0,37.1,-0.05,Low Risk
U571,2024,9,598039.0,Salary Increases & Fixed Expenses Increase,172458,58432.0,74622,133054.0,39404.0,22.85,-0.02,Medium Risk
U571,2024,10,637443.0,Salary Increases & Fixed Expenses Increase,172458,58432.0,53949,112381.0,60077.0,34.84,-0.02,Low Risk
U571,2024,11,697520.0,Salary Increases & Fixed Expenses Increase,172458,58432.0,78480,136912.0,35546.0,20.61,-0.04,Medium Risk
U571,2024,12,733066.0,Salary Increases & Fixed Expenses Increase,172458,58432.0,57510,115942.0,56516.0,32.77,0.01,Low Risk
U572,2024,1,149207.0,Stable Salary & Stable Fixed Expenses,57017,28553.0,23106,51659.0,5358.0,9.4,-0.0,High Risk
U572,2024,2,154565.0,Stable Salary & Stable Fixed Expenses,57017,28553.0,19256,47809.0,9208.0,16.15,0.02,Medium Risk
U572,2024,3,163773.0,Stable Salary & Stable Fixed Expenses,57017,28553.0,20383,48936.0,8081.0,14.17,-0.02,High Risk
U572,2024,4,171854.0,Stable Salary & Stable Fixed Expenses,57017,28553.0,21264,49817.0,7200.0,12.63,-0.01,High Risk
U572,2024,5,179054.0,Stable Salary & Stable Fixed Expenses,57017,28553.0,19574,48127.0,8890.0,15.59,0.02,Medium Risk
U572,2024,6,187944.0,Stable Salary & Stable Fixed Expenses,57017,28553.0,21235,49788.0,7229.0,12.68,-0.02,High Risk
U572,2024,7,195173.0,Stable Salary & Stable Fixed Expenses,57017,28553.0,26624,55177.0,1840.0,3.23,-0.02,High Risk
U572,2024,8,197013.0,Stable Salary & Stable Fixed Expenses,57017,28553.0,19618,48171.0,8846.0,15.51,0.04,Medium Risk
U572,2024,9,205859.0,Stable Salary & Stable Fixed Expenses,57017,28553.0,20976,49529.0,7488.0,13.13,-0.01,High Risk
U572,2024,10,213347.0,Stable Salary & Stable Fixed Expenses,57017,28553.0,31634,60187.0,-3170.0,-5.56,0.01,High Risk
U572,2024,11,210177.0,Stable Salary & Stable Fixed Expenses,57017,28553.0,18923,47476.0,9541.0,16.73,-0.02,Medium Risk
U572,2024,12,219718.0,Stable Salary & Stable Fixed Expenses,57017,28553.0,30322,58875.0,-1858.0,-3.26,0.04,High Risk
U573,2024,1,162635.0,Salary Increases & Fixed Expenses Decrease,73770,25009.0,29857,54866.0,18904.0,25.63,0.0,Low Risk
U573,2024,2,181539.0,Salary Increases & Fixed Expenses Decrease,73770,25009.0,32591,57600.0,16170.0,21.92,0.01,Medium Risk
U573,2024,3,197709.0,Salary Increases & Fixed Expenses Decrease,73770,25009.0,36666,61675.0,12095.0,16.4,0.02,Medium Risk
U573,2024,4,209804.0,Salary Increases & Fixed Expenses Decrease,73770,25009.0,23989,48998.0,24772.0,33.58,0.02,Low Risk
U573,2024,5,234576.0,Salary Increases & Fixed Expenses Decrease,87555,25009.0,35766,60775.0,26780.0,30.59,0.03,Low Risk
U573,2024,6,261356.0,Salary Increases & Fixed Expenses Decrease,87555,25009.0,40324,65333.0,22222.0,25.38,0.01,Low Risk
U573,2024,7,283578.0,Salary Increases & Fixed Expenses Decrease,87555,25009.0,41745,66754.0,20801.0,23.76,-0.03,Medium Risk
U573,2024,8,304379.0,Salary Increases & Fixed Expenses Decrease,87555,25009.0,35418,60427.0,27128.0,30.98,-0.01,Low Risk
U573,2024,9,331507.0,Salary Increases & Fixed Expenses Decrease,87555,25009.0,36973,61982.0,25573.0,29.21,0.04,Low Risk
U573,2024,10,357080.0,Salary Increases & Fixed Expenses Decrease,87555,25009.0,34638,59647.0,27908.0,31.87,-0.01,Low Risk
U573,2024,11,384988.0,Salary Increases & Fixed Expenses Decrease,87555,25009.0,40607,65616.0,21939.0,25.06,0.0,Low Risk
U573,2024,12,406927.0,Salary Increases & Fixed Expenses Decrease,87555,25009.0,35262,60271.0,27284.0,31.16,0.02,Low Risk
U574,2024,1,210636.0,Salary Increases & Fixed Expenses Increase,21466,20762.0,4804,25566.0,-4100.0,-19.1,-0.03,High Risk
U574,2024,2,206536.0,Salary Increases & Fixed Expenses Increase,21466,20762.0,5628,26390.0,-4924.0,-22.94,0.02,High Risk
U574,2024,3,201612.0,Salary Increases & Fixed Expenses Increase,21466,20762.0,5444,26206.0,-4740.0,-22.08,0.03,High Risk
U574,2024,4,196872.0,Salary Increases & Fixed Expenses Increase,21466,20762.0,6268,27030.0,-5564.0,-25.92,0.01,High Risk
U574,2024,5,191308.0,Salary Increases & Fixed Expenses Increase,43923,20762.0,12051,32813.0,11110.0,25.29,-0.02,Low Risk
U574,2024,6,202418.0,Salary Increases & Fixed Expenses Increase,43923,22577.0,9696,32273.0,11650.0,26.52,-0.0,Low Risk
U574,2024,7,214068.0,Salary Increases & Fixed Expenses Increase,43923,22577.0,12395,34972.0,8951.0,20.38,0.01,Medium Risk
U574,2024,8,223019.0,Salary Increases & Fixed Expenses Increase,43923,22577.0,9574,32151.0,11772.0,26.8,-0.05,Low Risk
U574,2024,9,234791.0,Salary Increases & Fixed Expenses Increase,43923,22577.0,12790,35367.0,8556.0,19.48,-0.04,Medium Risk
U574,2024,10,243347.0,Salary Increases & Fixed Expenses Increase,43923,22577.0,15111,37688.0,6235.0,14.2,-0.03,High Risk
U574,2024,11,249582.0,Salary Increases & Fixed Expenses Increase,43923,22577.0,13070,35647.0,8276.0,18.84,-0.01,Medium Risk
U574,2024,12,257858.0,Salary Increases & Fixed Expenses Increase,43923,22577.0,10471,33048.0,10875.0,24.76,0.04,Medium Risk
U575,2024,1,153063.0,Salary Increases & Fixed Expenses Decrease,107732,43865.0,25912,69777.0,37955.0,35.23,0.02,Low Risk
U575,2024,2,191018.0,Salary Increases & Fixed Expenses Decrease,107732,43865.0,27439,71304.0,36428.0,33.81,0.04,Low Risk
U575,2024,3,227446.0,Salary Increases & Fixed Expenses Decrease,107732,43865.0,27549,71414.0,36318.0,33.71,0.02,Low Risk
U575,2024,4,263764.0,Salary Increases & Fixed Expenses Decrease,107732,43865.0,30079,73944.0,33788.0,31.36,0.04,Low Risk
U575,2024,5,297552.0,Salary Increases & Fixed Expenses Decrease,107732,43865.0,28506,72371.0,35361.0,32.82,-0.03,Low Risk
U575,2024,6,332913.0,Salary Increases & Fixed Expenses Decrease,107732,43865.0,26330,70195.0,37537.0,34.84,-0.04,Low Risk
U575,2024,7,370450.0,Salary Increases & Fixed Expenses Decrease,130491,43865.0,28657,72522.0,57969.0,44.42,-0.03,Low Risk
U575,2024,8,428419.0,Salary Increases & Fixed Expenses Decrease,130491,43865.0,34875,78740.0,51751.0,39.66,0.03,Low Risk
U575,2024,9,480170.0,Salary Increases & Fixed Expenses Decrease,130491,43865.0,28860,72725.0,57766.0,44.27,0.03,Low Risk
U575,2024,10,537936.0,Salary Increases & Fixed Expenses Decrease,130491,43865.0,31750,75615.0,54876.0,42.05,0.02,Low Risk
U575,2024,11,592812.0,Salary Increases & Fixed Expenses Decrease,130491,43865.0,28278,72143.0,58348.0,44.71,-0.05,Low Risk
U575,2024,12,651160.0,Salary Increases & Fixed Expenses Decrease,130491,43865.0,38221,82086.0,48405.0,37.09,-0.03,Low Risk
U576,2024,1,250000.0,Stable Salary & Increasing Fixed Expenses,250086,73530.0,161420,234950.0,15136.0,6.05,0.04,High Risk
U576,2024,2,265136.0,Stable Salary & Increasing Fixed Expenses,250086,73530.0,132857,206387.0,43699.0,17.47,-0.03,Medium Risk
U576,2024,3,308835.0,Stable Salary & Increasing Fixed Expenses,250086,73530.0,175303,248833.0,1253.0,0.5,-0.04,High Risk
U576,2024,4,310088.0,Stable Salary & Increasing Fixed Expenses,250086,73530.0,134943,208473.0,41613.0,16.64,-0.02,Medium Risk
U576,2024,5,351701.0,Stable Salary & Increasing Fixed Expenses,250086,73530.0,147600,221130.0,28956.0,11.58,0.04,High Risk
U576,2024,6,380657.0,Stable Salary & Increasing Fixed Expenses,250086,75381.0,166618,241999.0,8087.0,3.23,-0.03,High Risk
U576,2024,7,388744.0,Stable Salary & Increasing Fixed Expenses,250086,76254.0,142258,218512.0,31574.0,12.63,0.05,High Risk
U576,2024,8,420318.0,Stable Salary & Increasing Fixed Expenses,250086,76254.0,135432,211686.0,38400.0,15.35,-0.0,Medium Risk
U576,2024,9,458718.0,Stable Salary & Increasing Fixed Expenses,250086,76254.0,140322,216576.0,33510.0,13.4,-0.0,High Risk
U576,2024,10,492228.0,Stable Salary & Increasing Fixed Expenses,250086,76254.0,204147,280401.0,-30315.0,-12.12,0.04,High Risk
U576,2024,11,461913.0,Stable Salary & Increasing Fixed Expenses,250086,76254.0,171842,248096.0,1990.0,0.8,0.0,High Risk
U576,2024,12,463903.0,Stable Salary & Increasing Fixed Expenses,250086,76254.0,143761,220015.0,30071.0,12.02,-0.05,High Risk
U577,2024,1,245860.0,Salary Increases & Fixed Expenses Remain Stable,131056,57225.0,62082,119307.0,11749.0,8.96,0.01,High Risk
U577,2024,2,257609.0,Salary Increases & Fixed Expenses Remain Stable,131056,57225.0,45140,102365.0,28691.0,21.89,0.03,Medium Risk
U577,2024,3,286300.0,Salary Increases & Fixed Expenses Remain Stable,131056,57225.0,46934,104159.0,26897.0,20.52,0.02,Medium Risk
U577,2024,4,313197.0,Salary Increases & Fixed Expenses Remain Stable,131056,57225.0,53894,111119.0,19937.0,15.21,0.03,Medium Risk
U577,2024,5,333134.0,Salary Increases & Fixed Expenses Remain Stable,131056,57225.0,65020,122245.0,8811.0,6.72,-0.05,High Risk
U577,2024,6,341945.0,Salary Increases & Fixed Expenses Remain Stable,131056,57225.0,58102,115327.0,15729.0,12.0,-0.05,High Risk
U577,2024,7,357674.0,Salary Increases & Fixed Expenses Remain Stable,137353,57225.0,46057,103282.0,34071.0,24.81,0.02,Medium Risk
U577,2024,8,391745.0,Salary Increases & Fixed Expenses Remain Stable,137353,57225.0,64315,121540.0,15813.0,11.51,0.0,High Risk
U577,2024,9,407558.0,Salary Increases & Fixed Expenses Remain Stable,137353,57225.0,65046,122271.0,15082.0,10.98,-0.01,High Risk
U577,2024,10,422640.0,Salary Increases & Fixed Expenses Remain Stable,137353,57225.0,50441,107666.0,29687.0,21.61,0.02,Medium Risk
U577,2024,11,452327.0,Salary Increases & Fixed Expenses Remain Stable,137353,57225.0,60227,117452.0,19901.0,14.49,0.01,High Risk
U577,2024,12,472228.0,Salary Increases & Fixed Expenses Remain Stable,137353,57225.0,45791,103016.0,34337.0,25.0,0.03,Medium Risk
U578,2024,1,233381.0,Salary Increases & Fixed Expenses Remain Stable,157253,65253.0,76333,141586.0,15667.0,9.96,-0.05,High Risk
U578,2024,2,249048.0,Salary Increases & Fixed Expenses Remain Stable,157253,65253.0,70875,136128.0,21125.0,13.43,-0.01,High Risk
U578,2024,3,270173.0,Salary Increases & Fixed Expenses Remain Stable,157253,65253.0,61749,127002.0,30251.0,19.24,-0.01,Medium Risk
U578,2024,4,300424.0,Salary Increases & Fixed Expenses Remain Stable,157253,65253.0,72984,138237.0,19016.0,12.09,-0.03,High Risk
U578,2024,5,319440.0,Salary Increases & Fixed Expenses Remain Stable,157253,65253.0,69765,135018.0,22235.0,14.14,-0.03,High Risk
U578,2024,6,341675.0,Salary Increases & Fixed Expenses Remain Stable,157253,65253.0,47322,112575.0,44678.0,28.41,-0.02,Low Risk
U578,2024,7,386353.0,Salary Increases & Fixed Expenses Remain Stable,157253,65253.0,75353,140606.0,16647.0,10.59,0.03,High Risk
U578,2024,8,403000.0,Salary Increases & Fixed Expenses Remain Stable,180353,65253.0,78252,143505.0,36848.0,20.43,0.03,Medium Risk
U578,2024,9,439848.0,Salary Increases & Fixed Expenses Remain Stable,180353,65253.0,86674,151927.0,28426.0,15.76,0.04,Medium Risk
U578,2024,10,468274.0,Salary Increases & Fixed Expenses Remain Stable,180353,65253.0,65588,130841.0,49512.0,27.45,0.04,Low Risk
U578,2024,11,517786.0,Salary Increases & Fixed Expenses Remain Stable,180353,65253.0,80770,146023.0,34330.0,19.03,0.04,Medium Risk
U578,2024,12,552116.0,Salary Increases & Fixed Expenses Remain Stable,180353,65253.0,63738,128991.0,51362.0,28.48,-0.01,Low Risk
U579,2024,1,249757.0,Stable Salary & Stable Fixed Expenses,249026,75774.0,85079,160853.0,88173.0,35.41,-0.01,Low Risk
U579,2024,2,337930.0,Stable Salary & Stable Fixed Expenses,249026,75774.0,106874,182648.0,66378.0,26.66,0.03,Low Risk
U579,2024,3,404308.0,Stable Salary & Stable Fixed Expenses,249026,75774.0,121734,197508.0,51518.0,20.69,-0.02,Medium Risk
U579,2024,4,455826.0,Stable Salary & Stable Fixed Expenses,249026,75774.0,107350,183124.0,65902.0,26.46,0.02,Low Risk
U579,2024,5,521728.0,Stable Salary & Stable Fixed Expenses,249026,75774.0,123644,199418.0,49608.0,19.92,0.0,Medium Risk
U579,2024,6,571336.0,Stable Salary & Stable Fixed Expenses,249026,75774.0,120953,196727.0,52299.0,21.0,0.03,Medium Risk
U579,2024,7,623635.0,Stable Salary & Stable Fixed Expenses,249026,75774.0,85263,161037.0,87989.0,35.33,0.05,Low Risk
U579,2024,8,711624.0,Stable Salary & Stable Fixed Expenses,249026,75774.0,78198,153972.0,95054.0,38.17,-0.04,Low Risk
U579,2024,9,806678.0,Stable Salary & Stable Fixed Expenses,249026,75774.0,119942,195716.0,53310.0,21.41,0.01,Medium Risk
U579,2024,10,859988.0,Stable Salary & Stable Fixed Expenses,249026,75774.0,93660,169434.0,79592.0,31.96,0.01,Low Risk
U579,2024,11,939580.0,Stable Salary & Stable Fixed Expenses,249026,75774.0,124943,200717.0,48309.0,19.4,-0.05,Medium Risk
U579,2024,12,987889.0,Stable Salary & Stable Fixed Expenses,249026,75774.0,130111,205885.0,43141.0,17.32,0.0,Medium Risk
U580,2024,1,185624.0,Salary Increases & Fixed Expenses Remain Stable,99569,30575.0,47631,78206.0,21363.0,21.46,-0.01,Medium Risk
U580,2024,2,206987.0,Salary Increases & Fixed Expenses Remain Stable,99569,30575.0,40768,71343.0,28226.0,28.35,0.04,Low Risk
U580,2024,3,235213.0,Salary Increases & Fixed Expenses Remain Stable,99569,30575.0,46217,76792.0,22777.0,22.88,-0.05,Medium Risk
U580,2024,4,257990.0,Salary Increases & Fixed Expenses Remain Stable,99569,30575.0,35729,66304.0,33265.0,33.41,-0.02,Low Risk
U580,2024,5,291255.0,Salary Increases & Fixed Expenses Remain Stable,109685,30575.0,33073,63648.0,46037.0,41.97,-0.01,Low Risk
U580,2024,6,337292.0,Salary Increases & Fixed Expenses Remain Stable,109685,30575.0,36216,66791.0,42894.0,39.11,-0.0,Low Risk
U580,2024,7,380186.0,Salary Increases & Fixed Expenses Remain Stable,109685,30575.0,46860,77435.0,32250.0,29.4,-0.02,Low Risk
U580,2024,8,412436.0,Salary Increases & Fixed Expenses Remain Stable,109685,30575.0,35191,65766.0,43919.0,40.04,0.02,Low Risk
U580,2024,9,456355.0,Salary Increases & Fixed Expenses Remain Stable,109685,30575.0,43865,74440.0,35245.0,32.13,-0.04,Low Risk
U580,2024,10,491600.0,Salary Increases & Fixed Expenses Remain Stable,109685,30575.0,43290,73865.0,35820.0,32.66,-0.01,Low Risk
U580,2024,11,527420.0,Salary Increases & Fixed Expenses Remain Stable,109685,30575.0,45835,76410.0,33275.0,30.34,0.05,Low Risk
U580,2024,12,560695.0,Salary Increases & Fixed Expenses Remain Stable,109685,30575.0,40792,71367.0,38318.0,34.93,0.02,Low Risk
U581,2024,1,173328.0,Stable Salary & Increasing Fixed Expenses,24238,13598.0,8883,22481.0,1757.0,7.25,0.02,High Risk
U581,2024,2,175085.0,Stable Salary & Increasing Fixed Expenses,24238,13598.0,10629,24227.0,11.0,0.05,-0.01,High Risk
U581,2024,3,175096.0,Stable Salary & Increasing Fixed Expenses,24238,13598.0,10137,23735.0,503.0,2.08,-0.03,High Risk
U581,2024,4,175599.0,Stable Salary & Increasing Fixed Expenses,24238,13598.0,7279,20877.0,3361.0,13.87,0.02,High Risk
U581,2024,5,178960.0,Stable Salary & Increasing Fixed Expenses,24238,13598.0,10083,23681.0,557.0,2.3,-0.04,High Risk
U581,2024,6,179517.0,Stable Salary & Increasing Fixed Expenses,24238,13598.0,9538,23136.0,1102.0,4.55,0.0,High Risk
U581,2024,7,180619.0,Stable Salary & Increasing Fixed Expenses,24238,13598.0,7700,21298.0,2940.0,12.13,0.02,High Risk
U581,2024,8,183559.0,Stable Salary & Increasing Fixed Expenses,24238,13598.0,10194,23792.0,446.0,1.84,-0.05,High Risk
U581,2024,9,184005.0,Stable Salary & Increasing Fixed Expenses,24238,13598.0,12190,25788.0,-1550.0,-6.39,0.04,High Risk
U581,2024,10,182455.0,Stable Salary & Increasing Fixed Expenses,24238,13598.0,8449,22047.0,2191.0,9.04,-0.04,High Risk
U581,2024,11,184646.0,Stable Salary & Increasing Fixed Expenses,24238,13598.0,9344,22942.0,1296.0,5.35,-0.02,High Risk
U581,2024,12,185942.0,Stable Salary & Increasing Fixed Expenses,24238,13598.0,7701,21299.0,2939.0,12.13,0.0,High Risk
U582,2024,1,231552.0,Stable Salary & Increasing Fixed Expenses,167875,43702.0,117501,161203.0,6672.0,3.97,0.02,High Risk
U582,2024,2,238224.0,Stable Salary & Increasing Fixed Expenses,167875,43702.0,88698,132400.0,35475.0,21.13,-0.01,Medium Risk
U582,2024,3,273699.0,Stable Salary & Increasing Fixed Expenses,167875,44862.0,84084,128946.0,38929.0,23.19,0.04,Medium Risk
U582,2024,4,312628.0,Stable Salary & Increasing Fixed Expenses,167875,44862.0,116856,161718.0,6157.0,3.67,0.03,High Risk
U582,2024,5,318785.0,Stable Salary & Increasing Fixed Expenses,167875,44862.0,109657,154519.0,13356.0,7.96,0.03,High Risk
U582,2024,6,332141.0,Stable Salary & Increasing Fixed Expenses,167875,46843.0,102280,149123.0,18752.0,11.17,-0.02,High Risk
U582,2024,7,350893.0,Stable Salary & Increasing Fixed Expenses,167875,46843.0,112638,159481.0,8394.0,5.0,0.04,High Risk
U582,2024,8,359287.0,Stable Salary & Increasing Fixed Expenses,167875,46843.0,92339,139182.0,28693.0,17.09,0.01,Medium Risk
U582,2024,9,387980.0,Stable Salary & Increasing Fixed Expenses,167875,46843.0,129997,176840.0,-8965.0,-5.34,0.03,High Risk
U582,2024,10,379015.0,Stable Salary & Increasing Fixed Expenses,167875,46843.0,90070,136913.0,30962.0,18.44,0.01,Medium Risk
U582,2024,11,409977.0,Stable Salary & Increasing Fixed Expenses,167875,46843.0,107282,154125.0,13750.0,8.19,0.02,High Risk
U582,2024,12,423727.0,Stable Salary & Increasing Fixed Expenses,167875,46843.0,101813,148656.0,19219.0,11.45,-0.02,High Risk
U583,2024,1,206787.0,Stable Salary & Increasing Fixed Expenses,133125,66476.0,51310,117786.0,15339.0,11.52,0.03,High Risk
U583,2024,2,222126.0,Stable Salary & Increasing Fixed Expenses,133125,66476.0,55868,122344.0,10781.0,8.1,0.02,High Risk
U583,2024,3,232907.0,Stable Salary & Increasing Fixed Expenses,133125,66476.0,64861,131337.0,1788.0,1.34,0.04,High Risk
U583,2024,4,234695.0,Stable Salary & Increasing Fixed Expenses,133125,66476.0,43864,110340.0,22785.0,17.12,0.03,Medium Risk
U583,2024,5,257480.0,Stable Salary & Increasing Fixed Expenses,133125,66476.0,60057,126533.0,6592.0,4.95,0.01,High Risk
U583,2024,6,264072.0,Stable Salary & Increasing Fixed Expenses,133125,66476.0,59408,125884.0,7241.0,5.44,0.02,High Risk
U583,2024,7,271313.0,Stable Salary & Increasing Fixed Expenses,133125,66476.0,45625,112101.0,21024.0,15.79,0.01,Medium Risk
U583,2024,8,292337.0,Stable Salary & Increasing Fixed Expenses,133125,66476.0,57883,124359.0,8766.0,6.58,0.01,High Risk
U583,2024,9,301103.0,Stable Salary & Increasing Fixed Expenses,133125,66476.0,60578,127054.0,6071.0,4.56,-0.02,High Risk
U583,2024,10,307174.0,Stable Salary & Increasing Fixed Expenses,133125,66476.0,72719,139195.0,-6070.0,-4.56,-0.01,High Risk
U583,2024,11,301104.0,Stable Salary & Increasing Fixed Expenses,133125,66476.0,61370,127846.0,5279.0,3.97,0.01,High Risk
U583,2024,12,306383.0,Stable Salary & Increasing Fixed Expenses,133125,66476.0,66182,132658.0,467.0,0.35,-0.05,High Risk
U584,2024,1,245825.0,Salary Increases & Fixed Expenses Increase,78471,25978.0,21946,47924.0,30547.0,38.93,0.0,Low Risk
U584,2024,2,276372.0,Salary Increases & Fixed Expenses Increase,78471,25978.0,18799,44777.0,33694.0,42.94,0.04,Low Risk
U584,2024,3,310066.0,Salary Increases & Fixed Expenses Increase,78471,25978.0,21837,47815.0,30656.0,39.07,-0.05,Low Risk
U584,2024,4,340722.0,Salary Increases & Fixed Expenses Increase,78471,25978.0,21074,47052.0,31419.0,40.04,-0.04,Low Risk
U584,2024,5,372141.0,Salary Increases & Fixed Expenses Increase,105252,25978.0,26633,52611.0,52641.0,50.01,-0.04,Low Risk
U584,2024,6,424782.0,Salary Increases & Fixed Expenses Increase,105252,25978.0,28760,54738.0,50514.0,47.99,0.05,Low Risk
U584,2024,7,475296.0,Salary Increases & Fixed Expenses Increase,105252,25978.0,31335,57313.0,47939.0,45.55,0.02,Low Risk
U584,2024,8,523235.0,Salary Increases & Fixed Expenses Increase,105252,26762.0,21562,48324.0,56928.0,54.09,-0.05,Low Risk
U584,2024,9,580163.0,Salary Increases & Fixed Expenses Increase,105252,26762.0,30623,57385.0,47867.0,45.48,0.02,Low Risk
U584,2024,10,628030.0,Salary Increases & Fixed Expenses Increase,105252,26762.0,35223,61985.0,43267.0,41.11,0.01,Low Risk
U584,2024,11,671297.0,Salary Increases & Fixed Expenses Increase,105252,26762.0,29520,56282.0,48970.0,46.53,-0.03,Low Risk
U584,2024,12,720267.0,Salary Increases & Fixed Expenses Increase,105252,26762.0,37263,64025.0,41227.0,39.17,-0.05,Low Risk
U585,2024,1,198175.0,Stable Salary & Increasing Fixed Expenses,196880,56394.0,66084,122478.0,74402.0,37.79,0.03,Low Risk
U585,2024,2,272577.0,Stable Salary & Increasing Fixed Expenses,196880,56394.0,95066,151460.0,45420.0,23.07,-0.02,Medium Risk
U585,2024,3,317997.0,Stable Salary & Increasing Fixed Expenses,196880,57769.0,81246,139015.0,57865.0,29.39,-0.03,Low Risk
U585,2024,4,375862.0,Stable Salary & Increasing Fixed Expenses,196880,57769.0,93867,151636.0,45244.0,22.98,0.04,Medium Risk
U585,2024,5,421106.0,Stable Salary & Increasing Fixed Expenses,196880,57769.0,71852,129621.0,67259.0,34.16,-0.02,Low Risk
U585,2024,6,488365.0,Stable Salary & Increasing Fixed Expenses,196880,57769.0,77592,135361.0,61519.0,31.25,-0.01,Low Risk
U585,2024,7,549884.0,Stable Salary & Increasing Fixed Expenses,196880,59762.0,71021,130783.0,66097.0,33.57,0.0,Low Risk
U585,2024,8,615981.0,Stable Salary & Increasing Fixed Expenses,196880,59762.0,69957,129719.0,67161.0,34.11,-0.02,Low Risk
U585,2024,9,683142.0,Stable Salary & Increasing Fixed Expenses,196880,59762.0,85698,145460.0,51420.0,26.12,-0.05,Low Risk
U585,2024,10,734562.0,Stable Salary & Increasing Fixed Expenses,196880,59762.0,74651,134413.0,62467.0,31.73,-0.01,Low Risk
U585,2024,11,797029.0,Stable Salary & Increasing Fixed Expenses,196880,59762.0,71652,131414.0,65466.0,33.25,-0.04,Low Risk
U585,2024,12,862495.0,Stable Salary & Increasing Fixed Expenses,196880,59762.0,97033,156795.0,40085.0,20.36,-0.03,Medium Risk
U586,2024,1,222736.0,Stable Salary & Decreasing Fixed Expenses,205685,113564.0,98183,211747.0,-6062.0,-2.95,0.01,High Risk
U586,2024,2,216674.0,Stable Salary & Decreasing Fixed Expenses,205685,113564.0,86354,199918.0,5767.0,2.8,-0.05,High Risk
U586,2024,3,222441.0,Stable Salary & Decreasing Fixed Expenses,205685,113564.0,67932,181496.0,24189.0,11.76,-0.04,High Risk
U586,2024,4,246630.0,Stable Salary & Decreasing Fixed Expenses,205685,113564.0,64216,177780.0,27905.0,13.57,0.02,High Risk
U586,2024,5,274535.0,Stable Salary & Decreasing Fixed Expenses,205685,113564.0,86746,200310.0,5375.0,2.61,0.02,High Risk
U586,2024,6,279910.0,Stable Salary & Decreasing Fixed Expenses,205685,113564.0,79894,193458.0,12227.0,5.94,0.03,High Risk
U586,2024,7,292137.0,Stable Salary & Decreasing Fixed Expenses,205685,113564.0,92983,206547.0,-862.0,-0.42,-0.03,High Risk
U586,2024,8,291275.0,Stable Salary & Decreasing Fixed Expenses,205685,113564.0,74415,187979.0,17706.0,8.61,0.03,High Risk
U586,2024,9,308981.0,Stable Salary & Decreasing Fixed Expenses,205685,113564.0,81446,195010.0,10675.0,5.19,0.02,High Risk
U586,2024,10,319656.0,Stable Salary & Decreasing Fixed Expenses,205685,113564.0,77530,191094.0,14591.0,7.09,0.0,High Risk
U586,2024,11,334247.0,Stable Salary & Decreasing Fixed Expenses,205685,113564.0,69050,182614.0,23071.0,11.22,-0.04,High Risk
U586,2024,12,357318.0,Stable Salary & Decreasing Fixed Expenses,205685,113564.0,62910,176474.0,29211.0,14.2,0.04,High Risk
U587,2024,1,186536.0,Salary Increases & Fixed Expenses Remain Stable,52589,28113.0,13938,42051.0,10538.0,20.04,-0.03,Medium Risk
U587,2024,2,197074.0,Salary Increases & Fixed Expenses Remain Stable,52589,28113.0,13214,41327.0,11262.0,21.42,-0.04,Medium Risk
U587,2024,3,208336.0,Salary Increases & Fixed Expenses Remain Stable,68852,28113.0,19913,48026.0,20826.0,30.25,0.01,Low Risk
U587,2024,4,229162.0,Salary Increases & Fixed Expenses Remain Stable,68852,28113.0,14065,42178.0,26674.0,38.74,0.01,Low Risk
U587,2024,5,255836.0,Salary Increases & Fixed Expenses Remain Stable,68852,28113.0,17066,45179.0,23673.0,34.38,-0.04,Low Risk
U587,2024,6,279509.0,Salary Increases & Fixed Expenses Remain Stable,68852,28113.0,20288,48401.0,20451.0,29.7,-0.02,Low Risk
U587,2024,7,299960.0,Salary Increases & Fixed Expenses Remain Stable,68852,28113.0,15254,43367.0,25485.0,37.01,0.01,Low Risk
U587,2024,8,325445.0,Salary Increases & Fixed Expenses Remain Stable,68852,28113.0,17460,45573.0,23279.0,33.81,-0.01,Low Risk
U587,2024,9,348724.0,Salary Increases & Fixed Expenses Remain Stable,68852,28113.0,17557,45670.0,23182.0,33.67,0.03,Low Risk
U587,2024,10,371906.0,Salary Increases & Fixed Expenses Remain Stable,68852,28113.0,16824,44937.0,23915.0,34.73,0.01,Low Risk
U587,2024,11,395821.0,Salary Increases & Fixed Expenses Remain Stable,68852,28113.0,21263,49376.0,19476.0,28.29,-0.01,Low Risk
U587,2024,12,415297.0,Salary Increases & Fixed Expenses Remain Stable,68852,28113.0,20428,48541.0,20311.0,29.5,-0.02,Low Risk
U588,2024,1,235674.0,Salary Increases & Fixed Expenses Increase,96783,29471.0,38287,67758.0,29025.0,29.99,-0.03,Low Risk
U588,2024,2,264699.0,Salary Increases & Fixed Expenses Increase,96783,29471.0,47123,76594.0,20189.0,20.86,0.05,Medium Risk
U588,2024,3,284888.0,Salary Increases & Fixed Expenses Increase,96783,29471.0,33940,63411.0,33372.0,34.48,0.02,Low Risk
U588,2024,4,318260.0,Salary Increases & Fixed Expenses Increase,96783,29471.0,37686,67157.0,29626.0,30.61,0.02,Low Risk
U588,2024,5,347886.0,Salary Increases & Fixed Expenses Increase,96783,30337.0,36249,66586.0,30197.0,31.2,0.04,Low Risk
U588,2024,6,378083.0,Salary Increases & Fixed Expenses Increase,119832,30337.0,46871,77208.0,42624.0,35.57,0.03,Low Risk
U588,2024,7,420707.0,Salary Increases & Fixed Expenses Increase,119832,30337.0,53512,83849.0,35983.0,30.03,-0.02,Low Risk
U588,2024,8,456690.0,Salary Increases & Fixed Expenses Increase,119832,30337.0,41671,72008.0,47824.0,39.91,-0.0,Low Risk
U588,2024,9,504514.0,Salary Increases & Fixed Expenses Increase,119832,32052.0,51759,83811.0,36021.0,30.06,-0.02,Low Risk
U588,2024,10,540535.0,Salary Increases & Fixed Expenses Increase,119832,32052.0,43489,75541.0,44291.0,36.96,0.0,Low Risk
U588,2024,11,584826.0,Salary Increases & Fixed Expenses Increase,119832,33316.0,57387,90703.0,29129.0,24.31,0.02,Medium Risk
U588,2024,12,613955.0,Salary Increases & Fixed Expenses Increase,119832,33316.0,46579,79895.0,39937.0,33.33,0.02,Low Risk
U589,2024,1,203254.0,Stable Salary & Increasing Fixed Expenses,174037,66732.0,110830,177562.0,-3525.0,-2.03,0.01,High Risk
U589,2024,2,199729.0,Stable Salary & Increasing Fixed Expenses,174037,66732.0,112098,178830.0,-4793.0,-2.75,0.04,High Risk
U589,2024,3,194936.0,Stable Salary & Increasing Fixed Expenses,174037,66732.0,104508,171240.0,2797.0,1.61,-0.04,High Risk
U589,2024,4,197733.0,Stable Salary & Increasing Fixed Expenses,174037,66732.0,95940,162672.0,11365.0,6.53,0.04,High Risk
U589,2024,5,209098.0,Stable Salary & Increasing Fixed Expenses,174037,66732.0,99500,166232.0,7805.0,4.48,-0.01,High Risk
U589,2024,6,216903.0,Stable Salary & Increasing Fixed Expenses,174037,66732.0,102834,169566.0,4471.0,2.57,-0.04,High Risk
U589,2024,7,221374.0,Stable Salary & Increasing Fixed Expenses,174037,66732.0,104192,170924.0,3113.0,1.79,0.04,High Risk
U589,2024,8,224487.0,Stable Salary & Increasing Fixed Expenses,174037,66732.0,113164,179896.0,-5859.0,-3.37,-0.01,High Risk
U589,2024,9,218628.0,Stable Salary & Increasing Fixed Expenses,174037,66732.0,95627,162359.0,11678.0,6.71,-0.04,High Risk
U589,2024,10,230306.0,Stable Salary & Increasing Fixed Expenses,174037,66732.0,96062,162794.0,11243.0,6.46,-0.04,High Risk
U589,2024,11,241549.0,Stable Salary & Increasing Fixed Expenses,174037,66732.0,94751,161483.0,12554.0,7.21,0.02,High Risk
U589,2024,12,254103.0,Stable Salary & Increasing Fixed Expenses,174037,66732.0,91319,158051.0,15986.0,9.19,-0.04,High Risk
U590,2024,1,241205.0,Salary Increases & Fixed Expenses Increase,154023,53570.0,44547,98117.0,55906.0,36.3,-0.0,Low Risk
U590,2024,2,297111.0,Salary Increases & Fixed Expenses Increase,154023,53570.0,43422,96992.0,57031.0,37.03,0.0,Low Risk
U590,2024,3,354142.0,Salary Increases & Fixed Expenses Increase,178439,53570.0,41320,94890.0,83549.0,46.82,0.01,Low Risk
U590,2024,4,437691.0,Salary Increases & Fixed Expenses Increase,178439,53570.0,36057,89627.0,88812.0,49.77,0.03,Low Risk
U590,2024,5,526503.0,Salary Increases & Fixed Expenses Increase,178439,53570.0,43993,97563.0,80876.0,45.32,0.03,Low Risk
U590,2024,6,607379.0,Salary Increases & Fixed Expenses Increase,178439,53570.0,45119,98689.0,79750.0,44.69,0.03,Low Risk
U590,2024,7,687129.0,Salary Increases & Fixed Expenses Increase,178439,53570.0,37355,90925.0,87514.0,49.04,0.03,Low Risk
U590,2024,8,774643.0,Salary Increases & Fixed Expenses Increase,178439,53570.0,51596,105166.0,73273.0,41.06,-0.03,Low Risk
U590,2024,9,847916.0,Salary Increases & Fixed Expenses Increase,178439,53570.0,39589,93159.0,85280.0,47.79,0.0,Low Risk
U590,2024,10,933196.0,Salary Increases & Fixed Expenses Increase,178439,53570.0,49849,103419.0,75020.0,42.04,-0.02,Low Risk
U590,2024,11,1008216.0,Salary Increases & Fixed Expenses Increase,178439,53570.0,42449,96019.0,82420.0,46.19,0.04,Low Risk
U590,2024,12,1090636.0,Salary Increases & Fixed Expenses Increase,178439,53570.0,46689,100259.0,78180.0,43.81,-0.01,Low Risk
U591,2024,1,195838.0,Salary Increases & Fixed Expenses Increase,77133,27904.0,17850,45754.0,31379.0,40.68,-0.03,Low Risk
U591,2024,2,227217.0,Salary Increases & Fixed Expenses Increase,77133,27904.0,20245,48149.0,28984.0,37.58,-0.04,Low Risk
U591,2024,3,256201.0,Salary Increases & Fixed Expenses Increase,77133,27904.0,22014,49918.0,27215.0,35.28,-0.02,Low Risk
U591,2024,4,283416.0,Salary Increases & Fixed Expenses Increase,77133,29075.0,20610,49685.0,27448.0,35.59,-0.04,Low Risk
U591,2024,5,310864.0,Salary Increases & Fixed Expenses Increase,77133,29075.0,22586,51661.0,25472.0,33.02,0.04,Low Risk
U591,2024,6,336336.0,Salary Increases & Fixed Expenses Increase,77133,30552.0,21071,51623.0,25510.0,33.07,-0.04,Low Risk
U591,2024,7,361846.0,Salary Increases & Fixed Expenses Increase,77133,30552.0,22329,52881.0,24252.0,31.44,0.02,Low Risk
U591,2024,8,386098.0,Salary Increases & Fixed Expenses Increase,82844,30552.0,19505,50057.0,32787.0,39.58,-0.0,Low Risk
U591,2024,9,418885.0,Salary Increases & Fixed Expenses Increase,82844,30552.0,21963,52515.0,30329.0,36.61,-0.04,Low Risk
U591,2024,10,449214.0,Salary Increases & Fixed Expenses Increase,82844,30552.0,23143,53695.0,29149.0,35.19,-0.03,Low Risk
U591,2024,11,478363.0,Salary Increases & Fixed Expenses Increase,82844,30552.0,22950,53502.0,29342.0,35.42,0.01,Low Risk
U591,2024,12,507705.0,Salary Increases & Fixed Expenses Increase,82844,30552.0,22964,53516.0,29328.0,35.4,0.03,Low Risk
U592,2024,1,250000.0,Stable Salary & Stable Fixed Expenses,277159,114943.0,81581,196524.0,80635.0,29.09,0.05,Low Risk
U592,2024,2,330635.0,Stable Salary & Stable Fixed Expenses,277159,114943.0,63081,178024.0,99135.0,35.77,-0.04,Low Risk
U592,2024,3,429770.0,Stable Salary & Stable Fixed Expenses,277159,114943.0,77329,192272.0,84887.0,30.63,-0.03,Low Risk
U592,2024,4,514657.0,Stable Salary & Stable Fixed Expenses,277159,114943.0,79083,194026.0,83133.0,29.99,-0.03,Low Risk
U592,2024,5,597790.0,Stable Salary & Stable Fixed Expenses,277159,114943.0,74915,189858.0,87301.0,31.5,0.01,Low Risk
U592,2024,6,685091.0,Stable Salary & Stable Fixed Expenses,277159,114943.0,58321,173264.0,103895.0,37.49,0.03,Low Risk
U592,2024,7,788986.0,Stable Salary & Stable Fixed Expenses,277159,114943.0,81626,196569.0,80590.0,29.08,0.0,Low Risk
U592,2024,8,869576.0,Stable Salary & Stable Fixed Expenses,277159,114943.0,59286,174229.0,102930.0,37.14,-0.01,Low Risk
U592,2024,9,972506.0,Stable Salary & Stable Fixed Expenses,277159,114943.0,68717,183660.0,93499.0,33.73,-0.0,Low Risk
U592,2024,10,1066005.0,Stable Salary & Stable Fixed Expenses,277159,114943.0,58425,173368.0,103791.0,37.45,0.0,Low Risk
U592,2024,11,1169796.0,Stable Salary & Stable Fixed Expenses,277159,114943.0,82703,197646.0,79513.0,28.69,0.02,Low Risk
U592,2024,12,1249309.0,Stable Salary & Stable Fixed Expenses,277159,114943.0,56537,171480.0,105679.0,38.13,-0.03,Low Risk
U593,2024,1,250000.0,Salary Increases & Fixed Expenses Increase,252947,91140.0,109420,200560.0,52387.0,20.71,-0.05,Medium Risk
U593,2024,2,302387.0,Salary Increases & Fixed Expenses Increase,252947,91140.0,87236,178376.0,74571.0,29.48,0.02,Low Risk
U593,2024,3,376958.0,Salary Increases & Fixed Expenses Increase,270084,91140.0,109210,200350.0,69734.0,25.82,-0.05,Low Risk
U593,2024,4,446692.0,Salary Increases & Fixed Expenses Increase,270084,91140.0,125149,216289.0,53795.0,19.92,-0.0,Medium Risk
U593,2024,5,500487.0,Salary Increases & Fixed Expenses Increase,270084,91140.0,98862,190002.0,80082.0,29.65,0.05,Low Risk
U593,2024,6,580569.0,Salary Increases & Fixed Expenses Increase,270084,91140.0,106229,197369.0,72715.0,26.92,-0.04,Low Risk
U593,2024,7,653284.0,Salary Increases & Fixed Expenses Increase,270084,91140.0,113743,204883.0,65201.0,24.14,0.01,Medium Risk
U593,2024,8,718485.0,Salary Increases & Fixed Expenses Increase,270084,91140.0,91898,183038.0,87046.0,32.23,0.03,Low Risk
U593,2024,9,805531.0,Salary Increases & Fixed Expenses Increase,270084,91140.0,131703,222843.0,47241.0,17.49,-0.02,Medium Risk
U593,2024,10,852772.0,Salary Increases & Fixed Expenses Increase,270084,91140.0,92497,183637.0,86447.0,32.01,0.03,Low Risk
U593,2024,11,939219.0,Salary Increases & Fixed Expenses Increase,270084,91140.0,86149,177289.0,92795.0,34.36,-0.03,Low Risk
U593,2024,12,1032014.0,Salary Increases & Fixed Expenses Increase,270084,91140.0,128144,219284.0,50800.0,18.81,0.0,Medium Risk
U594,2024,1,250000.0,Stable Salary & Stable Fixed Expenses,297609,112887.0,74036,186923.0,110686.0,37.19,-0.01,Low Risk
U594,2024,2,360686.0,Stable Salary & Stable Fixed Expenses,297609,112887.0,73893,186780.0,110829.0,37.24,-0.03,Low Risk
U594,2024,3,471515.0,Stable Salary & Stable Fixed Expenses,297609,112887.0,74562,187449.0,110160.0,37.02,0.01,Low Risk
U594,2024,4,581675.0,Stable Salary & Stable Fixed Expenses,297609,112887.0,85434,198321.0,99288.0,33.36,0.02,Low Risk
U594,2024,5,680963.0,Stable Salary & Stable Fixed Expenses,297609,112887.0,82071,194958.0,102651.0,34.49,-0.01,Low Risk
U594,2024,6,783614.0,Stable Salary & Stable Fixed Expenses,297609,112887.0,78578,191465.0,106144.0,35.67,0.0,Low Risk
U594,2024,7,889758.0,Stable Salary & Stable Fixed Expenses,297609,112887.0,70294,183181.0,114428.0,38.45,-0.02,Low Risk
U594,2024,8,1004186.0,Stable Salary & Stable Fixed Expenses,297609,112887.0,78836,191723.0,105886.0,35.58,-0.02,Low Risk
U594,2024,9,1110072.0,Stable Salary & Stable Fixed Expenses,297609,112887.0,89670,202557.0,95052.0,31.94,0.02,Low Risk
U594,2024,10,1205124.0,Stable Salary & Stable Fixed Expenses,297609,112887.0,62176,175063.0,122546.0,41.18,-0.0,Low Risk
U594,2024,11,1327670.0,Stable Salary & Stable Fixed Expenses,297609,112887.0,78768,191655.0,105954.0,35.6,0.04,Low Risk
U594,2024,12,1433624.0,Stable Salary & Stable Fixed Expenses,297609,112887.0,75949,188836.0,108773.0,36.55,-0.01,Low Risk
U595,2024,1,218530.0,Salary Increases & Fixed Expenses Remain Stable,180528,76160.0,120026,196186.0,-15658.0,-8.67,-0.04,High Risk
U595,2024,2,202872.0,Salary Increases & Fixed Expenses Remain Stable,180528,76160.0,94820,170980.0,9548.0,5.29,0.03,High Risk
U595,2024,3,212420.0,Salary Increases & Fixed Expenses Remain Stable,180528,76160.0,108142,184302.0,-3774.0,-2.09,-0.03,High Risk
U595,2024,4,208646.0,Salary Increases & Fixed Expenses Remain Stable,180528,76160.0,108764,184924.0,-4396.0,-2.44,-0.03,High Risk
U595,2024,5,204250.0,Salary Increases & Fixed Expenses Remain Stable,180528,76160.0,92335,168495.0,12033.0,6.67,0.01,High Risk
U595,2024,6,216283.0,Salary Increases & Fixed Expenses Remain Stable,180528,76160.0,95350,171510.0,9018.0,5.0,0.01,High Risk
U595,2024,7,225301.0,Salary Increases & Fixed Expenses Remain Stable,205304,76160.0,131672,207832.0,-2528.0,-1.23,-0.03,High Risk
U595,2024,8,222773.0,Salary Increases & Fixed Expenses Remain Stable,205304,76160.0,119548,195708.0,9596.0,4.67,0.03,High Risk
U595,2024,9,232369.0,Salary Increases & Fixed Expenses Remain Stable,205304,76160.0,127880,204040.0,1264.0,0.62,-0.02,High Risk
U595,2024,10,233633.0,Salary Increases & Fixed Expenses Remain Stable,205304,76160.0,103355,179515.0,25789.0,12.56,-0.02,High Risk
U595,2024,11,259422.0,Salary Increases & Fixed Expenses Remain Stable,205304,76160.0,153529,229689.0,-24385.0,-11.88,-0.04,High Risk
U595,2024,12,235037.0,Salary Increases & Fixed Expenses Remain Stable,205304,76160.0,118771,194931.0,10373.0,5.05,-0.01,High Risk
U596,2024,1,111627.0,Salary Increases & Fixed Expenses Remain Stable,47515,12715.0,14452,27167.0,20348.0,42.82,0.03,Low Risk
U596,2024,2,131975.0,Salary Increases & Fixed Expenses Remain Stable,47515,12715.0,17657,30372.0,17143.0,36.08,-0.02,Low Risk
U596,2024,3,149118.0,Salary Increases & Fixed Expenses Remain Stable,47515,12715.0,20332,33047.0,14468.0,30.45,-0.02,Low Risk
U596,2024,4,163586.0,Salary Increases & Fixed Expenses Remain Stable,47515,12715.0,21919,34634.0,12881.0,27.11,-0.01,Low Risk
U596,2024,5,176467.0,Salary Increases & Fixed Expenses Remain Stable,66849,12715.0,21847,34562.0,32287.0,48.3,0.04,Low Risk
U596,2024,6,208754.0,Salary Increases & Fixed Expenses Remain Stable,66849,12715.0,22674,35389.0,31460.0,47.06,0.04,Low Risk
U596,2024,7,240214.0,Salary Increases & Fixed Expenses Remain Stable,66849,12715.0,20130,32845.0,34004.0,50.87,0.01,Low Risk
U596,2024,8,274218.0,Salary Increases & Fixed Expenses Remain Stable,66849,12715.0,24959,37674.0,29175.0,43.64,-0.01,Low Risk
U596,2024,9,303393.0,Salary Increases & Fixed Expenses Remain Stable,66849,12715.0,34718,47433.0,19416.0,29.04,-0.03,Low Risk
U596,2024,10,322809.0,Salary Increases & Fixed Expenses Remain Stable,66849,12715.0,27949,40664.0,26185.0,39.17,0.04,Low Risk
U596,2024,11,348994.0,Salary Increases & Fixed Expenses Remain Stable,66849,12715.0,26432,39147.0,27702.0,41.44,0.02,Low Risk
U596,2024,12,376696.0,Salary Increases & Fixed Expenses Remain Stable,66849,12715.0,28429,41144.0,25705.0,38.45,0.04,Low Risk
U597,2024,1,225461.0,Stable Salary & Stable Fixed Expenses,212553,90140.0,83919,174059.0,38494.0,18.11,-0.03,Medium Risk
U597,2024,2,263955.0,Stable Salary & Stable Fixed Expenses,212553,90140.0,89306,179446.0,33107.0,15.58,-0.04,Medium Risk
U597,2024,3,297062.0,Stable Salary & Stable Fixed Expenses,212553,90140.0,81676,171816.0,40737.0,19.17,-0.04,Medium Risk
U597,2024,4,337799.0,Stable Salary & Stable Fixed Expenses,212553,90140.0,89908,180048.0,32505.0,15.29,-0.02,Medium Risk
U597,2024,5,370304.0,Stable Salary & Stable Fixed Expenses,212553,90140.0,69809,159949.0,52604.0,24.75,0.03,Medium Risk
U597,2024,6,422908.0,Stable Salary & Stable Fixed Expenses,212553,90140.0,86906,177046.0,35507.0,16.71,0.0,Medium Risk
U597,2024,7,458415.0,Stable Salary & Stable Fixed Expenses,212553,90140.0,87155,177295.0,35258.0,16.59,0.02,Medium Risk
U597,2024,8,493673.0,Stable Salary & Stable Fixed Expenses,212553,90140.0,82130,172270.0,40283.0,18.95,-0.0,Medium Risk
U597,2024,9,533956.0,Stable Salary & Stable Fixed Expenses,212553,90140.0,100279,190419.0,22134.0,10.41,-0.04,High Risk
U597,2024,10,556090.0,Stable Salary & Stable Fixed Expenses,212553,90140.0,105697,195837.0,16716.0,7.86,-0.0,High Risk
U597,2024,11,572806.0,Stable Salary & Stable Fixed Expenses,212553,90140.0,105480,195620.0,16933.0,7.97,-0.02,High Risk
U597,2024,12,589739.0,Stable Salary & Stable Fixed Expenses,212553,90140.0,95053,185193.0,27360.0,12.87,-0.02,High Risk
U598,2024,1,207865.0,Salary Increases & Fixed Expenses Remain Stable,167758,47331.0,85587,132918.0,34840.0,20.77,0.02,Medium Risk
U598,2024,2,242705.0,Salary Increases & Fixed Expenses Remain Stable,167758,47331.0,109372,156703.0,11055.0,6.59,-0.04,High Risk
U598,2024,3,253760.0,Salary Increases & Fixed Expenses Remain Stable,167758,47331.0,102090,149421.0,18337.0,10.93,0.05,High Risk
U598,2024,4,272097.0,Salary Increases & Fixed Expenses Remain Stable,178828,47331.0,101981,149312.0,29516.0,16.51,0.03,Medium Risk
U598,2024,5,301613.0,Salary Increases & Fixed Expenses Remain Stable,178828,47331.0,116012,163343.0,15485.0,8.66,0.04,High Risk
U598,2024,6,317098.0,Salary Increases & Fixed Expenses Remain Stable,178828,47331.0,96588,143919.0,34909.0,19.52,0.03,Medium Risk
U598,2024,7,352007.0,Salary Increases & Fixed Expenses Remain Stable,178828,47331.0,113119,160450.0,18378.0,10.28,0.03,High Risk
U598,2024,8,370385.0,Salary Increases & Fixed Expenses Remain Stable,178828,47331.0,97332,144663.0,34165.0,19.1,-0.04,Medium Risk
U598,2024,9,404550.0,Salary Increases & Fixed Expenses Remain Stable,178828,47331.0,104821,152152.0,26676.0,14.92,0.0,High Risk
U598,2024,10,431226.0,Salary Increases & Fixed Expenses Remain Stable,178828,47331.0,115997,163328.0,15500.0,8.67,0.01,High Risk
U598,2024,11,446726.0,Salary Increases & Fixed Expenses Remain Stable,178828,47331.0,121765,169096.0,9732.0,5.44,0.03,High Risk
U598,2024,12,456458.0,Salary Increases & Fixed Expenses Remain Stable,178828,47331.0,110770,158101.0,20727.0,11.59,0.02,High Risk
U599,2024,1,231068.0,Salary Increases & Fixed Expenses Increase,188253,77712.0,40913,118625.0,69628.0,36.99,-0.04,Low Risk
U599,2024,2,300696.0,Salary Increases & Fixed Expenses Increase,188253,77712.0,45730,123442.0,64811.0,34.43,-0.01,Low Risk
U599,2024,3,365507.0,Salary Increases & Fixed Expenses Increase,188253,77712.0,61769,139481.0,48772.0,25.91,0.0,Low Risk
U599,2024,4,414279.0,Salary Increases & Fixed Expenses Increase,188253,77712.0,42283,119995.0,68258.0,36.26,-0.03,Low Risk
U599,2024,5,482537.0,Salary Increases & Fixed Expenses Increase,188253,79474.0,39164,118638.0,69615.0,36.98,0.02,Low Risk
U599,2024,6,552152.0,Salary Increases & Fixed Expenses Increase,188253,81275.0,51088,132363.0,55890.0,29.69,0.03,Low Risk
U599,2024,7,608042.0,Salary Increases & Fixed Expenses Increase,199407,81275.0,58530,139805.0,59602.0,29.89,-0.04,Low Risk
U599,2024,8,667644.0,Salary Increases & Fixed Expenses Increase,199407,81275.0,54666,135941.0,63466.0,31.83,-0.03,Low Risk
U599,2024,9,731110.0,Salary Increases & Fixed Expenses Increase,199407,81275.0,46801,128076.0,71331.0,35.77,0.05,Low Risk
U599,2024,10,802441.0,Salary Increases & Fixed Expenses Increase,199407,81275.0,74722,155997.0,43410.0,21.77,0.03,Medium Risk
U599,2024,11,845851.0,Salary Increases & Fixed Expenses Increase,199407,81275.0,45664,126939.0,72468.0,36.34,0.04,Low Risk
U599,2024,12,918319.0,Salary Increases & Fixed Expenses Increase,199407,81275.0,51187,132462.0,66945.0,33.57,0.01,Low Risk
U600,2024,1,246344.0,Salary Increases & Fixed Expenses Remain Stable,243351,75797.0,112730,188527.0,54824.0,22.53,-0.0,Medium Risk
U600,2024,2,301168.0,Salary Increases & Fixed Expenses Remain Stable,243351,75797.0,116026,191823.0,51528.0,21.17,-0.02,Medium Risk
U600,2024,3,352696.0,Salary Increases & Fixed Expenses Remain Stable,243351,75797.0,105692,181489.0,61862.0,25.42,-0.01,Low Risk
U600,2024,4,414558.0,Salary Increases & Fixed Expenses Remain Stable,243351,75797.0,101100,176897.0,66454.0,27.31,-0.02,Low Risk
U600,2024,5,481012.0,Salary Increases & Fixed Expenses Remain Stable,243351,75797.0,84952,160749.0,82602.0,33.94,-0.04,Low Risk
U600,2024,6,563614.0,Salary Increases & Fixed Expenses Remain Stable,243351,75797.0,109541,185338.0,58013.0,23.84,-0.02,Medium Risk
U600,2024,7,621627.0,Salary Increases & Fixed Expenses Remain Stable,243351,75797.0,79260,155057.0,88294.0,36.28,0.02,Low Risk
U600,2024,8,709921.0,Salary Increases & Fixed Expenses Remain Stable,269965,75797.0,132586,208383.0,61582.0,22.81,-0.01,Medium Risk
U600,2024,9,771503.0,Salary Increases & Fixed Expenses Remain Stable,269965,75797.0,99305,175102.0,94863.0,35.14,0.04,Low Risk
U600,2024,10,866366.0,Salary Increases & Fixed Expenses Remain Stable,269965,75797.0,115698,191495.0,78470.0,29.07,-0.04,Low Risk
U600,2024,11,944836.0,Salary Increases & Fixed Expenses Remain Stable,269965,75797.0,100995,176792.0,93173.0,34.51,-0.03,Low Risk
U600,2024,12,1038009.0,Salary Increases & Fixed Expenses Remain Stable,269965,75797.0,103021,178818.0,91147.0,33.76,-0.01,Low Risk
U601,2024,1,189337.0,Salary Increases & Fixed Expenses Remain Stable,116615,55315.0,23878,79193.0,37422.0,32.09,0.04,Low Risk
U601,2024,2,226759.0,Salary Increases & Fixed Expenses Remain Stable,116615,55315.0,26131,81446.0,35169.0,30.16,0.05,Low Risk
U601,2024,3,261928.0,Salary Increases & Fixed Expenses Remain Stable,116615,55315.0,31813,87128.0,29487.0,25.29,0.01,Low Risk
U601,2024,4,291415.0,Salary Increases & Fixed Expenses Remain Stable,125325,55315.0,35685,91000.0,34325.0,27.39,0.04,Low Risk
U601,2024,5,325740.0,Salary Increases & Fixed Expenses Remain Stable,125325,55315.0,32370,87685.0,37640.0,30.03,0.03,Low Risk
U601,2024,6,363380.0,Salary Increases & Fixed Expenses Remain Stable,125325,55315.0,25366,80681.0,44644.0,35.62,-0.03,Low Risk
U601,2024,7,408024.0,Salary Increases & Fixed Expenses Remain Stable,125325,55315.0,31028,86343.0,38982.0,31.1,0.01,Low Risk
U601,2024,8,447006.0,Salary Increases & Fixed Expenses Remain Stable,125325,55315.0,35034,90349.0,34976.0,27.91,0.02,Low Risk
U601,2024,9,481982.0,Salary Increases & Fixed Expenses Remain Stable,125325,55315.0,30445,85760.0,39565.0,31.57,-0.03,Low Risk
U601,2024,10,521547.0,Salary Increases & Fixed Expenses Remain Stable,125325,55315.0,37779,93094.0,32231.0,25.72,0.05,Low Risk
U601,2024,11,553778.0,Salary Increases & Fixed Expenses Remain Stable,125325,55315.0,31726,87041.0,38284.0,30.55,0.03,Low Risk
U601,2024,12,592062.0,Salary Increases & Fixed Expenses Remain Stable,125325,55315.0,29045,84360.0,40965.0,32.69,-0.04,Low Risk
U602,2024,1,130043.0,Salary Increases & Fixed Expenses Increase,27656,12073.0,8453,20526.0,7130.0,25.78,0.05,Low Risk
U602,2024,2,137173.0,Salary Increases & Fixed Expenses Increase,27656,12073.0,8503,20576.0,7080.0,25.6,0.03,Low Risk
U602,2024,3,144253.0,Salary Increases & Fixed Expenses Increase,39173,12073.0,13618,25691.0,13482.0,34.42,0.04,Low Risk
U602,2024,4,157735.0,Salary Increases & Fixed Expenses Increase,39173,13108.0,14280,27388.0,11785.0,30.08,-0.03,Low Risk
U602,2024,5,169520.0,Salary Increases & Fixed Expenses Increase,39173,13108.0,12342,25450.0,13723.0,35.03,-0.03,Low Risk
U602,2024,6,183243.0,Salary Increases & Fixed Expenses Increase,39173,13108.0,16469,29577.0,9596.0,24.5,-0.03,Medium Risk
U602,2024,7,192839.0,Salary Increases & Fixed Expenses Increase,39173,13108.0,16938,30046.0,9127.0,23.3,0.03,Medium Risk
U602,2024,8,201966.0,Salary Increases & Fixed Expenses Increase,39173,13108.0,12557,25665.0,13508.0,34.48,0.01,Low Risk
U602,2024,9,215474.0,Salary Increases & Fixed Expenses Increase,39173,14338.0,19959,34297.0,4876.0,12.45,-0.03,High Risk
U602,2024,10,220350.0,Salary Increases & Fixed Expenses Increase,39173,16243.0,17753,33996.0,5177.0,13.22,-0.04,High Risk
U602,2024,11,225527.0,Salary Increases & Fixed Expenses Increase,39173,16243.0,16433,32676.0,6497.0,16.59,-0.03,Medium Risk
U602,2024,12,232024.0,Salary Increases & Fixed Expenses Increase,39173,16243.0,17328,33571.0,5602.0,14.3,-0.0,High Risk
U603,2024,1,250000.0,Salary Increases & Fixed Expenses Increase,270384,86852.0,85292,172144.0,98240.0,36.33,0.03,Low Risk
U603,2024,2,348240.0,Salary Increases & Fixed Expenses Increase,270384,86852.0,119670,206522.0,63862.0,23.62,-0.02,Medium Risk
U603,2024,3,412102.0,Salary Increases & Fixed Expenses Increase,270384,87644.0,88133,175777.0,94607.0,34.99,0.01,Low Risk
U603,2024,4,506709.0,Salary Increases & Fixed Expenses Increase,270384,87644.0,134615,222259.0,48125.0,17.8,-0.04,Medium Risk
U603,2024,5,554834.0,Salary Increases & Fixed Expenses Increase,270384,87644.0,121871,209515.0,60869.0,22.51,-0.0,Medium Risk
U603,2024,6,615703.0,Salary Increases & Fixed Expenses Increase,291289,87644.0,137413,225057.0,66232.0,22.74,0.04,Medium Risk
U603,2024,7,681935.0,Salary Increases & Fixed Expenses Increase,291289,88538.0,90751,179289.0,112000.0,38.45,0.02,Low Risk
U603,2024,8,793935.0,Salary Increases & Fixed Expenses Increase,291289,88538.0,129973,218511.0,72778.0,24.98,0.01,Medium Risk
U603,2024,9,866713.0,Salary Increases & Fixed Expenses Increase,291289,88538.0,110174,198712.0,92577.0,31.78,0.04,Low Risk
U603,2024,10,959290.0,Salary Increases & Fixed Expenses Increase,291289,88538.0,120537,209075.0,82214.0,28.22,-0.01,Low Risk
U603,2024,11,1041504.0,Salary Increases & Fixed Expenses Increase,291289,88538.0,125092,213630.0,77659.0,26.66,-0.03,Low Risk
U603,2024,12,1119163.0,Salary Increases & Fixed Expenses Increase,291289,88538.0,142984,231522.0,59767.0,20.52,-0.04,Medium Risk
U604,2024,1,71171.0,Stable Salary & Stable Fixed Expenses,64439,31481.0,19705,51186.0,13253.0,20.57,-0.04,Medium Risk
U604,2024,2,84424.0,Stable Salary & Stable Fixed Expenses,64439,31481.0,25579,57060.0,7379.0,11.45,0.01,High Risk
U604,2024,3,91803.0,Stable Salary & Stable Fixed Expenses,64439,31481.0,26637,58118.0,6321.0,9.81,-0.03,High Risk
U604,2024,4,98124.0,Stable Salary & Stable Fixed Expenses,64439,31481.0,20612,52093.0,12346.0,19.16,0.01,Medium Risk
U604,2024,5,110470.0,Stable Salary & Stable Fixed Expenses,64439,31481.0,20530,52011.0,12428.0,19.29,0.04,Medium Risk
U604,2024,6,122898.0,Stable Salary & Stable Fixed Expenses,64439,31481.0,22160,53641.0,10798.0,16.76,0.02,Medium Risk
U604,2024,7,133696.0,Stable Salary & Stable Fixed Expenses,64439,31481.0,19748,51229.0,13210.0,20.5,0.0,Medium Risk
U604,2024,8,146906.0,Stable Salary & Stable Fixed Expenses,64439,31481.0,19410,50891.0,13548.0,21.02,-0.02,Medium Risk
U604,2024,9,160454.0,Stable Salary & Stable Fixed Expenses,64439,31481.0,27584,59065.0,5374.0,8.34,-0.02,High Risk
U604,2024,10,165828.0,Stable Salary & Stable Fixed Expenses,64439,31481.0,29016,60497.0,3942.0,6.12,-0.03,High Risk
U604,2024,11,169770.0,Stable Salary & Stable Fixed Expenses,64439,31481.0,24789,56270.0,8169.0,12.68,-0.04,High Risk
U604,2024,12,177939.0,Stable Salary & Stable Fixed Expenses,64439,31481.0,21718,53199.0,11240.0,17.44,0.02,Medium Risk
U605,2024,1,247723.0,Salary Increases & Fixed Expenses Remain Stable,29788,11075.0,10528,21603.0,8185.0,27.48,0.02,Low Risk
U605,2024,2,255908.0,Salary Increases & Fixed Expenses Remain Stable,29788,11075.0,9366,20441.0,9347.0,31.38,-0.0,Low Risk
U605,2024,3,265255.0,Salary Increases & Fixed Expenses Remain Stable,29788,11075.0,12031,23106.0,6682.0,22.43,0.03,Medium Risk
U605,2024,4,271937.0,Salary Increases & Fixed Expenses Remain Stable,29788,11075.0,13812,24887.0,4901.0,16.45,0.03,Medium Risk
U605,2024,5,276838.0,Salary Increases & Fixed Expenses Remain Stable,29788,11075.0,11025,22100.0,7688.0,25.81,0.01,Low Risk
U605,2024,6,284526.0,Salary Increases & Fixed Expenses Remain Stable,29788,11075.0,11141,22216.0,7572.0,25.42,0.02,Low Risk
U605,2024,7,292098.0,Salary Increases & Fixed Expenses Remain Stable,29788,11075.0,13911,24986.0,4802.0,16.12,-0.03,Medium Risk
U605,2024,8,296900.0,Salary Increases & Fixed Expenses Remain Stable,51585,11075.0,22963,34038.0,17547.0,34.02,-0.02,Low Risk
U605,2024,9,314447.0,Salary Increases & Fixed Expenses Remain Stable,51585,11075.0,20519,31594.0,19991.0,38.75,-0.03,Low Risk
U605,2024,10,334438.0,Salary Increases & Fixed Expenses Remain Stable,51585,11075.0,15579,26654.0,24931.0,48.33,-0.04,Low Risk
U605,2024,11,359369.0,Salary Increases & Fixed Expenses Remain Stable,51585,11075.0,18730,29805.0,21780.0,42.22,-0.01,Low Risk
U605,2024,12,381149.0,Salary Increases & Fixed Expenses Remain Stable,51585,11075.0,20337,31412.0,20173.0,39.11,-0.02,Low Risk
U606,2024,1,245592.0,Salary Increases & Fixed Expenses Decrease,228567,118373.0,117147,235520.0,-6953.0,-3.04,-0.0,High Risk
U606,2024,2,238639.0,Salary Increases & Fixed Expenses Decrease,228567,118373.0,121424,239797.0,-11230.0,-4.91,0.04,High Risk
U606,2024,3,227409.0,Salary Increases & Fixed Expenses Decrease,228567,118373.0,149307,267680.0,-39113.0,-17.11,-0.05,High Risk
U606,2024,4,188296.0,Salary Increases & Fixed Expenses Decrease,228567,118373.0,149082,267455.0,-38888.0,-17.01,0.01,High Risk
U606,2024,5,149408.0,Salary Increases & Fixed Expenses Decrease,228567,118373.0,142492,260865.0,-32298.0,-14.13,0.04,High Risk
U606,2024,6,117110.0,Salary Increases & Fixed Expenses Decrease,228567,118373.0,120392,238765.0,-10198.0,-4.46,-0.0,High Risk
U606,2024,7,106912.0,Salary Increases & Fixed Expenses Decrease,228567,118373.0,157646,276019.0,-47452.0,-20.76,-0.02,High Risk
U606,2024,8,59460.0,Salary Increases & Fixed Expenses Decrease,241014,118373.0,128612,246985.0,-5971.0,-2.48,-0.0,High Risk
U606,2024,9,53489.0,Salary Increases & Fixed Expenses Decrease,241014,118373.0,140781,259154.0,-18140.0,-7.53,-0.05,High Risk
U606,2024,10,35349.0,Salary Increases & Fixed Expenses Decrease,241014,118373.0,121768,240141.0,873.0,0.36,-0.02,High Risk
U606,2024,11,36222.0,Salary Increases & Fixed Expenses Decrease,241014,118373.0,123515,241888.0,-874.0,-0.36,-0.04,High Risk
U606,2024,12,35348.0,Salary Increases & Fixed Expenses Decrease,241014,118373.0,133219,251592.0,-10578.0,-4.39,-0.03,High Risk
U607,2024,1,250000.0,Stable Salary & Increasing Fixed Expenses,291982,88099.0,137922,226021.0,65961.0,22.59,0.05,Medium Risk
U607,2024,2,315961.0,Stable Salary & Increasing Fixed Expenses,291982,88099.0,87923,176022.0,115960.0,39.71,0.03,Low Risk
U607,2024,3,431921.0,Stable Salary & Increasing Fixed Expenses,291982,88099.0,117747,205846.0,86136.0,29.5,-0.04,Low Risk
U607,2024,4,518057.0,Stable Salary & Increasing Fixed Expenses,291982,88099.0,113174,201273.0,90709.0,31.07,0.01,Low Risk
U607,2024,5,608766.0,Stable Salary & Increasing Fixed Expenses,291982,88099.0,124773,212872.0,79110.0,27.09,0.03,Low Risk
U607,2024,6,687876.0,Stable Salary & Increasing Fixed Expenses,291982,88099.0,92576,180675.0,111307.0,38.12,-0.0,Low Risk
U607,2024,7,799183.0,Stable Salary & Increasing Fixed Expenses,291982,88099.0,112361,200460.0,91522.0,31.35,0.01,Low Risk
U607,2024,8,890705.0,Stable Salary & Increasing Fixed Expenses,291982,88099.0,133303,221402.0,70580.0,24.17,0.01,Medium Risk
U607,2024,9,961285.0,Stable Salary & Increasing Fixed Expenses,291982,88099.0,133166,221265.0,70717.0,24.22,0.03,Medium Risk
U607,2024,10,1032002.0,Stable Salary & Increasing Fixed Expenses,291982,88099.0,114162,202261.0,89721.0,30.73,-0.01,Low Risk
U607,2024,11,1121723.0,Stable Salary & Increasing Fixed Expenses,291982,88099.0,113502,201601.0,90381.0,30.95,0.01,Low Risk
U607,2024,12,1212104.0,Stable Salary & Increasing Fixed Expenses,291982,88099.0,128460,216559.0,75423.0,25.83,0.04,Low Risk
U608,2024,1,243525.0,Stable Salary & Stable Fixed Expenses,114916,77713.0,48380,126093.0,-11177.0,-9.73,0.03,High Risk
U608,2024,2,232348.0,Stable Salary & Stable Fixed Expenses,114916,77713.0,39179,116892.0,-1976.0,-1.72,0.02,High Risk
U608,2024,3,230372.0,Stable Salary & Stable Fixed Expenses,114916,77713.0,63354,141067.0,-26151.0,-22.76,0.04,High Risk
U608,2024,4,204221.0,Stable Salary & Stable Fixed Expenses,114916,77713.0,55493,133206.0,-18290.0,-15.92,-0.03,High Risk
U608,2024,5,185931.0,Stable Salary & Stable Fixed Expenses,114916,77713.0,38978,116691.0,-1775.0,-1.54,-0.02,High Risk
U608,2024,6,184156.0,Stable Salary & Stable Fixed Expenses,114916,77713.0,39297,117010.0,-2094.0,-1.82,0.02,High Risk
U608,2024,7,182062.0,Stable Salary & Stable Fixed Expenses,114916,77713.0,50311,128024.0,-13108.0,-11.41,-0.03,High Risk
U608,2024,8,168954.0,Stable Salary & Stable Fixed Expenses,114916,77713.0,44531,122244.0,-7328.0,-6.38,0.01,High Risk
U608,2024,9,161626.0,Stable Salary & Stable Fixed Expenses,114916,77713.0,50091,127804.0,-12888.0,-11.22,0.01,High Risk
U608,2024,10,148738.0,Stable Salary & Stable Fixed Expenses,114916,77713.0,48287,126000.0,-11084.0,-9.65,-0.03,High Risk
U608,2024,11,137654.0,Stable Salary & Stable Fixed Expenses,114916,77713.0,59859,137572.0,-22656.0,-19.72,0.04,High Risk
U608,2024,12,114998.0,Stable Salary & Stable Fixed Expenses,114916,77713.0,50129,127842.0,-12926.0,-11.25,-0.01,High Risk
U609,2024,1,203659.0,Stable Salary & Decreasing Fixed Expenses,175171,63026.0,45102,108128.0,67043.0,38.27,0.01,Low Risk
U609,2024,2,270702.0,Stable Salary & Decreasing Fixed Expenses,175171,63026.0,48823,111849.0,63322.0,36.15,-0.03,Low Risk
U609,2024,3,334024.0,Stable Salary & Decreasing Fixed Expenses,175171,63026.0,55050,118076.0,57095.0,32.59,0.01,Low Risk
U609,2024,4,391119.0,Stable Salary & Decreasing Fixed Expenses,175171,63026.0,46690,109716.0,65455.0,37.37,0.02,Low Risk
U609,2024,5,456574.0,Stable Salary & Decreasing Fixed Expenses,175171,63026.0,42426,105452.0,69719.0,39.8,0.04,Low Risk
U609,2024,6,526293.0,Stable Salary & Decreasing Fixed Expenses,175171,63026.0,37630,100656.0,74515.0,42.54,-0.03,Low Risk
U609,2024,7,600808.0,Stable Salary & Decreasing Fixed Expenses,175171,63026.0,49866,112892.0,62279.0,35.55,-0.01,Low Risk
U609,2024,8,663087.0,Stable Salary & Decreasing Fixed Expenses,175171,63026.0,50482,113508.0,61663.0,35.2,-0.01,Low Risk
U609,2024,9,724750.0,Stable Salary & Decreasing Fixed Expenses,175171,63026.0,48405,111431.0,63740.0,36.39,0.02,Low Risk
U609,2024,10,788490.0,Stable Salary & Decreasing Fixed Expenses,175171,63026.0,56687,119713.0,55458.0,31.66,0.05,Low Risk
U609,2024,11,843948.0,Stable Salary & Decreasing Fixed Expenses,175171,63026.0,46906,109932.0,65239.0,37.24,0.03,Low Risk
U609,2024,12,909187.0,Stable Salary & Decreasing Fixed Expenses,175171,63026.0,58487,121513.0,53658.0,30.63,-0.04,Low Risk
U610,2024,1,210507.0,Stable Salary & Increasing Fixed Expenses,57281,37237.0,27333,64570.0,-7289.0,-12.72,-0.04,High Risk
U610,2024,2,203218.0,Stable Salary & Increasing Fixed Expenses,57281,37237.0,20346,57583.0,-302.0,-0.53,0.05,High Risk
U610,2024,3,202916.0,Stable Salary & Increasing Fixed Expenses,57281,37237.0,22966,60203.0,-2922.0,-5.1,0.01,High Risk
U610,2024,4,199994.0,Stable Salary & Increasing Fixed Expenses,57281,37237.0,26123,63360.0,-6079.0,-10.61,0.02,High Risk
U610,2024,5,193915.0,Stable Salary & Increasing Fixed Expenses,57281,37830.0,20382,58212.0,-931.0,-1.63,-0.03,High Risk
U610,2024,6,192984.0,Stable Salary & Increasing Fixed Expenses,57281,38852.0,21245,60097.0,-2816.0,-4.92,-0.02,High Risk
U610,2024,7,190168.0,Stable Salary & Increasing Fixed Expenses,57281,38852.0,25568,64420.0,-7139.0,-12.46,0.02,High Risk
U610,2024,8,183029.0,Stable Salary & Increasing Fixed Expenses,57281,40618.0,27718,68336.0,-11055.0,-19.3,-0.0,High Risk
U610,2024,9,171974.0,Stable Salary & Increasing Fixed Expenses,57281,40618.0,24502,65120.0,-7839.0,-13.69,-0.05,High Risk
U610,2024,10,164135.0,Stable Salary & Increasing Fixed Expenses,57281,40618.0,32971,73589.0,-16308.0,-28.47,-0.03,High Risk
U610,2024,11,147827.0,Stable Salary & Increasing Fixed Expenses,57281,40618.0,25399,66017.0,-8736.0,-15.25,-0.03,High Risk
U610,2024,12,139091.0,Stable Salary & Increasing Fixed Expenses,57281,40618.0,32332,72950.0,-15669.0,-27.35,0.03,High Risk
U611,2024,1,219119.0,Stable Salary & Stable Fixed Expenses,149941,67673.0,35420,103093.0,46848.0,31.24,0.03,Low Risk
U611,2024,2,265967.0,Stable Salary & Stable Fixed Expenses,149941,67673.0,39103,106776.0,43165.0,28.79,-0.01,Low Risk
U611,2024,3,309132.0,Stable Salary & Stable Fixed Expenses,149941,67673.0,30050,97723.0,52218.0,34.83,0.0,Low Risk
U611,2024,4,361350.0,Stable Salary & Stable Fixed Expenses,149941,67673.0,40405,108078.0,41863.0,27.92,0.01,Low Risk
U611,2024,5,403213.0,Stable Salary & Stable Fixed Expenses,149941,67673.0,30221,97894.0,52047.0,34.71,0.02,Low Risk
U611,2024,6,455260.0,Stable Salary & Stable Fixed Expenses,149941,67673.0,38896,106569.0,43372.0,28.93,0.02,Low Risk
U611,2024,7,498632.0,Stable Salary & Stable Fixed Expenses,149941,67673.0,35999,103672.0,46269.0,30.86,-0.05,Low Risk
U611,2024,8,544901.0,Stable Salary & Stable Fixed Expenses,149941,67673.0,33315,100988.0,48953.0,32.65,-0.03,Low Risk
U611,2024,9,593854.0,Stable Salary & Stable Fixed Expenses,149941,67673.0,37473,105146.0,44795.0,29.88,0.04,Low Risk
U611,2024,10,638649.0,Stable Salary & Stable Fixed Expenses,149941,67673.0,39257,106930.0,43011.0,28.69,-0.01,Low Risk
U611,2024,11,681660.0,Stable Salary & Stable Fixed Expenses,149941,67673.0,41491,109164.0,40777.0,27.2,0.04,Low Risk
U611,2024,12,722437.0,Stable Salary & Stable Fixed Expenses,149941,67673.0,33241,100914.0,49027.0,32.7,0.03,Low Risk
U612,2024,1,70276.0,Salary Increases & Fixed Expenses Remain Stable,24658,13426.0,7187,20613.0,4045.0,16.4,-0.0,Medium Risk
U612,2024,2,74321.0,Salary Increases & Fixed Expenses Remain Stable,24658,13426.0,7050,20476.0,4182.0,16.96,0.01,Medium Risk
U612,2024,3,78503.0,Salary Increases & Fixed Expenses Remain Stable,24658,13426.0,6954,20380.0,4278.0,17.35,0.04,Medium Risk
U612,2024,4,82781.0,Salary Increases & Fixed Expenses Remain Stable,24658,13426.0,5183,18609.0,6049.0,24.53,0.01,Medium Risk
U612,2024,5,88830.0,Salary Increases & Fixed Expenses Remain Stable,53638,13426.0,12653,26079.0,27559.0,51.38,0.01,Low Risk
U612,2024,6,116389.0,Salary Increases & Fixed Expenses Remain Stable,53638,13426.0,16082,29508.0,24130.0,44.99,-0.03,Low Risk
U612,2024,7,140519.0,Salary Increases & Fixed Expenses Remain Stable,53638,13426.0,14757,28183.0,25455.0,47.46,0.04,Low Risk
U612,2024,8,165974.0,Salary Increases & Fixed Expenses Remain Stable,53638,13426.0,16048,29474.0,24164.0,45.05,0.05,Low Risk
U612,2024,9,190138.0,Salary Increases & Fixed Expenses Remain Stable,53638,13426.0,14734,28160.0,25478.0,47.5,0.04,Low Risk
U612,2024,10,215616.0,Salary Increases & Fixed Expenses Remain Stable,53638,13426.0,14368,27794.0,25844.0,48.18,-0.04,Low Risk
U612,2024,11,241460.0,Salary Increases & Fixed Expenses Remain Stable,53638,13426.0,13973,27399.0,26239.0,48.92,0.02,Low Risk
U612,2024,12,267699.0,Salary Increases & Fixed Expenses Remain Stable,53638,13426.0,11269,24695.0,28943.0,53.96,0.05,Low Risk
U613,2024,1,250000.0,Stable Salary & Stable Fixed Expenses,252673,87013.0,125869,212882.0,39791.0,15.75,0.01,Medium Risk
U613,2024,2,289791.0,Stable Salary & Stable Fixed Expenses,252673,87013.0,99528,186541.0,66132.0,26.17,-0.02,Low Risk
U613,2024,3,355923.0,Stable Salary & Stable Fixed Expenses,252673,87013.0,125597,212610.0,40063.0,15.86,0.01,Medium Risk
U613,2024,4,395986.0,Stable Salary & Stable Fixed Expenses,252673,87013.0,86658,173671.0,79002.0,31.27,-0.03,Low Risk
U613,2024,5,474988.0,Stable Salary & Stable Fixed Expenses,252673,87013.0,109484,196497.0,56176.0,22.23,-0.03,Medium Risk
U613,2024,6,531164.0,Stable Salary & Stable Fixed Expenses,252673,87013.0,119291,206304.0,46369.0,18.35,-0.01,Medium Risk
U613,2024,7,577533.0,Stable Salary & Stable Fixed Expenses,252673,87013.0,96865,183878.0,68795.0,27.23,-0.03,Low Risk
U613,2024,8,646328.0,Stable Salary & Stable Fixed Expenses,252673,87013.0,85237,172250.0,80423.0,31.83,-0.04,Low Risk
U613,2024,9,726751.0,Stable Salary & Stable Fixed Expenses,252673,87013.0,105786,192799.0,59874.0,23.7,0.05,Medium Risk
U613,2024,10,786625.0,Stable Salary & Stable Fixed Expenses,252673,87013.0,80485,167498.0,85175.0,33.71,0.03,Low Risk
U613,2024,11,871800.0,Stable Salary & Stable Fixed Expenses,252673,87013.0,125664,212677.0,39996.0,15.83,-0.02,Medium Risk
U613,2024,12,911796.0,Stable Salary & Stable Fixed Expenses,252673,87013.0,112295,199308.0,53365.0,21.12,0.01,Medium Risk
U614,2024,1,239699.0,Salary Increases & Fixed Expenses Remain Stable,120641,58885.0,79218,138103.0,-17462.0,-14.47,0.01,High Risk
U614,2024,2,222237.0,Salary Increases & Fixed Expenses Remain Stable,120641,58885.0,82821,141706.0,-21065.0,-17.46,-0.04,High Risk
U614,2024,3,201172.0,Salary Increases & Fixed Expenses Remain Stable,120641,58885.0,105564,164449.0,-43808.0,-36.31,0.02,High Risk
U614,2024,4,157364.0,Salary Increases & Fixed Expenses Remain Stable,120641,58885.0,63264,122149.0,-1508.0,-1.25,0.02,High Risk
U614,2024,5,155856.0,Salary Increases & Fixed Expenses Remain Stable,135095,58885.0,88958,147843.0,-12748.0,-9.44,0.0,High Risk
U614,2024,6,143108.0,Salary Increases & Fixed Expenses Remain Stable,135095,58885.0,83091,141976.0,-6881.0,-5.09,-0.02,High Risk
U614,2024,7,136227.0,Salary Increases & Fixed Expenses Remain Stable,135095,58885.0,72847,131732.0,3363.0,2.49,0.01,High Risk
U614,2024,8,139590.0,Salary Increases & Fixed Expenses Remain Stable,135095,58885.0,91726,150611.0,-15516.0,-11.49,0.01,High Risk
U614,2024,9,124074.0,Salary Increases & Fixed Expenses Remain Stable,135095,58885.0,99288,158173.0,-23078.0,-17.08,-0.01,High Risk
U614,2024,10,100996.0,Salary Increases & Fixed Expenses Remain Stable,135095,58885.0,102840,161725.0,-26630.0,-19.71,-0.03,High Risk
U614,2024,11,74366.0,Salary Increases & Fixed Expenses Remain Stable,135095,58885.0,86187,145072.0,-9977.0,-7.39,-0.0,High Risk
U614,2024,12,64389.0,Salary Increases & Fixed Expenses Remain Stable,135095,58885.0,103955,162840.0,-27745.0,-20.54,0.02,High Risk
U615,2024,1,239232.0,Stable Salary & Stable Fixed Expenses,233527,87799.0,55833,143632.0,89895.0,38.49,0.05,Low Risk
U615,2024,2,329127.0,Stable Salary & Stable Fixed Expenses,233527,87799.0,62933,150732.0,82795.0,35.45,0.05,Low Risk
U615,2024,3,411922.0,Stable Salary & Stable Fixed Expenses,233527,87799.0,50231,138030.0,95497.0,40.89,-0.02,Low Risk
U615,2024,4,507419.0,Stable Salary & Stable Fixed Expenses,233527,87799.0,62343,150142.0,83385.0,35.71,0.01,Low Risk
U615,2024,5,590804.0,Stable Salary & Stable Fixed Expenses,233527,87799.0,51337,139136.0,94391.0,40.42,-0.02,Low Risk
U615,2024,6,685195.0,Stable Salary & Stable Fixed Expenses,233527,87799.0,60259,148058.0,85469.0,36.6,0.05,Low Risk
U615,2024,7,770664.0,Stable Salary & Stable Fixed Expenses,233527,87799.0,57704,145503.0,88024.0,37.69,-0.03,Low Risk
U615,2024,8,858688.0,Stable Salary & Stable Fixed Expenses,233527,87799.0,60823,148622.0,84905.0,36.36,-0.02,Low Risk
U615,2024,9,943593.0,Stable Salary & Stable Fixed Expenses,233527,87799.0,70323,158122.0,75405.0,32.29,-0.04,Low Risk
U615,2024,10,1018998.0,Stable Salary & Stable Fixed Expenses,233527,87799.0,56888,144687.0,88840.0,38.04,0.04,Low Risk
U615,2024,11,1107838.0,Stable Salary & Stable Fixed Expenses,233527,87799.0,76902,164701.0,68826.0,29.47,-0.03,Low Risk
U615,2024,12,1176664.0,Stable Salary & Stable Fixed Expenses,233527,87799.0,65401,153200.0,80327.0,34.4,-0.0,Low Risk
U616,2024,1,244062.0,Salary Increases & Fixed Expenses Decrease,220134,65196.0,92873,158069.0,62065.0,28.19,-0.04,Low Risk
U616,2024,2,306127.0,Salary Increases & Fixed Expenses Decrease,220134,65196.0,73962,139158.0,80976.0,36.78,-0.01,Low Risk
U616,2024,3,387103.0,Salary Increases & Fixed Expenses Decrease,220134,65196.0,89915,155111.0,65023.0,29.54,0.01,Low Risk
U616,2024,4,452126.0,Salary Increases & Fixed Expenses Decrease,220134,65196.0,73512,138708.0,81426.0,36.99,-0.04,Low Risk
U616,2024,5,533552.0,Salary Increases & Fixed Expenses Decrease,220134,65196.0,84822,150018.0,70116.0,31.85,-0.05,Low Risk
U616,2024,6,603668.0,Salary Increases & Fixed Expenses Decrease,220134,65196.0,88683,153879.0,66255.0,30.1,0.01,Low Risk
U616,2024,7,669923.0,Salary Increases & Fixed Expenses Decrease,220134,65196.0,91114,156310.0,63824.0,28.99,0.05,Low Risk
U616,2024,8,733747.0,Salary Increases & Fixed Expenses Decrease,249896,65196.0,89303,154499.0,95397.0,38.17,0.01,Low Risk
U616,2024,9,829144.0,Salary Increases & Fixed Expenses Decrease,249896,65196.0,118704,183900.0,65996.0,26.41,-0.04,Low Risk
U616,2024,10,895140.0,Salary Increases & Fixed Expenses Decrease,249896,65196.0,124579,189775.0,60121.0,24.06,-0.02,Medium Risk
U616,2024,11,955261.0,Salary Increases & Fixed Expenses Decrease,249896,65196.0,101542,166738.0,83158.0,33.28,-0.0,Low Risk
U616,2024,12,1038419.0,Salary Increases & Fixed Expenses Decrease,249896,65196.0,95583,160779.0,89117.0,35.66,0.0,Low Risk
U617,2024,1,60606.0,Salary Increases & Fixed Expenses Remain Stable,30007,16635.0,8885,25520.0,4487.0,14.95,0.04,High Risk
U617,2024,2,65093.0,Salary Increases & Fixed Expenses Remain Stable,30007,16635.0,6553,23188.0,6819.0,22.72,-0.04,Medium Risk
U617,2024,3,71912.0,Salary Increases & Fixed Expenses Remain Stable,30007,16635.0,9843,26478.0,3529.0,11.76,0.01,High Risk
U617,2024,4,75441.0,Salary Increases & Fixed Expenses Remain Stable,30007,16635.0,8486,25121.0,4886.0,16.28,0.02,Medium Risk
U617,2024,5,80327.0,Salary Increases & Fixed Expenses Remain Stable,52249,16635.0,14634,31269.0,20980.0,40.15,-0.02,Low Risk
U617,2024,6,101307.0,Salary Increases & Fixed Expenses Remain Stable,52249,16635.0,14469,31104.0,21145.0,40.47,0.03,Low Risk
U617,2024,7,122452.0,Salary Increases & Fixed Expenses Remain Stable,52249,16635.0,13327,29962.0,22287.0,42.66,0.01,Low Risk
U617,2024,8,144739.0,Salary Increases & Fixed Expenses Remain Stable,52249,16635.0,14203,30838.0,21411.0,40.98,0.04,Low Risk
U617,2024,9,166150.0,Salary Increases & Fixed Expenses Remain Stable,52249,16635.0,16213,32848.0,19401.0,37.13,0.01,Low Risk
U617,2024,10,185551.0,Salary Increases & Fixed Expenses Remain Stable,52249,16635.0,12823,29458.0,22791.0,43.62,-0.05,Low Risk
U617,2024,11,208342.0,Salary Increases & Fixed Expenses Remain Stable,52249,16635.0,12950,29585.0,22664.0,43.38,-0.01,Low Risk
U617,2024,12,231006.0,Salary Increases & Fixed Expenses Remain Stable,52249,16635.0,14707,31342.0,20907.0,40.01,0.04,Low Risk
U618,2024,1,223754.0,Salary Increases & Fixed Expenses Increase,222385,60827.0,75063,135890.0,86495.0,38.89,-0.05,Low Risk
U618,2024,2,310249.0,Salary Increases & Fixed Expenses Increase,222385,60827.0,100558,161385.0,61000.0,27.43,0.04,Low Risk
U618,2024,3,371249.0,Salary Increases & Fixed Expenses Increase,222385,62475.0,109305,171780.0,50605.0,22.76,0.02,Medium Risk
U618,2024,4,421854.0,Salary Increases & Fixed Expenses Increase,222385,63777.0,88768,152545.0,69840.0,31.4,0.0,Low Risk
U618,2024,5,491694.0,Salary Increases & Fixed Expenses Increase,222385,63777.0,73829,137606.0,84779.0,38.12,-0.03,Low Risk
U618,2024,6,576473.0,Salary Increases & Fixed Expenses Increase,222385,63777.0,70369,134146.0,88239.0,39.68,-0.02,Low Risk
U618,2024,7,664712.0,Salary Increases & Fixed Expenses Increase,227738,63777.0,68794,132571.0,95167.0,41.79,-0.04,Low Risk
U618,2024,8,759879.0,Salary Increases & Fixed Expenses Increase,227738,63777.0,91244,155021.0,72717.0,31.93,0.03,Low Risk
U618,2024,9,832596.0,Salary Increases & Fixed Expenses Increase,227738,63777.0,118600,182377.0,45361.0,19.92,0.05,Medium Risk
U618,2024,10,877957.0,Salary Increases & Fixed Expenses Increase,227738,63777.0,102411,166188.0,61550.0,27.03,-0.01,Low Risk
U618,2024,11,939507.0,Salary Increases & Fixed Expenses Increase,227738,63777.0,76681,140458.0,87280.0,38.32,-0.03,Low Risk
U618,2024,12,1026787.0,Salary Increases & Fixed Expenses Increase,227738,63777.0,144232,208009.0,19729.0,8.66,-0.02,High Risk
U619,2024,1,163986.0,Salary Increases & Fixed Expenses Increase,139133,53296.0,39938,93234.0,45899.0,32.99,-0.05,Low Risk
U619,2024,2,209885.0,Salary Increases & Fixed Expenses Increase,139133,53296.0,39328,92624.0,46509.0,33.43,-0.05,Low Risk
U619,2024,3,256394.0,Salary Increases & Fixed Expenses Increase,167231,53866.0,48336,102202.0,65029.0,38.89,0.05,Low Risk
U619,2024,4,321423.0,Salary Increases & Fixed Expenses Increase,167231,53866.0,42830,96696.0,70535.0,42.18,0.02,Low Risk
U619,2024,5,391958.0,Salary Increases & Fixed Expenses Increase,167231,53866.0,48353,102219.0,65012.0,38.88,0.0,Low Risk
U619,2024,6,456970.0,Salary Increases & Fixed Expenses Increase,167231,54730.0,49858,104588.0,62643.0,37.46,-0.0,Low Risk
U619,2024,7,519613.0,Salary Increases & Fixed Expenses Increase,167231,54730.0,40105,94835.0,72396.0,43.29,-0.04,Low Risk
U619,2024,8,592009.0,Salary Increases & Fixed Expenses Increase,167231,54730.0,38712,93442.0,73789.0,44.12,0.01,Low Risk
U619,2024,9,665798.0,Salary Increases & Fixed Expenses Increase,167231,54730.0,54924,109654.0,57577.0,34.43,-0.02,Low Risk
U619,2024,10,723375.0,Salary Increases & Fixed Expenses Increase,167231,56544.0,41681,98225.0,69006.0,41.26,0.03,Low Risk
U619,2024,11,792381.0,Salary Increases & Fixed Expenses Increase,167231,56544.0,43538,100082.0,67149.0,40.15,0.04,Low Risk
U619,2024,12,859530.0,Salary Increases & Fixed Expenses Increase,167231,56544.0,52709,109253.0,57978.0,34.67,-0.05,Low Risk
U620,2024,1,113146.0,Salary Increases & Fixed Expenses Increase,110857,43398.0,29078,72476.0,38381.0,34.62,0.04,Low Risk
U620,2024,2,151527.0,Salary Increases & Fixed Expenses Increase,110857,45300.0,29259,74559.0,36298.0,32.74,0.02,Low Risk
U620,2024,3,187825.0,Salary Increases & Fixed Expenses Increase,110857,45300.0,35446,80746.0,30111.0,27.16,0.02,Low Risk
U620,2024,4,217936.0,Salary Increases & Fixed Expenses Increase,110857,45300.0,29644,74944.0,35913.0,32.4,-0.0,Low Risk
U620,2024,5,253849.0,Salary Increases & Fixed Expenses Increase,110857,45300.0,27201,72501.0,38356.0,34.6,0.05,Low Risk
U620,2024,6,292205.0,Salary Increases & Fixed Expenses Increase,110857,45300.0,27149,72449.0,38408.0,34.65,-0.02,Low Risk
U620,2024,7,330613.0,Salary Increases & Fixed Expenses Increase,134270,45850.0,29084,74934.0,59336.0,44.19,0.01,Low Risk
U620,2024,8,389949.0,Salary Increases & Fixed Expenses Increase,134270,45850.0,33188,79038.0,55232.0,41.14,0.01,Low Risk
U620,2024,9,445181.0,Salary Increases & Fixed Expenses Increase,134270,45850.0,33872,79722.0,54548.0,40.63,-0.05,Low Risk
U620,2024,10,499729.0,Salary Increases & Fixed Expenses Increase,134270,45850.0,37530,83380.0,50890.0,37.9,0.03,Low Risk
U620,2024,11,550619.0,Salary Increases & Fixed Expenses Increase,134270,45850.0,31121,76971.0,57299.0,42.67,0.04,Low Risk
U620,2024,12,607918.0,Salary Increases & Fixed Expenses Increase,134270,45850.0,35798,81648.0,52622.0,39.19,-0.03,Low Risk
U621,2024,1,149896.0,Stable Salary & Stable Fixed Expenses,149317,51067.0,98443,149510.0,-193.0,-0.13,-0.04,High Risk
U621,2024,2,149703.0,Stable Salary & Stable Fixed Expenses,149317,51067.0,90298,141365.0,7952.0,5.33,0.0,High Risk
U621,2024,3,157655.0,Stable Salary & Stable Fixed Expenses,149317,51067.0,95050,146117.0,3200.0,2.14,0.03,High Risk
U621,2024,4,160855.0,Stable Salary & Stable Fixed Expenses,149317,51067.0,76207,127274.0,22043.0,14.76,-0.04,High Risk
U621,2024,5,182898.0,Stable Salary & Stable Fixed Expenses,149317,51067.0,101607,152674.0,-3357.0,-2.25,0.03,High Risk
U621,2024,6,179541.0,Stable Salary & Stable Fixed Expenses,149317,51067.0,91049,142116.0,7201.0,4.82,0.03,High Risk
U621,2024,7,186742.0,Stable Salary & Stable Fixed Expenses,149317,51067.0,79976,131043.0,18274.0,12.24,0.02,High Risk
U621,2024,8,205016.0,Stable Salary & Stable Fixed Expenses,149317,51067.0,100092,151159.0,-1842.0,-1.23,-0.0,High Risk
U621,2024,9,203174.0,Stable Salary & Stable Fixed Expenses,149317,51067.0,77087,128154.0,21163.0,14.17,0.01,High Risk
U621,2024,10,224337.0,Stable Salary & Stable Fixed Expenses,149317,51067.0,98925,149992.0,-675.0,-0.45,-0.05,High Risk
U621,2024,11,223662.0,Stable Salary & Stable Fixed Expenses,149317,51067.0,94993,146060.0,3257.0,2.18,0.02,High Risk
U621,2024,12,226919.0,Stable Salary & Stable Fixed Expenses,149317,51067.0,88683,139750.0,9567.0,6.41,0.02,High Risk
U622,2024,1,250000.0,Salary Increases & Fixed Expenses Increase,278821,75348.0,101858,177206.0,101615.0,36.44,0.01,Low Risk
U622,2024,2,351615.0,Salary Increases & Fixed Expenses Increase,278821,75348.0,124492,199840.0,78981.0,28.33,-0.01,Low Risk
U622,2024,3,430596.0,Salary Increases & Fixed Expenses Increase,278821,75348.0,129341,204689.0,74132.0,26.59,-0.03,Low Risk
U622,2024,4,504728.0,Salary Increases & Fixed Expenses Increase,278821,75348.0,127520,202868.0,75953.0,27.24,0.01,Low Risk
U622,2024,5,580681.0,Salary Increases & Fixed Expenses Increase,278821,75348.0,105103,180451.0,98370.0,35.28,0.04,Low Risk
U622,2024,6,679051.0,Salary Increases & Fixed Expenses Increase,278821,76457.0,127080,203537.0,75284.0,27.0,-0.01,Low Risk
U622,2024,7,754335.0,Salary Increases & Fixed Expenses Increase,284862,76457.0,136511,212968.0,71894.0,25.24,-0.05,Low Risk
U622,2024,8,826229.0,Salary Increases & Fixed Expenses Increase,284862,76457.0,104239,180696.0,104166.0,36.57,0.0,Low Risk
U622,2024,9,930395.0,Salary Increases & Fixed Expenses Increase,284862,77593.0,119842,197435.0,87427.0,30.69,-0.04,Low Risk
U622,2024,10,1017822.0,Salary Increases & Fixed Expenses Increase,284862,77593.0,124262,201855.0,83007.0,29.14,0.02,Low Risk
U622,2024,11,1100829.0,Salary Increases & Fixed Expenses Increase,284862,78314.0,120117,198431.0,86431.0,30.34,-0.01,Low Risk
U622,2024,12,1187260.0,Salary Increases & Fixed Expenses Increase,284862,78314.0,96237,174551.0,110311.0,38.72,0.04,Low Risk
U623,2024,1,186887.0,Salary Increases & Fixed Expenses Remain Stable,156900,67177.0,52082,119259.0,37641.0,23.99,0.0,Medium Risk
U623,2024,2,224528.0,Salary Increases & Fixed Expenses Remain Stable,156900,67177.0,56652,123829.0,33071.0,21.08,0.04,Medium Risk
U623,2024,3,257599.0,Salary Increases & Fixed Expenses Remain Stable,156900,67177.0,57078,124255.0,32645.0,20.81,-0.05,Medium Risk
U623,2024,4,290244.0,Salary Increases & Fixed Expenses Remain Stable,175098,67177.0,67081,134258.0,40840.0,23.32,0.04,Medium Risk
U623,2024,5,331084.0,Salary Increases & Fixed Expenses Remain Stable,175098,67177.0,81319,148496.0,26602.0,15.19,-0.01,Medium Risk
U623,2024,6,357686.0,Salary Increases & Fixed Expenses Remain Stable,175098,67177.0,81130,148307.0,26791.0,15.3,0.03,Medium Risk
U623,2024,7,384477.0,Salary Increases & Fixed Expenses Remain Stable,175098,67177.0,57589,124766.0,50332.0,28.75,-0.0,Low Risk
U623,2024,8,434809.0,Salary Increases & Fixed Expenses Remain Stable,175098,67177.0,86051,153228.0,21870.0,12.49,-0.03,High Risk
U623,2024,9,456679.0,Salary Increases & Fixed Expenses Remain Stable,175098,67177.0,93306,160483.0,14615.0,8.35,0.02,High Risk
U623,2024,10,471294.0,Salary Increases & Fixed Expenses Remain Stable,175098,67177.0,55137,122314.0,52784.0,30.15,-0.02,Low Risk
U623,2024,11,524078.0,Salary Increases & Fixed Expenses Remain Stable,175098,67177.0,70464,137641.0,37457.0,21.39,-0.03,Medium Risk
U623,2024,12,561535.0,Salary Increases & Fixed Expenses Remain Stable,175098,67177.0,59348,126525.0,48573.0,27.74,0.01,Low Risk
U624,2024,1,238619.0,Salary Increases & Fixed Expenses Decrease,229124,65776.0,55904,121680.0,107444.0,46.89,0.0,Low Risk
U624,2024,2,346063.0,Salary Increases & Fixed Expenses Decrease,229124,65776.0,67222,132998.0,96126.0,41.95,-0.04,Low Risk
U624,2024,3,442189.0,Salary Increases & Fixed Expenses Decrease,229124,65776.0,61541,127317.0,101807.0,44.43,-0.04,Low Risk
U624,2024,4,543996.0,Salary Increases & Fixed Expenses Decrease,229124,65776.0,49786,115562.0,113562.0,49.56,0.0,Low Risk
U624,2024,5,657558.0,Salary Increases & Fixed Expenses Decrease,229124,65776.0,65279,131055.0,98069.0,42.8,-0.04,Low Risk
U624,2024,6,755627.0,Salary Increases & Fixed Expenses Decrease,238637,65776.0,60758,126534.0,112103.0,46.98,0.03,Low Risk
U624,2024,7,867730.0,Salary Increases & Fixed Expenses Decrease,238637,65776.0,49090,114866.0,123771.0,51.87,-0.03,Low Risk
U624,2024,8,991501.0,Salary Increases & Fixed Expenses Decrease,238637,65776.0,62214,127990.0,110647.0,46.37,-0.02,Low Risk
U624,2024,9,1102148.0,Salary Increases & Fixed Expenses Decrease,238637,65776.0,54952,120728.0,117909.0,49.41,0.05,Low Risk
U624,2024,10,1220057.0,Salary Increases & Fixed Expenses Decrease,238637,65776.0,64072,129848.0,108789.0,45.59,-0.01,Low Risk
U624,2024,11,1328846.0,Salary Increases & Fixed Expenses Decrease,238637,65776.0,66969,132745.0,105892.0,44.37,0.01,Low Risk
U624,2024,12,1434738.0,Salary Increases & Fixed Expenses Decrease,238637,65776.0,79266,145042.0,93595.0,39.22,-0.01,Low Risk
U625,2024,1,250000.0,Stable Salary & Increasing Fixed Expenses,267441,95786.0,98970,194756.0,72685.0,27.18,-0.01,Low Risk
U625,2024,2,322685.0,Stable Salary & Increasing Fixed Expenses,267441,95786.0,104913,200699.0,66742.0,24.96,0.04,Medium Risk
U625,2024,3,389427.0,Stable Salary & Increasing Fixed Expenses,267441,95786.0,129720,225506.0,41935.0,15.68,0.01,Medium Risk
U625,2024,4,431362.0,Stable Salary & Increasing Fixed Expenses,267441,95786.0,109844,205630.0,61811.0,23.11,-0.0,Medium Risk
U625,2024,5,493173.0,Stable Salary & Increasing Fixed Expenses,267441,95786.0,117742,213528.0,53913.0,20.16,-0.01,Medium Risk
U625,2024,6,547086.0,Stable Salary & Increasing Fixed Expenses,267441,95786.0,133476,229262.0,38179.0,14.28,0.04,High Risk
U625,2024,7,585265.0,Stable Salary & Increasing Fixed Expenses,267441,95786.0,85746,181532.0,85909.0,32.12,0.05,Low Risk
U625,2024,8,671174.0,Stable Salary & Increasing Fixed Expenses,267441,95786.0,131261,227047.0,40394.0,15.1,0.03,Medium Risk
U625,2024,9,711568.0,Stable Salary & Increasing Fixed Expenses,267441,95786.0,129507,225293.0,42148.0,15.76,0.04,Medium Risk
U625,2024,10,753716.0,Stable Salary & Increasing Fixed Expenses,267441,96552.0,125341,221893.0,45548.0,17.03,-0.0,Medium Risk
U625,2024,11,799264.0,Stable Salary & Increasing Fixed Expenses,267441,96552.0,96707,193259.0,74182.0,27.74,0.02,Low Risk
U625,2024,12,873446.0,Stable Salary & Increasing Fixed Expenses,267441,96552.0,99955,196507.0,70934.0,26.52,-0.02,Low Risk
U626,2024,1,239733.0,Salary Increases & Fixed Expenses Remain Stable,238648,108910.0,107957,216867.0,21781.0,9.13,0.05,High Risk
U626,2024,2,261514.0,Salary Increases & Fixed Expenses Remain Stable,238648,108910.0,77295,186205.0,52443.0,21.98,0.05,Medium Risk
U626,2024,3,313957.0,Salary Increases & Fixed Expenses Remain Stable,238648,108910.0,72644,181554.0,57094.0,23.92,-0.01,Medium Risk
U626,2024,4,371051.0,Salary Increases & Fixed Expenses Remain Stable,238648,108910.0,87720,196630.0,42018.0,17.61,-0.03,Medium Risk
U626,2024,5,413069.0,Salary Increases & Fixed Expenses Remain Stable,238648,108910.0,86419,195329.0,43319.0,18.15,0.0,Medium Risk
U626,2024,6,456388.0,Salary Increases & Fixed Expenses Remain Stable,238648,108910.0,72071,180981.0,57667.0,24.16,0.03,Medium Risk
U626,2024,7,514055.0,Salary Increases & Fixed Expenses Remain Stable,245009,108910.0,106554,215464.0,29545.0,12.06,-0.03,High Risk
U626,2024,8,543600.0,Salary Increases & Fixed Expenses Remain Stable,245009,108910.0,91493,200403.0,44606.0,18.21,0.0,Medium Risk
U626,2024,9,588206.0,Salary Increases & Fixed Expenses Remain Stable,245009,108910.0,102167,211077.0,33932.0,13.85,0.04,High Risk
U626,2024,10,622138.0,Salary Increases & Fixed Expenses Remain Stable,245009,108910.0,90866,199776.0,45233.0,18.46,-0.02,Medium Risk
U626,2024,11,667371.0,Salary Increases & Fixed Expenses Remain Stable,245009,108910.0,83881,192791.0,52218.0,21.31,0.03,Medium Risk
U626,2024,12,719589.0,Salary Increases & Fixed Expenses Remain Stable,245009,108910.0,111730,220640.0,24369.0,9.95,-0.01,High Risk
U627,2024,1,203987.0,Salary Increases & Fixed Expenses Remain Stable,190792,63320.0,45284,108604.0,82188.0,43.08,-0.04,Low Risk
U627,2024,2,286175.0,Salary Increases & Fixed Expenses Remain Stable,190792,63320.0,50813,114133.0,76659.0,40.18,0.02,Low Risk
U627,2024,3,362834.0,Salary Increases & Fixed Expenses Remain Stable,196785,63320.0,43461,106781.0,90004.0,45.74,-0.03,Low Risk
U627,2024,4,452838.0,Salary Increases & Fixed Expenses Remain Stable,196785,63320.0,51269,114589.0,82196.0,41.77,-0.01,Low Risk
U627,2024,5,535034.0,Salary Increases & Fixed Expenses Remain Stable,196785,63320.0,54409,117729.0,79056.0,40.17,0.04,Low Risk
U627,2024,6,614090.0,Salary Increases & Fixed Expenses Remain Stable,196785,63320.0,42340,105660.0,91125.0,46.31,-0.02,Low Risk
U627,2024,7,705215.0,Salary Increases & Fixed Expenses Remain Stable,196785,63320.0,43127,106447.0,90338.0,45.91,0.02,Low Risk
U627,2024,8,795553.0,Salary Increases & Fixed Expenses Remain Stable,196785,63320.0,58254,121574.0,75211.0,38.22,-0.02,Low Risk
U627,2024,9,870764.0,Salary Increases & Fixed Expenses Remain Stable,196785,63320.0,44103,107423.0,89362.0,45.41,-0.0,Low Risk
U627,2024,10,960126.0,Salary Increases & Fixed Expenses Remain Stable,196785,63320.0,39837,103157.0,93628.0,47.58,-0.0,Low Risk
U627,2024,11,1053754.0,Salary Increases & Fixed Expenses Remain Stable,196785,63320.0,42907,106227.0,90558.0,46.02,0.04,Low Risk
U627,2024,12,1144312.0,Salary Increases & Fixed Expenses Remain Stable,196785,63320.0,40448,103768.0,93017.0,47.27,-0.03,Low Risk
U628,2024,1,172838.0,Stable Salary & Stable Fixed Expenses,77974,38795.0,38382,77177.0,797.0,1.02,-0.04,High Risk
U628,2024,2,173635.0,Stable Salary & Stable Fixed Expenses,77974,38795.0,36846,75641.0,2333.0,2.99,0.02,High Risk
U628,2024,3,175968.0,Stable Salary & Stable Fixed Expenses,77974,38795.0,32859,71654.0,6320.0,8.11,0.04,High Risk
U628,2024,4,182288.0,Stable Salary & Stable Fixed Expenses,77974,38795.0,25959,64754.0,13220.0,16.95,0.04,Medium Risk
U628,2024,5,195508.0,Stable Salary & Stable Fixed Expenses,77974,38795.0,27796,66591.0,11383.0,14.6,-0.02,High Risk
U628,2024,6,206891.0,Stable Salary & Stable Fixed Expenses,77974,38795.0,24587,63382.0,14592.0,18.71,0.02,Medium Risk
U628,2024,7,221483.0,Stable Salary & Stable Fixed Expenses,77974,38795.0,37281,76076.0,1898.0,2.43,0.05,High Risk
U628,2024,8,223381.0,Stable Salary & Stable Fixed Expenses,77974,38795.0,26620,65415.0,12559.0,16.11,-0.05,Medium Risk
U628,2024,9,235940.0,Stable Salary & Stable Fixed Expenses,77974,38795.0,33636,72431.0,5543.0,7.11,-0.04,High Risk
U628,2024,10,241483.0,Stable Salary & Stable Fixed Expenses,77974,38795.0,26274,65069.0,12905.0,16.55,-0.02,Medium Risk
U628,2024,11,254388.0,Stable Salary & Stable Fixed Expenses,77974,38795.0,34347,73142.0,4832.0,6.2,0.01,High Risk
U628,2024,12,259220.0,Stable Salary & Stable Fixed Expenses,77974,38795.0,30706,69501.0,8473.0,10.87,0.01,High Risk
U629,2024,1,176325.0,Salary Increases & Fixed Expenses Remain Stable,134608,54592.0,28573,83165.0,51443.0,38.22,0.02,Low Risk
U629,2024,2,227768.0,Salary Increases & Fixed Expenses Remain Stable,134608,54592.0,35825,90417.0,44191.0,32.83,0.01,Low Risk
U629,2024,3,271959.0,Salary Increases & Fixed Expenses Remain Stable,134608,54592.0,29017,83609.0,50999.0,37.89,0.01,Low Risk
U629,2024,4,322958.0,Salary Increases & Fixed Expenses Remain Stable,134608,54592.0,33340,87932.0,46676.0,34.68,0.05,Low Risk
U629,2024,5,369634.0,Salary Increases & Fixed Expenses Remain Stable,134608,54592.0,31754,86346.0,48262.0,35.85,-0.04,Low Risk
U629,2024,6,417896.0,Salary Increases & Fixed Expenses Remain Stable,134608,54592.0,27798,82390.0,52218.0,38.79,0.03,Low Risk
U629,2024,7,470114.0,Salary Increases & Fixed Expenses Remain Stable,144853,54592.0,37940,92532.0,52321.0,36.12,-0.02,Low Risk
U629,2024,8,522435.0,Salary Increases & Fixed Expenses Remain Stable,144853,54592.0,32500,87092.0,57761.0,39.88,-0.05,Low Risk
U629,2024,9,580196.0,Salary Increases & Fixed Expenses Remain Stable,144853,54592.0,29677,84269.0,60584.0,41.82,0.05,Low Risk
U629,2024,10,640780.0,Salary Increases & Fixed Expenses Remain Stable,144853,54592.0,36421,91013.0,53840.0,37.17,-0.05,Low Risk
U629,2024,11,694620.0,Salary Increases & Fixed Expenses Remain Stable,144853,54592.0,37064,91656.0,53197.0,36.72,0.0,Low Risk
U629,2024,12,747817.0,Salary Increases & Fixed Expenses Remain Stable,144853,54592.0,35471,90063.0,54790.0,37.82,-0.04,Low Risk
U630,2024,1,136083.0,Salary Increases & Fixed Expenses Increase,128048,56925.0,84890,141815.0,-13767.0,-10.75,0.04,High Risk
U630,2024,2,122316.0,Salary Increases & Fixed Expenses Increase,128048,56925.0,83936,140861.0,-12813.0,-10.01,0.02,High Risk
U630,2024,3,109503.0,Salary Increases & Fixed Expenses Increase,128048,58833.0,68952,127785.0,263.0,0.21,-0.05,High Risk
U630,2024,4,109766.0,Salary Increases & Fixed Expenses Increase,128048,58833.0,82523,141356.0,-13308.0,-10.39,0.0,High Risk
U630,2024,5,96458.0,Salary Increases & Fixed Expenses Increase,128048,59595.0,68845,128440.0,-392.0,-0.31,0.01,High Risk
U630,2024,6,96066.0,Salary Increases & Fixed Expenses Increase,128048,59595.0,77364,136959.0,-8911.0,-6.96,0.02,High Risk
U630,2024,7,87155.0,Salary Increases & Fixed Expenses Increase,133820,60640.0,81448,142088.0,-8268.0,-6.18,-0.04,High Risk
U630,2024,8,78887.0,Salary Increases & Fixed Expenses Increase,133820,60640.0,80256,140896.0,-7076.0,-5.29,-0.0,High Risk
U630,2024,9,71811.0,Salary Increases & Fixed Expenses Increase,133820,60640.0,94803,155443.0,-21623.0,-16.16,0.03,High Risk
U630,2024,10,50188.0,Salary Increases & Fixed Expenses Increase,133820,61670.0,85866,147536.0,-13716.0,-10.25,-0.03,High Risk
U630,2024,11,36472.0,Salary Increases & Fixed Expenses Increase,133820,61670.0,98539,160209.0,-26389.0,-19.72,-0.01,High Risk
U630,2024,12,10083.0,Salary Increases & Fixed Expenses Increase,133820,61670.0,80876,142546.0,-8726.0,-6.52,-0.02,High Risk
U631,2024,1,193524.0,Stable Salary & Increasing Fixed Expenses,36170,17181.0,18101,35282.0,888.0,2.46,0.04,High Risk
U631,2024,2,194412.0,Stable Salary & Increasing Fixed Expenses,36170,18706.0,24722,43428.0,-7258.0,-20.07,-0.0,High Risk
U631,2024,3,187154.0,Stable Salary & Increasing Fixed Expenses,36170,18706.0,19142,37848.0,-1678.0,-4.64,0.05,High Risk
U631,2024,4,185476.0,Stable Salary & Increasing Fixed Expenses,36170,18706.0,19030,37736.0,-1566.0,-4.33,0.0,High Risk
U631,2024,5,183910.0,Stable Salary & Increasing Fixed Expenses,36170,18706.0,21770,40476.0,-4306.0,-11.9,-0.03,High Risk
U631,2024,6,179604.0,Stable Salary & Increasing Fixed Expenses,36170,18706.0,19188,37894.0,-1724.0,-4.77,-0.0,High Risk
U631,2024,7,177880.0,Stable Salary & Increasing Fixed Expenses,36170,19791.0,22179,41970.0,-5800.0,-16.04,0.02,High Risk
U631,2024,8,172080.0,Stable Salary & Increasing Fixed Expenses,36170,19791.0,19425,39216.0,-3046.0,-8.42,-0.03,High Risk
U631,2024,9,169034.0,Stable Salary & Increasing Fixed Expenses,36170,19791.0,22668,42459.0,-6289.0,-17.39,0.03,High Risk
U631,2024,10,162745.0,Stable Salary & Increasing Fixed Expenses,36170,19791.0,19841,39632.0,-3462.0,-9.57,0.03,High Risk
U631,2024,11,159283.0,Stable Salary & Increasing Fixed Expenses,36170,19791.0,25025,44816.0,-8646.0,-23.9,-0.03,High Risk
U631,2024,12,150637.0,Stable Salary & Increasing Fixed Expenses,36170,19791.0,24436,44227.0,-8057.0,-22.28,0.01,High Risk
U632,2024,1,109430.0,Stable Salary & Increasing Fixed Expenses,101012,71934.0,26381,98315.0,2697.0,2.67,-0.03,High Risk
U632,2024,2,112127.0,Stable Salary & Increasing Fixed Expenses,101012,71934.0,21541,93475.0,7537.0,7.46,0.04,High Risk
U632,2024,3,119664.0,Stable Salary & Increasing Fixed Expenses,101012,71934.0,28774,100708.0,304.0,0.3,-0.05,High Risk
U632,2024,4,119968.0,Stable Salary & Increasing Fixed Expenses,101012,71934.0,22116,94050.0,6962.0,6.89,-0.01,High Risk
U632,2024,5,126930.0,Stable Salary & Increasing Fixed Expenses,101012,71934.0,27580,99514.0,1498.0,1.48,0.02,High Risk
U632,2024,6,128428.0,Stable Salary & Increasing Fixed Expenses,101012,71934.0,21776,93710.0,7302.0,7.23,-0.03,High Risk
U632,2024,7,135730.0,Stable Salary & Increasing Fixed Expenses,101012,71934.0,23660,95594.0,5418.0,5.36,-0.03,High Risk
U632,2024,8,141148.0,Stable Salary & Increasing Fixed Expenses,101012,73900.0,30149,104049.0,-3037.0,-3.01,0.02,High Risk
U632,2024,9,138111.0,Stable Salary & Increasing Fixed Expenses,101012,73900.0,25189,99089.0,1923.0,1.9,0.01,High Risk
U632,2024,10,140034.0,Stable Salary & Increasing Fixed Expenses,101012,73900.0,30451,104351.0,-3339.0,-3.31,-0.03,High Risk
U632,2024,11,136695.0,Stable Salary & Increasing Fixed Expenses,101012,73900.0,31084,104984.0,-3972.0,-3.93,-0.05,High Risk
U632,2024,12,132723.0,Stable Salary & Increasing Fixed Expenses,101012,73900.0,31902,105802.0,-4790.0,-4.74,-0.05,High Risk
U633,2024,1,200204.0,Stable Salary & Stable Fixed Expenses,134526,71805.0,51573,123378.0,11148.0,8.29,-0.03,High Risk
U633,2024,2,211352.0,Stable Salary & Stable Fixed Expenses,134526,71805.0,48266,120071.0,14455.0,10.75,-0.01,High Risk
U633,2024,3,225807.0,Stable Salary & Stable Fixed Expenses,134526,71805.0,49412,121217.0,13309.0,9.89,0.0,High Risk
U633,2024,4,239116.0,Stable Salary & Stable Fixed Expenses,134526,71805.0,62815,134620.0,-94.0,-0.07,0.0,High Risk
U633,2024,5,239022.0,Stable Salary & Stable Fixed Expenses,134526,71805.0,58668,130473.0,4053.0,3.01,0.03,High Risk
U633,2024,6,243075.0,Stable Salary & Stable Fixed Expenses,134526,71805.0,45649,117454.0,17072.0,12.69,0.04,High Risk
U633,2024,7,260147.0,Stable Salary & Stable Fixed Expenses,134526,71805.0,45744,117549.0,16977.0,12.62,-0.04,High Risk
U633,2024,8,277124.0,Stable Salary & Stable Fixed Expenses,134526,71805.0,52024,123829.0,10697.0,7.95,-0.01,High Risk
U633,2024,9,287821.0,Stable Salary & Stable Fixed Expenses,134526,71805.0,54644,126449.0,8077.0,6.0,-0.05,High Risk
U633,2024,10,295898.0,Stable Salary & Stable Fixed Expenses,134526,71805.0,63526,135331.0,-805.0,-0.6,-0.04,High Risk
U633,2024,11,295093.0,Stable Salary & Stable Fixed Expenses,134526,71805.0,65465,137270.0,-2744.0,-2.04,0.04,High Risk
U633,2024,12,292349.0,Stable Salary & Stable Fixed Expenses,134526,71805.0,40963,112768.0,21758.0,16.17,0.01,Medium Risk
U634,2024,1,138691.0,Stable Salary & Stable Fixed Expenses,134695,65664.0,28650,94314.0,40381.0,29.98,-0.01,Low Risk
U634,2024,2,179072.0,Stable Salary & Stable Fixed Expenses,134695,65664.0,33207,98871.0,35824.0,26.6,0.04,Low Risk
U634,2024,3,214896.0,Stable Salary & Stable Fixed Expenses,134695,65664.0,33906,99570.0,35125.0,26.08,-0.02,Low Risk
U634,2024,4,250021.0,Stable Salary & Stable Fixed Expenses,134695,65664.0,29997,95661.0,39034.0,28.98,-0.05,Low Risk
U634,2024,5,289055.0,Stable Salary & Stable Fixed Expenses,134695,65664.0,36107,101771.0,32924.0,24.44,0.04,Medium Risk
U634,2024,6,321979.0,Stable Salary & Stable Fixed Expenses,134695,65664.0,28126,93790.0,40905.0,30.37,-0.04,Low Risk
U634,2024,7,362884.0,Stable Salary & Stable Fixed Expenses,134695,65664.0,27522,93186.0,41509.0,30.82,-0.02,Low Risk
U634,2024,8,404393.0,Stable Salary & Stable Fixed Expenses,134695,65664.0,39958,105622.0,29073.0,21.58,0.02,Medium Risk
U634,2024,9,433466.0,Stable Salary & Stable Fixed Expenses,134695,65664.0,33379,99043.0,35652.0,26.47,0.01,Low Risk
U634,2024,10,469118.0,Stable Salary & Stable Fixed Expenses,134695,65664.0,27800,93464.0,41231.0,30.61,-0.05,Low Risk
U634,2024,11,510349.0,Stable Salary & Stable Fixed Expenses,134695,65664.0,35444,101108.0,33587.0,24.94,-0.0,Medium Risk
U634,2024,12,543936.0,Stable Salary & Stable Fixed Expenses,134695,65664.0,36209,101873.0,32822.0,24.37,0.05,Medium Risk
U635,2024,1,187595.0,Stable Salary & Increasing Fixed Expenses,168523,62796.0,43659,106455.0,62068.0,36.83,-0.05,Low Risk
U635,2024,2,249663.0,Stable Salary & Increasing Fixed Expenses,168523,62796.0,41600,104396.0,64127.0,38.05,-0.01,Low Risk
U635,2024,3,313790.0,Stable Salary & Increasing Fixed Expenses,168523,62796.0,39396,102192.0,66331.0,39.36,0.03,Low Risk
U635,2024,4,380121.0,Stable Salary & Increasing Fixed Expenses,168523,62796.0,41419,104215.0,64308.0,38.16,0.02,Low Risk
U635,2024,5,444429.0,Stable Salary & Increasing Fixed Expenses,168523,62796.0,37487,100283.0,68240.0,40.49,0.05,Low Risk
U635,2024,6,512669.0,Stable Salary & Increasing Fixed Expenses,168523,63707.0,46128,109835.0,58688.0,34.82,-0.02,Low Risk
U635,2024,7,571357.0,Stable Salary & Increasing Fixed Expenses,168523,63707.0,48363,112070.0,56453.0,33.5,0.01,Low Risk
U635,2024,8,627810.0,Stable Salary & Increasing Fixed Expenses,168523,63707.0,50011,113718.0,54805.0,32.52,0.01,Low Risk
U635,2024,9,682615.0,Stable Salary & Increasing Fixed Expenses,168523,63707.0,45354,109061.0,59462.0,35.28,-0.03,Low Risk
U635,2024,10,742077.0,Stable Salary & Increasing Fixed Expenses,168523,64628.0,38081,102709.0,65814.0,39.05,-0.03,Low Risk
U635,2024,11,807891.0,Stable Salary & Increasing Fixed Expenses,168523,64628.0,49162,113790.0,54733.0,32.48,-0.02,Low Risk
U635,2024,12,862624.0,Stable Salary & Increasing Fixed Expenses,168523,64628.0,46176,110804.0,57719.0,34.25,0.01,Low Risk
U636,2024,1,245119.0,Stable Salary & Decreasing Fixed Expenses,244795,70690.0,111933,182623.0,62172.0,25.4,0.04,Low Risk
U636,2024,2,307291.0,Stable Salary & Decreasing Fixed Expenses,244795,70690.0,96677,167367.0,77428.0,31.63,0.0,Low Risk
U636,2024,3,384719.0,Stable Salary & Decreasing Fixed Expenses,244795,70690.0,105584,176274.0,68521.0,27.99,0.04,Low Risk
U636,2024,4,453240.0,Stable Salary & Decreasing Fixed Expenses,244795,70690.0,77300,147990.0,96805.0,39.55,0.02,Low Risk
U636,2024,5,550045.0,Stable Salary & Decreasing Fixed Expenses,244795,70690.0,118691,189381.0,55414.0,22.64,0.03,Medium Risk
U636,2024,6,605459.0,Stable Salary & Decreasing Fixed Expenses,244795,70690.0,114300,184990.0,59805.0,24.43,0.03,Medium Risk
U636,2024,7,665264.0,Stable Salary & Decreasing Fixed Expenses,244795,70690.0,98172,168862.0,75933.0,31.02,-0.03,Low Risk
U636,2024,8,741197.0,Stable Salary & Decreasing Fixed Expenses,244795,70690.0,106671,177361.0,67434.0,27.55,-0.0,Low Risk
U636,2024,9,808631.0,Stable Salary & Decreasing Fixed Expenses,244795,70690.0,91686,162376.0,82419.0,33.67,0.04,Low Risk
U636,2024,10,891050.0,Stable Salary & Decreasing Fixed Expenses,244795,70690.0,107062,177752.0,67043.0,27.39,0.05,Low Risk
U636,2024,11,958093.0,Stable Salary & Decreasing Fixed Expenses,244795,70690.0,95466,166156.0,78639.0,32.12,0.04,Low Risk
U636,2024,12,1036732.0,Stable Salary & Decreasing Fixed Expenses,244795,70690.0,81326,152016.0,92779.0,37.9,0.04,Low Risk
U637,2024,1,250000.0,Salary Increases & Fixed Expenses Remain Stable,253853,110410.0,113457,223867.0,29986.0,11.81,-0.02,High Risk
U637,2024,2,279986.0,Salary Increases & Fixed Expenses Remain Stable,253853,110410.0,80970,191380.0,62473.0,24.61,-0.0,Medium Risk
U637,2024,3,342459.0,Salary Increases & Fixed Expenses Remain Stable,253853,110410.0,77550,187960.0,65893.0,25.96,0.02,Low Risk
U637,2024,4,408352.0,Salary Increases & Fixed Expenses Remain Stable,273439,110410.0,92594,203004.0,70435.0,25.76,-0.0,Low Risk
U637,2024,5,478787.0,Salary Increases & Fixed Expenses Remain Stable,273439,110410.0,108240,218650.0,54789.0,20.04,0.01,Medium Risk
U637,2024,6,533576.0,Salary Increases & Fixed Expenses Remain Stable,273439,110410.0,105306,215716.0,57723.0,21.11,-0.04,Medium Risk
U637,2024,7,591299.0,Salary Increases & Fixed Expenses Remain Stable,273439,110410.0,128367,238777.0,34662.0,12.68,-0.01,High Risk
U637,2024,8,625961.0,Salary Increases & Fixed Expenses Remain Stable,273439,110410.0,92348,202758.0,70681.0,25.85,-0.04,Low Risk
U637,2024,9,696642.0,Salary Increases & Fixed Expenses Remain Stable,273439,110410.0,109459,219869.0,53570.0,19.59,-0.0,Medium Risk
U637,2024,10,750212.0,Salary Increases & Fixed Expenses Remain Stable,273439,110410.0,86976,197386.0,76053.0,27.81,-0.04,Low Risk
U637,2024,11,826265.0,Salary Increases & Fixed Expenses Remain Stable,273439,110410.0,102347,212757.0,60682.0,22.19,-0.03,Medium Risk
U637,2024,12,886947.0,Salary Increases & Fixed Expenses Remain Stable,273439,110410.0,90523,200933.0,72506.0,26.52,0.03,Low Risk
U638,2024,1,232537.0,Stable Salary & Stable Fixed Expenses,223859,93925.0,126684,220609.0,3250.0,1.45,-0.02,High Risk
U638,2024,2,235787.0,Stable Salary & Stable Fixed Expenses,223859,93925.0,121879,215804.0,8055.0,3.6,0.0,High Risk
U638,2024,3,243842.0,Stable Salary & Stable Fixed Expenses,223859,93925.0,126760,220685.0,3174.0,1.42,-0.01,High Risk
U638,2024,4,247016.0,Stable Salary & Stable Fixed Expenses,223859,93925.0,117602,211527.0,12332.0,5.51,-0.01,High Risk
U638,2024,5,259348.0,Stable Salary & Stable Fixed Expenses,223859,93925.0,138194,232119.0,-8260.0,-3.69,-0.04,High Risk
U638,2024,6,251088.0,Stable Salary & Stable Fixed Expenses,223859,93925.0,137004,230929.0,-7070.0,-3.16,-0.02,High Risk
U638,2024,7,244018.0,Stable Salary & Stable Fixed Expenses,223859,93925.0,132907,226832.0,-2973.0,-1.33,-0.02,High Risk
U638,2024,8,241045.0,Stable Salary & Stable Fixed Expenses,223859,93925.0,155254,249179.0,-25320.0,-11.31,-0.04,High Risk
U638,2024,9,215725.0,Stable Salary & Stable Fixed Expenses,223859,93925.0,128312,222237.0,1622.0,0.72,-0.03,High Risk
U638,2024,10,217347.0,Stable Salary & Stable Fixed Expenses,223859,93925.0,175633,269558.0,-45699.0,-20.41,-0.03,High Risk
U638,2024,11,171648.0,Stable Salary & Stable Fixed Expenses,223859,93925.0,121507,215432.0,8427.0,3.76,-0.0,High Risk
U638,2024,12,180075.0,Stable Salary & Stable Fixed Expenses,223859,93925.0,162775,256700.0,-32841.0,-14.67,0.03,High Risk
U639,2024,1,62423.0,Salary Increases & Fixed Expenses Remain Stable,47877,18104.0,16504,34608.0,13269.0,27.71,-0.03,Low Risk
U639,2024,2,75692.0,Salary Increases & Fixed Expenses Remain Stable,47877,18104.0,17285,35389.0,12488.0,26.08,0.03,Low Risk
U639,2024,3,88180.0,Salary Increases & Fixed Expenses Remain Stable,47877,18104.0,16908,35012.0,12865.0,26.87,-0.02,Low Risk
U639,2024,4,101045.0,Salary Increases & Fixed Expenses Remain Stable,47877,18104.0,23243,41347.0,6530.0,13.64,0.03,High Risk
U639,2024,5,107575.0,Salary Increases & Fixed Expenses Remain Stable,47877,18104.0,15644,33748.0,14129.0,29.51,0.02,Low Risk
U639,2024,6,121704.0,Salary Increases & Fixed Expenses Remain Stable,47877,18104.0,21168,39272.0,8605.0,17.97,0.04,Medium Risk
U639,2024,7,130309.0,Salary Increases & Fixed Expenses Remain Stable,55192,18104.0,18667,36771.0,18421.0,33.38,0.03,Low Risk
U639,2024,8,148730.0,Salary Increases & Fixed Expenses Remain Stable,55192,18104.0,26990,45094.0,10098.0,18.3,0.0,Medium Risk
U639,2024,9,158828.0,Salary Increases & Fixed Expenses Remain Stable,55192,18104.0,23773,41877.0,13315.0,24.12,-0.02,Medium Risk
U639,2024,10,172143.0,Salary Increases & Fixed Expenses Remain Stable,55192,18104.0,18143,36247.0,18945.0,34.33,0.01,Low Risk
U639,2024,11,191088.0,Salary Increases & Fixed Expenses Remain Stable,55192,18104.0,20959,39063.0,16129.0,29.22,0.0,Low Risk
U639,2024,12,207217.0,Salary Increases & Fixed Expenses Remain Stable,55192,18104.0,22595,40699.0,14493.0,26.26,-0.04,Low Risk
U640,2024,1,250000.0,Salary Increases & Fixed Expenses Remain Stable,296438,90194.0,167155,257349.0,39089.0,13.19,-0.01,High Risk
U640,2024,2,289089.0,Salary Increases & Fixed Expenses Remain Stable,296438,90194.0,191704,281898.0,14540.0,4.9,0.01,High Risk
U640,2024,3,303629.0,Salary Increases & Fixed Expenses Remain Stable,296438,90194.0,191001,281195.0,15243.0,5.14,-0.04,High Risk
U640,2024,4,318872.0,Salary Increases & Fixed Expenses Remain Stable,296438,90194.0,189716,279910.0,16528.0,5.58,0.0,High Risk
U640,2024,5,335400.0,Salary Increases & Fixed Expenses Remain Stable,296438,90194.0,167893,258087.0,38351.0,12.94,0.0,High Risk
U640,2024,6,373751.0,Salary Increases & Fixed Expenses Remain Stable,296438,90194.0,173333,263527.0,32911.0,11.1,-0.01,High Risk
U640,2024,7,406662.0,Salary Increases & Fixed Expenses Remain Stable,316365,90194.0,194110,284304.0,32061.0,10.13,0.01,High Risk
U640,2024,8,438723.0,Salary Increases & Fixed Expenses Remain Stable,316365,90194.0,179334,269528.0,46837.0,14.8,-0.04,High Risk
U640,2024,9,485560.0,Salary Increases & Fixed Expenses Remain Stable,316365,90194.0,192866,283060.0,33305.0,10.53,0.05,High Risk
U640,2024,10,518865.0,Salary Increases & Fixed Expenses Remain Stable,316365,90194.0,228258,318452.0,-2087.0,-0.66,0.01,High Risk
U640,2024,11,516778.0,Salary Increases & Fixed Expenses Remain Stable,316365,90194.0,198756,288950.0,27415.0,8.67,0.01,High Risk
U640,2024,12,544193.0,Salary Increases & Fixed Expenses Remain Stable,316365,90194.0,222901,313095.0,3270.0,1.03,0.01,High Risk
U641,2024,1,235259.0,Stable Salary & Increasing Fixed Expenses,219660,116575.0,56342,172917.0,46743.0,21.28,0.04,Medium Risk
U641,2024,2,282002.0,Stable Salary & Increasing Fixed Expenses,219660,116575.0,47632,164207.0,55453.0,25.24,0.02,Low Risk
U641,2024,3,337455.0,Stable Salary & Increasing Fixed Expenses,219660,116575.0,52029,168604.0,51056.0,23.24,0.05,Medium Risk
U641,2024,4,388511.0,Stable Salary & Increasing Fixed Expenses,219660,116575.0,45180,161755.0,57905.0,26.36,-0.04,Low Risk
U641,2024,5,446416.0,Stable Salary & Increasing Fixed Expenses,219660,116575.0,60168,176743.0,42917.0,19.54,-0.04,Medium Risk
U641,2024,6,489333.0,Stable Salary & Increasing Fixed Expenses,219660,116575.0,60615,177190.0,42470.0,19.33,-0.01,Medium Risk
U641,2024,7,531803.0,Stable Salary & Increasing Fixed Expenses,219660,116575.0,62696,179271.0,40389.0,18.39,-0.05,Medium Risk
U641,2024,8,572192.0,Stable Salary & Increasing Fixed Expenses,219660,116575.0,52145,168720.0,50940.0,23.19,-0.02,Medium Risk
U641,2024,9,623132.0,Stable Salary & Increasing Fixed Expenses,219660,116575.0,60482,177057.0,42603.0,19.39,0.04,Medium Risk
U641,2024,10,665735.0,Stable Salary & Increasing Fixed Expenses,219660,117551.0,66897,184448.0,35212.0,16.03,0.01,Medium Risk
U641,2024,11,700947.0,Stable Salary & Increasing Fixed Expenses,219660,117551.0,69529,187080.0,32580.0,14.83,-0.02,High Risk
U641,2024,12,733527.0,Stable Salary & Increasing Fixed Expenses,219660,117551.0,55975,173526.0,46134.0,21.0,-0.0,Medium Risk
U642,2024,1,175590.0,Stable Salary & Decreasing Fixed Expenses,96329,24875.0,19698,44573.0,51756.0,53.73,0.02,Low Risk
U642,2024,2,227346.0,Stable Salary & Decreasing Fixed Expenses,96329,24875.0,26170,51045.0,45284.0,47.01,0.0,Low Risk
U642,2024,3,272630.0,Stable Salary & Decreasing Fixed Expenses,96329,24875.0,19758,44633.0,51696.0,53.67,-0.0,Low Risk
U642,2024,4,324326.0,Stable Salary & Decreasing Fixed Expenses,96329,24875.0,27691,52566.0,43763.0,45.43,0.01,Low Risk
U642,2024,5,368089.0,Stable Salary & Decreasing Fixed Expenses,96329,24875.0,24353,49228.0,47101.0,48.9,-0.03,Low Risk
U642,2024,6,415190.0,Stable Salary & Decreasing Fixed Expenses,96329,24875.0,19505,44380.0,51949.0,53.93,-0.03,Low Risk
U642,2024,7,467139.0,Stable Salary & Decreasing Fixed Expenses,96329,24875.0,25719,50594.0,45735.0,47.48,0.01,Low Risk
U642,2024,8,512874.0,Stable Salary & Decreasing Fixed Expenses,96329,24875.0,21626,46501.0,49828.0,51.73,0.03,Low Risk
U642,2024,9,562702.0,Stable Salary & Decreasing Fixed Expenses,96329,24875.0,21743,46618.0,49711.0,51.61,0.01,Low Risk
U642,2024,10,612413.0,Stable Salary & Decreasing Fixed Expenses,96329,23195.0,22874,46069.0,50260.0,52.18,0.03,Low Risk
U642,2024,11,662673.0,Stable Salary & Decreasing Fixed Expenses,96329,23195.0,24513,47708.0,48621.0,50.47,-0.05,Low Risk
U642,2024,12,711294.0,Stable Salary & Decreasing Fixed Expenses,96329,23195.0,23817,47012.0,49317.0,51.2,0.0,Low Risk
U643,2024,1,249060.0,Salary Increases & Fixed Expenses Remain Stable,246103,67782.0,81060,148842.0,97261.0,39.52,0.01,Low Risk
U643,2024,2,346321.0,Salary Increases & Fixed Expenses Remain Stable,246103,67782.0,116254,184036.0,62067.0,25.22,-0.03,Low Risk
U643,2024,3,408388.0,Salary Increases & Fixed Expenses Remain Stable,246103,67782.0,76468,144250.0,101853.0,41.39,0.03,Low Risk
U643,2024,4,510241.0,Salary Increases & Fixed Expenses Remain Stable,256802,67782.0,97975,165757.0,91045.0,35.45,-0.01,Low Risk
U643,2024,5,601286.0,Salary Increases & Fixed Expenses Remain Stable,256802,67782.0,78161,145943.0,110859.0,43.17,-0.03,Low Risk
U643,2024,6,712145.0,Salary Increases & Fixed Expenses Remain Stable,256802,67782.0,128064,195846.0,60956.0,23.74,0.0,Medium Risk
U643,2024,7,773101.0,Salary Increases & Fixed Expenses Remain Stable,256802,67782.0,90431,158213.0,98589.0,38.39,-0.01,Low Risk
U643,2024,8,871690.0,Salary Increases & Fixed Expenses Remain Stable,256802,67782.0,99943,167725.0,89077.0,34.69,-0.0,Low Risk
U643,2024,9,960767.0,Salary Increases & Fixed Expenses Remain Stable,256802,67782.0,110903,178685.0,78117.0,30.42,-0.02,Low Risk
U643,2024,10,1038884.0,Salary Increases & Fixed Expenses Remain Stable,256802,67782.0,121538,189320.0,67482.0,26.28,-0.04,Low Risk
U643,2024,11,1106366.0,Salary Increases & Fixed Expenses Remain Stable,256802,67782.0,102058,169840.0,86962.0,33.86,0.02,Low Risk
U643,2024,12,1193328.0,Salary Increases & Fixed Expenses Remain Stable,256802,67782.0,113977,181759.0,75043.0,29.22,0.03,Low Risk
U644,2024,1,142250.0,Salary Increases & Fixed Expenses Remain Stable,71116,30150.0,22385,52535.0,18581.0,26.13,-0.01,Low Risk
U644,2024,2,160831.0,Salary Increases & Fixed Expenses Remain Stable,71116,30150.0,34310,64460.0,6656.0,9.36,-0.01,High Risk
U644,2024,3,167487.0,Salary Increases & Fixed Expenses Remain Stable,71116,30150.0,35240,65390.0,5726.0,8.05,0.02,High Risk
U644,2024,4,173213.0,Salary Increases & Fixed Expenses Remain Stable,71116,30150.0,32159,62309.0,8807.0,12.38,-0.02,High Risk
U644,2024,5,182020.0,Salary Increases & Fixed Expenses Remain Stable,71116,30150.0,34786,64936.0,6180.0,8.69,-0.01,High Risk
U644,2024,6,188200.0,Salary Increases & Fixed Expenses Remain Stable,71116,30150.0,26091,56241.0,14875.0,20.92,-0.04,Medium Risk
U644,2024,7,203075.0,Salary Increases & Fixed Expenses Remain Stable,91657,30150.0,45599,75749.0,15908.0,17.36,0.03,Medium Risk
U644,2024,8,218983.0,Salary Increases & Fixed Expenses Remain Stable,91657,30150.0,42071,72221.0,19436.0,21.21,0.01,Medium Risk
U644,2024,9,238419.0,Salary Increases & Fixed Expenses Remain Stable,91657,30150.0,48312,78462.0,13195.0,14.4,-0.03,High Risk
U644,2024,10,251614.0,Salary Increases & Fixed Expenses Remain Stable,91657,30150.0,43810,73960.0,17697.0,19.31,-0.04,Medium Risk
U644,2024,11,269311.0,Salary Increases & Fixed Expenses Remain Stable,91657,30150.0,39311,69461.0,22196.0,24.22,0.02,Medium Risk
U644,2024,12,291507.0,Salary Increases & Fixed Expenses Remain Stable,91657,30150.0,45611,75761.0,15896.0,17.34,0.01,Medium Risk
U645,2024,1,239778.0,Salary Increases & Fixed Expenses Increase,163380,67478.0,98718,166196.0,-2816.0,-1.72,0.01,High Risk
U645,2024,2,236962.0,Salary Increases & Fixed Expenses Increase,163380,69048.0,100247,169295.0,-5915.0,-3.62,0.01,High Risk
U645,2024,3,231047.0,Salary Increases & Fixed Expenses Increase,163380,69810.0,100035,169845.0,-6465.0,-3.96,0.0,High Risk
U645,2024,4,224582.0,Salary Increases & Fixed Expenses Increase,163380,69810.0,105657,175467.0,-12087.0,-7.4,0.04,High Risk
U645,2024,5,212495.0,Salary Increases & Fixed Expenses Increase,163380,69810.0,107288,177098.0,-13718.0,-8.4,-0.01,High Risk
U645,2024,6,198777.0,Salary Increases & Fixed Expenses Increase,176256,69810.0,116401,186211.0,-9955.0,-5.65,-0.03,High Risk
U645,2024,7,188822.0,Salary Increases & Fixed Expenses Increase,176256,69810.0,92098,161908.0,14348.0,8.14,-0.03,High Risk
U645,2024,8,203170.0,Salary Increases & Fixed Expenses Increase,176256,69810.0,116733,186543.0,-10287.0,-5.84,-0.0,High Risk
U645,2024,9,192883.0,Salary Increases & Fixed Expenses Increase,176256,71175.0,132441,203616.0,-27360.0,-15.52,-0.02,High Risk
U645,2024,10,165523.0,Salary Increases & Fixed Expenses Increase,176256,71175.0,98953,170128.0,6128.0,3.48,0.0,High Risk
U645,2024,11,171651.0,Salary Increases & Fixed Expenses Increase,176256,72605.0,131301,203906.0,-27650.0,-15.69,0.02,High Risk
U645,2024,12,144001.0,Salary Increases & Fixed Expenses Increase,176256,72605.0,96769,169374.0,6882.0,3.9,0.02,High Risk
U646,2024,1,232815.0,Stable Salary & Stable Fixed Expenses,73408,29354.0,20696,50050.0,23358.0,31.82,-0.0,Low Risk
U646,2024,2,256173.0,Stable Salary & Stable Fixed Expenses,73408,29354.0,21050,50404.0,23004.0,31.34,-0.04,Low Risk
U646,2024,3,279177.0,Stable Salary & Stable Fixed Expenses,73408,29354.0,15748,45102.0,28306.0,38.56,0.01,Low Risk
U646,2024,4,307483.0,Stable Salary & Stable Fixed Expenses,73408,29354.0,21260,50614.0,22794.0,31.05,-0.02,Low Risk
U646,2024,5,330277.0,Stable Salary & Stable Fixed Expenses,73408,29354.0,19245,48599.0,24809.0,33.8,-0.0,Low Risk
U646,2024,6,355086.0,Stable Salary & Stable Fixed Expenses,73408,29354.0,21094,50448.0,22960.0,31.28,0.01,Low Risk
U646,2024,7,378046.0,Stable Salary & Stable Fixed Expenses,73408,29354.0,15841,45195.0,28213.0,38.43,0.04,Low Risk
U646,2024,8,406259.0,Stable Salary & Stable Fixed Expenses,73408,29354.0,16890,46244.0,27164.0,37.0,0.01,Low Risk
U646,2024,9,433423.0,Stable Salary & Stable Fixed Expenses,73408,29354.0,23834,53188.0,20220.0,27.54,-0.04,Low Risk
U646,2024,10,453643.0,Stable Salary & Stable Fixed Expenses,73408,29354.0,18539,47893.0,25515.0,34.76,-0.02,Low Risk
U646,2024,11,479158.0,Stable Salary & Stable Fixed Expenses,73408,29354.0,17782,47136.0,26272.0,35.79,0.01,Low Risk
U646,2024,12,505430.0,Stable Salary & Stable Fixed Expenses,73408,29354.0,19366,48720.0,24688.0,33.63,-0.04,Low Risk
U647,2024,1,250000.0,Salary Increases & Fixed Expenses Increase,282616,112168.0,91638,203806.0,78810.0,27.89,0.03,Low Risk
U647,2024,2,328810.0,Salary Increases & Fixed Expenses Increase,282616,112168.0,137505,249673.0,32943.0,11.66,0.03,High Risk
U647,2024,3,361753.0,Salary Increases & Fixed Expenses Increase,282616,112168.0,129257,241425.0,41191.0,14.57,-0.03,High Risk
U647,2024,4,402944.0,Salary Increases & Fixed Expenses Increase,282616,112168.0,140420,252588.0,30028.0,10.63,-0.03,High Risk
U647,2024,5,432972.0,Salary Increases & Fixed Expenses Increase,282616,112168.0,98495,210663.0,71953.0,25.46,0.02,Low Risk
U647,2024,6,504925.0,Salary Increases & Fixed Expenses Increase,282616,112168.0,103625,215793.0,66823.0,23.64,0.01,Medium Risk
U647,2024,7,571748.0,Salary Increases & Fixed Expenses Increase,303062,112168.0,148477,260645.0,42417.0,14.0,-0.02,High Risk
U647,2024,8,614165.0,Salary Increases & Fixed Expenses Increase,303062,112168.0,151015,263183.0,39879.0,13.16,-0.02,High Risk
U647,2024,9,654044.0,Salary Increases & Fixed Expenses Increase,303062,112862.0,129932,242794.0,60268.0,19.89,0.02,Medium Risk
U647,2024,10,714312.0,Salary Increases & Fixed Expenses Increase,303062,112862.0,141328,254190.0,48872.0,16.13,-0.03,Medium Risk
U647,2024,11,763184.0,Salary Increases & Fixed Expenses Increase,303062,112862.0,163133,275995.0,27067.0,8.93,-0.0,High Risk
U647,2024,12,790251.0,Salary Increases & Fixed Expenses Increase,303062,112862.0,105748,218610.0,84452.0,27.87,0.0,Low Risk
U648,2024,1,250000.0,Stable Salary & Stable Fixed Expenses,251432,84459.0,93068,177527.0,73905.0,29.39,0.02,Low Risk
U648,2024,2,323905.0,Stable Salary & Stable Fixed Expenses,251432,84459.0,97286,181745.0,69687.0,27.72,0.04,Low Risk
U648,2024,3,393592.0,Stable Salary & Stable Fixed Expenses,251432,84459.0,96674,181133.0,70299.0,27.96,-0.05,Low Risk
U648,2024,4,463891.0,Stable Salary & Stable Fixed Expenses,251432,84459.0,103175,187634.0,63798.0,25.37,-0.03,Low Risk
U648,2024,5,527689.0,Stable Salary & Stable Fixed Expenses,251432,84459.0,121787,206246.0,45186.0,17.97,0.04,Medium Risk
U648,2024,6,572875.0,Stable Salary & Stable Fixed Expenses,251432,84459.0,80830,165289.0,86143.0,34.26,-0.01,Low Risk
U648,2024,7,659018.0,Stable Salary & Stable Fixed Expenses,251432,84459.0,113627,198086.0,53346.0,21.22,0.01,Medium Risk
U648,2024,8,712364.0,Stable Salary & Stable Fixed Expenses,251432,84459.0,120117,204576.0,46856.0,18.64,0.03,Medium Risk
U648,2024,9,759220.0,Stable Salary & Stable Fixed Expenses,251432,84459.0,83933,168392.0,83040.0,33.03,0.01,Low Risk
U648,2024,10,842260.0,Stable Salary & Stable Fixed Expenses,251432,84459.0,110342,194801.0,56631.0,22.52,0.03,Medium Risk
U648,2024,11,898891.0,Stable Salary & Stable Fixed Expenses,251432,84459.0,97898,182357.0,69075.0,27.47,-0.05,Low Risk
U648,2024,12,967966.0,Stable Salary & Stable Fixed Expenses,251432,84459.0,82689,167148.0,84284.0,33.52,0.03,Low Risk
U649,2024,1,247446.0,Salary Increases & Fixed Expenses Remain Stable,93149,33914.0,18699,52613.0,40536.0,43.52,0.04,Low Risk
U649,2024,2,287982.0,Salary Increases & Fixed Expenses Remain Stable,93149,33914.0,26052,59966.0,33183.0,35.62,0.03,Low Risk
U649,2024,3,321165.0,Salary Increases & Fixed Expenses Remain Stable,93149,33914.0,26677,60591.0,32558.0,34.95,0.04,Low Risk
U649,2024,4,353723.0,Salary Increases & Fixed Expenses Remain Stable,93149,33914.0,21213,55127.0,38022.0,40.82,-0.03,Low Risk
U649,2024,5,391745.0,Salary Increases & Fixed Expenses Remain Stable,93149,33914.0,19253,53167.0,39982.0,42.92,0.01,Low Risk
U649,2024,6,431727.0,Salary Increases & Fixed Expenses Remain Stable,93149,33914.0,18949,52863.0,40286.0,43.25,0.01,Low Risk
U649,2024,7,472013.0,Salary Increases & Fixed Expenses Remain Stable,100202,33914.0,28036,61950.0,38252.0,38.17,-0.04,Low Risk
U649,2024,8,510265.0,Salary Increases & Fixed Expenses Remain Stable,100202,33914.0,26339,60253.0,39949.0,39.87,0.03,Low Risk
U649,2024,9,550214.0,Salary Increases & Fixed Expenses Remain Stable,100202,33914.0,26630,60544.0,39658.0,39.58,0.05,Low Risk
U649,2024,10,589872.0,Salary Increases & Fixed Expenses Remain Stable,100202,33914.0,21128,55042.0,45160.0,45.07,0.01,Low Risk
U649,2024,11,635032.0,Salary Increases & Fixed Expenses Remain Stable,100202,33914.0,24088,58002.0,42200.0,42.11,-0.02,Low Risk
U649,2024,12,677232.0,Salary Increases & Fixed Expenses Remain Stable,100202,33914.0,26587,60501.0,39701.0,39.62,0.03,Low Risk
U650,2024,1,239986.0,Stable Salary & Increasing Fixed Expenses,224220,103067.0,50704,153771.0,70449.0,31.42,0.05,Low Risk
U650,2024,2,310435.0,Stable Salary & Increasing Fixed Expenses,224220,103067.0,50092,153159.0,71061.0,31.69,-0.03,Low Risk
U650,2024,3,381496.0,Stable Salary & Increasing Fixed Expenses,224220,103067.0,74756,177823.0,46397.0,20.69,0.05,Medium Risk
U650,2024,4,427893.0,Stable Salary & Increasing Fixed Expenses,224220,103067.0,50889,153956.0,70264.0,31.34,0.01,Low Risk
U650,2024,5,498157.0,Stable Salary & Increasing Fixed Expenses,224220,103067.0,55829,158896.0,65324.0,29.13,0.05,Low Risk
U650,2024,6,563481.0,Stable Salary & Increasing Fixed Expenses,224220,103067.0,45357,148424.0,75796.0,33.8,-0.03,Low Risk
U650,2024,7,639277.0,Stable Salary & Increasing Fixed Expenses,224220,103067.0,48658,151725.0,72495.0,32.33,0.01,Low Risk
U650,2024,8,711772.0,Stable Salary & Increasing Fixed Expenses,224220,103067.0,49934,153001.0,71219.0,31.76,0.02,Low Risk
U650,2024,9,782991.0,Stable Salary & Increasing Fixed Expenses,224220,103603.0,57418,161021.0,63199.0,28.19,0.05,Low Risk
U650,2024,10,846190.0,Stable Salary & Increasing Fixed Expenses,224220,103603.0,55024,158627.0,65593.0,29.25,-0.02,Low Risk
U650,2024,11,911783.0,Stable Salary & Increasing Fixed Expenses,224220,103603.0,50702,154305.0,69915.0,31.18,0.03,Low Risk
U650,2024,12,981698.0,Stable Salary & Increasing Fixed Expenses,224220,103603.0,56373,159976.0,64244.0,28.65,-0.02,Low Risk
U651,2024,1,250000.0,Stable Salary & Stable Fixed Expenses,296520,79306.0,110619,189925.0,106595.0,35.95,0.0,Low Risk
U651,2024,2,356595.0,Stable Salary & Stable Fixed Expenses,296520,79306.0,124052,203358.0,93162.0,31.42,0.04,Low Risk
U651,2024,3,449757.0,Stable Salary & Stable Fixed Expenses,296520,79306.0,107757,187063.0,109457.0,36.91,-0.03,Low Risk
U651,2024,4,559214.0,Stable Salary & Stable Fixed Expenses,296520,79306.0,111779,191085.0,105435.0,35.56,-0.04,Low Risk
U651,2024,5,664649.0,Stable Salary & Stable Fixed Expenses,296520,79306.0,106454,185760.0,110760.0,37.35,-0.03,Low Risk
U651,2024,6,775409.0,Stable Salary & Stable Fixed Expenses,296520,79306.0,103573,182879.0,113641.0,38.32,0.02,Low Risk
U651,2024,7,889050.0,Stable Salary & Stable Fixed Expenses,296520,79306.0,138332,217638.0,78882.0,26.6,-0.05,Low Risk
U651,2024,8,967932.0,Stable Salary & Stable Fixed Expenses,296520,79306.0,118123,197429.0,99091.0,33.42,0.04,Low Risk
U651,2024,9,1067023.0,Stable Salary & Stable Fixed Expenses,296520,79306.0,114487,193793.0,102727.0,34.64,-0.01,Low Risk
U651,2024,10,1169750.0,Stable Salary & Stable Fixed Expenses,296520,79306.0,111720,191026.0,105494.0,35.58,0.04,Low Risk
U651,2024,11,1275244.0,Stable Salary & Stable Fixed Expenses,296520,79306.0,132038,211344.0,85176.0,28.73,0.05,Low Risk
U651,2024,12,1360420.0,Stable Salary & Stable Fixed Expenses,296520,79306.0,106407,185713.0,110807.0,37.37,0.05,Low Risk
U652,2024,1,158607.0,Stable Salary & Increasing Fixed Expenses,115310,40840.0,30929,71769.0,43541.0,37.76,0.0,Low Risk
U652,2024,2,202148.0,Stable Salary & Increasing Fixed Expenses,115310,40840.0,30836,71676.0,43634.0,37.84,-0.03,Low Risk
U652,2024,3,245782.0,Stable Salary & Increasing Fixed Expenses,115310,40840.0,32248,73088.0,42222.0,36.62,-0.03,Low Risk
U652,2024,4,288004.0,Stable Salary & Increasing Fixed Expenses,115310,40840.0,27737,68577.0,46733.0,40.53,0.01,Low Risk
U652,2024,5,334737.0,Stable Salary & Increasing Fixed Expenses,115310,40840.0,23605,64445.0,50865.0,44.11,-0.02,Low Risk
U652,2024,6,385602.0,Stable Salary & Increasing Fixed Expenses,115310,42147.0,28686,70833.0,44477.0,38.57,-0.04,Low Risk
U652,2024,7,430079.0,Stable Salary & Increasing Fixed Expenses,115310,42147.0,30905,73052.0,42258.0,36.65,0.0,Low Risk
U652,2024,8,472337.0,Stable Salary & Increasing Fixed Expenses,115310,42147.0,28948,71095.0,44215.0,38.34,-0.03,Low Risk
U652,2024,9,516552.0,Stable Salary & Increasing Fixed Expenses,115310,43953.0,26681,70634.0,44676.0,38.74,0.02,Low Risk
U652,2024,10,561228.0,Stable Salary & Increasing Fixed Expenses,115310,43953.0,29978,73931.0,41379.0,35.89,0.03,Low Risk
U652,2024,11,602607.0,Stable Salary & Increasing Fixed Expenses,115310,43953.0,33185,77138.0,38172.0,33.1,-0.02,Low Risk
U652,2024,12,640779.0,Stable Salary & Increasing Fixed Expenses,115310,45433.0,28430,73863.0,41447.0,35.94,0.01,Low Risk
U653,2024,1,230377.0,Salary Increases & Fixed Expenses Remain Stable,201666,87309.0,64249,151558.0,50108.0,24.85,-0.04,Medium Risk
U653,2024,2,280485.0,Salary Increases & Fixed Expenses Remain Stable,201666,87309.0,83639,170948.0,30718.0,15.23,0.04,Medium Risk
U653,2024,3,311203.0,Salary Increases & Fixed Expenses Remain Stable,212541,87309.0,68319,155628.0,56913.0,26.78,0.05,Low Risk
U653,2024,4,368116.0,Salary Increases & Fixed Expenses Remain Stable,212541,87309.0,90977,178286.0,34255.0,16.12,0.03,Medium Risk
U653,2024,5,402371.0,Salary Increases & Fixed Expenses Remain Stable,212541,87309.0,103740,191049.0,21492.0,10.11,0.02,High Risk
U653,2024,6,423863.0,Salary Increases & Fixed Expenses Remain Stable,212541,87309.0,91889,179198.0,33343.0,15.69,0.04,Medium Risk
U653,2024,7,457206.0,Salary Increases & Fixed Expenses Remain Stable,212541,87309.0,103898,191207.0,21334.0,10.04,-0.02,High Risk
U653,2024,8,478540.0,Salary Increases & Fixed Expenses Remain Stable,212541,87309.0,69952,157261.0,55280.0,26.01,-0.01,Low Risk
U653,2024,9,533820.0,Salary Increases & Fixed Expenses Remain Stable,212541,87309.0,88110,175419.0,37122.0,17.47,0.02,Medium Risk
U653,2024,10,570942.0,Salary Increases & Fixed Expenses Remain Stable,212541,87309.0,66038,153347.0,59194.0,27.85,0.02,Low Risk
U653,2024,11,630136.0,Salary Increases & Fixed Expenses Remain Stable,212541,87309.0,64644,151953.0,60588.0,28.51,0.02,Low Risk
U653,2024,12,690724.0,Salary Increases & Fixed Expenses Remain Stable,212541,87309.0,85033,172342.0,40199.0,18.91,0.04,Medium Risk
U654,2024,1,217929.0,Salary Increases & Fixed Expenses Increase,55241,32089.0,15363,47452.0,7789.0,14.1,-0.01,High Risk
U654,2024,2,225718.0,Salary Increases & Fixed Expenses Increase,55241,32089.0,13190,45279.0,9962.0,18.03,0.04,Medium Risk
U654,2024,3,235680.0,Salary Increases & Fixed Expenses Increase,61439,32089.0,12689,44778.0,16661.0,27.12,-0.01,Low Risk
U654,2024,4,252341.0,Salary Increases & Fixed Expenses Increase,61439,32089.0,16128,48217.0,13222.0,21.52,0.01,Medium Risk
U654,2024,5,265563.0,Salary Increases & Fixed Expenses Increase,61439,32089.0,13441,45530.0,15909.0,25.89,-0.04,Low Risk
U654,2024,6,281472.0,Salary Increases & Fixed Expenses Increase,61439,32089.0,15358,47447.0,13992.0,22.77,-0.04,Medium Risk
U654,2024,7,295464.0,Salary Increases & Fixed Expenses Increase,61439,32089.0,17781,49870.0,11569.0,18.83,0.01,Medium Risk
U654,2024,8,307033.0,Salary Increases & Fixed Expenses Increase,61439,32858.0,18311,51169.0,10270.0,16.72,0.03,Medium Risk
U654,2024,9,317303.0,Salary Increases & Fixed Expenses Increase,61439,32858.0,19520,52378.0,9061.0,14.75,0.02,High Risk
U654,2024,10,326364.0,Salary Increases & Fixed Expenses Increase,61439,32858.0,14761,47619.0,13820.0,22.49,0.04,Medium Risk
U654,2024,11,340184.0,Salary Increases & Fixed Expenses Increase,61439,32858.0,17571,50429.0,11010.0,17.92,-0.02,Medium Risk
U654,2024,12,351194.0,Salary Increases & Fixed Expenses Increase,61439,32858.0,15489,48347.0,13092.0,21.31,0.03,Medium Risk
U655,2024,1,196754.0,Salary Increases & Fixed Expenses Increase,190335,61196.0,44918,106114.0,84221.0,44.25,0.02,Low Risk
U655,2024,2,280975.0,Salary Increases & Fixed Expenses Increase,190335,61196.0,40754,101950.0,88385.0,46.44,-0.01,Low Risk
U655,2024,3,369360.0,Salary Increases & Fixed Expenses Increase,202849,61196.0,50840,112036.0,90813.0,44.77,0.02,Low Risk
U655,2024,4,460173.0,Salary Increases & Fixed Expenses Increase,202849,61196.0,51814,113010.0,89839.0,44.29,0.02,Low Risk
U655,2024,5,550012.0,Salary Increases & Fixed Expenses Increase,202849,61196.0,45775,106971.0,95878.0,47.27,-0.01,Low Risk
U655,2024,6,645890.0,Salary Increases & Fixed Expenses Increase,202849,61196.0,59789,120985.0,81864.0,40.36,-0.03,Low Risk
U655,2024,7,727754.0,Salary Increases & Fixed Expenses Increase,202849,61196.0,48297,109493.0,93356.0,46.02,0.02,Low Risk
U655,2024,8,821110.0,Salary Increases & Fixed Expenses Increase,202849,61196.0,59859,121055.0,81794.0,40.32,0.0,Low Risk
U655,2024,9,902904.0,Salary Increases & Fixed Expenses Increase,202849,61196.0,52002,113198.0,89651.0,44.2,0.04,Low Risk
U655,2024,10,992555.0,Salary Increases & Fixed Expenses Increase,202849,61196.0,50891,112087.0,90762.0,44.74,0.03,Low Risk
U655,2024,11,1083317.0,Salary Increases & Fixed Expenses Increase,202849,61196.0,43544,104740.0,98109.0,48.37,0.03,Low Risk
U655,2024,12,1181426.0,Salary Increases & Fixed Expenses Increase,202849,61196.0,50206,111402.0,91447.0,45.08,0.04,Low Risk
U656,2024,1,222918.0,Salary Increases & Fixed Expenses Remain Stable,186451,50206.0,73625,123831.0,62620.0,33.59,-0.04,Low Risk
U656,2024,2,285538.0,Salary Increases & Fixed Expenses Remain Stable,186451,50206.0,72157,122363.0,64088.0,34.37,0.04,Low Risk
U656,2024,3,349626.0,Salary Increases & Fixed Expenses Remain Stable,186451,50206.0,111429,161635.0,24816.0,13.31,-0.04,High Risk
U656,2024,4,374442.0,Salary Increases & Fixed Expenses Remain Stable,186451,50206.0,90639,140845.0,45606.0,24.46,-0.02,Medium Risk
U656,2024,5,420048.0,Salary Increases & Fixed Expenses Remain Stable,209077,50206.0,75973,126179.0,82898.0,39.65,-0.04,Low Risk
U656,2024,6,502946.0,Salary Increases & Fixed Expenses Remain Stable,209077,50206.0,76537,126743.0,82334.0,39.38,0.03,Low Risk
U656,2024,7,585280.0,Salary Increases & Fixed Expenses Remain Stable,209077,50206.0,62847,113053.0,96024.0,45.93,0.03,Low Risk
U656,2024,8,681304.0,Salary Increases & Fixed Expenses Remain Stable,209077,50206.0,86422,136628.0,72449.0,34.65,0.02,Low Risk
U656,2024,9,753753.0,Salary Increases & Fixed Expenses Remain Stable,209077,50206.0,89216,139422.0,69655.0,33.32,0.03,Low Risk
U656,2024,10,823408.0,Salary Increases & Fixed Expenses Remain Stable,209077,50206.0,130790,180996.0,28081.0,13.43,0.01,High Risk
U656,2024,11,851489.0,Salary Increases & Fixed Expenses Remain Stable,209077,50206.0,113249,163455.0,45622.0,21.82,0.02,Medium Risk
U656,2024,12,897111.0,Salary Increases & Fixed Expenses Remain Stable,209077,50206.0,77161,127367.0,81710.0,39.08,0.02,Low Risk
U657,2024,1,236469.0,Salary Increases & Fixed Expenses Increase,212841,112020.0,120352,232372.0,-19531.0,-9.18,0.02,High Risk
U657,2024,2,216938.0,Salary Increases & Fixed Expenses Increase,212841,112020.0,112435,224455.0,-11614.0,-5.46,-0.04,High Risk
U657,2024,3,205324.0,Salary Increases & Fixed Expenses Increase,212841,112020.0,128122,240142.0,-27301.0,-12.83,-0.03,High Risk
U657,2024,4,178023.0,Salary Increases & Fixed Expenses Increase,212841,112020.0,123553,235573.0,-22732.0,-10.68,0.05,High Risk
U657,2024,5,155291.0,Salary Increases & Fixed Expenses Increase,212841,112020.0,115607,227627.0,-14786.0,-6.95,-0.04,High Risk
U657,2024,6,140505.0,Salary Increases & Fixed Expenses Increase,220720,112020.0,117816,229836.0,-9116.0,-4.13,0.04,High Risk
U657,2024,7,131389.0,Salary Increases & Fixed Expenses Increase,220720,112020.0,137790,249810.0,-29090.0,-13.18,0.04,High Risk
U657,2024,8,102299.0,Salary Increases & Fixed Expenses Increase,220720,113043.0,144690,257733.0,-37013.0,-16.77,-0.01,High Risk
U657,2024,9,65286.0,Salary Increases & Fixed Expenses Increase,220720,113043.0,151165,264208.0,-43488.0,-19.7,-0.02,High Risk
U657,2024,10,21798.0,Salary Increases & Fixed Expenses Increase,220720,113043.0,146483,259526.0,-38806.0,-17.58,-0.0,High Risk
U657,2024,11,-17008.0,Salary Increases & Fixed Expenses Increase,220720,113869.0,127470,241339.0,-20619.0,-9.34,-0.02,High Risk
U657,2024,12,-37627.0,Salary Increases & Fixed Expenses Increase,220720,113869.0,181229,295098.0,-74378.0,-33.7,0.0,High Risk
U658,2024,1,226012.0,Stable Salary & Increasing Fixed Expenses,30519,10208.0,8739,18947.0,11572.0,37.92,0.02,Low Risk
U658,2024,2,237584.0,Stable Salary & Increasing Fixed Expenses,30519,10208.0,8925,19133.0,11386.0,37.31,-0.01,Low Risk
U658,2024,3,248970.0,Stable Salary & Increasing Fixed Expenses,30519,10208.0,7886,18094.0,12425.0,40.71,0.01,Low Risk
U658,2024,4,261395.0,Stable Salary & Increasing Fixed Expenses,30519,10208.0,7560,17768.0,12751.0,41.78,0.01,Low Risk
U658,2024,5,274146.0,Stable Salary & Increasing Fixed Expenses,30519,10208.0,6333,16541.0,13978.0,45.8,-0.02,Low Risk
U658,2024,6,288124.0,Stable Salary & Increasing Fixed Expenses,30519,11932.0,6300,18232.0,12287.0,40.26,0.04,Low Risk
U658,2024,7,300411.0,Stable Salary & Increasing Fixed Expenses,30519,11932.0,6533,18465.0,12054.0,39.5,-0.03,Low Risk
U658,2024,8,312465.0,Stable Salary & Increasing Fixed Expenses,30519,11932.0,7371,19303.0,11216.0,36.75,-0.01,Low Risk
U658,2024,9,323681.0,Stable Salary & Increasing Fixed Expenses,30519,11932.0,8433,20365.0,10154.0,33.27,0.01,Low Risk
U658,2024,10,333835.0,Stable Salary & Increasing Fixed Expenses,30519,11932.0,7900,19832.0,10687.0,35.02,0.03,Low Risk
U658,2024,11,344522.0,Stable Salary & Increasing Fixed Expenses,30519,11932.0,6561,18493.0,12026.0,39.4,-0.03,Low Risk
U658,2024,12,356548.0,Stable Salary & Increasing Fixed Expenses,30519,11932.0,8568,20500.0,10019.0,32.83,-0.01,Low Risk
U659,2024,1,176467.0,Salary Increases & Fixed Expenses Increase,99479,40308.0,29605,69913.0,29566.0,29.72,-0.04,Low Risk
U659,2024,2,206033.0,Salary Increases & Fixed Expenses Increase,99479,40308.0,27457,67765.0,31714.0,31.88,0.01,Low Risk
U659,2024,3,237747.0,Salary Increases & Fixed Expenses Increase,99479,40308.0,36365,76673.0,22806.0,22.93,-0.04,Medium Risk
U659,2024,4,260553.0,Salary Increases & Fixed Expenses Increase,106167,42144.0,26204,68348.0,37819.0,35.62,0.01,Low Risk
U659,2024,5,298372.0,Salary Increases & Fixed Expenses Increase,106167,43291.0,29310,72601.0,33566.0,31.62,-0.05,Low Risk
U659,2024,6,331938.0,Salary Increases & Fixed Expenses Increase,106167,43291.0,30578,73869.0,32298.0,30.42,-0.03,Low Risk
U659,2024,7,364236.0,Salary Increases & Fixed Expenses Increase,106167,43291.0,23360,66651.0,39516.0,37.22,0.02,Low Risk
U659,2024,8,403752.0,Salary Increases & Fixed Expenses Increase,106167,43291.0,29338,72629.0,33538.0,31.59,0.01,Low Risk
U659,2024,9,437290.0,Salary Increases & Fixed Expenses Increase,106167,43291.0,28462,71753.0,34414.0,32.41,-0.01,Low Risk
U659,2024,10,471704.0,Salary Increases & Fixed Expenses Increase,106167,43291.0,34175,77466.0,28701.0,27.03,-0.01,Low Risk
U659,2024,11,500405.0,Salary Increases & Fixed Expenses Increase,106167,43291.0,27831,71122.0,35045.0,33.01,0.04,Low Risk
U659,2024,12,535450.0,Salary Increases & Fixed Expenses Increase,106167,43291.0,29790,73081.0,33086.0,31.16,0.03,Low Risk
U660,2024,1,232663.0,Salary Increases & Fixed Expenses Increase,86705,28936.0,47225,76161.0,10544.0,12.16,-0.02,High Risk
U660,2024,2,243207.0,Salary Increases & Fixed Expenses Increase,86705,28936.0,50620,79556.0,7149.0,8.25,-0.01,High Risk
U660,2024,3,250356.0,Salary Increases & Fixed Expenses Increase,86705,28936.0,53673,82609.0,4096.0,4.72,0.05,High Risk
U660,2024,4,254452.0,Salary Increases & Fixed Expenses Increase,98821,28936.0,52620,81556.0,17265.0,17.47,0.03,Medium Risk
U660,2024,5,271717.0,Salary Increases & Fixed Expenses Increase,98821,28936.0,68714,97650.0,1171.0,1.18,0.04,High Risk
U660,2024,6,272888.0,Salary Increases & Fixed Expenses Increase,98821,28936.0,52870,81806.0,17015.0,17.22,-0.02,Medium Risk
U660,2024,7,289903.0,Salary Increases & Fixed Expenses Increase,98821,28936.0,59092,88028.0,10793.0,10.92,-0.05,High Risk
U660,2024,8,300696.0,Salary Increases & Fixed Expenses Increase,98821,28936.0,50184,79120.0,19701.0,19.94,0.01,Medium Risk
U660,2024,9,320397.0,Salary Increases & Fixed Expenses Increase,98821,28936.0,68336,97272.0,1549.0,1.57,0.02,High Risk
U660,2024,10,321946.0,Salary Increases & Fixed Expenses Increase,98821,28936.0,68836,97772.0,1049.0,1.06,0.02,High Risk
U660,2024,11,322995.0,Salary Increases & Fixed Expenses Increase,98821,28936.0,59979,88915.0,9906.0,10.02,0.03,High Risk
U660,2024,12,332901.0,Salary Increases & Fixed Expenses Increase,98821,28936.0,63597,92533.0,6288.0,6.36,-0.01,High Risk
U661,2024,1,250000.0,Salary Increases & Fixed Expenses Increase,257813,62154.0,109901,172055.0,85758.0,33.26,0.03,Low Risk
U661,2024,2,335758.0,Salary Increases & Fixed Expenses Increase,257813,62154.0,95755,157909.0,99904.0,38.75,0.0,Low Risk
U661,2024,3,435662.0,Salary Increases & Fixed Expenses Increase,257813,62154.0,82645,144799.0,113014.0,43.84,-0.04,Low Risk
U661,2024,4,548676.0,Salary Increases & Fixed Expenses Increase,257813,62154.0,119490,181644.0,76169.0,29.54,0.04,Low Risk
U661,2024,5,624845.0,Salary Increases & Fixed Expenses Increase,257813,62154.0,123607,185761.0,72052.0,27.95,-0.0,Low Risk
U661,2024,6,696897.0,Salary Increases & Fixed Expenses Increase,269056,63777.0,99987,163764.0,105292.0,39.13,-0.04,Low Risk
U661,2024,7,802189.0,Salary Increases & Fixed Expenses Increase,269056,63777.0,123343,187120.0,81936.0,30.45,-0.03,Low Risk
U661,2024,8,884125.0,Salary Increases & Fixed Expenses Increase,269056,63777.0,131984,195761.0,73295.0,27.24,0.02,Low Risk
U661,2024,9,957420.0,Salary Increases & Fixed Expenses Increase,269056,63777.0,88410,152187.0,116869.0,43.44,-0.04,Low Risk
U661,2024,10,1074289.0,Salary Increases & Fixed Expenses Increase,269056,63777.0,117593,181370.0,87686.0,32.59,-0.0,Low Risk
U661,2024,11,1161975.0,Salary Increases & Fixed Expenses Increase,269056,65499.0,103393,168892.0,100164.0,37.23,-0.03,Low Risk
U661,2024,12,1262139.0,Salary Increases & Fixed Expenses Increase,269056,65499.0,123911,189410.0,79646.0,29.6,0.01,Low Risk
U662,2024,1,250000.0,Stable Salary & Stable Fixed Expenses,295559,79032.0,149363,228395.0,67164.0,22.72,-0.03,Medium Risk
U662,2024,2,317164.0,Stable Salary & Stable Fixed Expenses,295559,79032.0,196948,275980.0,19579.0,6.62,0.0,High Risk
U662,2024,3,336743.0,Stable Salary & Stable Fixed Expenses,295559,79032.0,158161,237193.0,58366.0,19.75,-0.04,Medium Risk
U662,2024,4,395109.0,Stable Salary & Stable Fixed Expenses,295559,79032.0,151539,230571.0,64988.0,21.99,-0.0,Medium Risk
U662,2024,5,460097.0,Stable Salary & Stable Fixed Expenses,295559,79032.0,179585,258617.0,36942.0,12.5,-0.04,High Risk
U662,2024,6,497039.0,Stable Salary & Stable Fixed Expenses,295559,79032.0,182194,261226.0,34333.0,11.62,0.01,High Risk
U662,2024,7,531372.0,Stable Salary & Stable Fixed Expenses,295559,79032.0,180335,259367.0,36192.0,12.25,-0.04,High Risk
U662,2024,8,567564.0,Stable Salary & Stable Fixed Expenses,295559,79032.0,157800,236832.0,58727.0,19.87,0.01,Medium Risk
U662,2024,9,626291.0,Stable Salary & Stable Fixed Expenses,295559,79032.0,165191,244223.0,51336.0,17.37,-0.01,Medium Risk
U662,2024,10,677627.0,Stable Salary & Stable Fixed Expenses,295559,79032.0,157139,236171.0,59388.0,20.09,0.01,Medium Risk
U662,2024,11,737015.0,Stable Salary & Stable Fixed Expenses,295559,79032.0,173698,252730.0,42829.0,14.49,0.03,High Risk
U662,2024,12,779844.0,Stable Salary & Stable Fixed Expenses,295559,79032.0,152532,231564.0,63995.0,21.65,0.01,Medium Risk
U663,2024,1,223318.0,Stable Salary & Increasing Fixed Expenses,53672,37750.0,29428,67178.0,-13506.0,-25.16,-0.02,High Risk
U663,2024,2,209812.0,Stable Salary & Increasing Fixed Expenses,53672,37750.0,27705,65455.0,-11783.0,-21.95,0.04,High Risk
U663,2024,3,198029.0,Stable Salary & Increasing Fixed Expenses,53672,37750.0,27203,64953.0,-11281.0,-21.02,0.01,High Risk
U663,2024,4,186748.0,Stable Salary & Increasing Fixed Expenses,53672,37750.0,30748,68498.0,-14826.0,-27.62,0.03,High Risk
U663,2024,5,171922.0,Stable Salary & Increasing Fixed Expenses,53672,37750.0,28786,66536.0,-12864.0,-23.97,0.03,High Risk
U663,2024,6,159058.0,Stable Salary & Increasing Fixed Expenses,53672,37750.0,34741,72491.0,-18819.0,-35.06,-0.02,High Risk
U663,2024,7,140239.0,Stable Salary & Increasing Fixed Expenses,53672,37750.0,27456,65206.0,-11534.0,-21.49,-0.05,High Risk
U663,2024,8,128705.0,Stable Salary & Increasing Fixed Expenses,53672,37750.0,28011,65761.0,-12089.0,-22.52,-0.02,High Risk
U663,2024,9,116616.0,Stable Salary & Increasing Fixed Expenses,53672,37750.0,27700,65450.0,-11778.0,-21.94,-0.04,High Risk
U663,2024,10,104838.0,Stable Salary & Increasing Fixed Expenses,53672,37750.0,33443,71193.0,-17521.0,-32.64,0.02,High Risk
U663,2024,11,87317.0,Stable Salary & Increasing Fixed Expenses,53672,37750.0,31049,68799.0,-15127.0,-28.18,0.03,High Risk
U663,2024,12,72190.0,Stable Salary & Increasing Fixed Expenses,53672,37750.0,35108,72858.0,-19186.0,-35.75,-0.04,High Risk
U664,2024,1,246075.0,Salary Increases & Fixed Expenses Increase,98101,31579.0,23349,54928.0,43173.0,44.01,-0.02,Low Risk
U664,2024,2,289248.0,Salary Increases & Fixed Expenses Increase,98101,31579.0,24127,55706.0,42395.0,43.22,0.01,Low Risk
U664,2024,3,331643.0,Salary Increases & Fixed Expenses Increase,98101,31579.0,30009,61588.0,36513.0,37.22,0.05,Low Risk
U664,2024,4,368156.0,Salary Increases & Fixed Expenses Increase,98101,33424.0,27468,60892.0,37209.0,37.93,-0.01,Low Risk
U664,2024,5,405365.0,Salary Increases & Fixed Expenses Increase,98101,33424.0,22990,56414.0,41687.0,42.49,-0.01,Low Risk
U664,2024,6,447052.0,Salary Increases & Fixed Expenses Increase,127466,33424.0,27889,61313.0,66153.0,51.9,-0.02,Low Risk
U664,2024,7,513205.0,Salary Increases & Fixed Expenses Increase,127466,33424.0,38084,71508.0,55958.0,43.9,-0.03,Low Risk
U664,2024,8,569163.0,Salary Increases & Fixed Expenses Increase,127466,33424.0,36717,70141.0,57325.0,44.97,-0.04,Low Risk
U664,2024,9,626488.0,Salary Increases & Fixed Expenses Increase,127466,33424.0,40991,74415.0,53051.0,41.62,0.04,Low Risk
U664,2024,10,679539.0,Salary Increases & Fixed Expenses Increase,127466,33424.0,41618,75042.0,52424.0,41.13,-0.05,Low Risk
U664,2024,11,731963.0,Salary Increases & Fixed Expenses Increase,127466,33424.0,41161,74585.0,52881.0,41.49,-0.04,Low Risk
U664,2024,12,784844.0,Salary Increases & Fixed Expenses Increase,127466,33424.0,37740,71164.0,56302.0,44.17,0.04,Low Risk
U665,2024,1,56042.0,Salary Increases & Fixed Expenses Remain Stable,39964,11466.0,10649,22115.0,17849.0,44.66,0.0,Low Risk
U665,2024,2,73891.0,Salary Increases & Fixed Expenses Remain Stable,39964,11466.0,9648,21114.0,18850.0,47.17,0.02,Low Risk
U665,2024,3,92741.0,Salary Increases & Fixed Expenses Remain Stable,39964,11466.0,8421,19887.0,20077.0,50.24,-0.01,Low Risk
U665,2024,4,112818.0,Salary Increases & Fixed Expenses Remain Stable,39964,11466.0,10079,21545.0,18419.0,46.09,-0.03,Low Risk
U665,2024,5,131237.0,Salary Increases & Fixed Expenses Remain Stable,60027,11466.0,13092,24558.0,35469.0,59.09,-0.0,Low Risk
U665,2024,6,166706.0,Salary Increases & Fixed Expenses Remain Stable,60027,11466.0,13542,25008.0,35019.0,58.34,-0.0,Low Risk
U665,2024,7,201725.0,Salary Increases & Fixed Expenses Remain Stable,60027,11466.0,13232,24698.0,35329.0,58.86,0.03,Low Risk
U665,2024,8,237054.0,Salary Increases & Fixed Expenses Remain Stable,60027,11466.0,16100,27566.0,32461.0,54.08,-0.03,Low Risk
U665,2024,9,269515.0,Salary Increases & Fixed Expenses Remain Stable,60027,11466.0,14458,25924.0,34103.0,56.81,-0.05,Low Risk
U665,2024,10,303618.0,Salary Increases & Fixed Expenses Remain Stable,60027,11466.0,16771,28237.0,31790.0,52.96,0.03,Low Risk
U665,2024,11,335408.0,Salary Increases & Fixed Expenses Remain Stable,60027,11466.0,13054,24520.0,35507.0,59.15,-0.03,Low Risk
U665,2024,12,370915.0,Salary Increases & Fixed Expenses Remain Stable,60027,11466.0,13153,24619.0,35408.0,58.99,-0.04,Low Risk
U666,2024,1,250000.0,Salary Increases & Fixed Expenses Decrease,293259,114866.0,128022,242888.0,50371.0,17.18,0.0,Medium Risk
U666,2024,2,300371.0,Salary Increases & Fixed Expenses Decrease,293259,114866.0,98084,212950.0,80309.0,27.39,0.04,Low Risk
U666,2024,3,380680.0,Salary Increases & Fixed Expenses Decrease,293259,114866.0,113805,228671.0,64588.0,22.02,-0.05,Medium Risk
U666,2024,4,445268.0,Salary Increases & Fixed Expenses Decrease,304185,114866.0,131522,246388.0,57797.0,19.0,0.03,Medium Risk
U666,2024,5,503065.0,Salary Increases & Fixed Expenses Decrease,304185,114866.0,123227,238093.0,66092.0,21.73,-0.04,Medium Risk
U666,2024,6,569157.0,Salary Increases & Fixed Expenses Decrease,304185,114866.0,147418,262284.0,41901.0,13.77,0.04,High Risk
U666,2024,7,611058.0,Salary Increases & Fixed Expenses Decrease,304185,114866.0,130934,245800.0,58385.0,19.19,0.01,Medium Risk
U666,2024,8,669443.0,Salary Increases & Fixed Expenses Decrease,304185,114866.0,137020,251886.0,52299.0,17.19,0.05,Medium Risk
U666,2024,9,721742.0,Salary Increases & Fixed Expenses Decrease,304185,114866.0,120473,235339.0,68846.0,22.63,-0.03,Medium Risk
U666,2024,10,790588.0,Salary Increases & Fixed Expenses Decrease,304185,114866.0,109820,224686.0,79499.0,26.14,-0.03,Low Risk
U666,2024,11,870087.0,Salary Increases & Fixed Expenses Decrease,304185,114866.0,121333,236199.0,67986.0,22.35,-0.0,Medium Risk
U666,2024,12,938073.0,Salary Increases & Fixed Expenses Decrease,304185,114866.0,110941,225807.0,78378.0,25.77,-0.05,Low Risk
U667,2024,1,105751.0,Salary Increases & Fixed Expenses Remain Stable,87587,30255.0,20989,51244.0,36343.0,41.49,0.04,Low Risk
U667,2024,2,142094.0,Salary Increases & Fixed Expenses Remain Stable,87587,30255.0,20683,50938.0,36649.0,41.84,0.04,Low Risk
U667,2024,3,178743.0,Salary Increases & Fixed Expenses Remain Stable,87587,30255.0,26227,56482.0,31105.0,35.51,-0.02,Low Risk
U667,2024,4,209848.0,Salary Increases & Fixed Expenses Remain Stable,87587,30255.0,26085,56340.0,31247.0,35.68,-0.01,Low Risk
U667,2024,5,241095.0,Salary Increases & Fixed Expenses Remain Stable,87587,30255.0,20324,50579.0,37008.0,42.25,-0.02,Low Risk
U667,2024,6,278103.0,Salary Increases & Fixed Expenses Remain Stable,87587,30255.0,20019,50274.0,37313.0,42.6,-0.01,Low Risk
U667,2024,7,315416.0,Salary Increases & Fixed Expenses Remain Stable,87587,30255.0,23889,54144.0,33443.0,38.18,-0.03,Low Risk
U667,2024,8,348859.0,Salary Increases & Fixed Expenses Remain Stable,104930,30255.0,30845,61100.0,43830.0,41.77,0.05,Low Risk
U667,2024,9,392689.0,Salary Increases & Fixed Expenses Remain Stable,104930,30255.0,26108,56363.0,48567.0,46.29,0.03,Low Risk
U667,2024,10,441256.0,Salary Increases & Fixed Expenses Remain Stable,104930,30255.0,26863,57118.0,47812.0,45.57,-0.04,Low Risk
U667,2024,11,489068.0,Salary Increases & Fixed Expenses Remain Stable,104930,30255.0,32320,62575.0,42355.0,40.37,-0.02,Low Risk
U667,2024,12,531423.0,Salary Increases & Fixed Expenses Remain Stable,104930,30255.0,29512,59767.0,45163.0,43.04,0.02,Low Risk
U668,2024,1,152255.0,Stable Salary & Stable Fixed Expenses,36846,11174.0,25785,36959.0,-113.0,-0.31,0.04,High Risk
U668,2024,2,152142.0,Stable Salary & Stable Fixed Expenses,36846,11174.0,20771,31945.0,4901.0,13.3,-0.04,High Risk
U668,2024,3,157043.0,Stable Salary & Stable Fixed Expenses,36846,11174.0,25386,36560.0,286.0,0.78,0.02,High Risk
U668,2024,4,157329.0,Stable Salary & Stable Fixed Expenses,36846,11174.0,25191,36365.0,481.0,1.31,0.0,High Risk
U668,2024,5,157810.0,Stable Salary & Stable Fixed Expenses,36846,11174.0,21767,32941.0,3905.0,10.6,0.01,High Risk
U668,2024,6,161715.0,Stable Salary & Stable Fixed Expenses,36846,11174.0,21146,32320.0,4526.0,12.28,-0.01,High Risk
U668,2024,7,166241.0,Stable Salary & Stable Fixed Expenses,36846,11174.0,20966,32140.0,4706.0,12.77,-0.02,High Risk
U668,2024,8,170947.0,Stable Salary & Stable Fixed Expenses,36846,11174.0,24318,35492.0,1354.0,3.67,0.03,High Risk
U668,2024,9,172301.0,Stable Salary & Stable Fixed Expenses,36846,11174.0,24807,35981.0,865.0,2.35,-0.04,High Risk
U668,2024,10,173166.0,Stable Salary & Stable Fixed Expenses,36846,11174.0,20539,31713.0,5133.0,13.93,0.03,High Risk
U668,2024,11,178299.0,Stable Salary & Stable Fixed Expenses,36846,11174.0,25892,37066.0,-220.0,-0.6,-0.01,High Risk
U668,2024,12,178079.0,Stable Salary & Stable Fixed Expenses,36846,11174.0,25763,36937.0,-91.0,-0.25,-0.01,High Risk
U669,2024,1,250000.0,Salary Increases & Fixed Expenses Remain Stable,269456,71779.0,73476,145255.0,124201.0,46.09,0.04,Low Risk
U669,2024,2,374201.0,Salary Increases & Fixed Expenses Remain Stable,269456,71779.0,61242,133021.0,136435.0,50.63,-0.0,Low Risk
U669,2024,3,510636.0,Salary Increases & Fixed Expenses Remain Stable,294358,71779.0,80887,152666.0,141692.0,48.14,0.0,Low Risk
U669,2024,4,652328.0,Salary Increases & Fixed Expenses Remain Stable,294358,71779.0,61591,133370.0,160988.0,54.69,0.01,Low Risk
U669,2024,5,813316.0,Salary Increases & Fixed Expenses Remain Stable,294358,71779.0,81830,153609.0,140749.0,47.82,0.03,Low Risk
U669,2024,6,954065.0,Salary Increases & Fixed Expenses Remain Stable,294358,71779.0,63779,135558.0,158800.0,53.95,0.01,Low Risk
U669,2024,7,1112865.0,Salary Increases & Fixed Expenses Remain Stable,294358,71779.0,85183,156962.0,137396.0,46.68,-0.04,Low Risk
U669,2024,8,1250261.0,Salary Increases & Fixed Expenses Remain Stable,294358,71779.0,87830,159609.0,134749.0,45.78,0.01,Low Risk
U669,2024,9,1385010.0,Salary Increases & Fixed Expenses Remain Stable,294358,71779.0,92003,163782.0,130576.0,44.36,-0.03,Low Risk
U669,2024,10,1515586.0,Salary Increases & Fixed Expenses Remain Stable,294358,71779.0,61675,133454.0,160904.0,54.66,0.05,Low Risk
U669,2024,11,1676490.0,Salary Increases & Fixed Expenses Remain Stable,294358,71779.0,86445,158224.0,136134.0,46.25,-0.02,Low Risk
U669,2024,12,1812624.0,Salary Increases & Fixed Expenses Remain Stable,294358,71779.0,59458,131237.0,163121.0,55.42,-0.0,Low Risk
U670,2024,1,148504.0,Stable Salary & Increasing Fixed Expenses,95489,24002.0,33500,57502.0,37987.0,39.78,-0.03,Low Risk
U670,2024,2,186491.0,Stable Salary & Increasing Fixed Expenses,95489,24002.0,33066,57068.0,38421.0,40.24,0.02,Low Risk
U670,2024,3,224912.0,Stable Salary & Increasing Fixed Expenses,95489,24002.0,39010,63012.0,32477.0,34.01,-0.04,Low Risk
U670,2024,4,257389.0,Stable Salary & Increasing Fixed Expenses,95489,24002.0,33724,57726.0,37763.0,39.55,-0.02,Low Risk
U670,2024,5,295152.0,Stable Salary & Increasing Fixed Expenses,95489,24002.0,33198,57200.0,38289.0,40.1,0.02,Low Risk
U670,2024,6,333441.0,Stable Salary & Increasing Fixed Expenses,95489,24002.0,43292,67294.0,28195.0,29.53,-0.04,Low Risk
U670,2024,7,361636.0,Stable Salary & Increasing Fixed Expenses,95489,24002.0,35541,59543.0,35946.0,37.64,-0.04,Low Risk
U670,2024,8,397582.0,Stable Salary & Increasing Fixed Expenses,95489,24002.0,47549,71551.0,23938.0,25.07,-0.04,Low Risk
U670,2024,9,421520.0,Stable Salary & Increasing Fixed Expenses,95489,24002.0,52686,76688.0,18801.0,19.69,-0.02,Medium Risk
U670,2024,10,440321.0,Stable Salary & Increasing Fixed Expenses,95489,24002.0,52616,76618.0,18871.0,19.76,-0.05,Medium Risk
U670,2024,11,459192.0,Stable Salary & Increasing Fixed Expenses,95489,24002.0,40504,64506.0,30983.0,32.45,-0.02,Low Risk
U670,2024,12,490175.0,Stable Salary & Increasing Fixed Expenses,95489,24002.0,40418,64420.0,31069.0,32.54,0.03,Low Risk
U671,2024,1,242499.0,Salary Increases & Fixed Expenses Increase,241244,74359.0,66082,140441.0,100803.0,41.78,-0.04,Low Risk
U671,2024,2,343302.0,Salary Increases & Fixed Expenses Increase,241244,74359.0,52016,126375.0,114869.0,47.62,0.04,Low Risk
U671,2024,3,458171.0,Salary Increases & Fixed Expenses Increase,257293,74359.0,61841,136200.0,121093.0,47.06,-0.0,Low Risk
U671,2024,4,579264.0,Salary Increases & Fixed Expenses Increase,257293,75473.0,65893,141366.0,115927.0,45.06,0.03,Low Risk
U671,2024,5,695191.0,Salary Increases & Fixed Expenses Increase,257293,75473.0,53407,128880.0,128413.0,49.91,-0.05,Low Risk
U671,2024,6,823604.0,Salary Increases & Fixed Expenses Increase,257293,75473.0,56051,131524.0,125769.0,48.88,-0.04,Low Risk
U671,2024,7,949373.0,Salary Increases & Fixed Expenses Increase,257293,75473.0,66105,141578.0,115715.0,44.97,-0.04,Low Risk
U671,2024,8,1065088.0,Salary Increases & Fixed Expenses Increase,257293,77442.0,66176,143618.0,113675.0,44.18,0.0,Low Risk
U671,2024,9,1178763.0,Salary Increases & Fixed Expenses Increase,257293,77442.0,60200,137642.0,119651.0,46.5,-0.02,Low Risk
U671,2024,10,1298414.0,Salary Increases & Fixed Expenses Increase,257293,77442.0,68161,145603.0,111690.0,43.41,-0.02,Low Risk
U671,2024,11,1410104.0,Salary Increases & Fixed Expenses Increase,257293,77442.0,68904,146346.0,110947.0,43.12,-0.04,Low Risk
U671,2024,12,1521051.0,Salary Increases & Fixed Expenses Increase,257293,77442.0,58555,135997.0,121296.0,47.14,0.03,Low Risk
U672,2024,1,92781.0,Salary Increases & Fixed Expenses Decrease,73512,25935.0,31676,57611.0,15901.0,21.63,0.03,Medium Risk
U672,2024,2,108682.0,Salary Increases & Fixed Expenses Decrease,73512,25935.0,22166,48101.0,25411.0,34.57,0.04,Low Risk
U672,2024,3,134093.0,Salary Increases & Fixed Expenses Decrease,73512,25935.0,29666,55601.0,17911.0,24.36,0.04,Medium Risk
U672,2024,4,152004.0,Salary Increases & Fixed Expenses Decrease,98163,25935.0,41853,67788.0,30375.0,30.94,-0.02,Low Risk
U672,2024,5,182379.0,Salary Increases & Fixed Expenses Decrease,98163,25935.0,48984,74919.0,23244.0,23.68,0.04,Medium Risk
U672,2024,6,205623.0,Salary Increases & Fixed Expenses Decrease,98163,25935.0,42726,68661.0,29502.0,30.05,-0.05,Low Risk
U672,2024,7,235125.0,Salary Increases & Fixed Expenses Decrease,98163,25291.0,37860,63151.0,35012.0,35.67,-0.04,Low Risk
U672,2024,8,270137.0,Salary Increases & Fixed Expenses Decrease,98163,25291.0,32727,58018.0,40145.0,40.9,0.02,Low Risk
U672,2024,9,310282.0,Salary Increases & Fixed Expenses Decrease,98163,25291.0,37526,62817.0,35346.0,36.01,0.04,Low Risk
U672,2024,10,345628.0,Salary Increases & Fixed Expenses Decrease,98163,25291.0,45327,70618.0,27545.0,28.06,-0.02,Low Risk
U672,2024,11,373173.0,Salary Increases & Fixed Expenses Decrease,98163,25291.0,43666,68957.0,29206.0,29.75,-0.01,Low Risk
U672,2024,12,402379.0,Salary Increases & Fixed Expenses Decrease,98163,25291.0,45012,70303.0,27860.0,28.38,-0.04,Low Risk
U673,2024,1,210924.0,Salary Increases & Fixed Expenses Increase,184570,56813.0,112629,169442.0,15128.0,8.2,-0.0,High Risk
U673,2024,2,226052.0,Salary Increases & Fixed Expenses Increase,184570,56813.0,99066,155879.0,28691.0,15.54,-0.03,Medium Risk
U673,2024,3,254743.0,Salary Increases & Fixed Expenses Increase,199088,56813.0,107149,163962.0,35126.0,17.64,-0.05,Medium Risk
U673,2024,4,289869.0,Salary Increases & Fixed Expenses Increase,199088,57687.0,106345,164032.0,35056.0,17.61,0.0,Medium Risk
U673,2024,5,324925.0,Salary Increases & Fixed Expenses Increase,199088,57687.0,118782,176469.0,22619.0,11.36,0.02,High Risk
U673,2024,6,347544.0,Salary Increases & Fixed Expenses Increase,199088,57687.0,111704,169391.0,29697.0,14.92,0.03,High Risk
U673,2024,7,377241.0,Salary Increases & Fixed Expenses Increase,199088,57687.0,138522,196209.0,2879.0,1.45,-0.04,High Risk
U673,2024,8,380120.0,Salary Increases & Fixed Expenses Increase,199088,57687.0,114241,171928.0,27160.0,13.64,-0.04,High Risk
U673,2024,9,407280.0,Salary Increases & Fixed Expenses Increase,199088,57687.0,117663,175350.0,23738.0,11.92,0.01,High Risk
U673,2024,10,431018.0,Salary Increases & Fixed Expenses Increase,199088,57687.0,107880,165567.0,33521.0,16.84,-0.04,Medium Risk
U673,2024,11,464539.0,Salary Increases & Fixed Expenses Increase,199088,59396.0,109151,168547.0,30541.0,15.34,-0.04,Medium Risk
U673,2024,12,495080.0,Salary Increases & Fixed Expenses Increase,199088,60218.0,111677,171895.0,27193.0,13.66,-0.05,High Risk
U674,2024,1,91761.0,Salary Increases & Fixed Expenses Remain Stable,52632,34625.0,19929,54554.0,-1922.0,-3.65,-0.04,High Risk
U674,2024,2,89839.0,Salary Increases & Fixed Expenses Remain Stable,52632,34625.0,16056,50681.0,1951.0,3.71,-0.02,High Risk
U674,2024,3,91790.0,Salary Increases & Fixed Expenses Remain Stable,52632,34625.0,26261,60886.0,-8254.0,-15.68,-0.04,High Risk
U674,2024,4,83536.0,Salary Increases & Fixed Expenses Remain Stable,68298,34625.0,27912,62537.0,5761.0,8.44,-0.03,High Risk
U674,2024,5,89297.0,Salary Increases & Fixed Expenses Remain Stable,68298,34625.0,24389,59014.0,9284.0,13.59,0.02,High Risk
U674,2024,6,98581.0,Salary Increases & Fixed Expenses Remain Stable,68298,34625.0,26691,61316.0,6982.0,10.22,0.01,High Risk
U674,2024,7,105563.0,Salary Increases & Fixed Expenses Remain Stable,68298,34625.0,30284,64909.0,3389.0,4.96,-0.02,High Risk
U674,2024,8,108952.0,Salary Increases & Fixed Expenses Remain Stable,68298,34625.0,24236,58861.0,9437.0,13.82,-0.05,High Risk
U674,2024,9,118389.0,Salary Increases & Fixed Expenses Remain Stable,68298,34625.0,30875,65500.0,2798.0,4.1,0.03,High Risk
U674,2024,10,121187.0,Salary Increases & Fixed Expenses Remain Stable,68298,34625.0,24496,59121.0,9177.0,13.44,0.02,High Risk
U674,2024,11,130364.0,Salary Increases & Fixed Expenses Remain Stable,68298,34625.0,23164,57789.0,10509.0,15.39,-0.04,Medium Risk
U674,2024,12,140873.0,Salary Increases & Fixed Expenses Remain Stable,68298,34625.0,26447,61072.0,7226.0,10.58,-0.02,High Risk
U675,2024,1,250000.0,Stable Salary & Stable Fixed Expenses,284945,102437.0,125170,227607.0,57338.0,20.12,-0.02,Medium Risk
U675,2024,2,307338.0,Stable Salary & Stable Fixed Expenses,284945,102437.0,88135,190572.0,94373.0,33.12,-0.03,Low Risk
U675,2024,3,401711.0,Stable Salary & Stable Fixed Expenses,284945,102437.0,87354,189791.0,95154.0,33.39,0.04,Low Risk
U675,2024,4,496865.0,Stable Salary & Stable Fixed Expenses,284945,102437.0,129960,232397.0,52548.0,18.44,-0.03,Medium Risk
U675,2024,5,549413.0,Stable Salary & Stable Fixed Expenses,284945,102437.0,99054,201491.0,83454.0,29.29,-0.01,Low Risk
U675,2024,6,632867.0,Stable Salary & Stable Fixed Expenses,284945,102437.0,127088,229525.0,55420.0,19.45,0.0,Medium Risk
U675,2024,7,688287.0,Stable Salary & Stable Fixed Expenses,284945,102437.0,99981,202418.0,82527.0,28.96,-0.02,Low Risk
U675,2024,8,770814.0,Stable Salary & Stable Fixed Expenses,284945,102437.0,132605,235042.0,49903.0,17.51,-0.01,Medium Risk
U675,2024,9,820717.0,Stable Salary & Stable Fixed Expenses,284945,102437.0,139384,241821.0,43124.0,15.13,-0.01,Medium Risk
U675,2024,10,863841.0,Stable Salary & Stable Fixed Expenses,284945,102437.0,122665,225102.0,59843.0,21.0,0.02,Medium Risk
U675,2024,11,923684.0,Stable Salary & Stable Fixed Expenses,284945,102437.0,133274,235711.0,49234.0,17.28,0.04,Medium Risk
U675,2024,12,972918.0,Stable Salary & Stable Fixed Expenses,284945,102437.0,130598,233035.0,51910.0,18.22,0.0,Medium Risk
U676,2024,1,228858.0,Stable Salary & Stable Fixed Expenses,191336,40058.0,87768,127826.0,63510.0,33.19,-0.01,Low Risk
U676,2024,2,292368.0,Stable Salary & Stable Fixed Expenses,191336,40058.0,94482,134540.0,56796.0,29.68,-0.04,Low Risk
U676,2024,3,349164.0,Stable Salary & Stable Fixed Expenses,191336,40058.0,72969,113027.0,78309.0,40.93,0.03,Low Risk
U676,2024,4,427473.0,Stable Salary & Stable Fixed Expenses,191336,40058.0,70735,110793.0,80543.0,42.1,-0.01,Low Risk
U676,2024,5,508016.0,Stable Salary & Stable Fixed Expenses,191336,40058.0,95389,135447.0,55889.0,29.21,0.03,Low Risk
U676,2024,6,563905.0,Stable Salary & Stable Fixed Expenses,191336,40058.0,85770,125828.0,65508.0,34.24,0.03,Low Risk
U676,2024,7,629413.0,Stable Salary & Stable Fixed Expenses,191336,40058.0,65236,105294.0,86042.0,44.97,0.01,Low Risk
U676,2024,8,715455.0,Stable Salary & Stable Fixed Expenses,191336,40058.0,91678,131736.0,59600.0,31.15,-0.01,Low Risk
U676,2024,9,775055.0,Stable Salary & Stable Fixed Expenses,191336,40058.0,105748,145806.0,45530.0,23.8,-0.02,Medium Risk
U676,2024,10,820585.0,Stable Salary & Stable Fixed Expenses,191336,40058.0,66164,106222.0,85114.0,44.48,0.03,Low Risk
U676,2024,11,905699.0,Stable Salary & Stable Fixed Expenses,191336,40058.0,74107,114165.0,77171.0,40.33,-0.05,Low Risk
U676,2024,12,982870.0,Stable Salary & Stable Fixed Expenses,191336,40058.0,83064,123122.0,68214.0,35.65,0.0,Low Risk
U677,2024,1,149646.0,Stable Salary & Stable Fixed Expenses,27403,18667.0,18214,36881.0,-9478.0,-34.59,-0.03,High Risk
U677,2024,2,140168.0,Stable Salary & Stable Fixed Expenses,27403,18667.0,15796,34463.0,-7060.0,-25.76,0.03,High Risk
U677,2024,3,133108.0,Stable Salary & Stable Fixed Expenses,27403,18667.0,17666,36333.0,-8930.0,-32.59,0.02,High Risk
U677,2024,4,124178.0,Stable Salary & Stable Fixed Expenses,27403,18667.0,17094,35761.0,-8358.0,-30.5,-0.01,High Risk
U677,2024,5,115820.0,Stable Salary & Stable Fixed Expenses,27403,18667.0,16907,35574.0,-8171.0,-29.82,0.05,High Risk
U677,2024,6,107649.0,Stable Salary & Stable Fixed Expenses,27403,18667.0,13811,32478.0,-5075.0,-18.52,0.03,High Risk
U677,2024,7,102574.0,Stable Salary & Stable Fixed Expenses,27403,18667.0,18124,36791.0,-9388.0,-34.26,0.03,High Risk
U677,2024,8,93186.0,Stable Salary & Stable Fixed Expenses,27403,18667.0,16392,35059.0,-7656.0,-27.94,-0.01,High Risk
U677,2024,9,85530.0,Stable Salary & Stable Fixed Expenses,27403,18667.0,18021,36688.0,-9285.0,-33.88,-0.03,High Risk
U677,2024,10,76245.0,Stable Salary & Stable Fixed Expenses,27403,18667.0,16795,35462.0,-8059.0,-29.41,0.05,High Risk
U677,2024,11,68186.0,Stable Salary & Stable Fixed Expenses,27403,18667.0,15307,33974.0,-6571.0,-23.98,-0.01,High Risk
U677,2024,12,61615.0,Stable Salary & Stable Fixed Expenses,27403,18667.0,21972,40639.0,-13236.0,-48.3,-0.01,High Risk
U678,2024,1,136308.0,Salary Increases & Fixed Expenses Remain Stable,104858,63782.0,23225,87007.0,17851.0,17.02,-0.02,Medium Risk
U678,2024,2,154159.0,Salary Increases & Fixed Expenses Remain Stable,104858,63782.0,21550,85332.0,19526.0,18.62,0.02,Medium Risk
U678,2024,3,173685.0,Salary Increases & Fixed Expenses Remain Stable,104858,63782.0,38747,102529.0,2329.0,2.22,0.01,High Risk
U678,2024,4,176014.0,Salary Increases & Fixed Expenses Remain Stable,104858,63782.0,22453,86235.0,18623.0,17.76,0.01,Medium Risk
U678,2024,5,194637.0,Salary Increases & Fixed Expenses Remain Stable,104858,63782.0,29481,93263.0,11595.0,11.06,0.01,High Risk
U678,2024,6,206232.0,Salary Increases & Fixed Expenses Remain Stable,125161,63782.0,35304,99086.0,26075.0,20.83,-0.01,Medium Risk
U678,2024,7,232307.0,Salary Increases & Fixed Expenses Remain Stable,125161,63782.0,31692,95474.0,29687.0,23.72,-0.04,Medium Risk
U678,2024,8,261994.0,Salary Increases & Fixed Expenses Remain Stable,125161,63782.0,30624,94406.0,30755.0,24.57,0.02,Medium Risk
U678,2024,9,292749.0,Salary Increases & Fixed Expenses Remain Stable,125161,63782.0,35063,98845.0,26316.0,21.03,0.0,Medium Risk
U678,2024,10,319065.0,Salary Increases & Fixed Expenses Remain Stable,125161,63782.0,40283,104065.0,21096.0,16.86,-0.03,Medium Risk
U678,2024,11,340161.0,Salary Increases & Fixed Expenses Remain Stable,125161,63782.0,40061,103843.0,21318.0,17.03,-0.01,Medium Risk
U678,2024,12,361479.0,Salary Increases & Fixed Expenses Remain Stable,125161,63782.0,36777,100559.0,24602.0,19.66,0.03,Medium Risk
U679,2024,1,201765.0,Stable Salary & Increasing Fixed Expenses,166311,49833.0,104898,154731.0,11580.0,6.96,0.03,High Risk
U679,2024,2,213345.0,Stable Salary & Increasing Fixed Expenses,166311,49833.0,104232,154065.0,12246.0,7.36,0.03,High Risk
U679,2024,3,225591.0,Stable Salary & Increasing Fixed Expenses,166311,49833.0,104529,154362.0,11949.0,7.18,-0.04,High Risk
U679,2024,4,237540.0,Stable Salary & Increasing Fixed Expenses,166311,49833.0,94869,144702.0,21609.0,12.99,0.03,High Risk
U679,2024,5,259149.0,Stable Salary & Increasing Fixed Expenses,166311,50935.0,96604,147539.0,18772.0,11.29,-0.03,High Risk
U679,2024,6,277921.0,Stable Salary & Increasing Fixed Expenses,166311,50935.0,115415,166350.0,-39.0,-0.02,-0.04,High Risk
U679,2024,7,277882.0,Stable Salary & Increasing Fixed Expenses,166311,50935.0,105468,156403.0,9908.0,5.96,0.0,High Risk
U679,2024,8,287790.0,Stable Salary & Increasing Fixed Expenses,166311,50935.0,98068,149003.0,17308.0,10.41,-0.05,High Risk
U679,2024,9,305098.0,Stable Salary & Increasing Fixed Expenses,166311,50935.0,96472,147407.0,18904.0,11.37,0.04,High Risk
U679,2024,10,324002.0,Stable Salary & Increasing Fixed Expenses,166311,51443.0,111309,162752.0,3559.0,2.14,0.04,High Risk
U679,2024,11,327561.0,Stable Salary & Increasing Fixed Expenses,166311,53181.0,100600,153781.0,12530.0,7.53,-0.03,High Risk
U679,2024,12,340091.0,Stable Salary & Increasing Fixed Expenses,166311,53181.0,106765,159946.0,6365.0,3.83,-0.02,High Risk
U680,2024,1,250000.0,Stable Salary & Increasing Fixed Expenses,252103,65114.0,73634,138748.0,113355.0,44.96,0.01,Low Risk
U680,2024,2,363355.0,Stable Salary & Increasing Fixed Expenses,252103,65896.0,71523,137419.0,114684.0,45.49,-0.01,Low Risk
U680,2024,3,478039.0,Stable Salary & Increasing Fixed Expenses,252103,65896.0,73187,139083.0,113020.0,44.83,0.05,Low Risk
U680,2024,4,591059.0,Stable Salary & Increasing Fixed Expenses,252103,65896.0,67420,133316.0,118787.0,47.12,0.03,Low Risk
U680,2024,5,709846.0,Stable Salary & Increasing Fixed Expenses,252103,65896.0,54586,120482.0,131621.0,52.21,-0.01,Low Risk
U680,2024,6,841467.0,Stable Salary & Increasing Fixed Expenses,252103,65896.0,52175,118071.0,134032.0,53.17,-0.05,Low Risk
U680,2024,7,975499.0,Stable Salary & Increasing Fixed Expenses,252103,65896.0,52214,118110.0,133993.0,53.15,0.02,Low Risk
U680,2024,8,1109492.0,Stable Salary & Increasing Fixed Expenses,252103,65896.0,50697,116593.0,135510.0,53.75,0.04,Low Risk
U680,2024,9,1245002.0,Stable Salary & Increasing Fixed Expenses,252103,65896.0,54989,120885.0,131218.0,52.05,0.01,Low Risk
U680,2024,10,1376220.0,Stable Salary & Increasing Fixed Expenses,252103,65896.0,64540,130436.0,121667.0,48.26,-0.03,Low Risk
U680,2024,11,1497887.0,Stable Salary & Increasing Fixed Expenses,252103,65896.0,66540,132436.0,119667.0,47.47,-0.01,Low Risk
U680,2024,12,1617554.0,Stable Salary & Increasing Fixed Expenses,252103,65896.0,58576,124472.0,127631.0,50.63,0.01,Low Risk
U681,2024,1,250000.0,Stable Salary & Stable Fixed Expenses,294904,100812.0,103580,204392.0,90512.0,30.69,-0.04,Low Risk
U681,2024,2,340512.0,Stable Salary & Stable Fixed Expenses,294904,100812.0,120723,221535.0,73369.0,24.88,-0.01,Medium Risk
U681,2024,3,413881.0,Stable Salary & Stable Fixed Expenses,294904,100812.0,146921,247733.0,47171.0,16.0,0.04,Medium Risk
U681,2024,4,461052.0,Stable Salary & Stable Fixed Expenses,294904,100812.0,109823,210635.0,84269.0,28.58,0.04,Low Risk
U681,2024,5,545321.0,Stable Salary & Stable Fixed Expenses,294904,100812.0,138483,239295.0,55609.0,18.86,-0.02,Medium Risk
U681,2024,6,600930.0,Stable Salary & Stable Fixed Expenses,294904,100812.0,97394,198206.0,96698.0,32.79,-0.04,Low Risk
U681,2024,7,697628.0,Stable Salary & Stable Fixed Expenses,294904,100812.0,144988,245800.0,49104.0,16.65,0.05,Medium Risk
U681,2024,8,746732.0,Stable Salary & Stable Fixed Expenses,294904,100812.0,103437,204249.0,90655.0,30.74,-0.0,Low Risk
U681,2024,9,837387.0,Stable Salary & Stable Fixed Expenses,294904,100812.0,156072,256884.0,38020.0,12.89,-0.05,High Risk
U681,2024,10,875407.0,Stable Salary & Stable Fixed Expenses,294904,100812.0,132185,232997.0,61907.0,20.99,-0.03,Medium Risk
U681,2024,11,937314.0,Stable Salary & Stable Fixed Expenses,294904,100812.0,154872,255684.0,39220.0,13.3,0.03,High Risk
U681,2024,12,976534.0,Stable Salary & Stable Fixed Expenses,294904,100812.0,116554,217366.0,77538.0,26.29,-0.0,Low Risk
U682,2024,1,131123.0,Stable Salary & Increasing Fixed Expenses,83270,33379.0,24803,58182.0,25088.0,30.13,0.03,Low Risk
U682,2024,2,156211.0,Stable Salary & Increasing Fixed Expenses,83270,33379.0,23585,56964.0,26306.0,31.59,0.03,Low Risk
U682,2024,3,182517.0,Stable Salary & Increasing Fixed Expenses,83270,33379.0,19245,52624.0,30646.0,36.8,0.04,Low Risk
U682,2024,4,213163.0,Stable Salary & Increasing Fixed Expenses,83270,33379.0,17203,50582.0,32688.0,39.26,0.04,Low Risk
U682,2024,5,245851.0,Stable Salary & Increasing Fixed Expenses,83270,33379.0,23426,56805.0,26465.0,31.78,0.03,Low Risk
U682,2024,6,272316.0,Stable Salary & Increasing Fixed Expenses,83270,33379.0,17973,51352.0,31918.0,38.33,0.04,Low Risk
U682,2024,7,304234.0,Stable Salary & Increasing Fixed Expenses,83270,35135.0,21037,56172.0,27098.0,32.54,0.02,Low Risk
U682,2024,8,331332.0,Stable Salary & Increasing Fixed Expenses,83270,35135.0,17471,52606.0,30664.0,36.82,-0.01,Low Risk
U682,2024,9,361996.0,Stable Salary & Increasing Fixed Expenses,83270,35135.0,25254,60389.0,22881.0,27.48,-0.02,Low Risk
U682,2024,10,384877.0,Stable Salary & Increasing Fixed Expenses,83270,35135.0,24937,60072.0,23198.0,27.86,-0.02,Low Risk
U682,2024,11,408075.0,Stable Salary & Increasing Fixed Expenses,83270,35135.0,21967,57102.0,26168.0,31.43,-0.04,Low Risk
U682,2024,12,434243.0,Stable Salary & Increasing Fixed Expenses,83270,35135.0,20840,55975.0,27295.0,32.78,0.02,Low Risk
U683,2024,1,191539.0,Stable Salary & Stable Fixed Expenses,141323,54384.0,58052,112436.0,28887.0,20.44,-0.02,Medium Risk
U683,2024,2,220426.0,Stable Salary & Stable Fixed Expenses,141323,54384.0,49715,104099.0,37224.0,26.34,-0.05,Low Risk
U683,2024,3,257650.0,Stable Salary & Stable Fixed Expenses,141323,54384.0,64174,118558.0,22765.0,16.11,-0.04,Medium Risk
U683,2024,4,280415.0,Stable Salary & Stable Fixed Expenses,141323,54384.0,45489,99873.0,41450.0,29.33,0.05,Low Risk
U683,2024,5,321865.0,Stable Salary & Stable Fixed Expenses,141323,54384.0,70406,124790.0,16533.0,11.7,-0.04,High Risk
U683,2024,6,338398.0,Stable Salary & Stable Fixed Expenses,141323,54384.0,50338,104722.0,36601.0,25.9,-0.0,Low Risk
U683,2024,7,374999.0,Stable Salary & Stable Fixed Expenses,141323,54384.0,59123,113507.0,27816.0,19.68,-0.05,Medium Risk
U683,2024,8,402815.0,Stable Salary & Stable Fixed Expenses,141323,54384.0,51098,105482.0,35841.0,25.36,0.03,Low Risk
U683,2024,9,438656.0,Stable Salary & Stable Fixed Expenses,141323,54384.0,46356,100740.0,40583.0,28.72,0.05,Low Risk
U683,2024,10,479239.0,Stable Salary & Stable Fixed Expenses,141323,54384.0,44669,99053.0,42270.0,29.91,-0.0,Low Risk
U683,2024,11,521509.0,Stable Salary & Stable Fixed Expenses,141323,54384.0,51803,106187.0,35136.0,24.86,0.0,Medium Risk
U683,2024,12,556645.0,Stable Salary & Stable Fixed Expenses,141323,54384.0,43885,98269.0,43054.0,30.46,0.01,Low Risk
U684,2024,1,155459.0,Stable Salary & Increasing Fixed Expenses,113343,52573.0,65245,117818.0,-4475.0,-3.95,-0.03,High Risk
U684,2024,2,150984.0,Stable Salary & Increasing Fixed Expenses,113343,54413.0,61763,116176.0,-2833.0,-2.5,0.01,High Risk
U684,2024,3,148151.0,Stable Salary & Increasing Fixed Expenses,113343,54413.0,70326,124739.0,-11396.0,-10.05,-0.01,High Risk
U684,2024,4,136755.0,Stable Salary & Increasing Fixed Expenses,113343,54413.0,76778,131191.0,-17848.0,-15.75,0.05,High Risk
U684,2024,5,118907.0,Stable Salary & Increasing Fixed Expenses,113343,54413.0,78111,132524.0,-19181.0,-16.92,0.01,High Risk
U684,2024,6,99726.0,Stable Salary & Increasing Fixed Expenses,113343,54413.0,73205,127618.0,-14275.0,-12.59,0.01,High Risk
U684,2024,7,85451.0,Stable Salary & Increasing Fixed Expenses,113343,54413.0,74195,128608.0,-15265.0,-13.47,0.01,High Risk
U684,2024,8,70186.0,Stable Salary & Increasing Fixed Expenses,113343,54413.0,63082,117495.0,-4152.0,-3.66,0.01,High Risk
U684,2024,9,66034.0,Stable Salary & Increasing Fixed Expenses,113343,54413.0,79038,133451.0,-20108.0,-17.74,-0.01,High Risk
U684,2024,10,45926.0,Stable Salary & Increasing Fixed Expenses,113343,54413.0,60411,114824.0,-1481.0,-1.31,0.04,High Risk
U684,2024,11,44445.0,Stable Salary & Increasing Fixed Expenses,113343,54413.0,76650,131063.0,-17720.0,-15.63,-0.05,High Risk
U684,2024,12,26725.0,Stable Salary & Increasing Fixed Expenses,113343,54413.0,66632,121045.0,-7702.0,-6.8,0.04,High Risk
U685,2024,1,188859.0,Stable Salary & Stable Fixed Expenses,164779,50657.0,77543,128200.0,36579.0,22.2,-0.05,Medium Risk
U685,2024,2,225438.0,Stable Salary & Stable Fixed Expenses,164779,50657.0,53482,104139.0,60640.0,36.8,0.03,Low Risk
U685,2024,3,286078.0,Stable Salary & Stable Fixed Expenses,164779,50657.0,49876,100533.0,64246.0,38.99,-0.03,Low Risk
U685,2024,4,350324.0,Stable Salary & Stable Fixed Expenses,164779,50657.0,60142,110799.0,53980.0,32.76,0.05,Low Risk
U685,2024,5,404304.0,Stable Salary & Stable Fixed Expenses,164779,50657.0,74043,124700.0,40079.0,24.32,0.04,Medium Risk
U685,2024,6,444383.0,Stable Salary & Stable Fixed Expenses,164779,50657.0,62203,112860.0,51919.0,31.51,-0.03,Low Risk
U685,2024,7,496302.0,Stable Salary & Stable Fixed Expenses,164779,50657.0,71446,122103.0,42676.0,25.9,0.02,Low Risk
U685,2024,8,538978.0,Stable Salary & Stable Fixed Expenses,164779,50657.0,56478,107135.0,57644.0,34.98,-0.02,Low Risk
U685,2024,9,596622.0,Stable Salary & Stable Fixed Expenses,164779,50657.0,75568,126225.0,38554.0,23.4,0.02,Medium Risk
U685,2024,10,635176.0,Stable Salary & Stable Fixed Expenses,164779,50657.0,63332,113989.0,50790.0,30.82,0.02,Low Risk
U685,2024,11,685966.0,Stable Salary & Stable Fixed Expenses,164779,50657.0,76129,126786.0,37993.0,23.06,-0.03,Medium Risk
U685,2024,12,723959.0,Stable Salary & Stable Fixed Expenses,164779,50657.0,68525,119182.0,45597.0,27.67,-0.04,Low Risk
U686,2024,1,234300.0,Stable Salary & Stable Fixed Expenses,180317,45555.0,50806,96361.0,83956.0,46.56,0.01,Low Risk
U686,2024,2,318256.0,Stable Salary & Stable Fixed Expenses,180317,45555.0,43302,88857.0,91460.0,50.72,0.02,Low Risk
U686,2024,3,409716.0,Stable Salary & Stable Fixed Expenses,180317,45555.0,44381,89936.0,90381.0,50.12,-0.02,Low Risk
U686,2024,4,500097.0,Stable Salary & Stable Fixed Expenses,180317,45555.0,37153,82708.0,97609.0,54.13,-0.05,Low Risk
U686,2024,5,597706.0,Stable Salary & Stable Fixed Expenses,180317,45555.0,41964,87519.0,92798.0,51.46,-0.02,Low Risk
U686,2024,6,690504.0,Stable Salary & Stable Fixed Expenses,180317,45555.0,42785,88340.0,91977.0,51.01,0.04,Low Risk
U686,2024,7,782481.0,Stable Salary & Stable Fixed Expenses,180317,45555.0,53510,99065.0,81252.0,45.06,-0.01,Low Risk
U686,2024,8,863733.0,Stable Salary & Stable Fixed Expenses,180317,45555.0,53096,98651.0,81666.0,45.29,-0.04,Low Risk
U686,2024,9,945399.0,Stable Salary & Stable Fixed Expenses,180317,45555.0,45287,90842.0,89475.0,49.62,-0.05,Low Risk
U686,2024,10,1034874.0,Stable Salary & Stable Fixed Expenses,180317,45555.0,52447,98002.0,82315.0,45.65,0.02,Low Risk
U686,2024,11,1117189.0,Stable Salary & Stable Fixed Expenses,180317,45555.0,49430,94985.0,85332.0,47.32,0.03,Low Risk
U686,2024,12,1202521.0,Stable Salary & Stable Fixed Expenses,180317,45555.0,56892,102447.0,77870.0,43.19,-0.03,Low Risk
U687,2024,1,139494.0,Salary Increases & Fixed Expenses Remain Stable,132005,65447.0,48536,113983.0,18022.0,13.65,0.02,High Risk
U687,2024,2,157516.0,Salary Increases & Fixed Expenses Remain Stable,132005,65447.0,41941,107388.0,24617.0,18.65,-0.0,Medium Risk
U687,2024,3,182133.0,Salary Increases & Fixed Expenses Remain Stable,132005,65447.0,44167,109614.0,22391.0,16.96,0.01,Medium Risk
U687,2024,4,204524.0,Salary Increases & Fixed Expenses Remain Stable,132005,65447.0,60632,126079.0,5926.0,4.49,-0.01,High Risk
U687,2024,5,210450.0,Salary Increases & Fixed Expenses Remain Stable,132005,65447.0,49956,115403.0,16602.0,12.58,-0.05,High Risk
U687,2024,6,227052.0,Salary Increases & Fixed Expenses Remain Stable,157318,65447.0,60844,126291.0,31027.0,19.72,-0.02,Medium Risk
U687,2024,7,258079.0,Salary Increases & Fixed Expenses Remain Stable,157318,65447.0,74073,139520.0,17798.0,11.31,-0.0,High Risk
U687,2024,8,275877.0,Salary Increases & Fixed Expenses Remain Stable,157318,65447.0,66171,131618.0,25700.0,16.34,0.03,Medium Risk
U687,2024,9,301577.0,Salary Increases & Fixed Expenses Remain Stable,157318,65447.0,85854,151301.0,6017.0,3.82,0.03,High Risk
U687,2024,10,307594.0,Salary Increases & Fixed Expenses Remain Stable,157318,65447.0,61314,126761.0,30557.0,19.42,-0.04,Medium Risk
U687,2024,11,338151.0,Salary Increases & Fixed Expenses Remain Stable,157318,65447.0,83763,149210.0,8108.0,5.15,-0.03,High Risk
U687,2024,12,346259.0,Salary Increases & Fixed Expenses Remain Stable,157318,65447.0,90583,156030.0,1288.0,0.82,0.01,High Risk
U688,2024,1,179037.0,Salary Increases & Fixed Expenses Increase,145175,65448.0,48343,113791.0,31384.0,21.62,-0.03,Medium Risk
U688,2024,2,210421.0,Salary Increases & Fixed Expenses Increase,145175,66582.0,59591,126173.0,19002.0,13.09,0.04,High Risk
U688,2024,3,229423.0,Salary Increases & Fixed Expenses Increase,145175,66582.0,77994,144576.0,599.0,0.41,0.01,High Risk
U688,2024,4,230022.0,Salary Increases & Fixed Expenses Increase,145175,67199.0,51566,118765.0,26410.0,18.19,0.01,Medium Risk
U688,2024,5,256432.0,Salary Increases & Fixed Expenses Increase,145175,67199.0,61644,128843.0,16332.0,11.25,0.03,High Risk
U688,2024,6,272764.0,Salary Increases & Fixed Expenses Increase,145175,67199.0,68523,135722.0,9453.0,6.51,0.03,High Risk
U688,2024,7,282217.0,Salary Increases & Fixed Expenses Increase,164088,67199.0,75787,142986.0,21102.0,12.86,0.03,High Risk
U688,2024,8,303319.0,Salary Increases & Fixed Expenses Increase,164088,67199.0,56508,123707.0,40381.0,24.61,-0.03,Medium Risk
U688,2024,9,343700.0,Salary Increases & Fixed Expenses Increase,164088,67199.0,57218,124417.0,39671.0,24.18,-0.0,Medium Risk
U688,2024,10,383371.0,Salary Increases & Fixed Expenses Increase,164088,67199.0,89355,156554.0,7534.0,4.59,0.03,High Risk
U688,2024,11,390905.0,Salary Increases & Fixed Expenses Increase,164088,67199.0,85046,152245.0,11843.0,7.22,0.01,High Risk
U688,2024,12,402748.0,Salary Increases & Fixed Expenses Increase,164088,67199.0,75867,143066.0,21022.0,12.81,0.02,High Risk
U689,2024,1,246382.0,Stable Salary & Increasing Fixed Expenses,246186,109287.0,76878,186165.0,60021.0,24.38,0.01,Medium Risk
U689,2024,2,306403.0,Stable Salary & Increasing Fixed Expenses,246186,109287.0,114917,224204.0,21982.0,8.93,-0.04,High Risk
U689,2024,3,328385.0,Stable Salary & Increasing Fixed Expenses,246186,109287.0,95897,205184.0,41002.0,16.65,0.01,Medium Risk
U689,2024,4,369387.0,Stable Salary & Increasing Fixed Expenses,246186,109287.0,92305,201592.0,44594.0,18.11,0.04,Medium Risk
U689,2024,5,413981.0,Stable Salary & Increasing Fixed Expenses,246186,109287.0,85698,194985.0,51201.0,20.8,-0.04,Medium Risk
U689,2024,6,465182.0,Stable Salary & Increasing Fixed Expenses,246186,109287.0,88271,197558.0,48628.0,19.75,0.0,Medium Risk
U689,2024,7,513810.0,Stable Salary & Increasing Fixed Expenses,246186,109287.0,110233,219520.0,26666.0,10.83,-0.04,High Risk
U689,2024,8,540476.0,Stable Salary & Increasing Fixed Expenses,246186,109949.0,117744,227693.0,18493.0,7.51,-0.0,High Risk
U689,2024,9,558969.0,Stable Salary & Increasing Fixed Expenses,246186,109949.0,101062,211011.0,35175.0,14.29,0.05,High Risk
U689,2024,10,594144.0,Stable Salary & Increasing Fixed Expenses,246186,109949.0,116097,226046.0,20140.0,8.18,-0.01,High Risk
U689,2024,11,614284.0,Stable Salary & Increasing Fixed Expenses,246186,109949.0,98846,208795.0,37391.0,15.19,0.01,Medium Risk
U689,2024,12,651675.0,Stable Salary & Increasing Fixed Expenses,246186,109949.0,84175,194124.0,52062.0,21.15,-0.03,Medium Risk
U690,2024,1,240644.0,Salary Increases & Fixed Expenses Remain Stable,210362,105299.0,81900,187199.0,23163.0,11.01,-0.03,High Risk
U690,2024,2,263807.0,Salary Increases & Fixed Expenses Remain Stable,210362,105299.0,76783,182082.0,28280.0,13.44,-0.01,High Risk
U690,2024,3,292087.0,Salary Increases & Fixed Expenses Remain Stable,240012,105299.0,137181,242480.0,-2468.0,-1.03,-0.03,High Risk
U690,2024,4,289619.0,Salary Increases & Fixed Expenses Remain Stable,240012,105299.0,83499,188798.0,51214.0,21.34,-0.04,Medium Risk
U690,2024,5,340833.0,Salary Increases & Fixed Expenses Remain Stable,240012,105299.0,84570,189869.0,50143.0,20.89,0.01,Medium Risk
U690,2024,6,390976.0,Salary Increases & Fixed Expenses Remain Stable,240012,105299.0,119262,224561.0,15451.0,6.44,0.05,High Risk
U690,2024,7,406427.0,Salary Increases & Fixed Expenses Remain Stable,240012,105299.0,96190,201489.0,38523.0,16.05,0.04,Medium Risk
U690,2024,8,444950.0,Salary Increases & Fixed Expenses Remain Stable,240012,105299.0,101689,206988.0,33024.0,13.76,-0.03,High Risk
U690,2024,9,477974.0,Salary Increases & Fixed Expenses Remain Stable,240012,105299.0,100326,205625.0,34387.0,14.33,-0.01,High Risk
U690,2024,10,512361.0,Salary Increases & Fixed Expenses Remain Stable,240012,105299.0,125701,231000.0,9012.0,3.75,-0.01,High Risk
U690,2024,11,521373.0,Salary Increases & Fixed Expenses Remain Stable,240012,105299.0,104086,209385.0,30627.0,12.76,-0.02,High Risk
U690,2024,12,552000.0,Salary Increases & Fixed Expenses Remain Stable,240012,105299.0,119856,225155.0,14857.0,6.19,-0.02,High Risk
U691,2024,1,227686.0,Salary Increases & Fixed Expenses Increase,164398,49948.0,57833,107781.0,56617.0,34.44,0.03,Low Risk
U691,2024,2,284303.0,Salary Increases & Fixed Expenses Increase,164398,50698.0,54048,104746.0,59652.0,36.29,-0.05,Low Risk
U691,2024,3,343955.0,Salary Increases & Fixed Expenses Increase,178297,50698.0,73143,123841.0,54456.0,30.54,-0.05,Low Risk
U691,2024,4,398411.0,Salary Increases & Fixed Expenses Increase,178297,52348.0,69740,122088.0,56209.0,31.53,0.04,Low Risk
U691,2024,5,454620.0,Salary Increases & Fixed Expenses Increase,178297,53114.0,80985,134099.0,44198.0,24.79,-0.04,Medium Risk
U691,2024,6,498818.0,Salary Increases & Fixed Expenses Increase,178297,53114.0,65472,118586.0,59711.0,33.49,-0.01,Low Risk
U691,2024,7,558529.0,Salary Increases & Fixed Expenses Increase,178297,53801.0,58840,112641.0,65656.0,36.82,0.01,Low Risk
U691,2024,8,624185.0,Salary Increases & Fixed Expenses Increase,178297,53801.0,58416,112217.0,66080.0,37.06,0.0,Low Risk
U691,2024,9,690265.0,Salary Increases & Fixed Expenses Increase,178297,53801.0,58991,112792.0,65505.0,36.74,-0.01,Low Risk
U691,2024,10,755770.0,Salary Increases & Fixed Expenses Increase,178297,53801.0,70820,124621.0,53676.0,30.1,0.02,Low Risk
U691,2024,11,809446.0,Salary Increases & Fixed Expenses Increase,178297,53801.0,83433,137234.0,41063.0,23.03,0.0,Medium Risk
U691,2024,12,850509.0,Salary Increases & Fixed Expenses Increase,178297,53801.0,70402,124203.0,54094.0,30.34,-0.04,Low Risk
U692,2024,1,46065.0,Salary Increases & Fixed Expenses Increase,43647,17340.0,12062,29402.0,14245.0,32.64,0.02,Low Risk
U692,2024,2,60310.0,Salary Increases & Fixed Expenses Increase,43647,18721.0,12331,31052.0,12595.0,28.86,0.04,Low Risk
U692,2024,3,72905.0,Salary Increases & Fixed Expenses Increase,43647,18721.0,9091,27812.0,15835.0,36.28,-0.0,Low Risk
U692,2024,4,88740.0,Salary Increases & Fixed Expenses Increase,43647,20384.0,9678,30062.0,13585.0,31.12,0.01,Low Risk
U692,2024,5,102325.0,Salary Increases & Fixed Expenses Increase,43647,20384.0,11716,32100.0,11547.0,26.46,0.0,Low Risk
U692,2024,6,113872.0,Salary Increases & Fixed Expenses Increase,60403,22069.0,15667,37736.0,22667.0,37.53,0.01,Low Risk
U692,2024,7,136539.0,Salary Increases & Fixed Expenses Increase,60403,22069.0,17003,39072.0,21331.0,35.31,0.05,Low Risk
U692,2024,8,157870.0,Salary Increases & Fixed Expenses Increase,60403,22069.0,16920,38989.0,21414.0,35.45,-0.02,Low Risk
U692,2024,9,179284.0,Salary Increases & Fixed Expenses Increase,60403,22069.0,13862,35931.0,24472.0,40.51,0.0,Low Risk
U692,2024,10,203756.0,Salary Increases & Fixed Expenses Increase,60403,22069.0,17746,39815.0,20588.0,34.08,0.05,Low Risk
U692,2024,11,224344.0,Salary Increases & Fixed Expenses Increase,60403,23715.0,18388,42103.0,18300.0,30.3,0.04,Low Risk
U692,2024,12,242644.0,Salary Increases & Fixed Expenses Increase,60403,23715.0,13089,36804.0,23599.0,39.07,-0.0,Low Risk
U693,2024,1,242574.0,Salary Increases & Fixed Expenses Remain Stable,122686,57154.0,31083,88237.0,34449.0,28.08,-0.04,Low Risk
U693,2024,2,277023.0,Salary Increases & Fixed Expenses Remain Stable,122686,57154.0,26846,84000.0,38686.0,31.53,0.03,Low Risk
U693,2024,3,315709.0,Salary Increases & Fixed Expenses Remain Stable,122686,57154.0,39315,96469.0,26217.0,21.37,-0.01,Medium Risk
U693,2024,4,341926.0,Salary Increases & Fixed Expenses Remain Stable,130771,57154.0,38348,95502.0,35269.0,26.97,0.0,Low Risk
U693,2024,5,377195.0,Salary Increases & Fixed Expenses Remain Stable,130771,57154.0,31296,88450.0,42321.0,32.36,0.0,Low Risk
U693,2024,6,419516.0,Salary Increases & Fixed Expenses Remain Stable,130771,57154.0,36968,94122.0,36649.0,28.03,0.05,Low Risk
U693,2024,7,456165.0,Salary Increases & Fixed Expenses Remain Stable,130771,57154.0,26661,83815.0,46956.0,35.91,0.03,Low Risk
U693,2024,8,503121.0,Salary Increases & Fixed Expenses Remain Stable,130771,57154.0,36722,93876.0,36895.0,28.21,0.02,Low Risk
U693,2024,9,540016.0,Salary Increases & Fixed Expenses Remain Stable,130771,57154.0,32471,89625.0,41146.0,31.46,-0.01,Low Risk
U693,2024,10,581162.0,Salary Increases & Fixed Expenses Remain Stable,130771,57154.0,37712,94866.0,35905.0,27.46,0.04,Low Risk
U693,2024,11,617067.0,Salary Increases & Fixed Expenses Remain Stable,130771,57154.0,28215,85369.0,45402.0,34.72,0.02,Low Risk
U693,2024,12,662469.0,Salary Increases & Fixed Expenses Remain Stable,130771,57154.0,39723,96877.0,33894.0,25.92,0.03,Low Risk
U694,2024,1,236754.0,Stable Salary & Stable Fixed Expenses,222419,93902.0,136217,230119.0,-7700.0,-3.46,-0.04,High Risk
U694,2024,2,229054.0,Stable Salary & Stable Fixed Expenses,222419,93902.0,135685,229587.0,-7168.0,-3.22,-0.05,High Risk
U694,2024,3,221886.0,Stable Salary & Stable Fixed Expenses,222419,93902.0,118535,212437.0,9982.0,4.49,0.01,High Risk
U694,2024,4,231868.0,Stable Salary & Stable Fixed Expenses,222419,93902.0,134261,228163.0,-5744.0,-2.58,-0.03,High Risk
U694,2024,5,226124.0,Stable Salary & Stable Fixed Expenses,222419,93902.0,145805,239707.0,-17288.0,-7.77,0.02,High Risk
U694,2024,6,208836.0,Stable Salary & Stable Fixed Expenses,222419,93902.0,136745,230647.0,-8228.0,-3.7,-0.02,High Risk
U694,2024,7,200608.0,Stable Salary & Stable Fixed Expenses,222419,93902.0,141247,235149.0,-12730.0,-5.72,0.01,High Risk
U694,2024,8,187878.0,Stable Salary & Stable Fixed Expenses,222419,93902.0,116673,210575.0,11844.0,5.33,0.01,High Risk
U694,2024,9,199722.0,Stable Salary & Stable Fixed Expenses,222419,93902.0,134397,228299.0,-5880.0,-2.64,-0.03,High Risk
U694,2024,10,193842.0,Stable Salary & Stable Fixed Expenses,222419,93902.0,152569,246471.0,-24052.0,-10.81,0.0,High Risk
U694,2024,11,169790.0,Stable Salary & Stable Fixed Expenses,222419,93902.0,164334,258236.0,-35817.0,-16.1,-0.04,High Risk
U694,2024,12,133973.0,Stable Salary & Stable Fixed Expenses,222419,93902.0,126780,220682.0,1737.0,0.78,-0.01,High Risk
U695,2024,1,231675.0,Salary Increases & Fixed Expenses Increase,190105,73504.0,45545,119049.0,71056.0,37.38,0.04,Low Risk
U695,2024,2,302731.0,Salary Increases & Fixed Expenses Increase,190105,73504.0,44254,117758.0,72347.0,38.06,0.02,Low Risk
U695,2024,3,375078.0,Salary Increases & Fixed Expenses Increase,196910,73504.0,69840,143344.0,53566.0,27.2,-0.0,Low Risk
U695,2024,4,428644.0,Salary Increases & Fixed Expenses Increase,196910,73504.0,47357,120861.0,76049.0,38.62,0.01,Low Risk
U695,2024,5,504693.0,Salary Increases & Fixed Expenses Increase,196910,73504.0,57354,130858.0,66052.0,33.54,-0.04,Low Risk
U695,2024,6,570745.0,Salary Increases & Fixed Expenses Increase,196910,73504.0,51751,125255.0,71655.0,36.39,0.03,Low Risk
U695,2024,7,642400.0,Salary Increases & Fixed Expenses Increase,196910,73504.0,48651,122155.0,74755.0,37.96,0.01,Low Risk
U695,2024,8,717155.0,Salary Increases & Fixed Expenses Increase,196910,73504.0,52947,126451.0,70459.0,35.78,-0.03,Low Risk
U695,2024,9,787614.0,Salary Increases & Fixed Expenses Increase,196910,73504.0,51367,124871.0,72039.0,36.58,-0.05,Low Risk
U695,2024,10,859653.0,Salary Increases & Fixed Expenses Increase,196910,75019.0,44861,119880.0,77030.0,39.12,0.04,Low Risk
U695,2024,11,936683.0,Salary Increases & Fixed Expenses Increase,196910,75657.0,57125,132782.0,64128.0,32.57,0.02,Low Risk
U695,2024,12,1000811.0,Salary Increases & Fixed Expenses Increase,196910,77357.0,70438,147795.0,49115.0,24.94,0.02,Medium Risk
U696,2024,1,210410.0,Salary Increases & Fixed Expenses Increase,109162,50957.0,36697,87654.0,21508.0,19.7,0.03,Medium Risk
U696,2024,2,231918.0,Salary Increases & Fixed Expenses Increase,109162,52073.0,37937,90010.0,19152.0,17.54,0.01,Medium Risk
U696,2024,3,251070.0,Salary Increases & Fixed Expenses Increase,114180,52073.0,44431,96504.0,17676.0,15.48,-0.04,Medium Risk
U696,2024,4,268746.0,Salary Increases & Fixed Expenses Increase,114180,52073.0,49656,101729.0,12451.0,10.9,-0.04,High Risk
U696,2024,5,281197.0,Salary Increases & Fixed Expenses Increase,114180,52073.0,43267,95340.0,18840.0,16.5,0.04,Medium Risk
U696,2024,6,300037.0,Salary Increases & Fixed Expenses Increase,114180,52073.0,43784,95857.0,18323.0,16.05,0.01,Medium Risk
U696,2024,7,318360.0,Salary Increases & Fixed Expenses Increase,114180,53134.0,45768,98902.0,15278.0,13.38,0.04,High Risk
U696,2024,8,333638.0,Salary Increases & Fixed Expenses Increase,114180,53134.0,39929,93063.0,21117.0,18.49,0.0,Medium Risk
U696,2024,9,354755.0,Salary Increases & Fixed Expenses Increase,114180,53134.0,36884,90018.0,24162.0,21.16,0.0,Medium Risk
U696,2024,10,378917.0,Salary Increases & Fixed Expenses Increase,114180,53134.0,58564,111698.0,2482.0,2.17,-0.02,High Risk
U696,2024,11,381399.0,Salary Increases & Fixed Expenses Increase,114180,53134.0,58141,111275.0,2905.0,2.54,0.01,High Risk
U696,2024,12,384304.0,Salary Increases & Fixed Expenses Increase,114180,54350.0,68394,122744.0,-8564.0,-7.5,0.01,High Risk
U697,2024,1,206787.0,Stable Salary & Stable Fixed Expenses,83487,32291.0,30404,62695.0,20792.0,24.9,0.04,Medium Risk
U697,2024,2,227579.0,Stable Salary & Stable Fixed Expenses,83487,32291.0,32059,64350.0,19137.0,22.92,0.01,Medium Risk
U697,2024,3,246716.0,Stable Salary & Stable Fixed Expenses,83487,32291.0,44035,76326.0,7161.0,8.58,0.0,High Risk
U697,2024,4,253877.0,Stable Salary & Stable Fixed Expenses,83487,32291.0,37338,69629.0,13858.0,16.6,-0.0,Medium Risk
U697,2024,5,267735.0,Stable Salary & Stable Fixed Expenses,83487,32291.0,36389,68680.0,14807.0,17.74,0.01,Medium Risk
U697,2024,6,282542.0,Stable Salary & Stable Fixed Expenses,83487,32291.0,31967,64258.0,19229.0,23.03,0.02,Medium Risk
U697,2024,7,301771.0,Stable Salary & Stable Fixed Expenses,83487,32291.0,28940,61231.0,22256.0,26.66,0.03,Low Risk
U697,2024,8,324027.0,Stable Salary & Stable Fixed Expenses,83487,32291.0,28242,60533.0,22954.0,27.49,0.02,Low Risk
U697,2024,9,346981.0,Stable Salary & Stable Fixed Expenses,83487,32291.0,29679,61970.0,21517.0,25.77,0.03,Low Risk
U697,2024,10,368498.0,Stable Salary & Stable Fixed Expenses,83487,32291.0,34112,66403.0,17084.0,20.46,0.0,Medium Risk
U697,2024,11,385582.0,Stable Salary & Stable Fixed Expenses,83487,32291.0,42490,74781.0,8706.0,10.43,-0.01,High Risk
U697,2024,12,394288.0,Stable Salary & Stable Fixed Expenses,83487,32291.0,39520,71811.0,11676.0,13.99,-0.03,High Risk
U698,2024,1,250000.0,Salary Increases & Fixed Expenses Remain Stable,274616,80732.0,66728,147460.0,127156.0,46.3,-0.05,Low Risk
U698,2024,2,377156.0,Salary Increases & Fixed Expenses Remain Stable,274616,80732.0,72618,153350.0,121266.0,44.16,0.05,Low Risk
U698,2024,3,498422.0,Salary Increases & Fixed Expenses Remain Stable,274616,80732.0,74028,154760.0,119856.0,43.64,0.02,Low Risk
U698,2024,4,618278.0,Salary Increases & Fixed Expenses Remain Stable,274616,80732.0,75771,156503.0,118113.0,43.01,-0.01,Low Risk
U698,2024,5,736391.0,Salary Increases & Fixed Expenses Remain Stable,274616,80732.0,64562,145294.0,129322.0,47.09,0.02,Low Risk
U698,2024,6,865713.0,Salary Increases & Fixed Expenses Remain Stable,300341,80732.0,77938,158670.0,141671.0,47.17,0.01,Low Risk
U698,2024,7,1007384.0,Salary Increases & Fixed Expenses Remain Stable,300341,80732.0,86744,167476.0,132865.0,44.24,0.05,Low Risk
U698,2024,8,1140249.0,Salary Increases & Fixed Expenses Remain Stable,300341,80732.0,88172,168904.0,131437.0,43.76,-0.0,Low Risk
U698,2024,9,1271686.0,Salary Increases & Fixed Expenses Remain Stable,300341,80732.0,77910,158642.0,141699.0,47.18,0.01,Low Risk
U698,2024,10,1413385.0,Salary Increases & Fixed Expenses Remain Stable,300341,80732.0,92607,173339.0,127002.0,42.29,-0.01,Low Risk
U698,2024,11,1540387.0,Salary Increases & Fixed Expenses Remain Stable,300341,80732.0,76413,157145.0,143196.0,47.68,-0.04,Low Risk
U698,2024,12,1683583.0,Salary Increases & Fixed Expenses Remain Stable,300341,80732.0,77142,157874.0,142467.0,47.44,0.03,Low Risk
U699,2024,1,51945.0,Salary Increases & Fixed Expenses Decrease,40189,12548.0,8387,20935.0,19254.0,47.91,-0.01,Low Risk
U699,2024,2,71199.0,Salary Increases & Fixed Expenses Decrease,40189,12548.0,10734,23282.0,16907.0,42.07,0.01,Low Risk
U699,2024,3,88106.0,Salary Increases & Fixed Expenses Decrease,40189,12548.0,10118,22666.0,17523.0,43.6,0.04,Low Risk
U699,2024,4,105629.0,Salary Increases & Fixed Expenses Decrease,40189,11293.2,8348,19641.2,20547.8,51.13,-0.03,Low Risk
U699,2024,5,126176.8,Salary Increases & Fixed Expenses Decrease,47980,11293.2,11732,23025.2,24954.8,52.01,0.02,Low Risk
U699,2024,6,151131.6,Salary Increases & Fixed Expenses Decrease,47980,11293.2,12377,23670.2,24309.8,50.67,-0.04,Low Risk
U699,2024,7,175441.4,Salary Increases & Fixed Expenses Decrease,47980,11293.2,12751,24044.2,23935.8,49.89,-0.04,Low Risk
U699,2024,8,199377.19999999998,Salary Increases & Fixed Expenses Decrease,47980,11293.2,13884,25177.2,22802.8,47.53,0.04,Low Risk
U699,2024,9,222179.99999999997,Salary Increases & Fixed Expenses Decrease,47980,11293.2,9612,20905.2,27074.8,56.43,-0.0,Low Risk
U699,2024,10,249254.79999999996,Salary Increases & Fixed Expenses Decrease,47980,11293.2,11505,22798.2,25181.8,52.48,-0.02,Low Risk
U699,2024,11,274436.6,Salary Increases & Fixed Expenses Decrease,47980,11293.2,9921,21214.2,26765.8,55.79,0.04,Low Risk
U699,2024,12,301202.39999999997,Salary Increases & Fixed Expenses Decrease,47980,11293.2,12494,23787.2,24192.8,50.42,-0.03,Low Risk
U700,2024,1,202465.0,Salary Increases & Fixed Expenses Remain Stable,67117,24587.0,31030,55617.0,11500.0,17.13,0.04,Medium Risk
U700,2024,2,213965.0,Salary Increases & Fixed Expenses Remain Stable,67117,24587.0,27846,52433.0,14684.0,21.88,-0.01,Medium Risk
U700,2024,3,228649.0,Salary Increases & Fixed Expenses Remain Stable,88235,24587.0,39953,64540.0,23695.0,26.85,-0.04,Low Risk
U700,2024,4,252344.0,Salary Increases & Fixed Expenses Remain Stable,88235,24587.0,41620,66207.0,22028.0,24.97,0.01,Medium Risk
U700,2024,5,274372.0,Salary Increases & Fixed Expenses Remain Stable,88235,24587.0,32374,56961.0,31274.0,35.44,0.0,Low Risk
U700,2024,6,305646.0,Salary Increases & Fixed Expenses Remain Stable,88235,24587.0,37068,61655.0,26580.0,30.12,0.05,Low Risk
U700,2024,7,332226.0,Salary Increases & Fixed Expenses Remain Stable,88235,24587.0,35369,59956.0,28279.0,32.05,0.04,Low Risk
U700,2024,8,360505.0,Salary Increases & Fixed Expenses Remain Stable,88235,24587.0,26745,51332.0,36903.0,41.82,-0.02,Low Risk
U700,2024,9,397408.0,Salary Increases & Fixed Expenses Remain Stable,88235,24587.0,35662,60249.0,27986.0,31.72,0.03,Low Risk
U700,2024,10,425394.0,Salary Increases & Fixed Expenses Remain Stable,88235,24587.0,44039,68626.0,19609.0,22.22,0.01,Medium Risk
U700,2024,11,445003.0,Salary Increases & Fixed Expenses Remain Stable,88235,24587.0,34472,59059.0,29176.0,33.07,0.02,Low Risk
U700,2024,12,474179.0,Salary Increases & Fixed Expenses Remain Stable,88235,24587.0,34237,58824.0,29411.0,33.33,0.01,Low Risk
U701,2024,1,230268.0,Salary Increases & Fixed Expenses Decrease,158202,53567.0,43965,97532.0,60670.0,38.35,-0.01,Low Risk
U701,2024,2,290938.0,Salary Increases & Fixed Expenses Decrease,158202,53567.0,45504,99071.0,59131.0,37.38,0.05,Low Risk
U701,2024,3,350069.0,Salary Increases & Fixed Expenses Decrease,158202,53567.0,39581,93148.0,65054.0,41.12,-0.02,Low Risk
U701,2024,4,415123.0,Salary Increases & Fixed Expenses Decrease,158202,53567.0,39805,93372.0,64830.0,40.98,0.03,Low Risk
U701,2024,5,479953.0,Salary Increases & Fixed Expenses Decrease,158202,53567.0,45597,99164.0,59038.0,37.32,-0.01,Low Risk
U701,2024,6,538991.0,Salary Increases & Fixed Expenses Decrease,158202,53567.0,40626,94193.0,64009.0,40.46,-0.04,Low Risk
U701,2024,7,603000.0,Salary Increases & Fixed Expenses Decrease,158202,53567.0,36704,90271.0,67931.0,42.94,-0.01,Low Risk
U701,2024,8,670931.0,Salary Increases & Fixed Expenses Decrease,187206,53567.0,48243,101810.0,85396.0,45.62,-0.02,Low Risk
U701,2024,9,756327.0,Salary Increases & Fixed Expenses Decrease,187206,53567.0,37654,91221.0,95985.0,51.27,0.02,Low Risk
U701,2024,10,852312.0,Salary Increases & Fixed Expenses Decrease,187206,53567.0,50392,103959.0,83247.0,44.47,-0.03,Low Risk
U701,2024,11,935559.0,Salary Increases & Fixed Expenses Decrease,187206,53567.0,39014,92581.0,94625.0,50.55,0.02,Low Risk
U701,2024,12,1030184.0,Salary Increases & Fixed Expenses Decrease,187206,51762.0,50448,102210.0,84996.0,45.4,-0.0,Low Risk
U702,2024,1,61725.0,Salary Increases & Fixed Expenses Decrease,53784,28499.0,25047,53546.0,238.0,0.44,-0.04,High Risk
U702,2024,2,61963.0,Salary Increases & Fixed Expenses Decrease,53784,28499.0,23850,52349.0,1435.0,2.67,0.04,High Risk
U702,2024,3,63398.0,Salary Increases & Fixed Expenses Decrease,71946,28499.0,26355,54854.0,17092.0,23.76,-0.04,Medium Risk
U702,2024,4,80490.0,Salary Increases & Fixed Expenses Decrease,71946,28499.0,31475,59974.0,11972.0,16.64,-0.01,Medium Risk
U702,2024,5,92462.0,Salary Increases & Fixed Expenses Decrease,71946,28499.0,26134,54633.0,17313.0,24.06,-0.02,Medium Risk
U702,2024,6,109775.0,Salary Increases & Fixed Expenses Decrease,71946,28499.0,34299,62798.0,9148.0,12.72,0.0,High Risk
U702,2024,7,118923.0,Salary Increases & Fixed Expenses Decrease,71946,28499.0,34493,62992.0,8954.0,12.45,-0.04,High Risk
U702,2024,8,127877.0,Salary Increases & Fixed Expenses Decrease,71946,28499.0,28004,56503.0,15443.0,21.46,0.05,Medium Risk
U702,2024,9,143320.0,Salary Increases & Fixed Expenses Decrease,71946,28499.0,39452,67951.0,3995.0,5.55,0.03,High Risk
U702,2024,10,147315.0,Salary Increases & Fixed Expenses Decrease,71946,28499.0,35691,64190.0,7756.0,10.78,0.04,High Risk
U702,2024,11,155071.0,Salary Increases & Fixed Expenses Decrease,71946,28499.0,32456,60955.0,10991.0,15.28,-0.03,Medium Risk
U702,2024,12,166062.0,Salary Increases & Fixed Expenses Decrease,71946,28499.0,32358,60857.0,11089.0,15.41,0.04,Medium Risk
U703,2024,1,179929.0,Salary Increases & Fixed Expenses Remain Stable,170884,53151.0,42899,96050.0,74834.0,43.79,0.04,Low Risk
U703,2024,2,254763.0,Salary Increases & Fixed Expenses Remain Stable,170884,53151.0,50434,103585.0,67299.0,39.38,0.01,Low Risk
U703,2024,3,322062.0,Salary Increases & Fixed Expenses Remain Stable,186226,53151.0,42321,95472.0,90754.0,48.73,-0.03,Low Risk
U703,2024,4,412816.0,Salary Increases & Fixed Expenses Remain Stable,186226,53151.0,40080,93231.0,92995.0,49.94,0.0,Low Risk
U703,2024,5,505811.0,Salary Increases & Fixed Expenses Remain Stable,186226,53151.0,39685,92836.0,93390.0,50.15,-0.04,Low Risk
U703,2024,6,599201.0,Salary Increases & Fixed Expenses Remain Stable,186226,53151.0,52709,105860.0,80366.0,43.16,-0.01,Low Risk
U703,2024,7,679567.0,Salary Increases & Fixed Expenses Remain Stable,186226,53151.0,49941,103092.0,83134.0,44.64,-0.04,Low Risk
U703,2024,8,762701.0,Salary Increases & Fixed Expenses Remain Stable,186226,53151.0,53051,106202.0,80024.0,42.97,0.04,Low Risk
U703,2024,9,842725.0,Salary Increases & Fixed Expenses Remain Stable,186226,53151.0,40478,93629.0,92597.0,49.72,-0.01,Low Risk
U703,2024,10,935322.0,Salary Increases & Fixed Expenses Remain Stable,186226,53151.0,46925,100076.0,86150.0,46.26,-0.05,Low Risk
U703,2024,11,1021472.0,Salary Increases & Fixed Expenses Remain Stable,186226,53151.0,48651,101802.0,84424.0,45.33,-0.03,Low Risk
U703,2024,12,1105896.0,Salary Increases & Fixed Expenses Remain Stable,186226,53151.0,46961,100112.0,86114.0,46.24,0.0,Low Risk
U704,2024,1,250000.0,Stable Salary & Stable Fixed Expenses,254233,111756.0,167066,278822.0,-24589.0,-9.67,-0.03,High Risk
U704,2024,2,225411.0,Stable Salary & Stable Fixed Expenses,254233,111756.0,133027,244783.0,9450.0,3.72,-0.01,High Risk
U704,2024,3,234861.0,Stable Salary & Stable Fixed Expenses,254233,111756.0,162268,274024.0,-19791.0,-7.78,0.04,High Risk
U704,2024,4,215070.0,Stable Salary & Stable Fixed Expenses,254233,111756.0,132905,244661.0,9572.0,3.77,0.03,High Risk
U704,2024,5,224642.0,Stable Salary & Stable Fixed Expenses,254233,111756.0,159015,270771.0,-16538.0,-6.51,-0.01,High Risk
U704,2024,6,208104.0,Stable Salary & Stable Fixed Expenses,254233,111756.0,170948,282704.0,-28471.0,-11.2,-0.01,High Risk
U704,2024,7,179633.0,Stable Salary & Stable Fixed Expenses,254233,111756.0,139634,251390.0,2843.0,1.12,-0.03,High Risk
U704,2024,8,182476.0,Stable Salary & Stable Fixed Expenses,254233,111756.0,163407,275163.0,-20930.0,-8.23,-0.03,High Risk
U704,2024,9,161546.0,Stable Salary & Stable Fixed Expenses,254233,111756.0,128542,240298.0,13935.0,5.48,-0.03,High Risk
U704,2024,10,175481.0,Stable Salary & Stable Fixed Expenses,254233,111756.0,161536,273292.0,-19059.0,-7.5,-0.0,High Risk
U704,2024,11,156422.0,Stable Salary & Stable Fixed Expenses,254233,111756.0,144807,256563.0,-2330.0,-0.92,0.02,High Risk
U704,2024,12,154092.0,Stable Salary & Stable Fixed Expenses,254233,111756.0,153394,265150.0,-10917.0,-4.29,-0.01,High Risk
U705,2024,1,231529.0,Salary Increases & Fixed Expenses Remain Stable,113945,45876.0,27619,73495.0,40450.0,35.5,0.01,Low Risk
U705,2024,2,271979.0,Salary Increases & Fixed Expenses Remain Stable,113945,45876.0,23559,69435.0,44510.0,39.06,0.04,Low Risk
U705,2024,3,316489.0,Salary Increases & Fixed Expenses Remain Stable,113945,45876.0,30368,76244.0,37701.0,33.09,-0.04,Low Risk
U705,2024,4,354190.0,Salary Increases & Fixed Expenses Remain Stable,113945,45876.0,31967,77843.0,36102.0,31.68,-0.03,Low Risk
U705,2024,5,390292.0,Salary Increases & Fixed Expenses Remain Stable,113945,45876.0,33250,79126.0,34819.0,30.56,-0.01,Low Risk
U705,2024,6,425111.0,Salary Increases & Fixed Expenses Remain Stable,120729,45876.0,30351,76227.0,44502.0,36.86,-0.03,Low Risk
U705,2024,7,469613.0,Salary Increases & Fixed Expenses Remain Stable,120729,45876.0,30682,76558.0,44171.0,36.59,0.03,Low Risk
U705,2024,8,513784.0,Salary Increases & Fixed Expenses Remain Stable,120729,45876.0,33542,79418.0,41311.0,34.22,-0.01,Low Risk
U705,2024,9,555095.0,Salary Increases & Fixed Expenses Remain Stable,120729,45876.0,35286,81162.0,39567.0,32.77,0.0,Low Risk
U705,2024,10,594662.0,Salary Increases & Fixed Expenses Remain Stable,120729,45876.0,24944,70820.0,49909.0,41.34,-0.01,Low Risk
U705,2024,11,644571.0,Salary Increases & Fixed Expenses Remain Stable,120729,45876.0,27200,73076.0,47653.0,39.47,-0.05,Low Risk
U705,2024,12,692224.0,Salary Increases & Fixed Expenses Remain Stable,120729,45876.0,35280,81156.0,39573.0,32.78,0.03,Low Risk
U706,2024,1,232514.0,Stable Salary & Stable Fixed Expenses,212046,110608.0,54748,165356.0,46690.0,22.02,0.02,Medium Risk
U706,2024,2,279204.0,Stable Salary & Stable Fixed Expenses,212046,110608.0,62747,173355.0,38691.0,18.25,0.02,Medium Risk
U706,2024,3,317895.0,Stable Salary & Stable Fixed Expenses,212046,110608.0,50335,160943.0,51103.0,24.1,0.03,Medium Risk
U706,2024,4,368998.0,Stable Salary & Stable Fixed Expenses,212046,110608.0,58779,169387.0,42659.0,20.12,-0.04,Medium Risk
U706,2024,5,411657.0,Stable Salary & Stable Fixed Expenses,212046,110608.0,61314,171922.0,40124.0,18.92,0.03,Medium Risk
U706,2024,6,451781.0,Stable Salary & Stable Fixed Expenses,212046,110608.0,57990,168598.0,43448.0,20.49,-0.04,Medium Risk
U706,2024,7,495229.0,Stable Salary & Stable Fixed Expenses,212046,110608.0,52460,163068.0,48978.0,23.1,-0.03,Medium Risk
U706,2024,8,544207.0,Stable Salary & Stable Fixed Expenses,212046,110608.0,43578,154186.0,57860.0,27.29,-0.02,Low Risk
U706,2024,9,602067.0,Stable Salary & Stable Fixed Expenses,212046,110608.0,69760,180368.0,31678.0,14.94,0.01,High Risk
U706,2024,10,633745.0,Stable Salary & Stable Fixed Expenses,212046,110608.0,58889,169497.0,42549.0,20.07,0.02,Medium Risk
U706,2024,11,676294.0,Stable Salary & Stable Fixed Expenses,212046,110608.0,58563,169171.0,42875.0,20.22,0.02,Medium Risk
U706,2024,12,719169.0,Stable Salary & Stable Fixed Expenses,212046,110608.0,53189,163797.0,48249.0,22.75,-0.01,Medium Risk
U707,2024,1,208527.0,Stable Salary & Increasing Fixed Expenses,208057,67026.0,68934,135960.0,72097.0,34.65,-0.02,Low Risk
U707,2024,2,280624.0,Stable Salary & Increasing Fixed Expenses,208057,68282.0,103538,171820.0,36237.0,17.42,-0.01,Medium Risk
U707,2024,3,316861.0,Stable Salary & Increasing Fixed Expenses,208057,68282.0,85306,153588.0,54469.0,26.18,-0.04,Low Risk
U707,2024,4,371330.0,Stable Salary & Increasing Fixed Expenses,208057,68282.0,99394,167676.0,40381.0,19.41,-0.0,Medium Risk
U707,2024,5,411711.0,Stable Salary & Increasing Fixed Expenses,208057,68282.0,65060,133342.0,74715.0,35.91,-0.05,Low Risk
U707,2024,6,486426.0,Stable Salary & Increasing Fixed Expenses,208057,68282.0,95950,164232.0,43825.0,21.06,0.05,Medium Risk
U707,2024,7,530251.0,Stable Salary & Increasing Fixed Expenses,208057,68282.0,72514,140796.0,67261.0,32.33,-0.05,Low Risk
U707,2024,8,597512.0,Stable Salary & Increasing Fixed Expenses,208057,68282.0,89895,158177.0,49880.0,23.97,0.02,Medium Risk
U707,2024,9,647392.0,Stable Salary & Increasing Fixed Expenses,208057,68282.0,114890,183172.0,24885.0,11.96,0.01,High Risk
U707,2024,10,672277.0,Stable Salary & Increasing Fixed Expenses,208057,68282.0,97092,165374.0,42683.0,20.52,0.05,Medium Risk
U707,2024,11,714960.0,Stable Salary & Increasing Fixed Expenses,208057,69822.0,100562,170384.0,37673.0,18.11,0.02,Medium Risk
U707,2024,12,752633.0,Stable Salary & Increasing Fixed Expenses,208057,69822.0,97260,167082.0,40975.0,19.69,-0.0,Medium Risk
U708,2024,1,132939.0,Salary Increases & Fixed Expenses Remain Stable,66884,24867.0,18618,43485.0,23399.0,34.98,0.03,Low Risk
U708,2024,2,156338.0,Salary Increases & Fixed Expenses Remain Stable,66884,24867.0,17086,41953.0,24931.0,37.27,0.02,Low Risk
U708,2024,3,181269.0,Salary Increases & Fixed Expenses Remain Stable,66884,24867.0,20694,45561.0,21323.0,31.88,-0.01,Low Risk
U708,2024,4,202592.0,Salary Increases & Fixed Expenses Remain Stable,66884,24867.0,16871,41738.0,25146.0,37.6,0.01,Low Risk
U708,2024,5,227738.0,Salary Increases & Fixed Expenses Remain Stable,84951,24867.0,18577,43444.0,41507.0,48.86,-0.02,Low Risk
U708,2024,6,269245.0,Salary Increases & Fixed Expenses Remain Stable,84951,24867.0,24753,49620.0,35331.0,41.59,-0.0,Low Risk
U708,2024,7,304576.0,Salary Increases & Fixed Expenses Remain Stable,84951,24867.0,17622,42489.0,42462.0,49.98,0.04,Low Risk
U708,2024,8,347038.0,Salary Increases & Fixed Expenses Remain Stable,84951,24867.0,22311,47178.0,37773.0,44.46,-0.03,Low Risk
U708,2024,9,384811.0,Salary Increases & Fixed Expenses Remain Stable,84951,24867.0,24802,49669.0,35282.0,41.53,0.0,Low Risk
U708,2024,10,420093.0,Salary Increases & Fixed Expenses Remain Stable,84951,24867.0,25054,49921.0,35030.0,41.24,0.02,Low Risk
U708,2024,11,455123.0,Salary Increases & Fixed Expenses Remain Stable,84951,24867.0,21020,45887.0,39064.0,45.98,0.03,Low Risk
U708,2024,12,494187.0,Salary Increases & Fixed Expenses Remain Stable,84951,24867.0,29175,54042.0,30909.0,36.38,-0.03,Low Risk
U709,2024,1,208350.0,Salary Increases & Fixed Expenses Remain Stable,200965,73807.0,55990,129797.0,71168.0,35.41,-0.01,Low Risk
U709,2024,2,279518.0,Salary Increases & Fixed Expenses Remain Stable,200965,73807.0,44027,117834.0,83131.0,41.37,0.0,Low Risk
U709,2024,3,362649.0,Salary Increases & Fixed Expenses Remain Stable,200965,73807.0,50986,124793.0,76172.0,37.9,0.04,Low Risk
U709,2024,4,438821.0,Salary Increases & Fixed Expenses Remain Stable,200965,73807.0,51032,124839.0,76126.0,37.88,-0.03,Low Risk
U709,2024,5,514947.0,Salary Increases & Fixed Expenses Remain Stable,200965,73807.0,42783,116590.0,84375.0,41.98,0.04,Low Risk
U709,2024,6,599322.0,Salary Increases & Fixed Expenses Remain Stable,207577,73807.0,53428,127235.0,80342.0,38.7,-0.04,Low Risk
U709,2024,7,679664.0,Salary Increases & Fixed Expenses Remain Stable,207577,73807.0,52890,126697.0,80880.0,38.96,0.05,Low Risk
U709,2024,8,760544.0,Salary Increases & Fixed Expenses Remain Stable,207577,73807.0,44126,117933.0,89644.0,43.19,-0.04,Low Risk
U709,2024,9,850188.0,Salary Increases & Fixed Expenses Remain Stable,207577,73807.0,51582,125389.0,82188.0,39.59,0.02,Low Risk
U709,2024,10,932376.0,Salary Increases & Fixed Expenses Remain Stable,207577,73807.0,48478,122285.0,85292.0,41.09,0.03,Low Risk
U709,2024,11,1017668.0,Salary Increases & Fixed Expenses Remain Stable,207577,73807.0,59990,133797.0,73780.0,35.54,0.04,Low Risk
U709,2024,12,1091448.0,Salary Increases & Fixed Expenses Remain Stable,207577,73807.0,60292,134099.0,73478.0,35.4,0.04,Low Risk
U710,2024,1,203300.0,Salary Increases & Fixed Expenses Remain Stable,108427,77131.0,49694,126825.0,-18398.0,-16.97,0.05,High Risk
U710,2024,2,184902.0,Salary Increases & Fixed Expenses Remain Stable,108427,77131.0,51266,128397.0,-19970.0,-18.42,0.02,High Risk
U710,2024,3,164932.0,Salary Increases & Fixed Expenses Remain Stable,108427,77131.0,47295,124426.0,-15999.0,-14.76,-0.03,High Risk
U710,2024,4,148933.0,Salary Increases & Fixed Expenses Remain Stable,123450,77131.0,39504,116635.0,6815.0,5.52,0.01,High Risk
U710,2024,5,155748.0,Salary Increases & Fixed Expenses Remain Stable,123450,77131.0,48415,125546.0,-2096.0,-1.7,-0.02,High Risk
U710,2024,6,153652.0,Salary Increases & Fixed Expenses Remain Stable,123450,77131.0,45028,122159.0,1291.0,1.05,-0.04,High Risk
U710,2024,7,154943.0,Salary Increases & Fixed Expenses Remain Stable,123450,77131.0,60813,137944.0,-14494.0,-11.74,0.01,High Risk
U710,2024,8,140449.0,Salary Increases & Fixed Expenses Remain Stable,123450,77131.0,40073,117204.0,6246.0,5.06,0.03,High Risk
U710,2024,9,146695.0,Salary Increases & Fixed Expenses Remain Stable,123450,77131.0,53899,131030.0,-7580.0,-6.14,-0.01,High Risk
U710,2024,10,139115.0,Salary Increases & Fixed Expenses Remain Stable,123450,77131.0,48056,125187.0,-1737.0,-1.41,0.01,High Risk
U710,2024,11,137378.0,Salary Increases & Fixed Expenses Remain Stable,123450,77131.0,52329,129460.0,-6010.0,-4.87,-0.05,High Risk
U710,2024,12,131368.0,Salary Increases & Fixed Expenses Remain Stable,123450,77131.0,62998,140129.0,-16679.0,-13.51,-0.01,High Risk
U711,2024,1,92163.0,Stable Salary & Stable Fixed Expenses,54478,25445.0,22877,48322.0,6156.0,11.3,-0.05,High Risk
U711,2024,2,98319.0,Stable Salary & Stable Fixed Expenses,54478,25445.0,16646,42091.0,12387.0,22.74,0.03,Medium Risk
U711,2024,3,110706.0,Stable Salary & Stable Fixed Expenses,54478,25445.0,18676,44121.0,10357.0,19.01,0.05,Medium Risk
U711,2024,4,121063.0,Stable Salary & Stable Fixed Expenses,54478,25445.0,25976,51421.0,3057.0,5.61,0.04,High Risk
U711,2024,5,124120.0,Stable Salary & Stable Fixed Expenses,54478,25445.0,23393,48838.0,5640.0,10.35,0.04,High Risk
U711,2024,6,129760.0,Stable Salary & Stable Fixed Expenses,54478,25445.0,18654,44099.0,10379.0,19.05,0.03,Medium Risk
U711,2024,7,140139.0,Stable Salary & Stable Fixed Expenses,54478,25445.0,22790,48235.0,6243.0,11.46,0.0,High Risk
U711,2024,8,146382.0,Stable Salary & Stable Fixed Expenses,54478,25445.0,26597,52042.0,2436.0,4.47,-0.0,High Risk
U711,2024,9,148818.0,Stable Salary & Stable Fixed Expenses,54478,25445.0,27582,53027.0,1451.0,2.66,0.01,High Risk
U711,2024,10,150269.0,Stable Salary & Stable Fixed Expenses,54478,25445.0,18978,44423.0,10055.0,18.46,0.02,Medium Risk
U711,2024,11,160324.0,Stable Salary & Stable Fixed Expenses,54478,25445.0,25561,51006.0,3472.0,6.37,-0.04,High Risk
U711,2024,12,163796.0,Stable Salary & Stable Fixed Expenses,54478,25445.0,22737,48182.0,6296.0,11.56,-0.01,High Risk
U712,2024,1,242652.0,Stable Salary & Increasing Fixed Expenses,219258,78008.0,119603,197611.0,21647.0,9.87,-0.02,High Risk
U712,2024,2,264299.0,Stable Salary & Increasing Fixed Expenses,219258,79841.0,134315,214156.0,5102.0,2.33,-0.04,High Risk
U712,2024,3,269401.0,Stable Salary & Increasing Fixed Expenses,219258,79841.0,155669,235510.0,-16252.0,-7.41,0.03,High Risk
U712,2024,4,253149.0,Stable Salary & Increasing Fixed Expenses,219258,79841.0,129101,208942.0,10316.0,4.7,0.04,High Risk
U712,2024,5,263465.0,Stable Salary & Increasing Fixed Expenses,219258,81530.0,139225,220755.0,-1497.0,-0.68,0.03,High Risk
U712,2024,6,261968.0,Stable Salary & Increasing Fixed Expenses,219258,83008.0,141640,224648.0,-5390.0,-2.46,0.02,High Risk
U712,2024,7,256578.0,Stable Salary & Increasing Fixed Expenses,219258,83008.0,121663,204671.0,14587.0,6.65,-0.02,High Risk
U712,2024,8,271165.0,Stable Salary & Increasing Fixed Expenses,219258,83008.0,148966,231974.0,-12716.0,-5.8,-0.0,High Risk
U712,2024,9,258449.0,Stable Salary & Increasing Fixed Expenses,219258,83008.0,140791,223799.0,-4541.0,-2.07,0.0,High Risk
U712,2024,10,253908.0,Stable Salary & Increasing Fixed Expenses,219258,83008.0,156646,239654.0,-20396.0,-9.3,0.04,High Risk
U712,2024,11,233512.0,Stable Salary & Increasing Fixed Expenses,219258,83008.0,162353,245361.0,-26103.0,-11.91,0.04,High Risk
U712,2024,12,207409.0,Stable Salary & Increasing Fixed Expenses,219258,83008.0,141600,224608.0,-5350.0,-2.44,-0.02,High Risk
U713,2024,1,237544.0,Stable Salary & Stable Fixed Expenses,141742,49524.0,51684,101208.0,40534.0,28.6,-0.0,Low Risk
U713,2024,2,278078.0,Stable Salary & Stable Fixed Expenses,141742,49524.0,56322,105846.0,35896.0,25.32,0.02,Low Risk
U713,2024,3,313974.0,Stable Salary & Stable Fixed Expenses,141742,49524.0,56939,106463.0,35279.0,24.89,0.05,Medium Risk
U713,2024,4,349253.0,Stable Salary & Stable Fixed Expenses,141742,49524.0,43129,92653.0,49089.0,34.63,0.02,Low Risk
U713,2024,5,398342.0,Stable Salary & Stable Fixed Expenses,141742,49524.0,49639,99163.0,42579.0,30.04,-0.03,Low Risk
U713,2024,6,440921.0,Stable Salary & Stable Fixed Expenses,141742,49524.0,66371,115895.0,25847.0,18.24,-0.02,Medium Risk
U713,2024,7,466768.0,Stable Salary & Stable Fixed Expenses,141742,49524.0,49486,99010.0,42732.0,30.15,-0.03,Low Risk
U713,2024,8,509500.0,Stable Salary & Stable Fixed Expenses,141742,49524.0,63140,112664.0,29078.0,20.51,-0.02,Medium Risk
U713,2024,9,538578.0,Stable Salary & Stable Fixed Expenses,141742,49524.0,64112,113636.0,28106.0,19.83,-0.01,Medium Risk
U713,2024,10,566684.0,Stable Salary & Stable Fixed Expenses,141742,49524.0,53367,102891.0,38851.0,27.41,-0.04,Low Risk
U713,2024,11,605535.0,Stable Salary & Stable Fixed Expenses,141742,49524.0,70764,120288.0,21454.0,15.14,-0.03,Medium Risk
U713,2024,12,626989.0,Stable Salary & Stable Fixed Expenses,141742,49524.0,53914,103438.0,38304.0,27.02,-0.02,Low Risk
U714,2024,1,204118.0,Salary Increases & Fixed Expenses Remain Stable,159384,51138.0,62370,113508.0,45876.0,28.78,-0.0,Low Risk
U714,2024,2,249994.0,Salary Increases & Fixed Expenses Remain Stable,159384,51138.0,57844,108982.0,50402.0,31.62,-0.03,Low Risk
U714,2024,3,300396.0,Salary Increases & Fixed Expenses Remain Stable,180351,51138.0,90053,141191.0,39160.0,21.71,-0.01,Medium Risk
U714,2024,4,339556.0,Salary Increases & Fixed Expenses Remain Stable,180351,51138.0,54703,105841.0,74510.0,41.31,0.03,Low Risk
U714,2024,5,414066.0,Salary Increases & Fixed Expenses Remain Stable,180351,51138.0,63024,114162.0,66189.0,36.7,-0.04,Low Risk
U714,2024,6,480255.0,Salary Increases & Fixed Expenses Remain Stable,180351,51138.0,75978,127116.0,53235.0,29.52,-0.05,Low Risk
U714,2024,7,533490.0,Salary Increases & Fixed Expenses Remain Stable,180351,51138.0,73907,125045.0,55306.0,30.67,-0.04,Low Risk
U714,2024,8,588796.0,Salary Increases & Fixed Expenses Remain Stable,180351,51138.0,76730,127868.0,52483.0,29.1,0.03,Low Risk
U714,2024,9,641279.0,Salary Increases & Fixed Expenses Remain Stable,180351,51138.0,78279,129417.0,50934.0,28.24,0.04,Low Risk
U714,2024,10,692213.0,Salary Increases & Fixed Expenses Remain Stable,180351,51138.0,85974,137112.0,43239.0,23.97,-0.02,Medium Risk
U714,2024,11,735452.0,Salary Increases & Fixed Expenses Remain Stable,180351,51138.0,66512,117650.0,62701.0,34.77,-0.04,Low Risk
U714,2024,12,798153.0,Salary Increases & Fixed Expenses Remain Stable,180351,51138.0,69579,120717.0,59634.0,33.07,-0.04,Low Risk
U715,2024,1,113664.0,Salary Increases & Fixed Expenses Remain Stable,78162,29169.0,28420,57589.0,20573.0,26.32,0.03,Low Risk
U715,2024,2,134237.0,Salary Increases & Fixed Expenses Remain Stable,78162,29169.0,34403,63572.0,14590.0,18.67,0.01,Medium Risk
U715,2024,3,148827.0,Salary Increases & Fixed Expenses Remain Stable,78162,29169.0,37137,66306.0,11856.0,15.17,0.01,Medium Risk
U715,2024,4,160683.0,Salary Increases & Fixed Expenses Remain Stable,78162,29169.0,25120,54289.0,23873.0,30.54,0.04,Low Risk
U715,2024,5,184556.0,Salary Increases & Fixed Expenses Remain Stable,78162,29169.0,36405,65574.0,12588.0,16.11,0.03,Medium Risk
U715,2024,6,197144.0,Salary Increases & Fixed Expenses Remain Stable,102924,29169.0,42747,71916.0,31008.0,30.13,-0.02,Low Risk
U715,2024,7,228152.0,Salary Increases & Fixed Expenses Remain Stable,102924,29169.0,42490,71659.0,31265.0,30.38,-0.0,Low Risk
U715,2024,8,259417.0,Salary Increases & Fixed Expenses Remain Stable,102924,29169.0,44621,73790.0,29134.0,28.31,-0.04,Low Risk
U715,2024,9,288551.0,Salary Increases & Fixed Expenses Remain Stable,102924,29169.0,35421,64590.0,38334.0,37.24,0.0,Low Risk
U715,2024,10,326885.0,Salary Increases & Fixed Expenses Remain Stable,102924,29169.0,47805,76974.0,25950.0,25.21,-0.01,Low Risk
U715,2024,11,352835.0,Salary Increases & Fixed Expenses Remain Stable,102924,29169.0,43476,72645.0,30279.0,29.42,-0.01,Low Risk
U715,2024,12,383114.0,Salary Increases & Fixed Expenses Remain Stable,102924,29169.0,33796,62965.0,39959.0,38.82,0.01,Low Risk
U716,2024,1,250000.0,Salary Increases & Fixed Expenses Remain Stable,294996,94119.0,65768,159887.0,135109.0,45.8,0.0,Low Risk
U716,2024,2,385109.0,Salary Increases & Fixed Expenses Remain Stable,294996,94119.0,59396,153515.0,141481.0,47.96,-0.03,Low Risk
U716,2024,3,526590.0,Salary Increases & Fixed Expenses Remain Stable,294996,94119.0,84512,178631.0,116365.0,39.45,-0.04,Low Risk
U716,2024,4,642955.0,Salary Increases & Fixed Expenses Remain Stable,294996,94119.0,78140,172259.0,122737.0,41.61,0.0,Low Risk
U716,2024,5,765692.0,Salary Increases & Fixed Expenses Remain Stable,294996,94119.0,75371,169490.0,125506.0,42.54,-0.03,Low Risk
U716,2024,6,891198.0,Salary Increases & Fixed Expenses Remain Stable,294996,94119.0,67925,162044.0,132952.0,45.07,-0.03,Low Risk
U716,2024,7,1024150.0,Salary Increases & Fixed Expenses Remain Stable,316195,94119.0,66346,160465.0,155730.0,49.25,0.05,Low Risk
U716,2024,8,1179880.0,Salary Increases & Fixed Expenses Remain Stable,316195,94119.0,77571,171690.0,144505.0,45.7,-0.0,Low Risk
U716,2024,9,1324385.0,Salary Increases & Fixed Expenses Remain Stable,316195,94119.0,79597,173716.0,142479.0,45.06,-0.02,Low Risk
U716,2024,10,1466864.0,Salary Increases & Fixed Expenses Remain Stable,316195,94119.0,63642,157761.0,158434.0,50.11,-0.02,Low Risk
U716,2024,11,1625298.0,Salary Increases & Fixed Expenses Remain Stable,316195,94119.0,73358,167477.0,148718.0,47.03,0.01,Low Risk
U716,2024,12,1774016.0,Salary Increases & Fixed Expenses Remain Stable,316195,94119.0,82584,176703.0,139492.0,44.12,-0.02,Low Risk
U717,2024,1,113369.0,Stable Salary & Increasing Fixed Expenses,28537,17045.0,9195,26240.0,2297.0,8.05,0.03,High Risk
U717,2024,2,115666.0,Stable Salary & Increasing Fixed Expenses,28537,17045.0,12518,29563.0,-1026.0,-3.6,0.03,High Risk
U717,2024,3,114640.0,Stable Salary & Increasing Fixed Expenses,28537,17045.0,9433,26478.0,2059.0,7.22,-0.02,High Risk
U717,2024,4,116699.0,Stable Salary & Increasing Fixed Expenses,28537,17045.0,13323,30368.0,-1831.0,-6.42,0.03,High Risk
U717,2024,5,114868.0,Stable Salary & Increasing Fixed Expenses,28537,17045.0,9325,26370.0,2167.0,7.59,0.0,High Risk
U717,2024,6,117035.0,Stable Salary & Increasing Fixed Expenses,28537,17045.0,12712,29757.0,-1220.0,-4.28,-0.04,High Risk
U717,2024,7,115815.0,Stable Salary & Increasing Fixed Expenses,28537,17045.0,13911,30956.0,-2419.0,-8.48,-0.03,High Risk
U717,2024,8,113396.0,Stable Salary & Increasing Fixed Expenses,28537,17045.0,12470,29515.0,-978.0,-3.43,-0.03,High Risk
U717,2024,9,112418.0,Stable Salary & Increasing Fixed Expenses,28537,17045.0,14939,31984.0,-3447.0,-12.08,0.0,High Risk
U717,2024,10,108971.0,Stable Salary & Increasing Fixed Expenses,28537,17045.0,9985,27030.0,1507.0,5.28,0.02,High Risk
U717,2024,11,110478.0,Stable Salary & Increasing Fixed Expenses,28537,17045.0,12195,29240.0,-703.0,-2.46,0.01,High Risk
U717,2024,12,109775.0,Stable Salary & Increasing Fixed Expenses,28537,17045.0,10264,27309.0,1228.0,4.3,-0.03,High Risk
U718,2024,1,232783.0,Stable Salary & Stable Fixed Expenses,97554,34260.0,34547,68807.0,28747.0,29.47,-0.04,Low Risk
U718,2024,2,261530.0,Stable Salary & Stable Fixed Expenses,97554,34260.0,31274,65534.0,32020.0,32.82,0.01,Low Risk
U718,2024,3,293550.0,Stable Salary & Stable Fixed Expenses,97554,34260.0,33330,67590.0,29964.0,30.72,-0.02,Low Risk
U718,2024,4,323514.0,Stable Salary & Stable Fixed Expenses,97554,34260.0,44683,78943.0,18611.0,19.08,-0.01,Medium Risk
U718,2024,5,342125.0,Stable Salary & Stable Fixed Expenses,97554,34260.0,42900,77160.0,20394.0,20.91,-0.03,Medium Risk
U718,2024,6,362519.0,Stable Salary & Stable Fixed Expenses,97554,34260.0,42854,77114.0,20440.0,20.95,-0.04,Medium Risk
U718,2024,7,382959.0,Stable Salary & Stable Fixed Expenses,97554,34260.0,42677,76937.0,20617.0,21.13,-0.01,Medium Risk
U718,2024,8,403576.0,Stable Salary & Stable Fixed Expenses,97554,34260.0,43474,77734.0,19820.0,20.32,-0.01,Medium Risk
U718,2024,9,423396.0,Stable Salary & Stable Fixed Expenses,97554,34260.0,43411,77671.0,19883.0,20.38,-0.03,Medium Risk
U718,2024,10,443279.0,Stable Salary & Stable Fixed Expenses,97554,34260.0,48209,82469.0,15085.0,15.46,0.02,Medium Risk
U718,2024,11,458364.0,Stable Salary & Stable Fixed Expenses,97554,34260.0,37114,71374.0,26180.0,26.84,-0.03,Low Risk
U718,2024,12,484544.0,Stable Salary & Stable Fixed Expenses,97554,34260.0,32750,67010.0,30544.0,31.31,0.01,Low Risk
U719,2024,1,247270.0,Stable Salary & Increasing Fixed Expenses,238295,76017.0,135051,211068.0,27227.0,11.43,-0.0,High Risk
U719,2024,2,274497.0,Stable Salary & Increasing Fixed Expenses,238295,76017.0,152956,228973.0,9322.0,3.91,0.04,High Risk
U719,2024,3,283819.0,Stable Salary & Increasing Fixed Expenses,238295,76017.0,172927,248944.0,-10649.0,-4.47,0.02,High Risk
U719,2024,4,273170.0,Stable Salary & Increasing Fixed Expenses,238295,76017.0,145018,221035.0,17260.0,7.24,-0.03,High Risk
U719,2024,5,290430.0,Stable Salary & Increasing Fixed Expenses,238295,76017.0,142298,218315.0,19980.0,8.38,-0.0,High Risk
U719,2024,6,310410.0,Stable Salary & Increasing Fixed Expenses,238295,76017.0,143163,219180.0,19115.0,8.02,-0.02,High Risk
U719,2024,7,329525.0,Stable Salary & Increasing Fixed Expenses,238295,76017.0,123331,199348.0,38947.0,16.34,0.01,Medium Risk
U719,2024,8,368472.0,Stable Salary & Increasing Fixed Expenses,238295,76017.0,134632,210649.0,27646.0,11.6,0.01,High Risk
U719,2024,9,396118.0,Stable Salary & Increasing Fixed Expenses,238295,76017.0,148543,224560.0,13735.0,5.76,-0.01,High Risk
U719,2024,10,409853.0,Stable Salary & Increasing Fixed Expenses,238295,76017.0,198653,274670.0,-36375.0,-15.26,0.04,High Risk
U719,2024,11,373478.0,Stable Salary & Increasing Fixed Expenses,238295,76017.0,171739,247756.0,-9461.0,-3.97,-0.02,High Risk
U719,2024,12,364017.0,Stable Salary & Increasing Fixed Expenses,238295,76017.0,205850,281867.0,-43572.0,-18.28,-0.04,High Risk
U720,2024,1,192428.0,Stable Salary & Stable Fixed Expenses,34891,18450.0,17366,35816.0,-925.0,-2.65,0.03,High Risk
U720,2024,2,191503.0,Stable Salary & Stable Fixed Expenses,34891,18450.0,16770,35220.0,-329.0,-0.94,0.04,High Risk
U720,2024,3,191174.0,Stable Salary & Stable Fixed Expenses,34891,18450.0,16606,35056.0,-165.0,-0.47,-0.01,High Risk
U720,2024,4,191009.0,Stable Salary & Stable Fixed Expenses,34891,18450.0,11182,29632.0,5259.0,15.07,0.01,Medium Risk
U720,2024,5,196268.0,Stable Salary & Stable Fixed Expenses,34891,18450.0,10793,29243.0,5648.0,16.19,0.01,Medium Risk
U720,2024,6,201916.0,Stable Salary & Stable Fixed Expenses,34891,18450.0,10714,29164.0,5727.0,16.41,0.04,Medium Risk
U720,2024,7,207643.0,Stable Salary & Stable Fixed Expenses,34891,18450.0,13511,31961.0,2930.0,8.4,0.03,High Risk
U720,2024,8,210573.0,Stable Salary & Stable Fixed Expenses,34891,18450.0,10981,29431.0,5460.0,15.65,0.04,Medium Risk
U720,2024,9,216033.0,Stable Salary & Stable Fixed Expenses,34891,18450.0,18427,36877.0,-1986.0,-5.69,-0.02,High Risk
U720,2024,10,214047.0,Stable Salary & Stable Fixed Expenses,34891,18450.0,16316,34766.0,125.0,0.36,0.01,High Risk
U720,2024,11,214172.0,Stable Salary & Stable Fixed Expenses,34891,18450.0,15983,34433.0,458.0,1.31,0.04,High Risk
U720,2024,12,214630.0,Stable Salary & Stable Fixed Expenses,34891,18450.0,12900,31350.0,3541.0,10.15,-0.01,High Risk
U721,2024,1,200674.0,Stable Salary & Stable Fixed Expenses,182422,66660.0,47980,114640.0,67782.0,37.16,0.03,Low Risk
U721,2024,2,268456.0,Stable Salary & Stable Fixed Expenses,182422,66660.0,53674,120334.0,62088.0,34.04,0.04,Low Risk
U721,2024,3,330544.0,Stable Salary & Stable Fixed Expenses,182422,66660.0,55084,121744.0,60678.0,33.26,-0.04,Low Risk
U721,2024,4,391222.0,Stable Salary & Stable Fixed Expenses,182422,66660.0,51645,118305.0,64117.0,35.15,0.04,Low Risk
U721,2024,5,455339.0,Stable Salary & Stable Fixed Expenses,182422,66660.0,42979,109639.0,72783.0,39.9,-0.04,Low Risk
U721,2024,6,528122.0,Stable Salary & Stable Fixed Expenses,182422,66660.0,52253,118913.0,63509.0,34.81,0.05,Low Risk
U721,2024,7,591631.0,Stable Salary & Stable Fixed Expenses,182422,66660.0,54118,120778.0,61644.0,33.79,0.05,Low Risk
U721,2024,8,653275.0,Stable Salary & Stable Fixed Expenses,182422,66660.0,46717,113377.0,69045.0,37.85,-0.01,Low Risk
U721,2024,9,722320.0,Stable Salary & Stable Fixed Expenses,182422,66660.0,42492,109152.0,73270.0,40.17,0.02,Low Risk
U721,2024,10,795590.0,Stable Salary & Stable Fixed Expenses,182422,66660.0,45767,112427.0,69995.0,38.37,0.02,Low Risk
U721,2024,11,865585.0,Stable Salary & Stable Fixed Expenses,182422,66660.0,45516,112176.0,70246.0,38.51,-0.04,Low Risk
U721,2024,12,935831.0,Stable Salary & Stable Fixed Expenses,182422,66660.0,65859,132519.0,49903.0,27.36,0.03,Low Risk
U722,2024,1,161258.0,Stable Salary & Stable Fixed Expenses,125416,54307.0,62391,116698.0,8718.0,6.95,0.03,High Risk
U722,2024,2,169976.0,Stable Salary & Stable Fixed Expenses,125416,54307.0,54390,108697.0,16719.0,13.33,-0.0,High Risk
U722,2024,3,186695.0,Stable Salary & Stable Fixed Expenses,125416,54307.0,39694,94001.0,31415.0,25.05,0.03,Low Risk
U722,2024,4,218110.0,Stable Salary & Stable Fixed Expenses,125416,54307.0,58015,112322.0,13094.0,10.44,0.04,High Risk
U722,2024,5,231204.0,Stable Salary & Stable Fixed Expenses,125416,54307.0,56925,111232.0,14184.0,11.31,-0.03,High Risk
U722,2024,6,245388.0,Stable Salary & Stable Fixed Expenses,125416,54307.0,43322,97629.0,27787.0,22.16,-0.03,Medium Risk
U722,2024,7,273175.0,Stable Salary & Stable Fixed Expenses,125416,54307.0,57940,112247.0,13169.0,10.5,0.05,High Risk
U722,2024,8,286344.0,Stable Salary & Stable Fixed Expenses,125416,54307.0,41391,95698.0,29718.0,23.7,-0.0,Medium Risk
U722,2024,9,316062.0,Stable Salary & Stable Fixed Expenses,125416,54307.0,66312,120619.0,4797.0,3.82,-0.02,High Risk
U722,2024,10,320859.0,Stable Salary & Stable Fixed Expenses,125416,54307.0,48485,102792.0,22624.0,18.04,-0.05,Medium Risk
U722,2024,11,343483.0,Stable Salary & Stable Fixed Expenses,125416,54307.0,55883,110190.0,15226.0,12.14,0.02,High Risk
U722,2024,12,358709.0,Stable Salary & Stable Fixed Expenses,125416,54307.0,44837,99144.0,26272.0,20.95,0.0,Medium Risk
U723,2024,1,229767.0,Salary Increases & Fixed Expenses Remain Stable,228160,101298.0,113912,215210.0,12950.0,5.68,0.05,High Risk
U723,2024,2,242717.0,Salary Increases & Fixed Expenses Remain Stable,228160,101298.0,89207,190505.0,37655.0,16.5,-0.02,Medium Risk
U723,2024,3,280372.0,Salary Increases & Fixed Expenses Remain Stable,228160,101298.0,109016,210314.0,17846.0,7.82,-0.01,High Risk
U723,2024,4,298218.0,Salary Increases & Fixed Expenses Remain Stable,228160,101298.0,107407,208705.0,19455.0,8.53,0.03,High Risk
U723,2024,5,317673.0,Salary Increases & Fixed Expenses Remain Stable,228160,101298.0,112442,213740.0,14420.0,6.32,-0.04,High Risk
U723,2024,6,332093.0,Salary Increases & Fixed Expenses Remain Stable,228160,101298.0,91303,192601.0,35559.0,15.59,-0.05,Medium Risk
U723,2024,7,367652.0,Salary Increases & Fixed Expenses Remain Stable,228160,101298.0,111342,212640.0,15520.0,6.8,0.02,High Risk
U723,2024,8,383172.0,Salary Increases & Fixed Expenses Remain Stable,248679,101298.0,120875,222173.0,26506.0,10.66,0.01,High Risk
U723,2024,9,409678.0,Salary Increases & Fixed Expenses Remain Stable,248679,101298.0,120652,221950.0,26729.0,10.75,-0.04,High Risk
U723,2024,10,436407.0,Salary Increases & Fixed Expenses Remain Stable,248679,101298.0,120545,221843.0,26836.0,10.79,0.0,High Risk
U723,2024,11,463243.0,Salary Increases & Fixed Expenses Remain Stable,248679,101298.0,122914,224212.0,24467.0,9.84,-0.01,High Risk
U723,2024,12,487710.0,Salary Increases & Fixed Expenses Remain Stable,248679,101298.0,120784,222082.0,26597.0,10.7,0.04,High Risk
U724,2024,1,250000.0,Stable Salary & Decreasing Fixed Expenses,280215,81029.0,121424,202453.0,77762.0,27.75,-0.04,Low Risk
U724,2024,2,327762.0,Stable Salary & Decreasing Fixed Expenses,280215,81029.0,103081,184110.0,96105.0,34.3,-0.03,Low Risk
U724,2024,3,423867.0,Stable Salary & Decreasing Fixed Expenses,280215,81029.0,103495,184524.0,95691.0,34.15,0.03,Low Risk
U724,2024,4,519558.0,Stable Salary & Decreasing Fixed Expenses,280215,81029.0,124315,205344.0,74871.0,26.72,-0.04,Low Risk
U724,2024,5,594429.0,Stable Salary & Decreasing Fixed Expenses,280215,81029.0,123005,204034.0,76181.0,27.19,0.01,Low Risk
U724,2024,6,670610.0,Stable Salary & Decreasing Fixed Expenses,280215,81029.0,109813,190842.0,89373.0,31.89,0.02,Low Risk
U724,2024,7,759983.0,Stable Salary & Decreasing Fixed Expenses,280215,81029.0,106912,187941.0,92274.0,32.93,-0.04,Low Risk
U724,2024,8,852257.0,Stable Salary & Decreasing Fixed Expenses,280215,81029.0,106352,187381.0,92834.0,33.13,-0.04,Low Risk
U724,2024,9,945091.0,Stable Salary & Decreasing Fixed Expenses,280215,81029.0,98361,179390.0,100825.0,35.98,-0.03,Low Risk
U724,2024,10,1045916.0,Stable Salary & Decreasing Fixed Expenses,280215,81029.0,104999,186028.0,94187.0,33.61,0.03,Low Risk
U724,2024,11,1140103.0,Stable Salary & Decreasing Fixed Expenses,280215,81029.0,135352,216381.0,63834.0,22.78,-0.04,Medium Risk
U724,2024,12,1203937.0,Stable Salary & Decreasing Fixed Expenses,280215,81029.0,107167,188196.0,92019.0,32.84,0.01,Low Risk
U725,2024,1,91628.0,Stable Salary & Decreasing Fixed Expenses,38929,15130.0,25263,40393.0,-1464.0,-3.76,0.05,High Risk
U725,2024,2,90164.0,Stable Salary & Decreasing Fixed Expenses,38929,15130.0,23731,38861.0,68.0,0.17,-0.04,High Risk
U725,2024,3,90232.0,Stable Salary & Decreasing Fixed Expenses,38929,15130.0,25024,40154.0,-1225.0,-3.15,-0.02,High Risk
U725,2024,4,89007.0,Stable Salary & Decreasing Fixed Expenses,38929,15130.0,22562,37692.0,1237.0,3.18,-0.01,High Risk
U725,2024,5,90244.0,Stable Salary & Decreasing Fixed Expenses,38929,15130.0,19685,34815.0,4114.0,10.57,-0.0,High Risk
U725,2024,6,94358.0,Stable Salary & Decreasing Fixed Expenses,38929,15130.0,25752,40882.0,-1953.0,-5.02,-0.01,High Risk
U725,2024,7,92405.0,Stable Salary & Decreasing Fixed Expenses,38929,13964.0,20440,34404.0,4525.0,11.62,0.02,High Risk
U725,2024,8,96930.0,Stable Salary & Decreasing Fixed Expenses,38929,13964.0,19815,33779.0,5150.0,13.23,-0.01,High Risk
U725,2024,9,102080.0,Stable Salary & Decreasing Fixed Expenses,38929,13964.0,23859,37823.0,1106.0,2.84,-0.04,High Risk
U725,2024,10,103186.0,Stable Salary & Decreasing Fixed Expenses,38929,13964.0,20530,34494.0,4435.0,11.39,0.05,High Risk
U725,2024,11,107621.0,Stable Salary & Decreasing Fixed Expenses,38929,13964.0,26614,40578.0,-1649.0,-4.24,0.03,High Risk
U725,2024,12,105972.0,Stable Salary & Decreasing Fixed Expenses,38929,13964.0,22828,36792.0,2137.0,5.49,-0.02,High Risk
U726,2024,1,193336.0,Stable Salary & Stable Fixed Expenses,130631,56618.0,90639,147257.0,-16626.0,-12.73,0.03,High Risk
U726,2024,2,176710.0,Stable Salary & Stable Fixed Expenses,130631,56618.0,72618,129236.0,1395.0,1.07,-0.0,High Risk
U726,2024,3,178105.0,Stable Salary & Stable Fixed Expenses,130631,56618.0,74511,131129.0,-498.0,-0.38,0.04,High Risk
U726,2024,4,177607.0,Stable Salary & Stable Fixed Expenses,130631,56618.0,81309,137927.0,-7296.0,-5.59,0.05,High Risk
U726,2024,5,170311.0,Stable Salary & Stable Fixed Expenses,130631,56618.0,89331,145949.0,-15318.0,-11.73,-0.01,High Risk
U726,2024,6,154993.0,Stable Salary & Stable Fixed Expenses,130631,56618.0,80933,137551.0,-6920.0,-5.3,-0.01,High Risk
U726,2024,7,148073.0,Stable Salary & Stable Fixed Expenses,130631,56618.0,89062,145680.0,-15049.0,-11.52,-0.01,High Risk
U726,2024,8,133024.0,Stable Salary & Stable Fixed Expenses,130631,56618.0,82078,138696.0,-8065.0,-6.17,0.04,High Risk
U726,2024,9,124959.0,Stable Salary & Stable Fixed Expenses,130631,56618.0,92358,148976.0,-18345.0,-14.04,-0.04,High Risk
U726,2024,10,106614.0,Stable Salary & Stable Fixed Expenses,130631,56618.0,68749,125367.0,5264.0,4.03,-0.04,High Risk
U726,2024,11,111878.0,Stable Salary & Stable Fixed Expenses,130631,56618.0,100461,157079.0,-26448.0,-20.25,-0.05,High Risk
U726,2024,12,85430.0,Stable Salary & Stable Fixed Expenses,130631,56618.0,78777,135395.0,-4764.0,-3.65,0.02,High Risk
U727,2024,1,250000.0,Salary Increases & Fixed Expenses Remain Stable,290242,99533.0,147300,246833.0,43409.0,14.96,0.02,High Risk
U727,2024,2,293409.0,Salary Increases & Fixed Expenses Remain Stable,290242,99533.0,169438,268971.0,21271.0,7.33,-0.02,High Risk
U727,2024,3,314680.0,Salary Increases & Fixed Expenses Remain Stable,290242,99533.0,185024,284557.0,5685.0,1.96,0.02,High Risk
U727,2024,4,320365.0,Salary Increases & Fixed Expenses Remain Stable,290242,99533.0,162679,262212.0,28030.0,9.66,0.05,High Risk
U727,2024,5,348395.0,Salary Increases & Fixed Expenses Remain Stable,290242,99533.0,171119,270652.0,19590.0,6.75,0.04,High Risk
U727,2024,6,367985.0,Salary Increases & Fixed Expenses Remain Stable,290242,99533.0,193833,293366.0,-3124.0,-1.08,0.04,High Risk
U727,2024,7,364861.0,Salary Increases & Fixed Expenses Remain Stable,299424,99533.0,163890,263423.0,36001.0,12.02,0.03,High Risk
U727,2024,8,400862.0,Salary Increases & Fixed Expenses Remain Stable,299424,99533.0,169730,269263.0,30161.0,10.07,0.04,High Risk
U727,2024,9,431023.0,Salary Increases & Fixed Expenses Remain Stable,299424,99533.0,153547,253080.0,46344.0,15.48,-0.0,Medium Risk
U727,2024,10,477367.0,Salary Increases & Fixed Expenses Remain Stable,299424,99533.0,209254,308787.0,-9363.0,-3.13,0.03,High Risk
U727,2024,11,468004.0,Salary Increases & Fixed Expenses Remain Stable,299424,99533.0,183466,282999.0,16425.0,5.49,-0.02,High Risk
U727,2024,12,484429.0,Salary Increases & Fixed Expenses Remain Stable,299424,99533.0,173717,273250.0,26174.0,8.74,0.01,High Risk
U728,2024,1,242139.0,Salary Increases & Fixed Expenses Remain Stable,213617,113937.0,97725,211662.0,1955.0,0.92,0.03,High Risk
U728,2024,2,244094.0,Salary Increases & Fixed Expenses Remain Stable,213617,113937.0,75093,189030.0,24587.0,11.51,-0.04,High Risk
U728,2024,3,268681.0,Salary Increases & Fixed Expenses Remain Stable,213617,113937.0,81528,195465.0,18152.0,8.5,0.0,High Risk
U728,2024,4,286833.0,Salary Increases & Fixed Expenses Remain Stable,213617,113937.0,90277,204214.0,9403.0,4.4,-0.04,High Risk
U728,2024,5,296236.0,Salary Increases & Fixed Expenses Remain Stable,213617,113937.0,98432,212369.0,1248.0,0.58,0.03,High Risk
U728,2024,6,297484.0,Salary Increases & Fixed Expenses Remain Stable,213617,113937.0,87578,201515.0,12102.0,5.67,0.01,High Risk
U728,2024,7,309586.0,Salary Increases & Fixed Expenses Remain Stable,233205,113937.0,92002,205939.0,27266.0,11.69,0.0,High Risk
U728,2024,8,336852.0,Salary Increases & Fixed Expenses Remain Stable,233205,113937.0,89328,203265.0,29940.0,12.84,0.02,High Risk
U728,2024,9,366792.0,Salary Increases & Fixed Expenses Remain Stable,233205,113937.0,99512,213449.0,19756.0,8.47,-0.05,High Risk
U728,2024,10,386548.0,Salary Increases & Fixed Expenses Remain Stable,233205,113937.0,82645,196582.0,36623.0,15.7,-0.03,Medium Risk
U728,2024,11,423171.0,Salary Increases & Fixed Expenses Remain Stable,233205,113937.0,109715,223652.0,9553.0,4.1,0.04,High Risk
U728,2024,12,432724.0,Salary Increases & Fixed Expenses Remain Stable,233205,113937.0,77175,191112.0,42093.0,18.05,-0.05,Medium Risk
U729,2024,1,250000.0,Stable Salary & Stable Fixed Expenses,287013,68415.0,191297,259712.0,27301.0,9.51,0.0,High Risk
U729,2024,2,277301.0,Stable Salary & Stable Fixed Expenses,287013,68415.0,166980,235395.0,51618.0,17.98,-0.05,Medium Risk
U729,2024,3,328919.0,Stable Salary & Stable Fixed Expenses,287013,68415.0,171170,239585.0,47428.0,16.52,0.04,Medium Risk
U729,2024,4,376347.0,Stable Salary & Stable Fixed Expenses,287013,68415.0,172905,241320.0,45693.0,15.92,-0.04,Medium Risk
U729,2024,5,422040.0,Stable Salary & Stable Fixed Expenses,287013,68415.0,169176,237591.0,49422.0,17.22,0.0,Medium Risk
U729,2024,6,471462.0,Stable Salary & Stable Fixed Expenses,287013,68415.0,182719,251134.0,35879.0,12.5,0.04,High Risk
U729,2024,7,507341.0,Stable Salary & Stable Fixed Expenses,287013,68415.0,191954,260369.0,26644.0,9.28,-0.01,High Risk
U729,2024,8,533985.0,Stable Salary & Stable Fixed Expenses,287013,68415.0,151766,220181.0,66832.0,23.29,-0.03,Medium Risk
U729,2024,9,600817.0,Stable Salary & Stable Fixed Expenses,287013,68415.0,197773,266188.0,20825.0,7.26,-0.02,High Risk
U729,2024,10,621642.0,Stable Salary & Stable Fixed Expenses,287013,68415.0,200540,268955.0,18058.0,6.29,-0.03,High Risk
U729,2024,11,639700.0,Stable Salary & Stable Fixed Expenses,287013,68415.0,174143,242558.0,44455.0,15.49,0.05,Medium Risk
U729,2024,12,684155.0,Stable Salary & Stable Fixed Expenses,287013,68415.0,158106,226521.0,60492.0,21.08,0.0,Medium Risk
U730,2024,1,250000.0,Salary Increases & Fixed Expenses Remain Stable,274922,82544.0,65829,148373.0,126549.0,46.03,0.03,Low Risk
U730,2024,2,376549.0,Salary Increases & Fixed Expenses Remain Stable,274922,82544.0,64826,147370.0,127552.0,46.4,0.01,Low Risk
U730,2024,3,504101.0,Salary Increases & Fixed Expenses Remain Stable,274922,82544.0,92589,175133.0,99789.0,36.3,0.04,Low Risk
U730,2024,4,603890.0,Salary Increases & Fixed Expenses Remain Stable,274922,82544.0,78942,161486.0,113436.0,41.26,-0.02,Low Risk
U730,2024,5,717326.0,Salary Increases & Fixed Expenses Remain Stable,274922,82544.0,75043,157587.0,117335.0,42.68,-0.02,Low Risk
U730,2024,6,834661.0,Salary Increases & Fixed Expenses Remain Stable,274922,82544.0,55824,138368.0,136554.0,49.67,0.04,Low Risk
U730,2024,7,971215.0,Salary Increases & Fixed Expenses Remain Stable,280791,82544.0,78592,161136.0,119655.0,42.61,-0.03,Low Risk
U730,2024,8,1090870.0,Salary Increases & Fixed Expenses Remain Stable,280791,82544.0,61244,143788.0,137003.0,48.79,0.03,Low Risk
U730,2024,9,1227873.0,Salary Increases & Fixed Expenses Remain Stable,280791,82544.0,66816,149360.0,131431.0,46.81,-0.05,Low Risk
U730,2024,10,1359304.0,Salary Increases & Fixed Expenses Remain Stable,280791,82544.0,70966,153510.0,127281.0,45.33,0.02,Low Risk
U730,2024,11,1486585.0,Salary Increases & Fixed Expenses Remain Stable,280791,82544.0,90238,172782.0,108009.0,38.47,0.03,Low Risk
U730,2024,12,1594594.0,Salary Increases & Fixed Expenses Remain Stable,280791,82544.0,93112,175656.0,105135.0,37.44,0.04,Low Risk
U731,2024,1,249144.0,Stable Salary & Stable Fixed Expenses,248665,92950.0,56695,149645.0,99020.0,39.82,-0.04,Low Risk
U731,2024,2,348164.0,Stable Salary & Stable Fixed Expenses,248665,92950.0,63507,156457.0,92208.0,37.08,0.03,Low Risk
U731,2024,3,440372.0,Stable Salary & Stable Fixed Expenses,248665,92950.0,82041,174991.0,73674.0,29.63,0.03,Low Risk
U731,2024,4,514046.0,Stable Salary & Stable Fixed Expenses,248665,92950.0,68229,161179.0,87486.0,35.18,0.02,Low Risk
U731,2024,5,601532.0,Stable Salary & Stable Fixed Expenses,248665,92950.0,70002,162952.0,85713.0,34.47,-0.04,Low Risk
U731,2024,6,687245.0,Stable Salary & Stable Fixed Expenses,248665,92950.0,74372,167322.0,81343.0,32.71,-0.04,Low Risk
U731,2024,7,768588.0,Stable Salary & Stable Fixed Expenses,248665,92950.0,73653,166603.0,82062.0,33.0,0.04,Low Risk
U731,2024,8,850650.0,Stable Salary & Stable Fixed Expenses,248665,92950.0,63232,156182.0,92483.0,37.19,0.03,Low Risk
U731,2024,9,943133.0,Stable Salary & Stable Fixed Expenses,248665,92950.0,71206,164156.0,84509.0,33.99,0.03,Low Risk
U731,2024,10,1027642.0,Stable Salary & Stable Fixed Expenses,248665,92950.0,75471,168421.0,80244.0,32.27,-0.02,Low Risk
U731,2024,11,1107886.0,Stable Salary & Stable Fixed Expenses,248665,92950.0,75597,168547.0,80118.0,32.22,0.02,Low Risk
U731,2024,12,1188004.0,Stable Salary & Stable Fixed Expenses,248665,92950.0,58995,151945.0,96720.0,38.9,0.01,Low Risk
U732,2024,1,193276.0,Salary Increases & Fixed Expenses Increase,190828,68381.0,95999,164380.0,26448.0,13.86,-0.04,High Risk
U732,2024,2,219724.0,Salary Increases & Fixed Expenses Increase,190828,69767.0,127556,197323.0,-6495.0,-3.4,-0.0,High Risk
U732,2024,3,213229.0,Salary Increases & Fixed Expenses Increase,190828,70475.0,115908,186383.0,4445.0,2.33,-0.02,High Risk
U732,2024,4,217674.0,Salary Increases & Fixed Expenses Increase,190828,70475.0,126485,196960.0,-6132.0,-3.21,-0.03,High Risk
U732,2024,5,211542.0,Salary Increases & Fixed Expenses Increase,190828,71558.0,122164,193722.0,-2894.0,-1.52,0.03,High Risk
U732,2024,6,208648.0,Salary Increases & Fixed Expenses Increase,190828,71558.0,132407,203965.0,-13137.0,-6.88,0.02,High Risk
U732,2024,7,195511.0,Salary Increases & Fixed Expenses Increase,190828,71558.0,132139,203697.0,-12869.0,-6.74,-0.05,High Risk
U732,2024,8,182642.0,Salary Increases & Fixed Expenses Increase,201879,71558.0,124291,195849.0,6030.0,2.99,0.01,High Risk
U732,2024,9,188672.0,Salary Increases & Fixed Expenses Increase,201879,71558.0,152899,224457.0,-22578.0,-11.18,-0.02,High Risk
U732,2024,10,166094.0,Salary Increases & Fixed Expenses Increase,201879,71558.0,132868,204426.0,-2547.0,-1.26,0.0,High Risk
U732,2024,11,163547.0,Salary Increases & Fixed Expenses Increase,201879,71558.0,153965,225523.0,-23644.0,-11.71,-0.02,High Risk
U732,2024,12,139903.0,Salary Increases & Fixed Expenses Increase,201879,71558.0,102150,173708.0,28171.0,13.95,-0.01,High Risk
U733,2024,1,234086.0,Salary Increases & Fixed Expenses Decrease,169221,57589.0,52961,110550.0,58671.0,34.67,-0.05,Low Risk
U733,2024,2,292757.0,Salary Increases & Fixed Expenses Decrease,169221,57589.0,82680,140269.0,28952.0,17.11,0.01,Medium Risk
U733,2024,3,321709.0,Salary Increases & Fixed Expenses Decrease,175281,56151.0,69149,125300.0,49981.0,28.51,-0.04,Low Risk
U733,2024,4,371690.0,Salary Increases & Fixed Expenses Decrease,175281,56151.0,70957,127108.0,48173.0,27.48,0.05,Low Risk
U733,2024,5,419863.0,Salary Increases & Fixed Expenses Decrease,175281,56151.0,67320,123471.0,51810.0,29.56,-0.03,Low Risk
U733,2024,6,471673.0,Salary Increases & Fixed Expenses Decrease,175281,56151.0,59953,116104.0,59177.0,33.76,-0.02,Low Risk
U733,2024,7,530850.0,Salary Increases & Fixed Expenses Decrease,175281,56151.0,73800,129951.0,45330.0,25.86,0.01,Low Risk
U733,2024,8,576180.0,Salary Increases & Fixed Expenses Decrease,175281,56151.0,87304,143455.0,31826.0,18.16,-0.03,Medium Risk
U733,2024,9,608006.0,Salary Increases & Fixed Expenses Decrease,175281,56151.0,86312,142463.0,32818.0,18.72,0.04,Medium Risk
U733,2024,10,640824.0,Salary Increases & Fixed Expenses Decrease,175281,56151.0,77906,134057.0,41224.0,23.52,-0.05,Medium Risk
U733,2024,11,682048.0,Salary Increases & Fixed Expenses Decrease,175281,56151.0,53533,109684.0,65597.0,37.42,0.04,Low Risk
U733,2024,12,747645.0,Salary Increases & Fixed Expenses Decrease,175281,56151.0,66447,122598.0,52683.0,30.06,-0.01,Low Risk
U734,2024,1,247677.0,Salary Increases & Fixed Expenses Remain Stable,238916,89135.0,112754,201889.0,37027.0,15.5,-0.01,Medium Risk
U734,2024,2,284704.0,Salary Increases & Fixed Expenses Remain Stable,238916,89135.0,84999,174134.0,64782.0,27.11,-0.02,Low Risk
U734,2024,3,349486.0,Salary Increases & Fixed Expenses Remain Stable,238916,89135.0,102254,191389.0,47527.0,19.89,0.04,Medium Risk
U734,2024,4,397013.0,Salary Increases & Fixed Expenses Remain Stable,238916,89135.0,82673,171808.0,67108.0,28.09,-0.01,Low Risk
U734,2024,5,464121.0,Salary Increases & Fixed Expenses Remain Stable,266136,89135.0,96931,186066.0,80070.0,30.09,-0.04,Low Risk
U734,2024,6,544191.0,Salary Increases & Fixed Expenses Remain Stable,266136,89135.0,85239,174374.0,91762.0,34.48,0.01,Low Risk
U734,2024,7,635953.0,Salary Increases & Fixed Expenses Remain Stable,266136,89135.0,88946,178081.0,88055.0,33.09,0.04,Low Risk
U734,2024,8,724008.0,Salary Increases & Fixed Expenses Remain Stable,266136,89135.0,124659,213794.0,52342.0,19.67,-0.01,Medium Risk
U734,2024,9,776350.0,Salary Increases & Fixed Expenses Remain Stable,266136,89135.0,83227,172362.0,93774.0,35.24,0.04,Low Risk
U734,2024,10,870124.0,Salary Increases & Fixed Expenses Remain Stable,266136,89135.0,126576,215711.0,50425.0,18.95,-0.03,Medium Risk
U734,2024,11,920549.0,Salary Increases & Fixed Expenses Remain Stable,266136,89135.0,122538,211673.0,54463.0,20.46,-0.05,Medium Risk
U734,2024,12,975012.0,Salary Increases & Fixed Expenses Remain Stable,266136,89135.0,108207,197342.0,68794.0,25.85,0.02,Low Risk
U735,2024,1,140041.0,Stable Salary & Increasing Fixed Expenses,39234,10319.0,8856,19175.0,20059.0,51.13,0.03,Low Risk
U735,2024,2,160100.0,Stable Salary & Increasing Fixed Expenses,39234,10319.0,8588,18907.0,20327.0,51.81,0.05,Low Risk
U735,2024,3,180427.0,Stable Salary & Increasing Fixed Expenses,39234,10319.0,7855,18174.0,21060.0,53.68,-0.03,Low Risk
U735,2024,4,201487.0,Stable Salary & Increasing Fixed Expenses,39234,10319.0,11445,21764.0,17470.0,44.53,0.04,Low Risk
U735,2024,5,218957.0,Stable Salary & Increasing Fixed Expenses,39234,10319.0,10339,20658.0,18576.0,47.35,0.04,Low Risk
U735,2024,6,237533.0,Stable Salary & Increasing Fixed Expenses,39234,10319.0,9547,19866.0,19368.0,49.37,-0.04,Low Risk
U735,2024,7,256901.0,Stable Salary & Increasing Fixed Expenses,39234,10319.0,9530,19849.0,19385.0,49.41,-0.02,Low Risk
U735,2024,8,276286.0,Stable Salary & Increasing Fixed Expenses,39234,11792.0,9926,21718.0,17516.0,44.64,-0.01,Low Risk
U735,2024,9,293802.0,Stable Salary & Increasing Fixed Expenses,39234,11792.0,9949,21741.0,17493.0,44.59,-0.02,Low Risk
U735,2024,10,311295.0,Stable Salary & Increasing Fixed Expenses,39234,11792.0,9658,21450.0,17784.0,45.33,0.04,Low Risk
U735,2024,11,329079.0,Stable Salary & Increasing Fixed Expenses,39234,11792.0,9413,21205.0,18029.0,45.95,0.03,Low Risk
U735,2024,12,347108.0,Stable Salary & Increasing Fixed Expenses,39234,11792.0,9463,21255.0,17979.0,45.83,0.01,Low Risk
U736,2024,1,181240.0,Salary Increases & Fixed Expenses Decrease,161744,60125.0,44957,105082.0,56662.0,35.03,0.04,Low Risk
U736,2024,2,237902.0,Salary Increases & Fixed Expenses Decrease,161744,60125.0,33026,93151.0,68593.0,42.41,-0.03,Low Risk
U736,2024,3,306495.0,Salary Increases & Fixed Expenses Decrease,161744,60125.0,34314,94439.0,67305.0,41.61,-0.05,Low Risk
U736,2024,4,373800.0,Salary Increases & Fixed Expenses Decrease,161744,60125.0,35543,95668.0,66076.0,40.85,-0.03,Low Risk
U736,2024,5,439876.0,Salary Increases & Fixed Expenses Decrease,161744,60125.0,39158,99283.0,62461.0,38.62,0.01,Low Risk
U736,2024,6,502337.0,Salary Increases & Fixed Expenses Decrease,161744,60125.0,33551,93676.0,68068.0,42.08,0.0,Low Risk
U736,2024,7,570405.0,Salary Increases & Fixed Expenses Decrease,161744,60125.0,39573,99698.0,62046.0,38.36,-0.04,Low Risk
U736,2024,8,632451.0,Salary Increases & Fixed Expenses Decrease,170771,60125.0,38300,98425.0,72346.0,42.36,-0.05,Low Risk
U736,2024,9,704797.0,Salary Increases & Fixed Expenses Decrease,170771,60125.0,58090,118215.0,52556.0,30.78,-0.03,Low Risk
U736,2024,10,757353.0,Salary Increases & Fixed Expenses Decrease,170771,60125.0,36784,96909.0,73862.0,43.25,0.0,Low Risk
U736,2024,11,831215.0,Salary Increases & Fixed Expenses Decrease,170771,60125.0,48027,108152.0,62619.0,36.67,0.03,Low Risk
U736,2024,12,893834.0,Salary Increases & Fixed Expenses Decrease,170771,60125.0,38391,98516.0,72255.0,42.31,-0.04,Low Risk
U737,2024,1,153404.0,Salary Increases & Fixed Expenses Remain Stable,131369,65649.0,26723,92372.0,38997.0,29.69,-0.02,Low Risk
U737,2024,2,192401.0,Salary Increases & Fixed Expenses Remain Stable,131369,65649.0,33391,99040.0,32329.0,24.61,0.03,Medium Risk
U737,2024,3,224730.0,Salary Increases & Fixed Expenses Remain Stable,131369,65649.0,28848,94497.0,36872.0,28.07,-0.04,Low Risk
U737,2024,4,261602.0,Salary Increases & Fixed Expenses Remain Stable,131369,65649.0,35294,100943.0,30426.0,23.16,0.04,Medium Risk
U737,2024,5,292028.0,Salary Increases & Fixed Expenses Remain Stable,158400,65649.0,40197,105846.0,52554.0,33.18,0.03,Low Risk
U737,2024,6,344582.0,Salary Increases & Fixed Expenses Remain Stable,158400,65649.0,44520,110169.0,48231.0,30.45,-0.0,Low Risk
U737,2024,7,392813.0,Salary Increases & Fixed Expenses Remain Stable,158400,65649.0,44226,109875.0,48525.0,30.63,0.02,Low Risk
U737,2024,8,441338.0,Salary Increases & Fixed Expenses Remain Stable,158400,65649.0,42578,108227.0,50173.0,31.67,-0.02,Low Risk
U737,2024,9,491511.0,Salary Increases & Fixed Expenses Remain Stable,158400,65649.0,39139,104788.0,53612.0,33.85,0.05,Low Risk
U737,2024,10,545123.0,Salary Increases & Fixed Expenses Remain Stable,158400,65649.0,37919,103568.0,54832.0,34.62,0.02,Low Risk
U737,2024,11,599955.0,Salary Increases & Fixed Expenses Remain Stable,158400,65649.0,39291,104940.0,53460.0,33.75,-0.01,Low Risk
U737,2024,12,653415.0,Salary Increases & Fixed Expenses Remain Stable,158400,65649.0,44795,110444.0,47956.0,30.28,-0.01,Low Risk
U738,2024,1,97571.0,Salary Increases & Fixed Expenses Increase,66714,24478.0,23613,48091.0,18623.0,27.91,0.02,Low Risk
U738,2024,2,116194.0,Salary Increases & Fixed Expenses Increase,66714,24478.0,27111,51589.0,15125.0,22.67,-0.03,Medium Risk
U738,2024,3,131319.0,Salary Increases & Fixed Expenses Increase,66714,24478.0,23625,48103.0,18611.0,27.9,-0.04,Low Risk
U738,2024,4,149930.0,Salary Increases & Fixed Expenses Increase,96050,24478.0,38356,62834.0,33216.0,34.58,-0.0,Low Risk
U738,2024,5,183146.0,Salary Increases & Fixed Expenses Increase,96050,24478.0,44351,68829.0,27221.0,28.34,0.01,Low Risk
U738,2024,6,210367.0,Salary Increases & Fixed Expenses Increase,96050,24478.0,32173,56651.0,39399.0,41.02,-0.03,Low Risk
U738,2024,7,249766.0,Salary Increases & Fixed Expenses Increase,96050,24478.0,30406,54884.0,41166.0,42.86,0.03,Low Risk
U738,2024,8,290932.0,Salary Increases & Fixed Expenses Increase,96050,24478.0,46186,70664.0,25386.0,26.43,-0.04,Low Risk
U738,2024,9,316318.0,Salary Increases & Fixed Expenses Increase,96050,24478.0,48139,72617.0,23433.0,24.4,-0.02,Medium Risk
U738,2024,10,339751.0,Salary Increases & Fixed Expenses Increase,96050,24478.0,36251,60729.0,35321.0,36.77,0.04,Low Risk
U738,2024,11,375072.0,Salary Increases & Fixed Expenses Increase,96050,24478.0,42158,66636.0,29414.0,30.62,0.05,Low Risk
U738,2024,12,404486.0,Salary Increases & Fixed Expenses Increase,96050,25641.0,42090,67731.0,28319.0,29.48,-0.05,Low Risk
U739,2024,1,234892.0,Salary Increases & Fixed Expenses Remain Stable,216442,80956.0,81333,162289.0,54153.0,25.02,-0.01,Low Risk
U739,2024,2,289045.0,Salary Increases & Fixed Expenses Remain Stable,216442,80956.0,97158,178114.0,38328.0,17.71,0.02,Medium Risk
U739,2024,3,327373.0,Salary Increases & Fixed Expenses Remain Stable,216442,80956.0,75117,156073.0,60369.0,27.89,0.01,Low Risk
U739,2024,4,387742.0,Salary Increases & Fixed Expenses Remain Stable,216442,80956.0,97058,178014.0,38428.0,17.75,-0.01,Medium Risk
U739,2024,5,426170.0,Salary Increases & Fixed Expenses Remain Stable,216442,80956.0,101609,182565.0,33877.0,15.65,-0.01,Medium Risk
U739,2024,6,460047.0,Salary Increases & Fixed Expenses Remain Stable,216442,80956.0,69949,150905.0,65537.0,30.28,-0.02,Low Risk
U739,2024,7,525584.0,Salary Increases & Fixed Expenses Remain Stable,223471,80956.0,96373,177329.0,46142.0,20.65,0.0,Medium Risk
U739,2024,8,571726.0,Salary Increases & Fixed Expenses Remain Stable,223471,80956.0,70705,151661.0,71810.0,32.13,0.03,Low Risk
U739,2024,9,643536.0,Salary Increases & Fixed Expenses Remain Stable,223471,80956.0,69720,150676.0,72795.0,32.57,-0.0,Low Risk
U739,2024,10,716331.0,Salary Increases & Fixed Expenses Remain Stable,223471,80956.0,105117,186073.0,37398.0,16.74,0.04,Medium Risk
U739,2024,11,753729.0,Salary Increases & Fixed Expenses Remain Stable,223471,80956.0,103201,184157.0,39314.0,17.59,-0.03,Medium Risk
U739,2024,12,793043.0,Salary Increases & Fixed Expenses Remain Stable,223471,80956.0,76818,157774.0,65697.0,29.4,-0.0,Low Risk
U740,2024,1,192951.0,Stable Salary & Increasing Fixed Expenses,184299,47917.0,91574,139491.0,44808.0,24.31,0.03,Medium Risk
U740,2024,2,237759.0,Stable Salary & Increasing Fixed Expenses,184299,47917.0,70691,118608.0,65691.0,35.64,-0.01,Low Risk
U740,2024,3,303450.0,Stable Salary & Increasing Fixed Expenses,184299,47917.0,58574,106491.0,77808.0,42.22,0.03,Low Risk
U740,2024,4,381258.0,Stable Salary & Increasing Fixed Expenses,184299,47917.0,84785,132702.0,51597.0,28.0,-0.04,Low Risk
U740,2024,5,432855.0,Stable Salary & Increasing Fixed Expenses,184299,49592.0,58697,108289.0,76010.0,41.24,0.02,Low Risk
U740,2024,6,508865.0,Stable Salary & Increasing Fixed Expenses,184299,49592.0,66911,116503.0,67796.0,36.79,0.04,Low Risk
U740,2024,7,576661.0,Stable Salary & Increasing Fixed Expenses,184299,49592.0,66419,116011.0,68288.0,37.05,-0.02,Low Risk
U740,2024,8,644949.0,Stable Salary & Increasing Fixed Expenses,184299,49592.0,62882,112474.0,71825.0,38.97,0.04,Low Risk
U740,2024,9,716774.0,Stable Salary & Increasing Fixed Expenses,184299,49592.0,96676,146268.0,38031.0,20.64,0.02,Medium Risk
U740,2024,10,754805.0,Stable Salary & Increasing Fixed Expenses,184299,49592.0,66511,116103.0,68196.0,37.0,-0.0,Low Risk
U740,2024,11,823001.0,Stable Salary & Increasing Fixed Expenses,184299,49592.0,99126,148718.0,35581.0,19.31,-0.0,Medium Risk
U740,2024,12,858582.0,Stable Salary & Increasing Fixed Expenses,184299,49592.0,89417,139009.0,45290.0,24.57,0.04,Medium Risk
U741,2024,1,233283.0,Salary Increases & Fixed Expenses Remain Stable,225931,69061.0,64141,133202.0,92729.0,41.04,-0.04,Low Risk
U741,2024,2,326012.0,Salary Increases & Fixed Expenses Remain Stable,225931,69061.0,55410,124471.0,101460.0,44.91,-0.01,Low Risk
U741,2024,3,427472.0,Salary Increases & Fixed Expenses Remain Stable,225931,69061.0,50315,119376.0,106555.0,47.16,-0.03,Low Risk
U741,2024,4,534027.0,Salary Increases & Fixed Expenses Remain Stable,225931,69061.0,45503,114564.0,111367.0,49.29,-0.04,Low Risk
U741,2024,5,645394.0,Salary Increases & Fixed Expenses Remain Stable,225931,69061.0,60994,130055.0,95876.0,42.44,0.02,Low Risk
U741,2024,6,741270.0,Salary Increases & Fixed Expenses Remain Stable,225931,69061.0,53817,122878.0,103053.0,45.61,0.01,Low Risk
U741,2024,7,844323.0,Salary Increases & Fixed Expenses Remain Stable,242045,69061.0,59512,128573.0,113472.0,46.88,0.04,Low Risk
U741,2024,8,957795.0,Salary Increases & Fixed Expenses Remain Stable,242045,69061.0,55052,124113.0,117932.0,48.72,-0.01,Low Risk
U741,2024,9,1075727.0,Salary Increases & Fixed Expenses Remain Stable,242045,69061.0,77436,146497.0,95548.0,39.48,-0.02,Low Risk
U741,2024,10,1171275.0,Salary Increases & Fixed Expenses Remain Stable,242045,69061.0,72119,141180.0,100865.0,41.67,-0.03,Low Risk
U741,2024,11,1272140.0,Salary Increases & Fixed Expenses Remain Stable,242045,69061.0,61002,130063.0,111982.0,46.26,-0.02,Low Risk
U741,2024,12,1384122.0,Salary Increases & Fixed Expenses Remain Stable,242045,69061.0,68494,137555.0,104490.0,43.17,-0.05,Low Risk
U742,2024,1,246326.0,Stable Salary & Stable Fixed Expenses,89527,23536.0,36927,60463.0,29064.0,32.46,0.04,Low Risk
U742,2024,2,275390.0,Stable Salary & Stable Fixed Expenses,89527,23536.0,35543,59079.0,30448.0,34.01,0.01,Low Risk
U742,2024,3,305838.0,Stable Salary & Stable Fixed Expenses,89527,23536.0,39428,62964.0,26563.0,29.67,0.03,Low Risk
U742,2024,4,332401.0,Stable Salary & Stable Fixed Expenses,89527,23536.0,36381,59917.0,29610.0,33.07,-0.04,Low Risk
U742,2024,5,362011.0,Stable Salary & Stable Fixed Expenses,89527,23536.0,29793,53329.0,36198.0,40.43,-0.01,Low Risk
U742,2024,6,398209.0,Stable Salary & Stable Fixed Expenses,89527,23536.0,36346,59882.0,29645.0,33.11,0.01,Low Risk
U742,2024,7,427854.0,Stable Salary & Stable Fixed Expenses,89527,23536.0,33765,57301.0,32226.0,36.0,-0.05,Low Risk
U742,2024,8,460080.0,Stable Salary & Stable Fixed Expenses,89527,23536.0,29150,52686.0,36841.0,41.15,0.02,Low Risk
U742,2024,9,496921.0,Stable Salary & Stable Fixed Expenses,89527,23536.0,37170,60706.0,28821.0,32.19,-0.02,Low Risk
U742,2024,10,525742.0,Stable Salary & Stable Fixed Expenses,89527,23536.0,37904,61440.0,28087.0,31.37,0.05,Low Risk
U742,2024,11,553829.0,Stable Salary & Stable Fixed Expenses,89527,23536.0,33016,56552.0,32975.0,36.83,0.04,Low Risk
U742,2024,12,586804.0,Stable Salary & Stable Fixed Expenses,89527,23536.0,43832,67368.0,22159.0,24.75,0.01,Medium Risk
U743,2024,1,219204.0,Salary Increases & Fixed Expenses Remain Stable,27775,22596.0,6574,29170.0,-1395.0,-5.02,-0.02,High Risk
U743,2024,2,217809.0,Salary Increases & Fixed Expenses Remain Stable,27775,22596.0,7295,29891.0,-2116.0,-7.62,-0.01,High Risk
U743,2024,3,215693.0,Salary Increases & Fixed Expenses Remain Stable,27775,22596.0,6336,28932.0,-1157.0,-4.17,-0.03,High Risk
U743,2024,4,214536.0,Salary Increases & Fixed Expenses Remain Stable,27775,22596.0,5556,28152.0,-377.0,-1.36,-0.05,High Risk
U743,2024,5,214159.0,Salary Increases & Fixed Expenses Remain Stable,27775,22596.0,7315,29911.0,-2136.0,-7.69,0.03,High Risk
U743,2024,6,212023.0,Salary Increases & Fixed Expenses Remain Stable,42850,22596.0,10523,33119.0,9731.0,22.71,-0.03,Medium Risk
U743,2024,7,221754.0,Salary Increases & Fixed Expenses Remain Stable,42850,22596.0,8932,31528.0,11322.0,26.42,0.01,Low Risk
U743,2024,8,233076.0,Salary Increases & Fixed Expenses Remain Stable,42850,22596.0,11546,34142.0,8708.0,20.32,0.05,Medium Risk
U743,2024,9,241784.0,Salary Increases & Fixed Expenses Remain Stable,42850,22596.0,11668,34264.0,8586.0,20.04,0.04,Medium Risk
U743,2024,10,250370.0,Salary Increases & Fixed Expenses Remain Stable,42850,22596.0,9732,32328.0,10522.0,24.56,-0.0,Medium Risk
U743,2024,11,260892.0,Salary Increases & Fixed Expenses Remain Stable,42850,22596.0,14249,36845.0,6005.0,14.01,-0.01,High Risk
U743,2024,12,266897.0,Salary Increases & Fixed Expenses Remain Stable,42850,22596.0,9436,32032.0,10818.0,25.25,-0.01,Low Risk
U744,2024,1,215634.0,Stable Salary & Stable Fixed Expenses,204065,103132.0,126785,229917.0,-25852.0,-12.67,0.01,High Risk
U744,2024,2,189782.0,Stable Salary & Stable Fixed Expenses,204065,103132.0,141982,245114.0,-41049.0,-20.12,-0.02,High Risk
U744,2024,3,148733.0,Stable Salary & Stable Fixed Expenses,204065,103132.0,107879,211011.0,-6946.0,-3.4,-0.02,High Risk
U744,2024,4,141787.0,Stable Salary & Stable Fixed Expenses,204065,103132.0,107522,210654.0,-6589.0,-3.23,0.03,High Risk
U744,2024,5,135198.0,Stable Salary & Stable Fixed Expenses,204065,103132.0,135250,238382.0,-34317.0,-16.82,-0.01,High Risk
U744,2024,6,100881.0,Stable Salary & Stable Fixed Expenses,204065,103132.0,141247,244379.0,-40314.0,-19.76,-0.04,High Risk
U744,2024,7,60567.0,Stable Salary & Stable Fixed Expenses,204065,103132.0,133164,236296.0,-32231.0,-15.79,0.03,High Risk
U744,2024,8,28336.0,Stable Salary & Stable Fixed Expenses,204065,103132.0,110087,213219.0,-9154.0,-4.49,-0.01,High Risk
U744,2024,9,19182.0,Stable Salary & Stable Fixed Expenses,204065,103132.0,152568,255700.0,-51635.0,-25.3,0.03,High Risk
U744,2024,10,-32453.0,Stable Salary & Stable Fixed Expenses,204065,103132.0,136096,239228.0,-35163.0,-17.23,0.02,High Risk
U744,2024,11,-67616.0,Stable Salary & Stable Fixed Expenses,204065,103132.0,121707,224839.0,-20774.0,-10.18,0.02,High Risk
U744,2024,12,-88390.0,Stable Salary & Stable Fixed Expenses,204065,103132.0,120167,223299.0,-19234.0,-9.43,-0.02,High Risk
U745,2024,1,248695.0,Salary Increases & Fixed Expenses Remain Stable,245097,113367.0,115912,229279.0,15818.0,6.45,-0.0,High Risk
U745,2024,2,264513.0,Salary Increases & Fixed Expenses Remain Stable,245097,113367.0,104696,218063.0,27034.0,11.03,-0.01,High Risk
U745,2024,3,291547.0,Salary Increases & Fixed Expenses Remain Stable,245097,113367.0,109331,222698.0,22399.0,9.14,-0.04,High Risk
U745,2024,4,313946.0,Salary Increases & Fixed Expenses Remain Stable,245097,113367.0,106822,220189.0,24908.0,10.16,-0.01,High Risk
U745,2024,5,338854.0,Salary Increases & Fixed Expenses Remain Stable,245097,113367.0,78657,192024.0,53073.0,21.65,0.01,Medium Risk
U745,2024,6,391927.0,Salary Increases & Fixed Expenses Remain Stable,267614,113367.0,86212,199579.0,68035.0,25.42,0.0,Low Risk
U745,2024,7,459962.0,Salary Increases & Fixed Expenses Remain Stable,267614,113367.0,119428,232795.0,34819.0,13.01,0.04,High Risk
U745,2024,8,494781.0,Salary Increases & Fixed Expenses Remain Stable,267614,113367.0,93942,207309.0,60305.0,22.53,-0.03,Medium Risk
U745,2024,9,555086.0,Salary Increases & Fixed Expenses Remain Stable,267614,113367.0,105628,218995.0,48619.0,18.17,0.01,Medium Risk
U745,2024,10,603705.0,Salary Increases & Fixed Expenses Remain Stable,267614,113367.0,124736,238103.0,29511.0,11.03,-0.0,High Risk
U745,2024,11,633216.0,Salary Increases & Fixed Expenses Remain Stable,267614,113367.0,89556,202923.0,64691.0,24.17,-0.01,Medium Risk
U745,2024,12,697907.0,Salary Increases & Fixed Expenses Remain Stable,267614,113367.0,94438,207805.0,59809.0,22.35,-0.02,Medium Risk
U746,2024,1,250000.0,Stable Salary & Increasing Fixed Expenses,263123,97712.0,132869,230581.0,32542.0,12.37,0.04,High Risk
U746,2024,2,282542.0,Stable Salary & Increasing Fixed Expenses,263123,97712.0,168602,266314.0,-3191.0,-1.21,0.02,High Risk
U746,2024,3,279351.0,Stable Salary & Increasing Fixed Expenses,263123,97712.0,149395,247107.0,16016.0,6.09,-0.0,High Risk
U746,2024,4,295367.0,Stable Salary & Increasing Fixed Expenses,263123,97712.0,172958,270670.0,-7547.0,-2.87,-0.01,High Risk
U746,2024,5,287820.0,Stable Salary & Increasing Fixed Expenses,263123,97712.0,144294,242006.0,21117.0,8.03,-0.02,High Risk
U746,2024,6,308937.0,Stable Salary & Increasing Fixed Expenses,263123,97712.0,150317,248029.0,15094.0,5.74,-0.04,High Risk
U746,2024,7,324031.0,Stable Salary & Increasing Fixed Expenses,263123,98270.0,134880,233150.0,29973.0,11.39,0.0,High Risk
U746,2024,8,354004.0,Stable Salary & Increasing Fixed Expenses,263123,98270.0,166802,265072.0,-1949.0,-0.74,-0.02,High Risk
U746,2024,9,352055.0,Stable Salary & Increasing Fixed Expenses,263123,98270.0,151542,249812.0,13311.0,5.06,0.0,High Risk
U746,2024,10,365366.0,Stable Salary & Increasing Fixed Expenses,263123,99930.0,156641,256571.0,6552.0,2.49,-0.05,High Risk
U746,2024,11,371918.0,Stable Salary & Increasing Fixed Expenses,263123,99930.0,195176,295106.0,-31983.0,-12.16,0.04,High Risk
U746,2024,12,339935.0,Stable Salary & Increasing Fixed Expenses,263123,99930.0,165609,265539.0,-2416.0,-0.92,0.05,High Risk
U747,2024,1,237371.0,Salary Increases & Fixed Expenses Decrease,172732,71901.0,70222,142123.0,30609.0,17.72,0.05,Medium Risk
U747,2024,2,267980.0,Salary Increases & Fixed Expenses Decrease,172732,71901.0,53849,125750.0,46982.0,27.2,-0.04,Low Risk
U747,2024,3,314962.0,Salary Increases & Fixed Expenses Decrease,172732,71901.0,90399,162300.0,10432.0,6.04,0.01,High Risk
U747,2024,4,325394.0,Salary Increases & Fixed Expenses Decrease,172732,71901.0,86124,158025.0,14707.0,8.51,0.03,High Risk
U747,2024,5,340101.0,Salary Increases & Fixed Expenses Decrease,172732,71901.0,65859,137760.0,34972.0,20.25,0.02,Medium Risk
U747,2024,6,375073.0,Salary Increases & Fixed Expenses Decrease,172732,71901.0,67447,139348.0,33384.0,19.33,0.03,Medium Risk
U747,2024,7,408457.0,Salary Increases & Fixed Expenses Decrease,189784,71901.0,70194,142095.0,47689.0,25.13,0.05,Low Risk
U747,2024,8,456146.0,Salary Increases & Fixed Expenses Decrease,189784,71901.0,70369,142270.0,47514.0,25.04,0.02,Low Risk
U747,2024,9,503660.0,Salary Increases & Fixed Expenses Decrease,189784,71901.0,86764,158665.0,31119.0,16.4,-0.04,Medium Risk
U747,2024,10,534779.0,Salary Increases & Fixed Expenses Decrease,189784,71901.0,101743,173644.0,16140.0,8.5,0.02,High Risk
U747,2024,11,550919.0,Salary Increases & Fixed Expenses Decrease,189784,71901.0,81626,153527.0,36257.0,19.1,-0.0,Medium Risk
U747,2024,12,587176.0,Salary Increases & Fixed Expenses Decrease,189784,71901.0,67858,139759.0,50025.0,26.36,0.0,Low Risk
U748,2024,1,180390.0,Salary Increases & Fixed Expenses Remain Stable,66420,35002.0,24032,59034.0,7386.0,11.12,0.03,High Risk
U748,2024,2,187776.0,Salary Increases & Fixed Expenses Remain Stable,66420,35002.0,21100,56102.0,10318.0,15.53,0.01,Medium Risk
U748,2024,3,198094.0,Salary Increases & Fixed Expenses Remain Stable,66420,35002.0,41531,76533.0,-10113.0,-15.23,-0.02,High Risk
U748,2024,4,187981.0,Salary Increases & Fixed Expenses Remain Stable,66420,35002.0,23996,58998.0,7422.0,11.17,-0.03,High Risk
U748,2024,5,195403.0,Salary Increases & Fixed Expenses Remain Stable,66420,35002.0,20001,55003.0,11417.0,17.19,0.02,Medium Risk
U748,2024,6,206820.0,Salary Increases & Fixed Expenses Remain Stable,90469,35002.0,27970,62972.0,27497.0,30.39,0.02,Low Risk
U748,2024,7,234317.0,Salary Increases & Fixed Expenses Remain Stable,90469,35002.0,34201,69203.0,21266.0,23.51,-0.03,Medium Risk
U748,2024,8,255583.0,Salary Increases & Fixed Expenses Remain Stable,90469,35002.0,35500,70502.0,19967.0,22.07,0.04,Medium Risk
U748,2024,9,275550.0,Salary Increases & Fixed Expenses Remain Stable,90469,35002.0,34437,69439.0,21030.0,23.25,0.01,Medium Risk
U748,2024,10,296580.0,Salary Increases & Fixed Expenses Remain Stable,90469,35002.0,47025,82027.0,8442.0,9.33,-0.02,High Risk
U748,2024,11,305022.0,Salary Increases & Fixed Expenses Remain Stable,90469,35002.0,46520,81522.0,8947.0,9.89,-0.04,High Risk
U748,2024,12,313969.0,Salary Increases & Fixed Expenses Remain Stable,90469,35002.0,48248,83250.0,7219.0,7.98,0.0,High Risk
U749,2024,1,240031.0,Salary Increases & Fixed Expenses Increase,142586,72172.0,63284,135456.0,7130.0,5.0,0.0,High Risk
U749,2024,2,247161.0,Salary Increases & Fixed Expenses Increase,142586,72172.0,69000,141172.0,1414.0,0.99,0.03,High Risk
U749,2024,3,248575.0,Salary Increases & Fixed Expenses Increase,142586,73230.0,79053,152283.0,-9697.0,-6.8,0.04,High Risk
U749,2024,4,238878.0,Salary Increases & Fixed Expenses Increase,142586,73731.0,50208,123939.0,18647.0,13.08,0.04,High Risk
U749,2024,5,257525.0,Salary Increases & Fixed Expenses Increase,142586,73731.0,64779,138510.0,4076.0,2.86,-0.01,High Risk
U749,2024,6,261601.0,Salary Increases & Fixed Expenses Increase,142586,73731.0,62935,136666.0,5920.0,4.15,0.04,High Risk
U749,2024,7,267521.0,Salary Increases & Fixed Expenses Increase,142586,75175.0,63553,138728.0,3858.0,2.71,-0.02,High Risk
U749,2024,8,271379.0,Salary Increases & Fixed Expenses Increase,148552,75175.0,72712,147887.0,665.0,0.45,-0.01,High Risk
U749,2024,9,272044.0,Salary Increases & Fixed Expenses Increase,148552,75895.0,52627,128522.0,20030.0,13.48,0.02,High Risk
U749,2024,10,292074.0,Salary Increases & Fixed Expenses Increase,148552,75895.0,54041,129936.0,18616.0,12.53,0.05,High Risk
U749,2024,11,310690.0,Salary Increases & Fixed Expenses Increase,148552,77490.0,58408,135898.0,12654.0,8.52,0.01,High Risk
U749,2024,12,323344.0,Salary Increases & Fixed Expenses Increase,148552,77490.0,54452,131942.0,16610.0,11.18,-0.03,High Risk
U750,2024,1,196713.0,Salary Increases & Fixed Expenses Increase,114873,79559.0,67307,146866.0,-31993.0,-27.85,0.04,High Risk
U750,2024,2,164720.0,Salary Increases & Fixed Expenses Increase,114873,79559.0,67755,147314.0,-32441.0,-28.24,0.05,High Risk
U750,2024,3,132279.0,Salary Increases & Fixed Expenses Increase,114873,79559.0,73703,153262.0,-38389.0,-33.42,0.04,High Risk
U750,2024,4,93890.0,Salary Increases & Fixed Expenses Increase,114873,79559.0,69728,149287.0,-34414.0,-29.96,-0.01,High Risk
U750,2024,5,59476.0,Salary Increases & Fixed Expenses Increase,114873,79559.0,63693,143252.0,-28379.0,-24.7,-0.02,High Risk
U750,2024,6,31097.0,Salary Increases & Fixed Expenses Increase,114873,80734.0,57703,138437.0,-23564.0,-20.51,0.02,High Risk
U750,2024,7,7533.0,Salary Increases & Fixed Expenses Increase,142018,80734.0,81062,161796.0,-19778.0,-13.93,0.01,High Risk
U750,2024,8,-12245.0,Salary Increases & Fixed Expenses Increase,142018,80734.0,72119,152853.0,-10835.0,-7.63,0.04,High Risk
U750,2024,9,-23080.0,Salary Increases & Fixed Expenses Increase,142018,80734.0,86738,167472.0,-25454.0,-17.92,0.01,High Risk
U750,2024,10,-48534.0,Salary Increases & Fixed Expenses Increase,142018,80734.0,108401,189135.0,-47117.0,-33.18,0.04,High Risk
U750,2024,11,-95651.0,Salary Increases & Fixed Expenses Increase,142018,80734.0,87219,167953.0,-25935.0,-18.26,-0.04,High Risk
U750,2024,12,-121586.0,Salary Increases & Fixed Expenses Increase,142018,80734.0,119721,200455.0,-58437.0,-41.15,0.02,High Risk
U751,2024,1,106587.0,Salary Increases & Fixed Expenses Increase,71978,32866.0,44594,77460.0,-5482.0,-7.62,-0.02,High Risk
U751,2024,2,101105.0,Salary Increases & Fixed Expenses Increase,71978,32866.0,37306,70172.0,1806.0,2.51,0.04,High Risk
U751,2024,3,102911.0,Salary Increases & Fixed Expenses Increase,71978,32866.0,37220,70086.0,1892.0,2.63,-0.03,High Risk
U751,2024,4,104803.0,Salary Increases & Fixed Expenses Increase,71978,32866.0,47774,80640.0,-8662.0,-12.03,-0.01,High Risk
U751,2024,5,96141.0,Salary Increases & Fixed Expenses Increase,71978,33919.0,43781,77700.0,-5722.0,-7.95,0.01,High Risk
U751,2024,6,90419.0,Salary Increases & Fixed Expenses Increase,90870,35276.0,54546,89822.0,1048.0,1.15,-0.02,High Risk
U751,2024,7,91467.0,Salary Increases & Fixed Expenses Increase,90870,35276.0,62130,97406.0,-6536.0,-7.19,-0.03,High Risk
U751,2024,8,84931.0,Salary Increases & Fixed Expenses Increase,90870,35276.0,47374,82650.0,8220.0,9.05,0.01,High Risk
U751,2024,9,93151.0,Salary Increases & Fixed Expenses Increase,90870,35276.0,46176,81452.0,9418.0,10.36,0.03,High Risk
U751,2024,10,102569.0,Salary Increases & Fixed Expenses Increase,90870,35276.0,52529,87805.0,3065.0,3.37,-0.0,High Risk
U751,2024,11,105634.0,Salary Increases & Fixed Expenses Increase,90870,35276.0,53438,88714.0,2156.0,2.37,-0.01,High Risk
U751,2024,12,107790.0,Salary Increases & Fixed Expenses Increase,90870,35276.0,49209,84485.0,6385.0,7.03,-0.02,High Risk
U752,2024,1,230056.0,Salary Increases & Fixed Expenses Increase,141451,59309.0,86300,145609.0,-4158.0,-2.94,0.04,High Risk
U752,2024,2,225898.0,Salary Increases & Fixed Expenses Increase,141451,59309.0,73439,132748.0,8703.0,6.15,-0.02,High Risk
U752,2024,3,234601.0,Salary Increases & Fixed Expenses Increase,141451,59309.0,81724,141033.0,418.0,0.3,-0.05,High Risk
U752,2024,4,235019.0,Salary Increases & Fixed Expenses Increase,141451,59309.0,86866,146175.0,-4724.0,-3.34,-0.02,High Risk
U752,2024,5,230295.0,Salary Increases & Fixed Expenses Increase,166340,60950.0,96687,157637.0,8703.0,5.23,0.0,High Risk
U752,2024,6,238998.0,Salary Increases & Fixed Expenses Increase,166340,60950.0,85653,146603.0,19737.0,11.87,-0.04,High Risk
U752,2024,7,258735.0,Salary Increases & Fixed Expenses Increase,166340,60950.0,111416,172366.0,-6026.0,-3.62,0.03,High Risk
U752,2024,8,252709.0,Salary Increases & Fixed Expenses Increase,166340,60950.0,88798,149748.0,16592.0,9.97,-0.02,High Risk
U752,2024,9,269301.0,Salary Increases & Fixed Expenses Increase,166340,60950.0,108635,169585.0,-3245.0,-1.95,0.02,High Risk
U752,2024,10,266056.0,Salary Increases & Fixed Expenses Increase,166340,61938.0,111850,173788.0,-7448.0,-4.48,-0.01,High Risk
U752,2024,11,258608.0,Salary Increases & Fixed Expenses Increase,166340,61938.0,104934,166872.0,-532.0,-0.32,-0.01,High Risk
U752,2024,12,258076.0,Salary Increases & Fixed Expenses Increase,166340,61938.0,101624,163562.0,2778.0,1.67,-0.03,High Risk
U753,2024,1,188397.0,Salary Increases & Fixed Expenses Increase,109180,64095.0,30413,94508.0,14672.0,13.44,0.03,High Risk
U753,2024,2,203069.0,Salary Increases & Fixed Expenses Increase,109180,64095.0,23279,87374.0,21806.0,19.97,0.04,Medium Risk
U753,2024,3,224875.0,Salary Increases & Fixed Expenses Increase,109180,64991.0,33703,98694.0,10486.0,9.6,0.04,High Risk
U753,2024,4,235361.0,Salary Increases & Fixed Expenses Increase,109180,64991.0,27450,92441.0,16739.0,15.33,0.03,Medium Risk
U753,2024,5,252100.0,Salary Increases & Fixed Expenses Increase,109180,64991.0,32354,97345.0,11835.0,10.84,0.04,High Risk
U753,2024,6,263935.0,Salary Increases & Fixed Expenses Increase,109180,64991.0,30050,95041.0,14139.0,12.95,0.03,High Risk
U753,2024,7,278074.0,Salary Increases & Fixed Expenses Increase,116781,66526.0,28525,95051.0,21730.0,18.61,-0.02,Medium Risk
U753,2024,8,299804.0,Salary Increases & Fixed Expenses Increase,116781,66526.0,25079,91605.0,25176.0,21.56,0.05,Medium Risk
U753,2024,9,324980.0,Salary Increases & Fixed Expenses Increase,116781,66526.0,28096,94622.0,22159.0,18.97,0.01,Medium Risk
U753,2024,10,347139.0,Salary Increases & Fixed Expenses Increase,116781,66526.0,41439,107965.0,8816.0,7.55,0.01,High Risk
U753,2024,11,355955.0,Salary Increases & Fixed Expenses Increase,116781,66526.0,30063,96589.0,20192.0,17.29,0.03,Medium Risk
U753,2024,12,376147.0,Salary Increases & Fixed Expenses Increase,116781,66526.0,33271,99797.0,16984.0,14.54,0.01,High Risk
U754,2024,1,231542.0,Stable Salary & Increasing Fixed Expenses,208200,104478.0,73679,178157.0,30043.0,14.43,0.02,High Risk
U754,2024,2,261585.0,Stable Salary & Increasing Fixed Expenses,208200,104478.0,72411,176889.0,31311.0,15.04,-0.02,Medium Risk
U754,2024,3,292896.0,Stable Salary & Increasing Fixed Expenses,208200,104478.0,78985,183463.0,24737.0,11.88,-0.02,High Risk
U754,2024,4,317633.0,Stable Salary & Increasing Fixed Expenses,208200,104478.0,62988,167466.0,40734.0,19.56,0.01,Medium Risk
U754,2024,5,358367.0,Stable Salary & Increasing Fixed Expenses,208200,104478.0,89343,193821.0,14379.0,6.91,-0.02,High Risk
U754,2024,6,372746.0,Stable Salary & Increasing Fixed Expenses,208200,104478.0,87853,192331.0,15869.0,7.62,-0.01,High Risk
U754,2024,7,388615.0,Stable Salary & Increasing Fixed Expenses,208200,104478.0,72825,177303.0,30897.0,14.84,-0.05,High Risk
U754,2024,8,419512.0,Stable Salary & Increasing Fixed Expenses,208200,104478.0,71490,175968.0,32232.0,15.48,-0.01,Medium Risk
U754,2024,9,451744.0,Stable Salary & Increasing Fixed Expenses,208200,104478.0,112592,217070.0,-8870.0,-4.26,0.01,High Risk
U754,2024,10,442874.0,Stable Salary & Increasing Fixed Expenses,208200,104478.0,92315,196793.0,11407.0,5.48,0.04,High Risk
U754,2024,11,454281.0,Stable Salary & Increasing Fixed Expenses,208200,104478.0,97078,201556.0,6644.0,3.19,-0.04,High Risk
U754,2024,12,460925.0,Stable Salary & Increasing Fixed Expenses,208200,104478.0,92219,196697.0,11503.0,5.52,0.05,High Risk
U755,2024,1,228205.0,Stable Salary & Decreasing Fixed Expenses,183184,51338.0,72764,124102.0,59082.0,32.25,0.03,Low Risk
U755,2024,2,287287.0,Stable Salary & Decreasing Fixed Expenses,183184,51338.0,65812,117150.0,66034.0,36.05,-0.04,Low Risk
U755,2024,3,353321.0,Stable Salary & Decreasing Fixed Expenses,183184,51338.0,56723,108061.0,75123.0,41.01,-0.04,Low Risk
U755,2024,4,428444.0,Stable Salary & Decreasing Fixed Expenses,183184,51338.0,58261,109599.0,73585.0,40.17,-0.04,Low Risk
U755,2024,5,502029.0,Stable Salary & Decreasing Fixed Expenses,183184,51338.0,67147,118485.0,64699.0,35.32,-0.03,Low Risk
U755,2024,6,566728.0,Stable Salary & Decreasing Fixed Expenses,183184,51338.0,83631,134969.0,48215.0,26.32,0.0,Low Risk
U755,2024,7,614943.0,Stable Salary & Decreasing Fixed Expenses,183184,51338.0,82324,133662.0,49522.0,27.03,-0.05,Low Risk
U755,2024,8,664465.0,Stable Salary & Decreasing Fixed Expenses,183184,51338.0,70498,121836.0,61348.0,33.49,-0.02,Low Risk
U755,2024,9,725813.0,Stable Salary & Decreasing Fixed Expenses,183184,51338.0,80025,131363.0,51821.0,28.29,-0.04,Low Risk
U755,2024,10,777634.0,Stable Salary & Decreasing Fixed Expenses,183184,51338.0,60038,111376.0,71808.0,39.2,-0.01,Low Risk
U755,2024,11,849442.0,Stable Salary & Decreasing Fixed Expenses,183184,51338.0,87677,139015.0,44169.0,24.11,0.02,Medium Risk
U755,2024,12,893611.0,Stable Salary & Decreasing Fixed Expenses,183184,51338.0,81513,132851.0,50333.0,27.48,0.01,Low Risk
U756,2024,1,189505.0,Salary Increases & Fixed Expenses Remain Stable,175656,48576.0,101147,149723.0,25933.0,14.76,0.05,High Risk
U756,2024,2,215438.0,Salary Increases & Fixed Expenses Remain Stable,175656,48576.0,98673,147249.0,28407.0,16.17,0.0,Medium Risk
U756,2024,3,243845.0,Salary Increases & Fixed Expenses Remain Stable,175656,48576.0,110478,159054.0,16602.0,9.45,0.0,High Risk
U756,2024,4,260447.0,Salary Increases & Fixed Expenses Remain Stable,205295,48576.0,138354,186930.0,18365.0,8.95,-0.01,High Risk
U756,2024,5,278812.0,Salary Increases & Fixed Expenses Remain Stable,205295,48576.0,104897,153473.0,51822.0,25.24,-0.05,Low Risk
U756,2024,6,330634.0,Salary Increases & Fixed Expenses Remain Stable,205295,48576.0,103053,151629.0,53666.0,26.14,0.02,Low Risk
U756,2024,7,384300.0,Salary Increases & Fixed Expenses Remain Stable,205295,48576.0,109463,158039.0,47256.0,23.02,-0.01,Medium Risk
U756,2024,8,431556.0,Salary Increases & Fixed Expenses Remain Stable,205295,48576.0,107572,156148.0,49147.0,23.94,-0.01,Medium Risk
U756,2024,9,480703.0,Salary Increases & Fixed Expenses Remain Stable,205295,48576.0,121316,169892.0,35403.0,17.24,0.04,Medium Risk
U756,2024,10,516106.0,Salary Increases & Fixed Expenses Remain Stable,205295,48576.0,143076,191652.0,13643.0,6.65,0.02,High Risk
U756,2024,11,529749.0,Salary Increases & Fixed Expenses Remain Stable,205295,48576.0,127826,176402.0,28893.0,14.07,0.04,High Risk
U756,2024,12,558642.0,Salary Increases & Fixed Expenses Remain Stable,205295,48576.0,113555,162131.0,43164.0,21.03,-0.05,Medium Risk
U757,2024,1,225454.0,Salary Increases & Fixed Expenses Remain Stable,204516,60482.0,47097,107579.0,96937.0,47.4,0.02,Low Risk
U757,2024,2,322391.0,Salary Increases & Fixed Expenses Remain Stable,204516,60482.0,51278,111760.0,92756.0,45.35,-0.03,Low Risk
U757,2024,3,415147.0,Salary Increases & Fixed Expenses Remain Stable,204516,60482.0,64582,125064.0,79452.0,38.85,-0.02,Low Risk
U757,2024,4,494599.0,Salary Increases & Fixed Expenses Remain Stable,226082,60482.0,62311,122793.0,103289.0,45.69,-0.05,Low Risk
U757,2024,5,597888.0,Salary Increases & Fixed Expenses Remain Stable,226082,60482.0,63251,123733.0,102349.0,45.27,-0.04,Low Risk
U757,2024,6,700237.0,Salary Increases & Fixed Expenses Remain Stable,226082,60482.0,53111,113593.0,112489.0,49.76,-0.05,Low Risk
U757,2024,7,812726.0,Salary Increases & Fixed Expenses Remain Stable,226082,60482.0,45710,106192.0,119890.0,53.03,0.0,Low Risk
U757,2024,8,932616.0,Salary Increases & Fixed Expenses Remain Stable,226082,60482.0,61321,121803.0,104279.0,46.12,0.03,Low Risk
U757,2024,9,1036895.0,Salary Increases & Fixed Expenses Remain Stable,226082,60482.0,59088,119570.0,106512.0,47.11,-0.02,Low Risk
U757,2024,10,1143407.0,Salary Increases & Fixed Expenses Remain Stable,226082,60482.0,53905,114387.0,111695.0,49.4,0.01,Low Risk
U757,2024,11,1255102.0,Salary Increases & Fixed Expenses Remain Stable,226082,60482.0,63015,123497.0,102585.0,45.38,-0.05,Low Risk
U757,2024,12,1357687.0,Salary Increases & Fixed Expenses Remain Stable,226082,60482.0,75406,135888.0,90194.0,39.89,0.01,Low Risk
U758,2024,1,250000.0,Stable Salary & Stable Fixed Expenses,268041,87874.0,67207,155081.0,112960.0,42.14,-0.04,Low Risk
U758,2024,2,362960.0,Stable Salary & Stable Fixed Expenses,268041,87874.0,75933,163807.0,104234.0,38.89,0.02,Low Risk
U758,2024,3,467194.0,Stable Salary & Stable Fixed Expenses,268041,87874.0,74116,161990.0,106051.0,39.57,-0.03,Low Risk
U758,2024,4,573245.0,Stable Salary & Stable Fixed Expenses,268041,87874.0,76218,164092.0,103949.0,38.78,0.04,Low Risk
U758,2024,5,677194.0,Stable Salary & Stable Fixed Expenses,268041,87874.0,61126,149000.0,119041.0,44.41,-0.03,Low Risk
U758,2024,6,796235.0,Stable Salary & Stable Fixed Expenses,268041,87874.0,54539,142413.0,125628.0,46.87,-0.02,Low Risk
U758,2024,7,921863.0,Stable Salary & Stable Fixed Expenses,268041,87874.0,62066,149940.0,118101.0,44.06,0.04,Low Risk
U758,2024,8,1039964.0,Stable Salary & Stable Fixed Expenses,268041,87874.0,76933,164807.0,103234.0,38.51,-0.0,Low Risk
U758,2024,9,1143198.0,Stable Salary & Stable Fixed Expenses,268041,87874.0,79824,167698.0,100343.0,37.44,0.03,Low Risk
U758,2024,10,1243541.0,Stable Salary & Stable Fixed Expenses,268041,87874.0,56916,144790.0,123251.0,45.98,0.01,Low Risk
U758,2024,11,1366792.0,Stable Salary & Stable Fixed Expenses,268041,87874.0,74577,162451.0,105590.0,39.39,-0.02,Low Risk
U758,2024,12,1472382.0,Stable Salary & Stable Fixed Expenses,268041,87874.0,69970,157844.0,110197.0,41.11,-0.02,Low Risk
U759,2024,1,204176.0,Stable Salary & Increasing Fixed Expenses,179504,58661.0,39121,97782.0,81722.0,45.53,-0.04,Low Risk
U759,2024,2,285898.0,Stable Salary & Increasing Fixed Expenses,179504,58661.0,49678,108339.0,71165.0,39.65,-0.05,Low Risk
U759,2024,3,357063.0,Stable Salary & Increasing Fixed Expenses,179504,58661.0,45198,103859.0,75645.0,42.14,-0.05,Low Risk
U759,2024,4,432708.0,Stable Salary & Increasing Fixed Expenses,179504,58661.0,42791,101452.0,78052.0,43.48,-0.04,Low Risk
U759,2024,5,510760.0,Stable Salary & Increasing Fixed Expenses,179504,58661.0,50725,109386.0,70118.0,39.06,0.04,Low Risk
U759,2024,6,580878.0,Stable Salary & Increasing Fixed Expenses,179504,58661.0,38060,96721.0,82783.0,46.12,0.0,Low Risk
U759,2024,7,663661.0,Stable Salary & Increasing Fixed Expenses,179504,58661.0,44855,103516.0,75988.0,42.33,-0.01,Low Risk
U759,2024,8,739649.0,Stable Salary & Increasing Fixed Expenses,179504,58661.0,37927,96588.0,82916.0,46.19,-0.03,Low Risk
U759,2024,9,822565.0,Stable Salary & Increasing Fixed Expenses,179504,58661.0,47025,105686.0,73818.0,41.12,-0.03,Low Risk
U759,2024,10,896383.0,Stable Salary & Increasing Fixed Expenses,179504,58661.0,44161,102822.0,76682.0,42.72,-0.01,Low Risk
U759,2024,11,973065.0,Stable Salary & Increasing Fixed Expenses,179504,59360.0,49138,108498.0,71006.0,39.56,0.05,Low Risk
U759,2024,12,1044071.0,Stable Salary & Increasing Fixed Expenses,179504,59360.0,51391,110751.0,68753.0,38.3,-0.04,Low Risk
U760,2024,1,81362.0,Stable Salary & Stable Fixed Expenses,31474,14907.0,7204,22111.0,9363.0,29.75,0.03,Low Risk
U760,2024,2,90725.0,Stable Salary & Stable Fixed Expenses,31474,14907.0,7724,22631.0,8843.0,28.1,-0.03,Low Risk
U760,2024,3,99568.0,Stable Salary & Stable Fixed Expenses,31474,14907.0,9260,24167.0,7307.0,23.22,-0.03,Medium Risk
U760,2024,4,106875.0,Stable Salary & Stable Fixed Expenses,31474,14907.0,7846,22753.0,8721.0,27.71,-0.01,Low Risk
U760,2024,5,115596.0,Stable Salary & Stable Fixed Expenses,31474,14907.0,8554,23461.0,8013.0,25.46,0.04,Low Risk
U760,2024,6,123609.0,Stable Salary & Stable Fixed Expenses,31474,14907.0,6930,21837.0,9637.0,30.62,0.02,Low Risk
U760,2024,7,133246.0,Stable Salary & Stable Fixed Expenses,31474,14907.0,7542,22449.0,9025.0,28.67,-0.01,Low Risk
U760,2024,8,142271.0,Stable Salary & Stable Fixed Expenses,31474,14907.0,6752,21659.0,9815.0,31.18,-0.04,Low Risk
U760,2024,9,152086.0,Stable Salary & Stable Fixed Expenses,31474,14907.0,9723,24630.0,6844.0,21.74,-0.03,Medium Risk
U760,2024,10,158930.0,Stable Salary & Stable Fixed Expenses,31474,14907.0,9166,24073.0,7401.0,23.51,-0.03,Medium Risk
U760,2024,11,166331.0,Stable Salary & Stable Fixed Expenses,31474,14907.0,7027,21934.0,9540.0,30.31,0.01,Low Risk
U760,2024,12,175871.0,Stable Salary & Stable Fixed Expenses,31474,14907.0,7644,22551.0,8923.0,28.35,-0.03,Low Risk
U761,2024,1,204591.0,Stable Salary & Stable Fixed Expenses,176701,72767.0,40584,113351.0,63350.0,35.85,-0.03,Low Risk
U761,2024,2,267941.0,Stable Salary & Stable Fixed Expenses,176701,72767.0,36104,108871.0,67830.0,38.39,0.02,Low Risk
U761,2024,3,335771.0,Stable Salary & Stable Fixed Expenses,176701,72767.0,58981,131748.0,44953.0,25.44,0.02,Low Risk
U761,2024,4,380724.0,Stable Salary & Stable Fixed Expenses,176701,72767.0,41489,114256.0,62445.0,35.34,0.02,Low Risk
U761,2024,5,443169.0,Stable Salary & Stable Fixed Expenses,176701,72767.0,40548,113315.0,63386.0,35.87,0.01,Low Risk
U761,2024,6,506555.0,Stable Salary & Stable Fixed Expenses,176701,72767.0,42004,114771.0,61930.0,35.05,-0.01,Low Risk
U761,2024,7,568485.0,Stable Salary & Stable Fixed Expenses,176701,72767.0,50415,123182.0,53519.0,30.29,0.04,Low Risk
U761,2024,8,622004.0,Stable Salary & Stable Fixed Expenses,176701,72767.0,50105,122872.0,53829.0,30.46,0.01,Low Risk
U761,2024,9,675833.0,Stable Salary & Stable Fixed Expenses,176701,72767.0,53701,126468.0,50233.0,28.43,-0.04,Low Risk
U761,2024,10,726066.0,Stable Salary & Stable Fixed Expenses,176701,72767.0,64117,136884.0,39817.0,22.53,-0.01,Medium Risk
U761,2024,11,765883.0,Stable Salary & Stable Fixed Expenses,176701,72767.0,47367,120134.0,56567.0,32.01,0.03,Low Risk
U761,2024,12,822450.0,Stable Salary & Stable Fixed Expenses,176701,72767.0,62677,135444.0,41257.0,23.35,-0.0,Medium Risk
U762,2024,1,250000.0,Salary Increases & Fixed Expenses Remain Stable,275528,82802.0,93945,176747.0,98781.0,35.85,-0.04,Low Risk
U762,2024,2,348781.0,Salary Increases & Fixed Expenses Remain Stable,275528,82802.0,105434,188236.0,87292.0,31.68,-0.02,Low Risk
U762,2024,3,436073.0,Salary Increases & Fixed Expenses Remain Stable,288272,82802.0,95630,178432.0,109840.0,38.1,0.02,Low Risk
U762,2024,4,545913.0,Salary Increases & Fixed Expenses Remain Stable,288272,82802.0,132008,214810.0,73462.0,25.48,-0.01,Low Risk
U762,2024,5,619375.0,Salary Increases & Fixed Expenses Remain Stable,288272,82802.0,139445,222247.0,66025.0,22.9,-0.01,Medium Risk
U762,2024,6,685400.0,Salary Increases & Fixed Expenses Remain Stable,288272,82802.0,128044,210846.0,77426.0,26.86,0.04,Low Risk
U762,2024,7,762826.0,Salary Increases & Fixed Expenses Remain Stable,288272,82802.0,124142,206944.0,81328.0,28.21,-0.05,Low Risk
U762,2024,8,844154.0,Salary Increases & Fixed Expenses Remain Stable,288272,82802.0,107290,190092.0,98180.0,34.06,0.03,Low Risk
U762,2024,9,942334.0,Salary Increases & Fixed Expenses Remain Stable,288272,82802.0,95562,178364.0,109908.0,38.13,-0.0,Low Risk
U762,2024,10,1052242.0,Salary Increases & Fixed Expenses Remain Stable,288272,82802.0,88986,171788.0,116484.0,40.41,0.04,Low Risk
U762,2024,11,1168726.0,Salary Increases & Fixed Expenses Remain Stable,288272,82802.0,112720,195522.0,92750.0,32.17,0.0,Low Risk
U762,2024,12,1261476.0,Salary Increases & Fixed Expenses Remain Stable,288272,82802.0,139506,222308.0,65964.0,22.88,0.01,Medium Risk
U763,2024,1,114309.0,Salary Increases & Fixed Expenses Remain Stable,52073,31774.0,18958,50732.0,1341.0,2.58,0.0,High Risk
U763,2024,2,115650.0,Salary Increases & Fixed Expenses Remain Stable,52073,31774.0,19713,51487.0,586.0,1.13,-0.04,High Risk
U763,2024,3,116236.0,Salary Increases & Fixed Expenses Remain Stable,52073,31774.0,25114,56888.0,-4815.0,-9.25,-0.01,High Risk
U763,2024,4,111421.0,Salary Increases & Fixed Expenses Remain Stable,52073,31774.0,19194,50968.0,1105.0,2.12,0.04,High Risk
U763,2024,5,112526.0,Salary Increases & Fixed Expenses Remain Stable,73458,31774.0,30462,62236.0,11222.0,15.28,-0.03,Medium Risk
U763,2024,6,123748.0,Salary Increases & Fixed Expenses Remain Stable,73458,31774.0,28350,60124.0,13334.0,18.15,0.02,Medium Risk
U763,2024,7,137082.0,Salary Increases & Fixed Expenses Remain Stable,73458,31774.0,25393,57167.0,16291.0,22.18,-0.02,Medium Risk
U763,2024,8,153373.0,Salary Increases & Fixed Expenses Remain Stable,73458,31774.0,24683,56457.0,17001.0,23.14,-0.01,Medium Risk
U763,2024,9,170374.0,Salary Increases & Fixed Expenses Remain Stable,73458,31774.0,38983,70757.0,2701.0,3.68,0.0,High Risk
U763,2024,10,173075.0,Salary Increases & Fixed Expenses Remain Stable,73458,31774.0,40026,71800.0,1658.0,2.26,0.03,High Risk
U763,2024,11,174733.0,Salary Increases & Fixed Expenses Remain Stable,73458,31774.0,35856,67630.0,5828.0,7.93,-0.01,High Risk
U763,2024,12,180561.0,Salary Increases & Fixed Expenses Remain Stable,73458,31774.0,27877,59651.0,13807.0,18.8,-0.01,Medium Risk
U764,2024,1,249369.0,Salary Increases & Fixed Expenses Increase,242728,109555.0,54667,164222.0,78506.0,32.34,-0.02,Low Risk
U764,2024,2,327875.0,Salary Increases & Fixed Expenses Increase,242728,109555.0,66051,175606.0,67122.0,27.65,-0.04,Low Risk
U764,2024,3,394997.0,Salary Increases & Fixed Expenses Increase,242728,109555.0,63451,173006.0,69722.0,28.72,0.01,Low Risk
U764,2024,4,464719.0,Salary Increases & Fixed Expenses Increase,242728,110733.0,50825,161558.0,81170.0,33.44,0.04,Low Risk
U764,2024,5,545889.0,Salary Increases & Fixed Expenses Increase,242728,110733.0,71738,182471.0,60257.0,24.82,-0.0,Medium Risk
U764,2024,6,606146.0,Salary Increases & Fixed Expenses Increase,242728,110733.0,52332,163065.0,79663.0,32.82,-0.04,Low Risk
U764,2024,7,685809.0,Salary Increases & Fixed Expenses Increase,271225,110733.0,73660,184393.0,86832.0,32.01,0.01,Low Risk
U764,2024,8,772641.0,Salary Increases & Fixed Expenses Increase,271225,110733.0,71533,182266.0,88959.0,32.8,-0.01,Low Risk
U764,2024,9,861600.0,Salary Increases & Fixed Expenses Increase,271225,111878.0,92607,204485.0,66740.0,24.61,0.02,Medium Risk
U764,2024,10,928340.0,Salary Increases & Fixed Expenses Increase,271225,111878.0,56169,168047.0,103178.0,38.04,0.0,Low Risk
U764,2024,11,1031518.0,Salary Increases & Fixed Expenses Increase,271225,112867.0,64793,177660.0,93565.0,34.5,0.01,Low Risk
U764,2024,12,1125083.0,Salary Increases & Fixed Expenses Increase,271225,112867.0,69955,182822.0,88403.0,32.59,0.02,Low Risk
U765,2024,1,112198.0,Salary Increases & Fixed Expenses Increase,54058,37069.0,12741,49810.0,4248.0,7.86,0.01,High Risk
U765,2024,2,116446.0,Salary Increases & Fixed Expenses Increase,54058,37069.0,11315,48384.0,5674.0,10.5,0.01,High Risk
U765,2024,3,122120.0,Salary Increases & Fixed Expenses Increase,54058,37069.0,14679,51748.0,2310.0,4.27,0.01,High Risk
U765,2024,4,124430.0,Salary Increases & Fixed Expenses Increase,54058,37069.0,12413,49482.0,4576.0,8.46,-0.04,High Risk
U765,2024,5,129006.0,Salary Increases & Fixed Expenses Increase,70873,37069.0,16165,53234.0,17639.0,24.89,-0.02,Medium Risk
U765,2024,6,146645.0,Salary Increases & Fixed Expenses Increase,70873,37069.0,20955,58024.0,12849.0,18.13,0.02,Medium Risk
U765,2024,7,159494.0,Salary Increases & Fixed Expenses Increase,70873,37069.0,14913,51982.0,18891.0,26.65,0.01,Low Risk
U765,2024,8,178385.0,Salary Increases & Fixed Expenses Increase,70873,37069.0,17895,54964.0,15909.0,22.45,-0.03,Medium Risk
U765,2024,9,194294.0,Salary Increases & Fixed Expenses Increase,70873,37069.0,16030,53099.0,17774.0,25.08,-0.03,Low Risk
U765,2024,10,212068.0,Salary Increases & Fixed Expenses Increase,70873,37069.0,16276,53345.0,17528.0,24.73,0.01,Medium Risk
U765,2024,11,229596.0,Salary Increases & Fixed Expenses Increase,70873,38631.0,16010,54641.0,16232.0,22.9,0.01,Medium Risk
U765,2024,12,245828.0,Salary Increases & Fixed Expenses Increase,70873,38631.0,20937,59568.0,11305.0,15.95,-0.03,Medium Risk
U766,2024,1,132525.0,Salary Increases & Fixed Expenses Increase,65767,23932.0,22565,46497.0,19270.0,29.3,0.0,Low Risk
U766,2024,2,151795.0,Salary Increases & Fixed Expenses Increase,65767,25107.0,31063,56170.0,9597.0,14.59,-0.05,High Risk
U766,2024,3,161392.0,Salary Increases & Fixed Expenses Increase,65767,25107.0,24284,49391.0,16376.0,24.9,0.02,Medium Risk
U766,2024,4,177768.0,Salary Increases & Fixed Expenses Increase,65767,25723.0,32667,58390.0,7377.0,11.22,0.03,High Risk
U766,2024,5,185145.0,Salary Increases & Fixed Expenses Increase,65767,25723.0,21203,46926.0,18841.0,28.65,0.04,Low Risk
U766,2024,6,203986.0,Salary Increases & Fixed Expenses Increase,65767,25723.0,23990,49713.0,16054.0,24.41,-0.05,Medium Risk
U766,2024,7,220040.0,Salary Increases & Fixed Expenses Increase,82765,25723.0,35002,60725.0,22040.0,26.63,0.05,Low Risk
U766,2024,8,242080.0,Salary Increases & Fixed Expenses Increase,82765,25723.0,29582,55305.0,27460.0,33.18,-0.04,Low Risk
U766,2024,9,269540.0,Salary Increases & Fixed Expenses Increase,82765,25723.0,32611,58334.0,24431.0,29.52,0.04,Low Risk
U766,2024,10,293971.0,Salary Increases & Fixed Expenses Increase,82765,25723.0,30190,55913.0,26852.0,32.44,-0.02,Low Risk
U766,2024,11,320823.0,Salary Increases & Fixed Expenses Increase,82765,25723.0,33164,58887.0,23878.0,28.85,-0.02,Low Risk
U766,2024,12,344701.0,Salary Increases & Fixed Expenses Increase,82765,25723.0,31763,57486.0,25279.0,30.54,0.0,Low Risk
U767,2024,1,250000.0,Stable Salary & Stable Fixed Expenses,259582,97753.0,79221,176974.0,82608.0,31.82,-0.04,Low Risk
U767,2024,2,332608.0,Stable Salary & Stable Fixed Expenses,259582,97753.0,125203,222956.0,36626.0,14.11,-0.03,High Risk
U767,2024,3,369234.0,Stable Salary & Stable Fixed Expenses,259582,97753.0,87866,185619.0,73963.0,28.49,-0.01,Low Risk
U767,2024,4,443197.0,Stable Salary & Stable Fixed Expenses,259582,97753.0,101857,199610.0,59972.0,23.1,-0.01,Medium Risk
U767,2024,5,503169.0,Stable Salary & Stable Fixed Expenses,259582,97753.0,119133,216886.0,42696.0,16.45,0.05,Medium Risk
U767,2024,6,545865.0,Stable Salary & Stable Fixed Expenses,259582,97753.0,98713,196466.0,63116.0,24.31,-0.02,Medium Risk
U767,2024,7,608981.0,Stable Salary & Stable Fixed Expenses,259582,97753.0,113442,211195.0,48387.0,18.64,0.05,Medium Risk
U767,2024,8,657368.0,Stable Salary & Stable Fixed Expenses,259582,97753.0,117052,214805.0,44777.0,17.25,-0.03,Medium Risk
U767,2024,9,702145.0,Stable Salary & Stable Fixed Expenses,259582,97753.0,117316,215069.0,44513.0,17.15,0.01,Medium Risk
U767,2024,10,746658.0,Stable Salary & Stable Fixed Expenses,259582,97753.0,79007,176760.0,82822.0,31.91,-0.03,Low Risk
U767,2024,11,829480.0,Stable Salary & Stable Fixed Expenses,259582,97753.0,127503,225256.0,34326.0,13.22,-0.02,High Risk
U767,2024,12,863806.0,Stable Salary & Stable Fixed Expenses,259582,97753.0,108111,205864.0,53718.0,20.69,0.04,Medium Risk
U768,2024,1,250000.0,Salary Increases & Fixed Expenses Increase,260470,70201.0,122929,193130.0,67340.0,25.85,0.0,Low Risk
U768,2024,2,317340.0,Salary Increases & Fixed Expenses Increase,260470,70201.0,94861,165062.0,95408.0,36.63,-0.04,Low Risk
U768,2024,3,412748.0,Salary Increases & Fixed Expenses Increase,260470,70201.0,114265,184466.0,76004.0,29.18,0.0,Low Risk
U768,2024,4,488752.0,Salary Increases & Fixed Expenses Increase,260470,70935.0,84577,155512.0,104958.0,40.3,0.03,Low Risk
U768,2024,5,593710.0,Salary Increases & Fixed Expenses Increase,260470,70935.0,98678,169613.0,90857.0,34.88,0.04,Low Risk
U768,2024,6,684567.0,Salary Increases & Fixed Expenses Increase,260470,70935.0,108697,179632.0,80838.0,31.04,-0.02,Low Risk
U768,2024,7,765405.0,Salary Increases & Fixed Expenses Increase,260470,70935.0,80078,151013.0,109457.0,42.02,0.04,Low Risk
U768,2024,8,874862.0,Salary Increases & Fixed Expenses Increase,281881,70935.0,92743,163678.0,118203.0,41.93,0.02,Low Risk
U768,2024,9,993065.0,Salary Increases & Fixed Expenses Increase,281881,71821.0,145200,217021.0,64860.0,23.01,0.0,Medium Risk
U768,2024,10,1057925.0,Salary Increases & Fixed Expenses Increase,281881,71821.0,107728,179549.0,102332.0,36.3,-0.03,Low Risk
U768,2024,11,1160257.0,Salary Increases & Fixed Expenses Increase,281881,71821.0,102323,174144.0,107737.0,38.22,-0.05,Low Risk
U768,2024,12,1267994.0,Salary Increases & Fixed Expenses Increase,281881,71821.0,110858,182679.0,99202.0,35.19,-0.05,Low Risk
U769,2024,1,250000.0,Salary Increases & Fixed Expenses Remain Stable,260454,63238.0,72000,135238.0,125216.0,48.08,0.01,Low Risk
U769,2024,2,375216.0,Salary Increases & Fixed Expenses Remain Stable,260454,63238.0,69344,132582.0,127872.0,49.1,-0.02,Low Risk
U769,2024,3,503088.0,Salary Increases & Fixed Expenses Remain Stable,260454,63238.0,62588,125826.0,134628.0,51.69,0.01,Low Risk
U769,2024,4,637716.0,Salary Increases & Fixed Expenses Remain Stable,260454,63238.0,69198,132436.0,128018.0,49.15,-0.03,Low Risk
U769,2024,5,765734.0,Salary Increases & Fixed Expenses Remain Stable,275443,63238.0,68091,131329.0,144114.0,52.32,0.03,Low Risk
U769,2024,6,909848.0,Salary Increases & Fixed Expenses Remain Stable,275443,63238.0,78058,141296.0,134147.0,48.7,0.04,Low Risk
U769,2024,7,1043995.0,Salary Increases & Fixed Expenses Remain Stable,275443,63238.0,82091,145329.0,130114.0,47.24,-0.02,Low Risk
U769,2024,8,1174109.0,Salary Increases & Fixed Expenses Remain Stable,275443,63238.0,64420,127658.0,147785.0,53.65,0.01,Low Risk
U769,2024,9,1321894.0,Salary Increases & Fixed Expenses Remain Stable,275443,63238.0,88991,152229.0,123214.0,44.73,0.02,Low Risk
U769,2024,10,1445108.0,Salary Increases & Fixed Expenses Remain Stable,275443,63238.0,65593,128831.0,146612.0,53.23,0.02,Low Risk
U769,2024,11,1591720.0,Salary Increases & Fixed Expenses Remain Stable,275443,63238.0,81498,144736.0,130707.0,47.45,-0.03,Low Risk
U769,2024,12,1722427.0,Salary Increases & Fixed Expenses Remain Stable,275443,63238.0,81230,144468.0,130975.0,47.55,0.03,Low Risk
U770,2024,1,250000.0,Salary Increases & Fixed Expenses Increase,256780,103750.0,64452,168202.0,88578.0,34.5,0.02,Low Risk
U770,2024,2,338578.0,Salary Increases & Fixed Expenses Increase,256780,103750.0,68221,171971.0,84809.0,33.03,-0.04,Low Risk
U770,2024,3,423387.0,Salary Increases & Fixed Expenses Increase,256780,103750.0,72100,175850.0,80930.0,31.52,-0.03,Low Risk
U770,2024,4,504317.0,Salary Increases & Fixed Expenses Increase,256780,104873.0,57116,161989.0,94791.0,36.92,0.05,Low Risk
U770,2024,5,599108.0,Salary Increases & Fixed Expenses Increase,256780,104873.0,57891,162764.0,94016.0,36.61,-0.01,Low Risk
U770,2024,6,693124.0,Salary Increases & Fixed Expenses Increase,256780,104873.0,53591,158464.0,98316.0,38.29,0.01,Low Risk
U770,2024,7,791440.0,Salary Increases & Fixed Expenses Increase,256780,104873.0,73717,178590.0,78190.0,30.45,-0.01,Low Risk
U770,2024,8,869630.0,Salary Increases & Fixed Expenses Increase,267403,104873.0,58493,163366.0,104037.0,38.91,0.05,Low Risk
U770,2024,9,973667.0,Salary Increases & Fixed Expenses Increase,267403,104873.0,64162,169035.0,98368.0,36.79,0.03,Low Risk
U770,2024,10,1072035.0,Salary Increases & Fixed Expenses Increase,267403,104873.0,55699,160572.0,106831.0,39.95,0.03,Low Risk
U770,2024,11,1178866.0,Salary Increases & Fixed Expenses Increase,267403,104873.0,66437,171310.0,96093.0,35.94,0.02,Low Risk
U770,2024,12,1274959.0,Salary Increases & Fixed Expenses Increase,267403,104873.0,55702,160575.0,106828.0,39.95,-0.05,Low Risk
U771,2024,1,219281.0,Salary Increases & Fixed Expenses Increase,213317,105940.0,60280,166220.0,47097.0,22.08,-0.03,Medium Risk
U771,2024,2,266378.0,Salary Increases & Fixed Expenses Increase,213317,105940.0,48383,154323.0,58994.0,27.66,0.02,Low Risk
U771,2024,3,325372.0,Salary Increases & Fixed Expenses Increase,213317,107635.0,48677,156312.0,57005.0,26.72,-0.0,Low Risk
U771,2024,4,382377.0,Salary Increases & Fixed Expenses Increase,238545,107635.0,58156,165791.0,72754.0,30.5,-0.02,Low Risk
U771,2024,5,455131.0,Salary Increases & Fixed Expenses Increase,238545,107635.0,53522,161157.0,77388.0,32.44,-0.02,Low Risk
U771,2024,6,532519.0,Salary Increases & Fixed Expenses Increase,238545,107635.0,58180,165815.0,72730.0,30.49,-0.03,Low Risk
U771,2024,7,605249.0,Salary Increases & Fixed Expenses Increase,238545,107635.0,48330,155965.0,82580.0,34.62,0.03,Low Risk
U771,2024,8,687829.0,Salary Increases & Fixed Expenses Increase,238545,107635.0,63254,170889.0,67656.0,28.36,-0.03,Low Risk
U771,2024,9,755485.0,Salary Increases & Fixed Expenses Increase,238545,107635.0,67729,175364.0,63181.0,26.49,0.02,Low Risk
U771,2024,10,818666.0,Salary Increases & Fixed Expenses Increase,238545,107635.0,63282,170917.0,67628.0,28.35,0.01,Low Risk
U771,2024,11,886294.0,Salary Increases & Fixed Expenses Increase,238545,108814.0,61770,170584.0,67961.0,28.49,-0.02,Low Risk
U771,2024,12,954255.0,Salary Increases & Fixed Expenses Increase,238545,109456.0,65023,174479.0,64066.0,26.86,-0.04,Low Risk
U772,2024,1,69879.0,Stable Salary & Stable Fixed Expenses,44972,14340.0,15807,30147.0,14825.0,32.96,-0.03,Low Risk
U772,2024,2,84704.0,Stable Salary & Stable Fixed Expenses,44972,14340.0,15013,29353.0,15619.0,34.73,-0.04,Low Risk
U772,2024,3,100323.0,Stable Salary & Stable Fixed Expenses,44972,14340.0,24067,38407.0,6565.0,14.6,0.03,High Risk
U772,2024,4,106888.0,Stable Salary & Stable Fixed Expenses,44972,14340.0,13511,27851.0,17121.0,38.07,-0.02,Low Risk
U772,2024,5,124009.0,Stable Salary & Stable Fixed Expenses,44972,14340.0,14390,28730.0,16242.0,36.12,-0.04,Low Risk
U772,2024,6,140251.0,Stable Salary & Stable Fixed Expenses,44972,14340.0,21468,35808.0,9164.0,20.38,0.05,Medium Risk
U772,2024,7,149415.0,Stable Salary & Stable Fixed Expenses,44972,14340.0,19620,33960.0,11012.0,24.49,-0.04,Medium Risk
U772,2024,8,160427.0,Stable Salary & Stable Fixed Expenses,44972,14340.0,13534,27874.0,17098.0,38.02,-0.02,Low Risk
U772,2024,9,177525.0,Stable Salary & Stable Fixed Expenses,44972,14340.0,19500,33840.0,11132.0,24.75,-0.05,Medium Risk
U772,2024,10,188657.0,Stable Salary & Stable Fixed Expenses,44972,14340.0,24730,39070.0,5902.0,13.12,-0.04,High Risk
U772,2024,11,194559.0,Stable Salary & Stable Fixed Expenses,44972,14340.0,23792,38132.0,6840.0,15.21,0.02,Medium Risk
U772,2024,12,201399.0,Stable Salary & Stable Fixed Expenses,44972,14340.0,24440,38780.0,6192.0,13.77,0.01,High Risk
U773,2024,1,240809.0,Stable Salary & Stable Fixed Expenses,215171,60003.0,63650,123653.0,91518.0,42.53,-0.01,Low Risk
U773,2024,2,332327.0,Stable Salary & Stable Fixed Expenses,215171,60003.0,48437,108440.0,106731.0,49.6,0.04,Low Risk
U773,2024,3,439058.0,Stable Salary & Stable Fixed Expenses,215171,60003.0,50327,110330.0,104841.0,48.72,-0.04,Low Risk
U773,2024,4,543899.0,Stable Salary & Stable Fixed Expenses,215171,60003.0,61176,121179.0,93992.0,43.68,-0.02,Low Risk
U773,2024,5,637891.0,Stable Salary & Stable Fixed Expenses,215171,60003.0,47027,107030.0,108141.0,50.26,-0.0,Low Risk
U773,2024,6,746032.0,Stable Salary & Stable Fixed Expenses,215171,60003.0,51485,111488.0,103683.0,48.19,0.03,Low Risk
U773,2024,7,849715.0,Stable Salary & Stable Fixed Expenses,215171,60003.0,57161,117164.0,98007.0,45.55,-0.04,Low Risk
U773,2024,8,947722.0,Stable Salary & Stable Fixed Expenses,215171,60003.0,56854,116857.0,98314.0,45.69,0.03,Low Risk
U773,2024,9,1046036.0,Stable Salary & Stable Fixed Expenses,215171,60003.0,60464,120467.0,94704.0,44.01,-0.03,Low Risk
U773,2024,10,1140740.0,Stable Salary & Stable Fixed Expenses,215171,60003.0,52097,112100.0,103071.0,47.9,0.02,Low Risk
U773,2024,11,1243811.0,Stable Salary & Stable Fixed Expenses,215171,60003.0,58495,118498.0,96673.0,44.93,0.0,Low Risk
U773,2024,12,1340484.0,Stable Salary & Stable Fixed Expenses,215171,60003.0,54419,114422.0,100749.0,46.82,0.0,Low Risk
U774,2024,1,150952.0,Salary Increases & Fixed Expenses Remain Stable,116670,58416.0,33599,92015.0,24655.0,21.13,0.02,Medium Risk
U774,2024,2,175607.0,Salary Increases & Fixed Expenses Remain Stable,116670,58416.0,31616,90032.0,26638.0,22.83,0.03,Medium Risk
U774,2024,3,202245.0,Salary Increases & Fixed Expenses Remain Stable,116670,58416.0,31052,89468.0,27202.0,23.32,-0.01,Medium Risk
U774,2024,4,229447.0,Salary Increases & Fixed Expenses Remain Stable,116670,58416.0,30293,88709.0,27961.0,23.97,0.02,Medium Risk
U774,2024,5,257408.0,Salary Increases & Fixed Expenses Remain Stable,116670,58416.0,34965,93381.0,23289.0,19.96,0.05,Medium Risk
U774,2024,6,280697.0,Salary Increases & Fixed Expenses Remain Stable,116670,58416.0,33623,92039.0,24631.0,21.11,0.04,Medium Risk
U774,2024,7,305328.0,Salary Increases & Fixed Expenses Remain Stable,116670,58416.0,29978,88394.0,28276.0,24.24,0.03,Medium Risk
U774,2024,8,333604.0,Salary Increases & Fixed Expenses Remain Stable,145113,58416.0,35614,94030.0,51083.0,35.2,-0.04,Low Risk
U774,2024,9,384687.0,Salary Increases & Fixed Expenses Remain Stable,145113,58416.0,39325,97741.0,47372.0,32.64,-0.03,Low Risk
U774,2024,10,432059.0,Salary Increases & Fixed Expenses Remain Stable,145113,58416.0,38560,96976.0,48137.0,33.17,-0.01,Low Risk
U774,2024,11,480196.0,Salary Increases & Fixed Expenses Remain Stable,145113,58416.0,44627,103043.0,42070.0,28.99,-0.02,Low Risk
U774,2024,12,522266.0,Salary Increases & Fixed Expenses Remain Stable,145113,58416.0,38554,96970.0,48143.0,33.18,-0.01,Low Risk
U775,2024,1,248226.0,Salary Increases & Fixed Expenses Decrease,153201,65049.0,82696,147745.0,5456.0,3.56,-0.05,High Risk
U775,2024,2,253682.0,Salary Increases & Fixed Expenses Decrease,153201,65049.0,90540,155589.0,-2388.0,-1.56,-0.0,High Risk
U775,2024,3,251294.0,Salary Increases & Fixed Expenses Decrease,168954,65049.0,114066,179115.0,-10161.0,-6.01,0.01,High Risk
U775,2024,4,241133.0,Salary Increases & Fixed Expenses Decrease,168954,65049.0,98739,163788.0,5166.0,3.06,0.0,High Risk
U775,2024,5,246299.0,Salary Increases & Fixed Expenses Decrease,168954,65049.0,101545,166594.0,2360.0,1.4,-0.03,High Risk
U775,2024,6,248659.0,Salary Increases & Fixed Expenses Decrease,168954,63549.0,104123,167672.0,1282.0,0.76,0.04,High Risk
U775,2024,7,249941.0,Salary Increases & Fixed Expenses Decrease,168954,63549.0,113392,176941.0,-7987.0,-4.73,0.04,High Risk
U775,2024,8,241954.0,Salary Increases & Fixed Expenses Decrease,168954,62874.0,96764,159638.0,9316.0,5.51,0.04,High Risk
U775,2024,9,251270.0,Salary Increases & Fixed Expenses Decrease,168954,62874.0,114968,177842.0,-8888.0,-5.26,-0.03,High Risk
U775,2024,10,242382.0,Salary Increases & Fixed Expenses Decrease,168954,62874.0,92341,155215.0,13739.0,8.13,-0.04,High Risk
U775,2024,11,256121.0,Salary Increases & Fixed Expenses Decrease,168954,62874.0,107126,170000.0,-1046.0,-0.62,0.05,High Risk
U775,2024,12,255075.0,Salary Increases & Fixed Expenses Decrease,168954,62874.0,100595,163469.0,5485.0,3.25,-0.0,High Risk
U776,2024,1,238155.0,Salary Increases & Fixed Expenses Remain Stable,220097,113768.0,85498,199266.0,20831.0,9.46,0.0,High Risk
U776,2024,2,258986.0,Salary Increases & Fixed Expenses Remain Stable,220097,113768.0,85743,199511.0,20586.0,9.35,0.0,High Risk
U776,2024,3,279572.0,Salary Increases & Fixed Expenses Remain Stable,220097,113768.0,87197,200965.0,19132.0,8.69,0.05,High Risk
U776,2024,4,298704.0,Salary Increases & Fixed Expenses Remain Stable,228243,113768.0,80921,194689.0,33554.0,14.7,0.03,High Risk
U776,2024,5,332258.0,Salary Increases & Fixed Expenses Remain Stable,228243,113768.0,69434,183202.0,45041.0,19.73,0.01,Medium Risk
U776,2024,6,377299.0,Salary Increases & Fixed Expenses Remain Stable,228243,113768.0,80467,194235.0,34008.0,14.9,-0.02,High Risk
U776,2024,7,411307.0,Salary Increases & Fixed Expenses Remain Stable,228243,113768.0,72985,186753.0,41490.0,18.18,-0.02,Medium Risk
U776,2024,8,452797.0,Salary Increases & Fixed Expenses Remain Stable,228243,113768.0,108896,222664.0,5579.0,2.44,0.03,High Risk
U776,2024,9,458376.0,Salary Increases & Fixed Expenses Remain Stable,228243,113768.0,102708,216476.0,11767.0,5.16,0.05,High Risk
U776,2024,10,470143.0,Salary Increases & Fixed Expenses Remain Stable,228243,113768.0,104789,218557.0,9686.0,4.24,0.03,High Risk
U776,2024,11,479829.0,Salary Increases & Fixed Expenses Remain Stable,228243,113768.0,84254,198022.0,30221.0,13.24,0.04,High Risk
U776,2024,12,510050.0,Salary Increases & Fixed Expenses Remain Stable,228243,113768.0,84285,198053.0,30190.0,13.23,0.02,High Risk
U777,2024,1,250000.0,Stable Salary & Stable Fixed Expenses,268732,108798.0,130735,239533.0,29199.0,10.87,0.01,High Risk
U777,2024,2,279199.0,Stable Salary & Stable Fixed Expenses,268732,108798.0,106592,215390.0,53342.0,19.85,0.04,Medium Risk
U777,2024,3,332541.0,Stable Salary & Stable Fixed Expenses,268732,108798.0,110417,219215.0,49517.0,18.43,-0.02,Medium Risk
U777,2024,4,382058.0,Stable Salary & Stable Fixed Expenses,268732,108798.0,125892,234690.0,34042.0,12.67,-0.0,High Risk
U777,2024,5,416100.0,Stable Salary & Stable Fixed Expenses,268732,108798.0,116052,224850.0,43882.0,16.33,-0.04,Medium Risk
U777,2024,6,459982.0,Stable Salary & Stable Fixed Expenses,268732,108798.0,124987,233785.0,34947.0,13.0,0.02,High Risk
U777,2024,7,494929.0,Stable Salary & Stable Fixed Expenses,268732,108798.0,82280,191078.0,77654.0,28.9,0.03,Low Risk
U777,2024,8,572583.0,Stable Salary & Stable Fixed Expenses,268732,108798.0,96227,205025.0,63707.0,23.71,0.02,Medium Risk
U777,2024,9,636290.0,Stable Salary & Stable Fixed Expenses,268732,108798.0,107128,215926.0,52806.0,19.65,-0.05,Medium Risk
U777,2024,10,689096.0,Stable Salary & Stable Fixed Expenses,268732,108798.0,123755,232553.0,36179.0,13.46,0.03,High Risk
U777,2024,11,725275.0,Stable Salary & Stable Fixed Expenses,268732,108798.0,141129,249927.0,18805.0,7.0,-0.04,High Risk
U777,2024,12,744080.0,Stable Salary & Stable Fixed Expenses,268732,108798.0,166726,275524.0,-6792.0,-2.53,0.03,High Risk
U778,2024,1,206794.0,Salary Increases & Fixed Expenses Decrease,149986,69160.0,64588,133748.0,16238.0,10.83,0.0,High Risk
U778,2024,2,223032.0,Salary Increases & Fixed Expenses Decrease,149986,69160.0,64060,133220.0,16766.0,11.18,0.03,High Risk
U778,2024,3,239798.0,Salary Increases & Fixed Expenses Decrease,149986,69160.0,59677,128837.0,21149.0,14.1,0.01,High Risk
U778,2024,4,260947.0,Salary Increases & Fixed Expenses Decrease,149986,69160.0,45969,115129.0,34857.0,23.24,-0.04,Medium Risk
U778,2024,5,295804.0,Salary Increases & Fixed Expenses Decrease,171629,69160.0,69164,138324.0,33305.0,19.41,0.04,Medium Risk
U778,2024,6,329109.0,Salary Increases & Fixed Expenses Decrease,171629,69160.0,82298,151458.0,20171.0,11.75,0.01,High Risk
U778,2024,7,349280.0,Salary Increases & Fixed Expenses Decrease,171629,69160.0,81085,150245.0,21384.0,12.46,0.04,High Risk
U778,2024,8,370664.0,Salary Increases & Fixed Expenses Decrease,171629,69160.0,85727,154887.0,16742.0,9.75,-0.02,High Risk
U778,2024,9,387406.0,Salary Increases & Fixed Expenses Decrease,171629,69160.0,55830,124990.0,46639.0,27.17,-0.02,Low Risk
U778,2024,10,434045.0,Salary Increases & Fixed Expenses Decrease,171629,69160.0,69568,138728.0,32901.0,19.17,-0.02,Medium Risk
U778,2024,11,466946.0,Salary Increases & Fixed Expenses Decrease,171629,69160.0,70997,140157.0,31472.0,18.34,-0.0,Medium Risk
U778,2024,12,498418.0,Salary Increases & Fixed Expenses Decrease,171629,69160.0,61028,130188.0,41441.0,24.15,-0.04,Medium Risk
U779,2024,1,250000.0,Salary Increases & Fixed Expenses Remain Stable,290633,116081.0,132842,248923.0,41710.0,14.35,-0.05,High Risk
U779,2024,2,291710.0,Salary Increases & Fixed Expenses Remain Stable,290633,116081.0,139832,255913.0,34720.0,11.95,0.0,High Risk
U779,2024,3,326430.0,Salary Increases & Fixed Expenses Remain Stable,290633,116081.0,109140,225221.0,65412.0,22.51,0.04,Medium Risk
U779,2024,4,391842.0,Salary Increases & Fixed Expenses Remain Stable,290633,116081.0,142365,258446.0,32187.0,11.07,-0.05,High Risk
U779,2024,5,424029.0,Salary Increases & Fixed Expenses Remain Stable,290633,116081.0,111947,228028.0,62605.0,21.54,-0.04,Medium Risk
U779,2024,6,486634.0,Salary Increases & Fixed Expenses Remain Stable,290633,116081.0,106288,222369.0,68264.0,23.49,-0.01,Medium Risk
U779,2024,7,554898.0,Salary Increases & Fixed Expenses Remain Stable,290633,116081.0,87622,203703.0,86930.0,29.91,0.0,Low Risk
U779,2024,8,641828.0,Salary Increases & Fixed Expenses Remain Stable,304470,116081.0,131045,247126.0,57344.0,18.83,0.0,Medium Risk
U779,2024,9,699172.0,Salary Increases & Fixed Expenses Remain Stable,304470,116081.0,147085,263166.0,41304.0,13.57,-0.02,High Risk
U779,2024,10,740476.0,Salary Increases & Fixed Expenses Remain Stable,304470,116081.0,116984,233065.0,71405.0,23.45,-0.04,Medium Risk
U779,2024,11,811881.0,Salary Increases & Fixed Expenses Remain Stable,304470,116081.0,113109,229190.0,75280.0,24.72,-0.02,Medium Risk
U779,2024,12,887161.0,Salary Increases & Fixed Expenses Remain Stable,304470,116081.0,104806,220887.0,83583.0,27.45,0.0,Low Risk
U780,2024,1,180234.0,Salary Increases & Fixed Expenses Increase,124955,44976.0,61990,106966.0,17989.0,14.4,0.01,High Risk
U780,2024,2,198223.0,Salary Increases & Fixed Expenses Increase,124955,44976.0,38113,83089.0,41866.0,33.5,0.04,Low Risk
U780,2024,3,240089.0,Salary Increases & Fixed Expenses Increase,124955,46853.0,66542,113395.0,11560.0,9.25,-0.01,High Risk
U780,2024,4,251649.0,Salary Increases & Fixed Expenses Increase,124955,46853.0,47080,93933.0,31022.0,24.83,0.01,Medium Risk
U780,2024,5,282671.0,Salary Increases & Fixed Expenses Increase,124955,46853.0,38408,85261.0,39694.0,31.77,-0.05,Low Risk
U780,2024,6,322365.0,Salary Increases & Fixed Expenses Increase,124955,46853.0,56782,103635.0,21320.0,17.06,-0.04,Medium Risk
U780,2024,7,343685.0,Salary Increases & Fixed Expenses Increase,143330,46853.0,44654,91507.0,51823.0,36.16,0.05,Low Risk
U780,2024,8,395508.0,Salary Increases & Fixed Expenses Increase,143330,46853.0,51152,98005.0,45325.0,31.62,0.04,Low Risk
U780,2024,9,440833.0,Salary Increases & Fixed Expenses Increase,143330,48262.0,70611,118873.0,24457.0,17.06,-0.02,Medium Risk
U780,2024,10,465290.0,Salary Increases & Fixed Expenses Increase,143330,48262.0,72584,120846.0,22484.0,15.69,-0.05,Medium Risk
U780,2024,11,487774.0,Salary Increases & Fixed Expenses Increase,143330,48262.0,72838,121100.0,22230.0,15.51,-0.0,Medium Risk
U780,2024,12,510004.0,Salary Increases & Fixed Expenses Increase,143330,48262.0,80013,128275.0,15055.0,10.5,0.04,High Risk
U781,2024,1,185566.0,Stable Salary & Stable Fixed Expenses,183460,44895.0,79442,124337.0,59123.0,32.23,-0.01,Low Risk
U781,2024,2,244689.0,Stable Salary & Stable Fixed Expenses,183460,44895.0,58031,102926.0,80534.0,43.9,-0.01,Low Risk
U781,2024,3,325223.0,Stable Salary & Stable Fixed Expenses,183460,44895.0,91661,136556.0,46904.0,25.57,-0.0,Low Risk
U781,2024,4,372127.0,Stable Salary & Stable Fixed Expenses,183460,44895.0,69912,114807.0,68653.0,37.42,-0.0,Low Risk
U781,2024,5,440780.0,Stable Salary & Stable Fixed Expenses,183460,44895.0,79412,124307.0,59153.0,32.24,-0.01,Low Risk
U781,2024,6,499933.0,Stable Salary & Stable Fixed Expenses,183460,44895.0,62094,106989.0,76471.0,41.68,-0.03,Low Risk
U781,2024,7,576404.0,Stable Salary & Stable Fixed Expenses,183460,44895.0,82083,126978.0,56482.0,30.79,0.02,Low Risk
U781,2024,8,632886.0,Stable Salary & Stable Fixed Expenses,183460,44895.0,66368,111263.0,72197.0,39.35,0.0,Low Risk
U781,2024,9,705083.0,Stable Salary & Stable Fixed Expenses,183460,44895.0,89486,134381.0,49079.0,26.75,0.01,Low Risk
U781,2024,10,754162.0,Stable Salary & Stable Fixed Expenses,183460,44895.0,99543,144438.0,39022.0,21.27,-0.05,Medium Risk
U781,2024,11,793184.0,Stable Salary & Stable Fixed Expenses,183460,44895.0,73519,118414.0,65046.0,35.46,-0.01,Low Risk
U781,2024,12,858230.0,Stable Salary & Stable Fixed Expenses,183460,44895.0,78374,123269.0,60191.0,32.81,0.05,Low Risk
U782,2024,1,241465.0,Stable Salary & Stable Fixed Expenses,138067,60272.0,75282,135554.0,2513.0,1.82,0.03,High Risk
U782,2024,2,243978.0,Stable Salary & Stable Fixed Expenses,138067,60272.0,93302,153574.0,-15507.0,-11.23,-0.03,High Risk
U782,2024,3,228471.0,Stable Salary & Stable Fixed Expenses,138067,60272.0,77683,137955.0,112.0,0.08,0.04,High Risk
U782,2024,4,228583.0,Stable Salary & Stable Fixed Expenses,138067,60272.0,86211,146483.0,-8416.0,-6.1,0.04,High Risk
U782,2024,5,220167.0,Stable Salary & Stable Fixed Expenses,138067,60272.0,92945,153217.0,-15150.0,-10.97,-0.0,High Risk
U782,2024,6,205017.0,Stable Salary & Stable Fixed Expenses,138067,60272.0,91684,151956.0,-13889.0,-10.06,0.05,High Risk
U782,2024,7,191128.0,Stable Salary & Stable Fixed Expenses,138067,60272.0,71978,132250.0,5817.0,4.21,-0.02,High Risk
U782,2024,8,196945.0,Stable Salary & Stable Fixed Expenses,138067,60272.0,83574,143846.0,-5779.0,-4.19,-0.0,High Risk
U782,2024,9,191166.0,Stable Salary & Stable Fixed Expenses,138067,60272.0,95315,155587.0,-17520.0,-12.69,0.04,High Risk
U782,2024,10,173646.0,Stable Salary & Stable Fixed Expenses,138067,60272.0,72420,132692.0,5375.0,3.89,0.04,High Risk
U782,2024,11,179021.0,Stable Salary & Stable Fixed Expenses,138067,60272.0,83457,143729.0,-5662.0,-4.1,-0.02,High Risk
U782,2024,12,173359.0,Stable Salary & Stable Fixed Expenses,138067,60272.0,94988,155260.0,-17193.0,-12.45,0.04,High Risk
U783,2024,1,153890.0,Salary Increases & Fixed Expenses Increase,86850,26491.0,48384,74875.0,11975.0,13.79,0.0,High Risk
U783,2024,2,165865.0,Salary Increases & Fixed Expenses Increase,86850,28078.0,51830,79908.0,6942.0,7.99,-0.02,High Risk
U783,2024,3,172807.0,Salary Increases & Fixed Expenses Increase,95833,28078.0,76156,104234.0,-8401.0,-8.77,-0.02,High Risk
U783,2024,4,164406.0,Salary Increases & Fixed Expenses Increase,95833,28078.0,52942,81020.0,14813.0,15.46,-0.05,Medium Risk
U783,2024,5,179219.0,Salary Increases & Fixed Expenses Increase,95833,29991.0,61866,91857.0,3976.0,4.15,-0.01,High Risk
U783,2024,6,183195.0,Salary Increases & Fixed Expenses Increase,95833,29991.0,57437,87428.0,8405.0,8.77,-0.04,High Risk
U783,2024,7,191600.0,Salary Increases & Fixed Expenses Increase,95833,29991.0,51902,81893.0,13940.0,14.55,0.05,High Risk
U783,2024,8,205540.0,Salary Increases & Fixed Expenses Increase,95833,29991.0,59550,89541.0,6292.0,6.57,0.04,High Risk
U783,2024,9,211832.0,Salary Increases & Fixed Expenses Increase,95833,29991.0,64656,94647.0,1186.0,1.24,-0.02,High Risk
U783,2024,10,213018.0,Salary Increases & Fixed Expenses Increase,95833,29991.0,60126,90117.0,5716.0,5.96,-0.01,High Risk
U783,2024,11,218734.0,Salary Increases & Fixed Expenses Increase,95833,29991.0,58309,88300.0,7533.0,7.86,-0.03,High Risk
U783,2024,12,226267.0,Salary Increases & Fixed Expenses Increase,95833,29991.0,56874,86865.0,8968.0,9.36,0.03,High Risk
U784,2024,1,120012.0,Stable Salary & Stable Fixed Expenses,56181,36012.0,14949,50961.0,5220.0,9.29,-0.05,High Risk
U784,2024,2,125232.0,Stable Salary & Stable Fixed Expenses,56181,36012.0,12837,48849.0,7332.0,13.05,-0.04,High Risk
U784,2024,3,132564.0,Stable Salary & Stable Fixed Expenses,56181,36012.0,12394,48406.0,7775.0,13.84,0.02,High Risk
U784,2024,4,140339.0,Stable Salary & Stable Fixed Expenses,56181,36012.0,11579,47591.0,8590.0,15.29,-0.03,Medium Risk
U784,2024,5,148929.0,Stable Salary & Stable Fixed Expenses,56181,36012.0,14938,50950.0,5231.0,9.31,-0.02,High Risk
U784,2024,6,154160.0,Stable Salary & Stable Fixed Expenses,56181,36012.0,12169,48181.0,8000.0,14.24,-0.01,High Risk
U784,2024,7,162160.0,Stable Salary & Stable Fixed Expenses,56181,36012.0,14724,50736.0,5445.0,9.69,-0.02,High Risk
U784,2024,8,167605.0,Stable Salary & Stable Fixed Expenses,56181,36012.0,11491,47503.0,8678.0,15.45,-0.02,Medium Risk
U784,2024,9,176283.0,Stable Salary & Stable Fixed Expenses,56181,36012.0,18705,54717.0,1464.0,2.61,0.01,High Risk
U784,2024,10,177747.0,Stable Salary & Stable Fixed Expenses,56181,36012.0,12167,48179.0,8002.0,14.24,-0.03,High Risk
U784,2024,11,185749.0,Stable Salary & Stable Fixed Expenses,56181,36012.0,17983,53995.0,2186.0,3.89,0.02,High Risk
U784,2024,12,187935.0,Stable Salary & Stable Fixed Expenses,56181,36012.0,13571,49583.0,6598.0,11.74,-0.04,High Risk
U785,2024,1,113919.0,Salary Increases & Fixed Expenses Decrease,73831,25307.0,49863,75170.0,-1339.0,-1.81,-0.03,High Risk
U785,2024,2,112580.0,Salary Increases & Fixed Expenses Decrease,73831,25307.0,43384,68691.0,5140.0,6.96,0.01,High Risk
U785,2024,3,117720.0,Salary Increases & Fixed Expenses Decrease,73831,25307.0,49565,74872.0,-1041.0,-1.41,0.04,High Risk
U785,2024,4,116679.0,Salary Increases & Fixed Expenses Decrease,73831,25307.0,49399,74706.0,-875.0,-1.19,0.01,High Risk
U785,2024,5,115804.0,Salary Increases & Fixed Expenses Decrease,96704,25307.0,56387,81694.0,15010.0,15.52,0.03,Medium Risk
U785,2024,6,130814.0,Salary Increases & Fixed Expenses Decrease,96704,25307.0,53660,78967.0,17737.0,18.34,0.04,Medium Risk
U785,2024,7,148551.0,Salary Increases & Fixed Expenses Decrease,96704,25307.0,52535,77842.0,18862.0,19.5,-0.02,Medium Risk
U785,2024,8,167413.0,Salary Increases & Fixed Expenses Decrease,96704,25307.0,57302,82609.0,14095.0,14.58,0.05,High Risk
U785,2024,9,181508.0,Salary Increases & Fixed Expenses Decrease,96704,25307.0,52989,78296.0,18408.0,19.04,-0.01,Medium Risk
U785,2024,10,199916.0,Salary Increases & Fixed Expenses Decrease,96704,25307.0,62888,88195.0,8509.0,8.8,-0.0,High Risk
U785,2024,11,208425.0,Salary Increases & Fixed Expenses Decrease,96704,25307.0,64674,89981.0,6723.0,6.95,0.03,High Risk
U785,2024,12,215148.0,Salary Increases & Fixed Expenses Decrease,96704,25307.0,59481,84788.0,11916.0,12.32,0.01,High Risk
U786,2024,1,232128.0,Salary Increases & Fixed Expenses Remain Stable,199443,54690.0,69768,124458.0,74985.0,37.6,-0.01,Low Risk
U786,2024,2,307113.0,Salary Increases & Fixed Expenses Remain Stable,199443,54690.0,84344,139034.0,60409.0,30.29,-0.0,Low Risk
U786,2024,3,367522.0,Salary Increases & Fixed Expenses Remain Stable,199443,54690.0,69455,124145.0,75298.0,37.75,-0.01,Low Risk
U786,2024,4,442820.0,Salary Increases & Fixed Expenses Remain Stable,199443,54690.0,72733,127423.0,72020.0,36.11,-0.05,Low Risk
U786,2024,5,514840.0,Salary Increases & Fixed Expenses Remain Stable,199443,54690.0,85718,140408.0,59035.0,29.6,0.01,Low Risk
U786,2024,6,573875.0,Salary Increases & Fixed Expenses Remain Stable,199443,54690.0,73034,127724.0,71719.0,35.96,-0.02,Low Risk
U786,2024,7,645594.0,Salary Increases & Fixed Expenses Remain Stable,199443,54690.0,83973,138663.0,60780.0,30.47,0.02,Low Risk
U786,2024,8,706374.0,Salary Increases & Fixed Expenses Remain Stable,208709,54690.0,77573,132263.0,76446.0,36.63,-0.02,Low Risk
U786,2024,9,782820.0,Salary Increases & Fixed Expenses Remain Stable,208709,54690.0,64727,119417.0,89292.0,42.78,-0.03,Low Risk
U786,2024,10,872112.0,Salary Increases & Fixed Expenses Remain Stable,208709,54690.0,83696,138386.0,70323.0,33.69,0.04,Low Risk
U786,2024,11,942435.0,Salary Increases & Fixed Expenses Remain Stable,208709,54690.0,98478,153168.0,55541.0,26.61,0.02,Low Risk
U786,2024,12,997976.0,Salary Increases & Fixed Expenses Remain Stable,208709,54690.0,89357,144047.0,64662.0,30.98,-0.01,Low Risk
U787,2024,1,225298.0,Salary Increases & Fixed Expenses Remain Stable,173984,76575.0,59339,135914.0,38070.0,21.88,0.03,Medium Risk
U787,2024,2,263368.0,Salary Increases & Fixed Expenses Remain Stable,173984,76575.0,70855,147430.0,26554.0,15.26,0.01,Medium Risk
U787,2024,3,289922.0,Salary Increases & Fixed Expenses Remain Stable,173984,76575.0,60256,136831.0,37153.0,21.35,-0.05,Medium Risk
U787,2024,4,327075.0,Salary Increases & Fixed Expenses Remain Stable,173984,76575.0,83827,160402.0,13582.0,7.81,-0.01,High Risk
U787,2024,5,340657.0,Salary Increases & Fixed Expenses Remain Stable,173984,76575.0,54669,131244.0,42740.0,24.57,0.01,Medium Risk
U787,2024,6,383397.0,Salary Increases & Fixed Expenses Remain Stable,203765,76575.0,82085,158660.0,45105.0,22.14,0.02,Medium Risk
U787,2024,7,428502.0,Salary Increases & Fixed Expenses Remain Stable,203765,76575.0,92082,168657.0,35108.0,17.23,0.04,Medium Risk
U787,2024,8,463610.0,Salary Increases & Fixed Expenses Remain Stable,203765,76575.0,85217,161792.0,41973.0,20.6,-0.0,Medium Risk
U787,2024,9,505583.0,Salary Increases & Fixed Expenses Remain Stable,203765,76575.0,98419,174994.0,28771.0,14.12,0.02,High Risk
U787,2024,10,534354.0,Salary Increases & Fixed Expenses Remain Stable,203765,76575.0,81545,158120.0,45645.0,22.4,-0.01,Medium Risk
U787,2024,11,579999.0,Salary Increases & Fixed Expenses Remain Stable,203765,76575.0,65528,142103.0,61662.0,30.26,0.02,Low Risk
U787,2024,12,641661.0,Salary Increases & Fixed Expenses Remain Stable,203765,76575.0,65487,142062.0,61703.0,30.28,-0.01,Low Risk
U788,2024,1,134861.0,Salary Increases & Fixed Expenses Increase,101461,79805.0,30113,109918.0,-8457.0,-8.34,0.04,High Risk
U788,2024,2,126404.0,Salary Increases & Fixed Expenses Increase,101461,79805.0,30026,109831.0,-8370.0,-8.25,-0.02,High Risk
U788,2024,3,118034.0,Salary Increases & Fixed Expenses Increase,101461,81589.0,28919,110508.0,-9047.0,-8.92,-0.02,High Risk
U788,2024,4,108987.0,Salary Increases & Fixed Expenses Increase,101461,82532.0,28863,111395.0,-9934.0,-9.79,-0.0,High Risk
U788,2024,5,99053.0,Salary Increases & Fixed Expenses Increase,128935,82532.0,37094,119626.0,9309.0,7.22,-0.03,High Risk
U788,2024,6,108362.0,Salary Increases & Fixed Expenses Increase,128935,82532.0,32212,114744.0,14191.0,11.01,0.04,High Risk
U788,2024,7,122553.0,Salary Increases & Fixed Expenses Increase,128935,82532.0,27102,109634.0,19301.0,14.97,-0.0,High Risk
U788,2024,8,141854.0,Salary Increases & Fixed Expenses Increase,128935,82532.0,35572,118104.0,10831.0,8.4,-0.05,High Risk
U788,2024,9,152685.0,Salary Increases & Fixed Expenses Increase,128935,82532.0,28640,111172.0,17763.0,13.78,-0.04,High Risk
U788,2024,10,170448.0,Salary Increases & Fixed Expenses Increase,128935,82532.0,33895,116427.0,12508.0,9.7,-0.03,High Risk
U788,2024,11,182956.0,Salary Increases & Fixed Expenses Increase,128935,82532.0,27185,109717.0,19218.0,14.91,0.03,High Risk
U788,2024,12,202174.0,Salary Increases & Fixed Expenses Increase,128935,82532.0,36004,118536.0,10399.0,8.07,-0.04,High Risk
U789,2024,1,172191.0,Salary Increases & Fixed Expenses Remain Stable,147889,72185.0,39612,111797.0,36092.0,24.4,0.02,Medium Risk
U789,2024,2,208283.0,Salary Increases & Fixed Expenses Remain Stable,147889,72185.0,39675,111860.0,36029.0,24.36,-0.03,Medium Risk
U789,2024,3,244312.0,Salary Increases & Fixed Expenses Remain Stable,147889,72185.0,39435,111620.0,36269.0,24.52,0.02,Medium Risk
U789,2024,4,280581.0,Salary Increases & Fixed Expenses Remain Stable,168856,72185.0,42232,114417.0,54439.0,32.24,-0.02,Low Risk
U789,2024,5,335020.0,Salary Increases & Fixed Expenses Remain Stable,168856,72185.0,47748,119933.0,48923.0,28.97,-0.04,Low Risk
U789,2024,6,383943.0,Salary Increases & Fixed Expenses Remain Stable,168856,72185.0,36116,108301.0,60555.0,35.86,-0.0,Low Risk
U789,2024,7,444498.0,Salary Increases & Fixed Expenses Remain Stable,168856,72185.0,43428,115613.0,53243.0,31.53,-0.03,Low Risk
U789,2024,8,497741.0,Salary Increases & Fixed Expenses Remain Stable,168856,72185.0,36102,108287.0,60569.0,35.87,-0.05,Low Risk
U789,2024,9,558310.0,Salary Increases & Fixed Expenses Remain Stable,168856,72185.0,44964,117149.0,51707.0,30.62,-0.01,Low Risk
U789,2024,10,610017.0,Salary Increases & Fixed Expenses Remain Stable,168856,72185.0,44425,116610.0,52246.0,30.94,0.04,Low Risk
U789,2024,11,662263.0,Salary Increases & Fixed Expenses Remain Stable,168856,72185.0,49730,121915.0,46941.0,27.8,0.03,Low Risk
U789,2024,12,709204.0,Salary Increases & Fixed Expenses Remain Stable,168856,72185.0,34277,106462.0,62394.0,36.95,0.04,Low Risk
U790,2024,1,250000.0,Salary Increases & Fixed Expenses Increase,251787,95297.0,75761,171058.0,80729.0,32.06,-0.02,Low Risk
U790,2024,2,330729.0,Salary Increases & Fixed Expenses Increase,251787,95297.0,89244,184541.0,67246.0,26.71,0.03,Low Risk
U790,2024,3,397975.0,Salary Increases & Fixed Expenses Increase,263049,96273.0,144732,241005.0,22044.0,8.38,0.01,High Risk
U790,2024,4,420019.0,Salary Increases & Fixed Expenses Increase,263049,96273.0,116045,212318.0,50731.0,19.29,-0.0,Medium Risk
U790,2024,5,470750.0,Salary Increases & Fixed Expenses Increase,263049,96273.0,99664,195937.0,67112.0,25.51,0.05,Low Risk
U790,2024,6,537862.0,Salary Increases & Fixed Expenses Increase,263049,96273.0,87375,183648.0,79401.0,30.18,0.02,Low Risk
U790,2024,7,617263.0,Salary Increases & Fixed Expenses Increase,263049,96273.0,102064,198337.0,64712.0,24.6,0.04,Medium Risk
U790,2024,8,681975.0,Salary Increases & Fixed Expenses Increase,263049,96273.0,107655,203928.0,59121.0,22.48,-0.01,Medium Risk
U790,2024,9,741096.0,Salary Increases & Fixed Expenses Increase,263049,96273.0,104330,200603.0,62446.0,23.74,0.04,Medium Risk
U790,2024,10,803542.0,Salary Increases & Fixed Expenses Increase,263049,98088.0,133772,231860.0,31189.0,11.86,-0.04,High Risk
U790,2024,11,834731.0,Salary Increases & Fixed Expenses Increase,263049,98088.0,132758,230846.0,32203.0,12.24,-0.01,High Risk
U790,2024,12,866934.0,Salary Increases & Fixed Expenses Increase,263049,98088.0,140063,238151.0,24898.0,9.47,-0.03,High Risk
U791,2024,1,218853.0,Salary Increases & Fixed Expenses Remain Stable,143020,57635.0,96792,154427.0,-11407.0,-7.98,0.04,High Risk
U791,2024,2,207446.0,Salary Increases & Fixed Expenses Remain Stable,143020,57635.0,89661,147296.0,-4276.0,-2.99,-0.01,High Risk
U791,2024,3,203170.0,Salary Increases & Fixed Expenses Remain Stable,143020,57635.0,105656,163291.0,-20271.0,-14.17,-0.04,High Risk
U791,2024,4,182899.0,Salary Increases & Fixed Expenses Remain Stable,143020,57635.0,86421,144056.0,-1036.0,-0.72,-0.04,High Risk
U791,2024,5,181863.0,Salary Increases & Fixed Expenses Remain Stable,143020,57635.0,96102,153737.0,-10717.0,-7.49,0.03,High Risk
U791,2024,6,171146.0,Salary Increases & Fixed Expenses Remain Stable,143020,57635.0,84125,141760.0,1260.0,0.88,-0.01,High Risk
U791,2024,7,172406.0,Salary Increases & Fixed Expenses Remain Stable,143020,57635.0,99573,157208.0,-14188.0,-9.92,-0.0,High Risk
U791,2024,8,158218.0,Salary Increases & Fixed Expenses Remain Stable,153186,57635.0,98247,155882.0,-2696.0,-1.76,0.01,High Risk
U791,2024,9,155522.0,Salary Increases & Fixed Expenses Remain Stable,153186,57635.0,85191,142826.0,10360.0,6.76,0.02,High Risk
U791,2024,10,165882.0,Salary Increases & Fixed Expenses Remain Stable,153186,57635.0,103252,160887.0,-7701.0,-5.03,0.04,High Risk
U791,2024,11,158181.0,Salary Increases & Fixed Expenses Remain Stable,153186,57635.0,82761,140396.0,12790.0,8.35,-0.03,High Risk
U791,2024,12,170971.0,Salary Increases & Fixed Expenses Remain Stable,153186,57635.0,106103,163738.0,-10552.0,-6.89,-0.02,High Risk
U792,2024,1,246991.0,Salary Increases & Fixed Expenses Increase,240632,103472.0,85822,189294.0,51338.0,21.33,0.01,Medium Risk
U792,2024,2,298329.0,Salary Increases & Fixed Expenses Increase,240632,103472.0,97116,200588.0,40044.0,16.64,-0.05,Medium Risk
U792,2024,3,338373.0,Salary Increases & Fixed Expenses Increase,240632,103472.0,142946,246418.0,-5786.0,-2.4,-0.01,High Risk
U792,2024,4,332587.0,Salary Increases & Fixed Expenses Increase,240632,103472.0,112288,215760.0,24872.0,10.34,0.02,High Risk
U792,2024,5,357459.0,Salary Increases & Fixed Expenses Increase,240632,105405.0,104533,209938.0,30694.0,12.76,-0.05,High Risk
U792,2024,6,388153.0,Salary Increases & Fixed Expenses Increase,240632,105405.0,98178,203583.0,37049.0,15.4,0.04,Medium Risk
U792,2024,7,425202.0,Salary Increases & Fixed Expenses Increase,268723,105405.0,99596,205001.0,63722.0,23.71,-0.0,Medium Risk
U792,2024,8,488924.0,Salary Increases & Fixed Expenses Increase,268723,105405.0,80992,186397.0,82326.0,30.64,0.03,Low Risk
U792,2024,9,571250.0,Salary Increases & Fixed Expenses Increase,268723,105405.0,126342,231747.0,36976.0,13.76,-0.04,High Risk
U792,2024,10,608226.0,Salary Increases & Fixed Expenses Increase,268723,105405.0,139341,244746.0,23977.0,8.92,-0.01,High Risk
U792,2024,11,632203.0,Salary Increases & Fixed Expenses Increase,268723,105405.0,110679,216084.0,52639.0,19.59,0.01,Medium Risk
U792,2024,12,684842.0,Salary Increases & Fixed Expenses Increase,268723,105405.0,147778,253183.0,15540.0,5.78,-0.02,High Risk
U793,2024,1,172518.0,Salary Increases & Fixed Expenses Increase,146508,71854.0,98225,170079.0,-23571.0,-16.09,0.02,High Risk
U793,2024,2,148947.0,Salary Increases & Fixed Expenses Increase,146508,71854.0,85395,157249.0,-10741.0,-7.33,0.05,High Risk
U793,2024,3,138206.0,Salary Increases & Fixed Expenses Increase,146508,71854.0,90759,162613.0,-16105.0,-10.99,-0.04,High Risk
U793,2024,4,122101.0,Salary Increases & Fixed Expenses Increase,146508,71854.0,82194,154048.0,-7540.0,-5.15,0.01,High Risk
U793,2024,5,114561.0,Salary Increases & Fixed Expenses Increase,146508,71854.0,100692,172546.0,-26038.0,-17.77,0.02,High Risk
U793,2024,6,88523.0,Salary Increases & Fixed Expenses Increase,146508,71854.0,97083,168937.0,-22429.0,-15.31,-0.04,High Risk
U793,2024,7,66094.0,Salary Increases & Fixed Expenses Increase,146508,71854.0,87396,159250.0,-12742.0,-8.7,0.03,High Risk
U793,2024,8,53352.0,Salary Increases & Fixed Expenses Increase,173194,72584.0,116462,189046.0,-15852.0,-9.15,0.0,High Risk
U793,2024,9,37500.0,Salary Increases & Fixed Expenses Increase,173194,72584.0,108606,181190.0,-7996.0,-4.62,-0.03,High Risk
U793,2024,10,29504.0,Salary Increases & Fixed Expenses Increase,173194,72584.0,89242,161826.0,11368.0,6.56,-0.02,High Risk
U793,2024,11,40872.0,Salary Increases & Fixed Expenses Increase,173194,72584.0,115675,188259.0,-15065.0,-8.7,0.0,High Risk
U793,2024,12,25807.0,Salary Increases & Fixed Expenses Increase,173194,72584.0,117739,190323.0,-17129.0,-9.89,-0.04,High Risk
U794,2024,1,183314.0,Salary Increases & Fixed Expenses Increase,136588,77481.0,68252,145733.0,-9145.0,-6.7,-0.0,High Risk
U794,2024,2,174169.0,Salary Increases & Fixed Expenses Increase,136588,77481.0,49420,126901.0,9687.0,7.09,0.04,High Risk
U794,2024,3,183856.0,Salary Increases & Fixed Expenses Increase,136588,77481.0,55206,132687.0,3901.0,2.86,0.01,High Risk
U794,2024,4,187757.0,Salary Increases & Fixed Expenses Increase,153622,77481.0,56203,133684.0,19938.0,12.98,0.03,High Risk
U794,2024,5,207695.0,Salary Increases & Fixed Expenses Increase,153622,77481.0,65759,143240.0,10382.0,6.76,0.05,High Risk
U794,2024,6,218077.0,Salary Increases & Fixed Expenses Increase,153622,77481.0,70859,148340.0,5282.0,3.44,-0.02,High Risk
U794,2024,7,223359.0,Salary Increases & Fixed Expenses Increase,153622,77481.0,46275,123756.0,29866.0,19.44,-0.03,Medium Risk
U794,2024,8,253225.0,Salary Increases & Fixed Expenses Increase,153622,77481.0,52654,130135.0,23487.0,15.29,0.02,Medium Risk
U794,2024,9,276712.0,Salary Increases & Fixed Expenses Increase,153622,77481.0,56950,134431.0,19191.0,12.49,0.0,High Risk
U794,2024,10,295903.0,Salary Increases & Fixed Expenses Increase,153622,77990.0,60636,138626.0,14996.0,9.76,0.03,High Risk
U794,2024,11,310899.0,Salary Increases & Fixed Expenses Increase,153622,77990.0,73961,151951.0,1671.0,1.09,-0.01,High Risk
U794,2024,12,312570.0,Salary Increases & Fixed Expenses Increase,153622,77990.0,54135,132125.0,21497.0,13.99,-0.01,High Risk
U795,2024,1,219429.0,Salary Increases & Fixed Expenses Increase,185654,58518.0,80876,139394.0,46260.0,24.92,-0.0,Medium Risk
U795,2024,2,265689.0,Salary Increases & Fixed Expenses Increase,185654,58518.0,67767,126285.0,59369.0,31.98,-0.02,Low Risk
U795,2024,3,325058.0,Salary Increases & Fixed Expenses Increase,185654,58518.0,69304,127822.0,57832.0,31.15,-0.05,Low Risk
U795,2024,4,382890.0,Salary Increases & Fixed Expenses Increase,185654,59541.0,88606,148147.0,37507.0,20.2,0.03,Medium Risk
U795,2024,5,420397.0,Salary Increases & Fixed Expenses Increase,185654,59541.0,80878,140419.0,45235.0,24.37,-0.02,Medium Risk
U795,2024,6,465632.0,Salary Increases & Fixed Expenses Increase,201301,59541.0,78031,137572.0,63729.0,31.66,-0.03,Low Risk
U795,2024,7,529361.0,Salary Increases & Fixed Expenses Increase,201301,59541.0,92629,152170.0,49131.0,24.41,-0.02,Medium Risk
U795,2024,8,578492.0,Salary Increases & Fixed Expenses Increase,201301,60379.0,74179,134558.0,66743.0,33.16,-0.04,Low Risk
U795,2024,9,645235.0,Salary Increases & Fixed Expenses Increase,201301,60379.0,89364,149743.0,51558.0,25.61,0.0,Low Risk
U795,2024,10,696793.0,Salary Increases & Fixed Expenses Increase,201301,61781.0,71573,133354.0,67947.0,33.75,0.04,Low Risk
U795,2024,11,764740.0,Salary Increases & Fixed Expenses Increase,201301,61781.0,102790,164571.0,36730.0,18.25,-0.05,Medium Risk
U795,2024,12,801470.0,Salary Increases & Fixed Expenses Increase,201301,61781.0,86711,148492.0,52809.0,26.23,-0.04,Low Risk
U796,2024,1,250000.0,Salary Increases & Fixed Expenses Remain Stable,277196,85178.0,131697,216875.0,60321.0,21.76,0.04,Medium Risk
U796,2024,2,310321.0,Salary Increases & Fixed Expenses Remain Stable,277196,85178.0,117328,202506.0,74690.0,26.94,0.01,Low Risk
U796,2024,3,385011.0,Salary Increases & Fixed Expenses Remain Stable,277196,85178.0,139150,224328.0,52868.0,19.07,-0.04,Medium Risk
U796,2024,4,437879.0,Salary Increases & Fixed Expenses Remain Stable,277196,85178.0,107066,192244.0,84952.0,30.65,-0.05,Low Risk
U796,2024,5,522831.0,Salary Increases & Fixed Expenses Remain Stable,277196,85178.0,110316,195494.0,81702.0,29.47,-0.02,Low Risk
U796,2024,6,604533.0,Salary Increases & Fixed Expenses Remain Stable,277196,85178.0,129482,214660.0,62536.0,22.56,-0.04,Medium Risk
U796,2024,7,667069.0,Salary Increases & Fixed Expenses Remain Stable,277196,85178.0,121945,207123.0,70073.0,25.28,-0.02,Low Risk
U796,2024,8,737142.0,Salary Increases & Fixed Expenses Remain Stable,283839,85178.0,99574,184752.0,99087.0,34.91,0.03,Low Risk
U796,2024,9,836229.0,Salary Increases & Fixed Expenses Remain Stable,283839,85178.0,130396,215574.0,68265.0,24.05,0.04,Medium Risk
U796,2024,10,904494.0,Salary Increases & Fixed Expenses Remain Stable,283839,85178.0,136377,221555.0,62284.0,21.94,0.01,Medium Risk
U796,2024,11,966778.0,Salary Increases & Fixed Expenses Remain Stable,283839,85178.0,97003,182181.0,101658.0,35.82,-0.03,Low Risk
U796,2024,12,1068436.0,Salary Increases & Fixed Expenses Remain Stable,283839,85178.0,108105,193283.0,90556.0,31.9,-0.02,Low Risk
U797,2024,1,199623.0,Stable Salary & Stable Fixed Expenses,38878,16667.0,17771,34438.0,4440.0,11.42,-0.02,High Risk
U797,2024,2,204063.0,Stable Salary & Stable Fixed Expenses,38878,16667.0,13893,30560.0,8318.0,21.4,0.02,Medium Risk
U797,2024,3,212381.0,Stable Salary & Stable Fixed Expenses,38878,16667.0,12630,29297.0,9581.0,24.64,0.04,Medium Risk
U797,2024,4,221962.0,Stable Salary & Stable Fixed Expenses,38878,16667.0,12935,29602.0,9276.0,23.86,0.01,Medium Risk
U797,2024,5,231238.0,Stable Salary & Stable Fixed Expenses,38878,16667.0,17493,34160.0,4718.0,12.14,0.03,High Risk
U797,2024,6,235956.0,Stable Salary & Stable Fixed Expenses,38878,16667.0,14015,30682.0,8196.0,21.08,0.02,Medium Risk
U797,2024,7,244152.0,Stable Salary & Stable Fixed Expenses,38878,16667.0,15301,31968.0,6910.0,17.77,0.04,Medium Risk
U797,2024,8,251062.0,Stable Salary & Stable Fixed Expenses,38878,16667.0,11824,28491.0,10387.0,26.72,-0.05,Low Risk
U797,2024,9,261449.0,Stable Salary & Stable Fixed Expenses,38878,16667.0,16783,33450.0,5428.0,13.96,-0.03,High Risk
U797,2024,10,266877.0,Stable Salary & Stable Fixed Expenses,38878,16667.0,12748,29415.0,9463.0,24.34,0.05,Medium Risk
U797,2024,11,276340.0,Stable Salary & Stable Fixed Expenses,38878,16667.0,17402,34069.0,4809.0,12.37,-0.01,High Risk
U797,2024,12,281149.0,Stable Salary & Stable Fixed Expenses,38878,16667.0,17616,34283.0,4595.0,11.82,-0.0,High Risk
U798,2024,1,151870.0,Salary Increases & Fixed Expenses Decrease,122154,76717.0,79690,156407.0,-34253.0,-28.04,-0.05,High Risk
U798,2024,2,117617.0,Salary Increases & Fixed Expenses Decrease,122154,76717.0,64582,141299.0,-19145.0,-15.67,-0.0,High Risk
U798,2024,3,98472.0,Salary Increases & Fixed Expenses Decrease,122154,76717.0,83501,160218.0,-38064.0,-31.16,0.04,High Risk
U798,2024,4,60408.0,Salary Increases & Fixed Expenses Decrease,122154,76717.0,73256,149973.0,-27819.0,-22.77,0.05,High Risk
U798,2024,5,32589.0,Salary Increases & Fixed Expenses Decrease,122154,76717.0,75441,152158.0,-30004.0,-24.56,0.01,High Risk
U798,2024,6,2585.0,Salary Increases & Fixed Expenses Decrease,137890,76717.0,93236,169953.0,-32063.0,-23.25,0.01,High Risk
U798,2024,7,-29478.0,Salary Increases & Fixed Expenses Decrease,137890,76717.0,79986,156703.0,-18813.0,-13.64,0.01,High Risk
U798,2024,8,-48291.0,Salary Increases & Fixed Expenses Decrease,137890,76717.0,85967,162684.0,-24794.0,-17.98,-0.0,High Risk
U798,2024,9,-73085.0,Salary Increases & Fixed Expenses Decrease,137890,76717.0,84296,161013.0,-23123.0,-16.77,0.04,High Risk
U798,2024,10,-96208.0,Salary Increases & Fixed Expenses Decrease,137890,76717.0,87044,163761.0,-25871.0,-18.76,-0.04,High Risk
U798,2024,11,-122079.0,Salary Increases & Fixed Expenses Decrease,137890,76717.0,87432,164149.0,-26259.0,-19.04,0.02,High Risk
U798,2024,12,-148338.0,Salary Increases & Fixed Expenses Decrease,137890,76717.0,91680,168397.0,-30507.0,-22.12,-0.02,High Risk
U799,2024,1,200751.0,Salary Increases & Fixed Expenses Remain Stable,58448,36974.0,33310,70284.0,-11836.0,-20.25,-0.03,High Risk
U799,2024,2,188915.0,Salary Increases & Fixed Expenses Remain Stable,58448,36974.0,39616,76590.0,-18142.0,-31.04,0.03,High Risk
U799,2024,3,170773.0,Salary Increases & Fixed Expenses Remain Stable,58448,36974.0,31689,68663.0,-10215.0,-17.48,-0.03,High Risk
U799,2024,4,160558.0,Salary Increases & Fixed Expenses Remain Stable,58448,36974.0,40058,77032.0,-18584.0,-31.8,-0.03,High Risk
U799,2024,5,141974.0,Salary Increases & Fixed Expenses Remain Stable,58448,36974.0,32265,69239.0,-10791.0,-18.46,0.02,High Risk
U799,2024,6,131183.0,Salary Increases & Fixed Expenses Remain Stable,84795,36974.0,53130,90104.0,-5309.0,-6.26,-0.04,High Risk
U799,2024,7,125874.0,Salary Increases & Fixed Expenses Remain Stable,84795,36974.0,47762,84736.0,59.0,0.07,0.01,High Risk
U799,2024,8,125933.0,Salary Increases & Fixed Expenses Remain Stable,84795,36974.0,47628,84602.0,193.0,0.23,-0.04,High Risk
U799,2024,9,126126.0,Salary Increases & Fixed Expenses Remain Stable,84795,36974.0,48283,85257.0,-462.0,-0.54,0.02,High Risk
U799,2024,10,125664.0,Salary Increases & Fixed Expenses Remain Stable,84795,36974.0,52438,89412.0,-4617.0,-5.44,-0.02,High Risk
U799,2024,11,121047.0,Salary Increases & Fixed Expenses Remain Stable,84795,36974.0,60991,97965.0,-13170.0,-15.53,0.03,High Risk
U799,2024,12,107877.0,Salary Increases & Fixed Expenses Remain Stable,84795,36974.0,55512,92486.0,-7691.0,-9.07,-0.01,High Risk
U800,2024,1,193890.0,Stable Salary & Increasing Fixed Expenses,190990,59507.0,58751,118258.0,72732.0,38.08,-0.04,Low Risk
U800,2024,2,266622.0,Stable Salary & Increasing Fixed Expenses,190990,59507.0,68430,127937.0,63053.0,33.01,-0.02,Low Risk
U800,2024,3,329675.0,Stable Salary & Increasing Fixed Expenses,190990,59507.0,110687,170194.0,20796.0,10.89,0.01,High Risk
U800,2024,4,350471.0,Stable Salary & Increasing Fixed Expenses,190990,60069.0,70997,131066.0,59924.0,31.38,0.03,Low Risk
U800,2024,5,410395.0,Stable Salary & Increasing Fixed Expenses,190990,61224.0,72896,134120.0,56870.0,29.78,0.02,Low Risk
U800,2024,6,467265.0,Stable Salary & Increasing Fixed Expenses,190990,61224.0,87826,149050.0,41940.0,21.96,-0.05,Medium Risk
U800,2024,7,509205.0,Stable Salary & Increasing Fixed Expenses,190990,61224.0,67851,129075.0,61915.0,32.42,-0.01,Low Risk
U800,2024,8,571120.0,Stable Salary & Increasing Fixed Expenses,190990,61224.0,87315,148539.0,42451.0,22.23,-0.02,Medium Risk
U800,2024,9,613571.0,Stable Salary & Increasing Fixed Expenses,190990,61224.0,71199,132423.0,58567.0,30.66,-0.03,Low Risk
U800,2024,10,672138.0,Stable Salary & Increasing Fixed Expenses,190990,61224.0,91294,152518.0,38472.0,20.14,0.0,Medium Risk
U800,2024,11,710610.0,Stable Salary & Increasing Fixed Expenses,190990,62022.0,100652,162674.0,28316.0,14.83,-0.02,High Risk
U800,2024,12,738926.0,Stable Salary & Increasing Fixed Expenses,190990,62022.0,103857,165879.0,25111.0,13.15,-0.02,High Risk
U801,2024,1,69531.0,Salary Increases & Fixed Expenses Increase,37963,20986.0,18857,39843.0,-1880.0,-4.95,0.0,High Risk
U801,2024,2,67651.0,Salary Increases & Fixed Expenses Increase,37963,20986.0,18186,39172.0,-1209.0,-3.18,0.03,High Risk
U801,2024,3,66442.0,Salary Increases & Fixed Expenses Increase,55035,20986.0,25807,46793.0,8242.0,14.98,0.02,High Risk
U801,2024,4,74684.0,Salary Increases & Fixed Expenses Increase,55035,20986.0,19890,40876.0,14159.0,25.73,-0.02,Low Risk
U801,2024,5,88843.0,Salary Increases & Fixed Expenses Increase,55035,20986.0,25484,46470.0,8565.0,15.56,0.01,Medium Risk
U801,2024,6,97408.0,Salary Increases & Fixed Expenses Increase,55035,21721.0,22760,44481.0,10554.0,19.18,0.03,Medium Risk
U801,2024,7,107962.0,Salary Increases & Fixed Expenses Increase,55035,21721.0,21423,43144.0,11891.0,21.61,-0.03,Medium Risk
U801,2024,8,119853.0,Salary Increases & Fixed Expenses Increase,55035,21721.0,27179,48900.0,6135.0,11.15,0.0,High Risk
U801,2024,9,125988.0,Salary Increases & Fixed Expenses Increase,55035,21721.0,24003,45724.0,9311.0,16.92,-0.01,Medium Risk
U801,2024,10,135299.0,Salary Increases & Fixed Expenses Increase,55035,21721.0,32859,54580.0,455.0,0.83,0.01,High Risk
U801,2024,11,135754.0,Salary Increases & Fixed Expenses Increase,55035,21721.0,27546,49267.0,5768.0,10.48,-0.02,High Risk
U801,2024,12,141522.0,Salary Increases & Fixed Expenses Increase,55035,22982.0,21066,44048.0,10987.0,19.96,0.02,Medium Risk
U802,2024,1,250000.0,Salary Increases & Fixed Expenses Decrease,279314,68494.0,83893,152387.0,126927.0,45.44,-0.02,Low Risk
U802,2024,2,376927.0,Salary Increases & Fixed Expenses Decrease,279314,68494.0,91680,160174.0,119140.0,42.65,0.02,Low Risk
U802,2024,3,496067.0,Salary Increases & Fixed Expenses Decrease,279314,68494.0,102631,171125.0,108189.0,38.73,-0.0,Low Risk
U802,2024,4,604256.0,Salary Increases & Fixed Expenses Decrease,279314,67589.0,96833,164422.0,114892.0,41.13,0.01,Low Risk
U802,2024,5,719148.0,Salary Increases & Fixed Expenses Decrease,279314,67589.0,117601,185190.0,94124.0,33.7,-0.03,Low Risk
U802,2024,6,813272.0,Salary Increases & Fixed Expenses Decrease,306133,67589.0,133367,200956.0,105177.0,34.36,-0.02,Low Risk
U802,2024,7,918449.0,Salary Increases & Fixed Expenses Decrease,306133,67589.0,111787,179376.0,126757.0,41.41,0.03,Low Risk
U802,2024,8,1045206.0,Salary Increases & Fixed Expenses Decrease,306133,67589.0,138122,205711.0,100422.0,32.8,-0.04,Low Risk
U802,2024,9,1145628.0,Salary Increases & Fixed Expenses Decrease,306133,67589.0,119214,186803.0,119330.0,38.98,0.02,Low Risk
U802,2024,10,1264958.0,Salary Increases & Fixed Expenses Decrease,306133,67589.0,149735,217324.0,88809.0,29.01,-0.02,Low Risk
U802,2024,11,1353767.0,Salary Increases & Fixed Expenses Decrease,306133,67589.0,165606,233195.0,72938.0,23.83,0.04,Medium Risk
U802,2024,12,1426705.0,Salary Increases & Fixed Expenses Decrease,306133,67589.0,135827,203416.0,102717.0,33.55,-0.03,Low Risk
U803,2024,1,246982.0,Stable Salary & Stable Fixed Expenses,48991,10990.0,12330,23320.0,25671.0,52.4,-0.04,Low Risk
U803,2024,2,272653.0,Stable Salary & Stable Fixed Expenses,48991,10990.0,13487,24477.0,24514.0,50.04,0.02,Low Risk
U803,2024,3,297167.0,Stable Salary & Stable Fixed Expenses,48991,10990.0,12941,23931.0,25060.0,51.15,0.01,Low Risk
U803,2024,4,322227.0,Stable Salary & Stable Fixed Expenses,48991,10990.0,12349,23339.0,25652.0,52.36,-0.04,Low Risk
U803,2024,5,347879.0,Stable Salary & Stable Fixed Expenses,48991,10990.0,11787,22777.0,26214.0,53.51,0.05,Low Risk
U803,2024,6,374093.0,Stable Salary & Stable Fixed Expenses,48991,10990.0,14278,25268.0,23723.0,48.42,-0.01,Low Risk
U803,2024,7,397816.0,Stable Salary & Stable Fixed Expenses,48991,10990.0,11453,22443.0,26548.0,54.19,0.01,Low Risk
U803,2024,8,424364.0,Stable Salary & Stable Fixed Expenses,48991,10990.0,12380,23370.0,25621.0,52.3,-0.04,Low Risk
U803,2024,9,449985.0,Stable Salary & Stable Fixed Expenses,48991,10990.0,15047,26037.0,22954.0,46.85,-0.0,Low Risk
U803,2024,10,472939.0,Stable Salary & Stable Fixed Expenses,48991,10990.0,12847,23837.0,25154.0,51.34,-0.0,Low Risk
U803,2024,11,498093.0,Stable Salary & Stable Fixed Expenses,48991,10990.0,10808,21798.0,27193.0,55.51,-0.01,Low Risk
U803,2024,12,525286.0,Stable Salary & Stable Fixed Expenses,48991,10990.0,11288,22278.0,26713.0,54.53,0.03,Low Risk
U804,2024,1,145226.0,Salary Increases & Fixed Expenses Increase,105747,62205.0,35106,97311.0,8436.0,7.98,-0.02,High Risk
U804,2024,2,153662.0,Salary Increases & Fixed Expenses Increase,105747,62205.0,44109,106314.0,-567.0,-0.54,0.04,High Risk
U804,2024,3,153095.0,Salary Increases & Fixed Expenses Increase,105747,62205.0,49835,112040.0,-6293.0,-5.95,-0.04,High Risk
U804,2024,4,146802.0,Salary Increases & Fixed Expenses Increase,105747,62205.0,46009,108214.0,-2467.0,-2.33,-0.0,High Risk
U804,2024,5,144335.0,Salary Increases & Fixed Expenses Increase,105747,62205.0,33475,95680.0,10067.0,9.52,-0.04,High Risk
U804,2024,6,154402.0,Salary Increases & Fixed Expenses Increase,105747,62205.0,51145,113350.0,-7603.0,-7.19,-0.05,High Risk
U804,2024,7,146799.0,Salary Increases & Fixed Expenses Increase,105747,62205.0,32288,94493.0,11254.0,10.64,-0.01,High Risk
U804,2024,8,158053.0,Salary Increases & Fixed Expenses Increase,135673,62205.0,54167,116372.0,19301.0,14.23,-0.04,High Risk
U804,2024,9,177354.0,Salary Increases & Fixed Expenses Increase,135673,62205.0,61593,123798.0,11875.0,8.75,0.01,High Risk
U804,2024,10,189229.0,Salary Increases & Fixed Expenses Increase,135673,62205.0,80550,142755.0,-7082.0,-5.22,-0.02,High Risk
U804,2024,11,182147.0,Salary Increases & Fixed Expenses Increase,135673,62205.0,73862,136067.0,-394.0,-0.29,0.04,High Risk
U804,2024,12,181753.0,Salary Increases & Fixed Expenses Increase,135673,62205.0,70953,133158.0,2515.0,1.85,0.02,High Risk
U805,2024,1,193918.0,Salary Increases & Fixed Expenses Increase,63106,25339.0,19410,44749.0,18357.0,29.09,0.0,Low Risk
U805,2024,2,212275.0,Salary Increases & Fixed Expenses Increase,63106,25339.0,27754,53093.0,10013.0,15.87,-0.02,Medium Risk
U805,2024,3,222288.0,Salary Increases & Fixed Expenses Increase,82972,27305.0,37003,64308.0,18664.0,22.49,-0.04,Medium Risk
U805,2024,4,240952.0,Salary Increases & Fixed Expenses Increase,82972,27305.0,27115,54420.0,28552.0,34.41,0.04,Low Risk
U805,2024,5,269504.0,Salary Increases & Fixed Expenses Increase,82972,27305.0,30412,57717.0,25255.0,30.44,0.02,Low Risk
U805,2024,6,294759.0,Salary Increases & Fixed Expenses Increase,82972,27305.0,34600,61905.0,21067.0,25.39,-0.0,Low Risk
U805,2024,7,315826.0,Salary Increases & Fixed Expenses Increase,82972,28581.0,37753,66334.0,16638.0,20.05,0.03,Medium Risk
U805,2024,8,332464.0,Salary Increases & Fixed Expenses Increase,82972,28581.0,37782,66363.0,16609.0,20.02,0.01,Medium Risk
U805,2024,9,349073.0,Salary Increases & Fixed Expenses Increase,82972,28581.0,26188,54769.0,28203.0,33.99,-0.04,Low Risk
U805,2024,10,377276.0,Salary Increases & Fixed Expenses Increase,82972,28581.0,30901,59482.0,23490.0,28.31,0.04,Low Risk
U805,2024,11,400766.0,Salary Increases & Fixed Expenses Increase,82972,28581.0,33700,62281.0,20691.0,24.94,0.02,Medium Risk
U805,2024,12,421457.0,Salary Increases & Fixed Expenses Increase,82972,28581.0,36718,65299.0,17673.0,21.3,-0.0,Medium Risk
U806,2024,1,225695.0,Stable Salary & Stable Fixed Expenses,222226,98896.0,68143,167039.0,55187.0,24.83,0.01,Medium Risk
U806,2024,2,280882.0,Stable Salary & Stable Fixed Expenses,222226,98896.0,80582,179478.0,42748.0,19.24,0.01,Medium Risk
U806,2024,3,323630.0,Stable Salary & Stable Fixed Expenses,222226,98896.0,97916,196812.0,25414.0,11.44,0.04,High Risk
U806,2024,4,349044.0,Stable Salary & Stable Fixed Expenses,222226,98896.0,81994,180890.0,41336.0,18.6,0.02,Medium Risk
U806,2024,5,390380.0,Stable Salary & Stable Fixed Expenses,222226,98896.0,72552,171448.0,50778.0,22.85,-0.01,Medium Risk
U806,2024,6,441158.0,Stable Salary & Stable Fixed Expenses,222226,98896.0,83061,181957.0,40269.0,18.12,0.05,Medium Risk
U806,2024,7,481427.0,Stable Salary & Stable Fixed Expenses,222226,98896.0,81027,179923.0,42303.0,19.04,0.03,Medium Risk
U806,2024,8,523730.0,Stable Salary & Stable Fixed Expenses,222226,98896.0,101160,200056.0,22170.0,9.98,-0.04,High Risk
U806,2024,9,545900.0,Stable Salary & Stable Fixed Expenses,222226,98896.0,111554,210450.0,11776.0,5.3,-0.02,High Risk
U806,2024,10,557676.0,Stable Salary & Stable Fixed Expenses,222226,98896.0,99551,198447.0,23779.0,10.7,0.02,High Risk
U806,2024,11,581455.0,Stable Salary & Stable Fixed Expenses,222226,98896.0,76429,175325.0,46901.0,21.11,0.04,Medium Risk
U806,2024,12,628356.0,Stable Salary & Stable Fixed Expenses,222226,98896.0,89505,188401.0,33825.0,15.22,-0.04,Medium Risk
U807,2024,1,250000.0,Salary Increases & Fixed Expenses Increase,285466,73383.0,59682,133065.0,152401.0,53.39,0.01,Low Risk
U807,2024,2,402401.0,Salary Increases & Fixed Expenses Increase,285466,73383.0,64237,137620.0,147846.0,51.79,-0.02,Low Risk
U807,2024,3,550247.0,Salary Increases & Fixed Expenses Increase,285466,74187.0,98478,172665.0,112801.0,39.51,-0.01,Low Risk
U807,2024,4,663048.0,Salary Increases & Fixed Expenses Increase,303516,74187.0,89726,163913.0,139603.0,46.0,-0.01,Low Risk
U807,2024,5,802651.0,Salary Increases & Fixed Expenses Increase,303516,74187.0,82308,156495.0,147021.0,48.44,-0.02,Low Risk
U807,2024,6,949672.0,Salary Increases & Fixed Expenses Increase,303516,74187.0,83670,157857.0,145659.0,47.99,-0.01,Low Risk
U807,2024,7,1095331.0,Salary Increases & Fixed Expenses Increase,303516,74187.0,84645,158832.0,144684.0,47.67,0.01,Low Risk
U807,2024,8,1240015.0,Salary Increases & Fixed Expenses Increase,303516,74187.0,63845,138032.0,165484.0,54.52,0.02,Low Risk
U807,2024,9,1405499.0,Salary Increases & Fixed Expenses Increase,303516,74187.0,80012,154199.0,149317.0,49.2,0.03,Low Risk
U807,2024,10,1554816.0,Salary Increases & Fixed Expenses Increase,303516,74187.0,95518,169705.0,133811.0,44.09,0.04,Low Risk
U807,2024,11,1688627.0,Salary Increases & Fixed Expenses Increase,303516,74187.0,90276,164463.0,139053.0,45.81,0.04,Low Risk
U807,2024,12,1827680.0,Salary Increases & Fixed Expenses Increase,303516,74187.0,102252,176439.0,127077.0,41.87,0.02,Low Risk
U808,2024,1,185529.0,Salary Increases & Fixed Expenses Increase,174709,56363.0,55526,111889.0,62820.0,35.96,-0.02,Low Risk
U808,2024,2,248349.0,Salary Increases & Fixed Expenses Increase,174709,56363.0,52519,108882.0,65827.0,37.68,0.03,Low Risk
U808,2024,3,314176.0,Salary Increases & Fixed Expenses Increase,174709,56363.0,86693,143056.0,31653.0,18.12,0.01,Medium Risk
U808,2024,4,345829.0,Salary Increases & Fixed Expenses Increase,174709,56363.0,76529,132892.0,41817.0,23.94,-0.01,Medium Risk
U808,2024,5,387646.0,Salary Increases & Fixed Expenses Increase,174709,56363.0,74694,131057.0,43652.0,24.99,-0.0,Medium Risk
U808,2024,6,431298.0,Salary Increases & Fixed Expenses Increase,174709,58229.0,80587,138816.0,35893.0,20.54,0.02,Medium Risk
U808,2024,7,467191.0,Salary Increases & Fixed Expenses Increase,174709,58229.0,66802,125031.0,49678.0,28.43,-0.05,Low Risk
U808,2024,8,516869.0,Salary Increases & Fixed Expenses Increase,199367,58229.0,67261,125490.0,73877.0,37.06,0.05,Low Risk
U808,2024,9,590746.0,Salary Increases & Fixed Expenses Increase,199367,58229.0,70765,128994.0,70373.0,35.3,0.04,Low Risk
U808,2024,10,661119.0,Salary Increases & Fixed Expenses Increase,199367,59494.0,97009,156503.0,42864.0,21.5,-0.01,Medium Risk
U808,2024,11,703983.0,Salary Increases & Fixed Expenses Increase,199367,59494.0,76497,135991.0,63376.0,31.79,0.03,Low Risk
U808,2024,12,767359.0,Salary Increases & Fixed Expenses Increase,199367,59494.0,81507,141001.0,58366.0,29.28,-0.0,Low Risk
U809,2024,1,250000.0,Stable Salary & Stable Fixed Expenses,270130,61074.0,87478,148552.0,121578.0,45.01,-0.01,Low Risk
U809,2024,2,371578.0,Stable Salary & Stable Fixed Expenses,270130,61074.0,116570,177644.0,92486.0,34.24,0.04,Low Risk
U809,2024,3,464064.0,Stable Salary & Stable Fixed Expenses,270130,61074.0,96956,158030.0,112100.0,41.5,0.0,Low Risk
U809,2024,4,576164.0,Stable Salary & Stable Fixed Expenses,270130,61074.0,103924,164998.0,105132.0,38.92,-0.02,Low Risk
U809,2024,5,681296.0,Stable Salary & Stable Fixed Expenses,270130,61074.0,130334,191408.0,78722.0,29.14,-0.02,Low Risk
U809,2024,6,760018.0,Stable Salary & Stable Fixed Expenses,270130,61074.0,126996,188070.0,82060.0,30.38,-0.04,Low Risk
U809,2024,7,842078.0,Stable Salary & Stable Fixed Expenses,270130,61074.0,101326,162400.0,107730.0,39.88,0.04,Low Risk
U809,2024,8,949808.0,Stable Salary & Stable Fixed Expenses,270130,61074.0,91771,152845.0,117285.0,43.42,-0.02,Low Risk
U809,2024,9,1067093.0,Stable Salary & Stable Fixed Expenses,270130,61074.0,105306,166380.0,103750.0,38.41,-0.01,Low Risk
U809,2024,10,1170843.0,Stable Salary & Stable Fixed Expenses,270130,61074.0,97295,158369.0,111761.0,41.37,0.05,Low Risk
U809,2024,11,1282604.0,Stable Salary & Stable Fixed Expenses,270130,61074.0,136818,197892.0,72238.0,26.74,0.01,Low Risk
U809,2024,12,1354842.0,Stable Salary & Stable Fixed Expenses,270130,61074.0,93931,155005.0,115125.0,42.62,-0.02,Low Risk
U810,2024,1,215395.0,Salary Increases & Fixed Expenses Increase,204648,103346.0,133634,236980.0,-32332.0,-15.8,-0.0,High Risk
U810,2024,2,183063.0,Salary Increases & Fixed Expenses Increase,204648,103346.0,132948,236294.0,-31646.0,-15.46,-0.01,High Risk
U810,2024,3,151417.0,Salary Increases & Fixed Expenses Increase,204648,104973.0,132332,237305.0,-32657.0,-15.96,0.04,High Risk
U810,2024,4,118760.0,Salary Increases & Fixed Expenses Increase,204648,105697.0,126022,231719.0,-27071.0,-13.23,0.04,High Risk
U810,2024,5,91689.0,Salary Increases & Fixed Expenses Increase,204648,105697.0,106856,212553.0,-7905.0,-3.86,-0.04,High Risk
U810,2024,6,83784.0,Salary Increases & Fixed Expenses Increase,230402,107208.0,157879,265087.0,-34685.0,-15.05,0.02,High Risk
U810,2024,7,49099.0,Salary Increases & Fixed Expenses Increase,230402,107208.0,121958,229166.0,1236.0,0.54,-0.01,High Risk
U810,2024,8,50335.0,Salary Increases & Fixed Expenses Increase,230402,107208.0,139044,246252.0,-15850.0,-6.88,0.04,High Risk
U810,2024,9,34485.0,Salary Increases & Fixed Expenses Increase,230402,107208.0,160841,268049.0,-37647.0,-16.34,0.03,High Risk
U810,2024,10,-3162.0,Salary Increases & Fixed Expenses Increase,230402,107208.0,154503,261711.0,-31309.0,-13.59,0.03,High Risk
U810,2024,11,-34471.0,Salary Increases & Fixed Expenses Increase,230402,107208.0,158332,265540.0,-35138.0,-15.25,-0.03,High Risk
U810,2024,12,-69609.0,Salary Increases & Fixed Expenses Increase,230402,107208.0,121693,228901.0,1501.0,0.65,-0.01,High Risk
U811,2024,1,250000.0,Salary Increases & Fixed Expenses Increase,293511,97611.0,141721,239332.0,54179.0,18.46,0.02,Medium Risk
U811,2024,2,304179.0,Salary Increases & Fixed Expenses Increase,293511,97611.0,127498,225109.0,68402.0,23.3,0.03,Medium Risk
U811,2024,3,372581.0,Salary Increases & Fixed Expenses Increase,293511,98268.0,135026,233294.0,60217.0,20.52,-0.05,Medium Risk
U811,2024,4,432798.0,Salary Increases & Fixed Expenses Increase,293511,98268.0,141334,239602.0,53909.0,18.37,-0.03,Medium Risk
U811,2024,5,486707.0,Salary Increases & Fixed Expenses Increase,302605,98268.0,97200,195468.0,107137.0,35.4,0.02,Low Risk
U811,2024,6,593844.0,Salary Increases & Fixed Expenses Increase,302605,98910.0,105821,204731.0,97874.0,32.34,0.02,Low Risk
U811,2024,7,691718.0,Salary Increases & Fixed Expenses Increase,302605,98910.0,118208,217118.0,85487.0,28.25,0.02,Low Risk
U811,2024,8,777205.0,Salary Increases & Fixed Expenses Increase,302605,98910.0,129132,228042.0,74563.0,24.64,0.03,Medium Risk
U811,2024,9,851768.0,Salary Increases & Fixed Expenses Increase,302605,98910.0,130373,229283.0,73322.0,24.23,-0.0,Medium Risk
U811,2024,10,925090.0,Salary Increases & Fixed Expenses Increase,302605,98910.0,133179,232089.0,70516.0,23.3,-0.03,Medium Risk
U811,2024,11,995606.0,Salary Increases & Fixed Expenses Increase,302605,98910.0,135579,234489.0,68116.0,22.51,0.02,Medium Risk
U811,2024,12,1063722.0,Salary Increases & Fixed Expenses Increase,302605,98910.0,186666,285576.0,17029.0,5.63,-0.02,High Risk
U812,2024,1,225157.0,Salary Increases & Fixed Expenses Increase,81182,29265.0,38975,68240.0,12942.0,15.94,0.04,Medium Risk
U812,2024,2,238099.0,Salary Increases & Fixed Expenses Increase,81182,29265.0,34944,64209.0,16973.0,20.91,-0.04,Medium Risk
U812,2024,3,255072.0,Salary Increases & Fixed Expenses Increase,81182,30092.0,31423,61515.0,19667.0,24.23,-0.02,Medium Risk
U812,2024,4,274739.0,Salary Increases & Fixed Expenses Increase,81182,30092.0,33546,63638.0,17544.0,21.61,-0.01,Medium Risk
U812,2024,5,292283.0,Salary Increases & Fixed Expenses Increase,81182,30092.0,32147,62239.0,18943.0,23.33,0.02,Medium Risk
U812,2024,6,311226.0,Salary Increases & Fixed Expenses Increase,81182,30092.0,29161,59253.0,21929.0,27.01,-0.01,Low Risk
U812,2024,7,333155.0,Salary Increases & Fixed Expenses Increase,81182,30092.0,34913,65005.0,16177.0,19.93,-0.01,Medium Risk
U812,2024,8,349332.0,Salary Increases & Fixed Expenses Increase,92864,31869.0,34014,65883.0,26981.0,29.05,0.05,Low Risk
U812,2024,9,376313.0,Salary Increases & Fixed Expenses Increase,92864,31869.0,30467,62336.0,30528.0,32.87,0.0,Low Risk
U812,2024,10,406841.0,Salary Increases & Fixed Expenses Increase,92864,33520.0,32141,65661.0,27203.0,29.29,-0.01,Low Risk
U812,2024,11,434044.0,Salary Increases & Fixed Expenses Increase,92864,33520.0,46248,79768.0,13096.0,14.1,-0.04,High Risk
U812,2024,12,447140.0,Salary Increases & Fixed Expenses Increase,92864,33520.0,28225,61745.0,31119.0,33.51,0.01,Low Risk
U813,2024,1,167406.0,Salary Increases & Fixed Expenses Remain Stable,128901,79396.0,81916,161312.0,-32411.0,-25.14,0.02,High Risk
U813,2024,2,134995.0,Salary Increases & Fixed Expenses Remain Stable,128901,79396.0,76262,155658.0,-26757.0,-20.76,0.03,High Risk
U813,2024,3,108238.0,Salary Increases & Fixed Expenses Remain Stable,128901,79396.0,81538,160934.0,-32033.0,-24.85,0.03,High Risk
U813,2024,4,76205.0,Salary Increases & Fixed Expenses Remain Stable,157881,79396.0,102173,181569.0,-23688.0,-15.0,-0.01,High Risk
U813,2024,5,52517.0,Salary Increases & Fixed Expenses Remain Stable,157881,79396.0,79083,158479.0,-598.0,-0.38,-0.04,High Risk
U813,2024,6,51919.0,Salary Increases & Fixed Expenses Remain Stable,157881,79396.0,80199,159595.0,-1714.0,-1.09,-0.0,High Risk
U813,2024,7,50205.0,Salary Increases & Fixed Expenses Remain Stable,157881,79396.0,105317,184713.0,-26832.0,-17.0,-0.01,High Risk
U813,2024,8,23373.0,Salary Increases & Fixed Expenses Remain Stable,157881,79396.0,103713,183109.0,-25228.0,-15.98,0.04,High Risk
U813,2024,9,-1855.0,Salary Increases & Fixed Expenses Remain Stable,157881,79396.0,86216,165612.0,-7731.0,-4.9,-0.03,High Risk
U813,2024,10,-9586.0,Salary Increases & Fixed Expenses Remain Stable,157881,79396.0,80594,159990.0,-2109.0,-1.34,0.05,High Risk
U813,2024,11,-11695.0,Salary Increases & Fixed Expenses Remain Stable,157881,79396.0,110323,189719.0,-31838.0,-20.17,0.03,High Risk
U813,2024,12,-43533.0,Salary Increases & Fixed Expenses Remain Stable,157881,79396.0,108291,187687.0,-29806.0,-18.88,0.02,High Risk
U814,2024,1,205854.0,Stable Salary & Increasing Fixed Expenses,62676,36703.0,28658,65361.0,-2685.0,-4.28,-0.02,High Risk
U814,2024,2,203169.0,Stable Salary & Increasing Fixed Expenses,62676,36703.0,29698,66401.0,-3725.0,-5.94,0.01,High Risk
U814,2024,3,199444.0,Stable Salary & Increasing Fixed Expenses,62676,36703.0,20400,57103.0,5573.0,8.89,0.04,High Risk
U814,2024,4,205017.0,Stable Salary & Increasing Fixed Expenses,62676,37906.0,28215,66121.0,-3445.0,-5.5,0.02,High Risk
U814,2024,5,201572.0,Stable Salary & Increasing Fixed Expenses,62676,37906.0,21837,59743.0,2933.0,4.68,-0.03,High Risk
U814,2024,6,204505.0,Stable Salary & Increasing Fixed Expenses,62676,37906.0,30924,68830.0,-6154.0,-9.82,-0.02,High Risk
U814,2024,7,198351.0,Stable Salary & Increasing Fixed Expenses,62676,37906.0,22149,60055.0,2621.0,4.18,-0.04,High Risk
U814,2024,8,200972.0,Stable Salary & Increasing Fixed Expenses,62676,37906.0,30720,68626.0,-5950.0,-9.49,-0.01,High Risk
U814,2024,9,195022.0,Stable Salary & Increasing Fixed Expenses,62676,37906.0,29389,67295.0,-4619.0,-7.37,0.04,High Risk
U814,2024,10,190403.0,Stable Salary & Increasing Fixed Expenses,62676,39237.0,23034,62271.0,405.0,0.65,-0.0,High Risk
U814,2024,11,190808.0,Stable Salary & Increasing Fixed Expenses,62676,40592.0,25915,66507.0,-3831.0,-6.11,-0.02,High Risk
U814,2024,12,186977.0,Stable Salary & Increasing Fixed Expenses,62676,40592.0,18968,59560.0,3116.0,4.97,-0.03,High Risk
U815,2024,1,245061.0,Salary Increases & Fixed Expenses Increase,241767,74698.0,70794,145492.0,96275.0,39.82,0.03,Low Risk
U815,2024,2,341336.0,Salary Increases & Fixed Expenses Increase,241767,74698.0,57128,131826.0,109941.0,45.47,0.04,Low Risk
U815,2024,3,451277.0,Salary Increases & Fixed Expenses Increase,241767,74698.0,49799,124497.0,117270.0,48.51,-0.05,Low Risk
U815,2024,4,568547.0,Salary Increases & Fixed Expenses Increase,241767,74698.0,48581,123279.0,118488.0,49.01,-0.04,Low Risk
U815,2024,5,687035.0,Salary Increases & Fixed Expenses Increase,241767,74698.0,64023,138721.0,103046.0,42.62,0.04,Low Risk
U815,2024,6,790081.0,Salary Increases & Fixed Expenses Increase,266910,74698.0,56859,131557.0,135353.0,50.71,-0.02,Low Risk
U815,2024,7,925434.0,Salary Increases & Fixed Expenses Increase,266910,75954.0,59390,135344.0,131566.0,49.29,-0.04,Low Risk
U815,2024,8,1057000.0,Salary Increases & Fixed Expenses Increase,266910,75954.0,54333,130287.0,136623.0,51.19,-0.0,Low Risk
U815,2024,9,1193623.0,Salary Increases & Fixed Expenses Increase,266910,75954.0,66285,142239.0,124671.0,46.71,0.01,Low Risk
U815,2024,10,1318294.0,Salary Increases & Fixed Expenses Increase,266910,75954.0,63921,139875.0,127035.0,47.59,0.03,Low Risk
U815,2024,11,1445329.0,Salary Increases & Fixed Expenses Increase,266910,75954.0,87337,163291.0,103619.0,38.82,-0.01,Low Risk
U815,2024,12,1548948.0,Salary Increases & Fixed Expenses Increase,266910,75954.0,65177,141131.0,125779.0,47.12,-0.0,Low Risk
U816,2024,1,179798.0,Stable Salary & Increasing Fixed Expenses,161106,79431.0,41217,120648.0,40458.0,25.11,0.01,Low Risk
U816,2024,2,220256.0,Stable Salary & Increasing Fixed Expenses,161106,80258.0,39568,119826.0,41280.0,25.62,-0.0,Low Risk
U816,2024,3,261536.0,Stable Salary & Increasing Fixed Expenses,161106,80258.0,44116,124374.0,36732.0,22.8,-0.01,Medium Risk
U816,2024,4,298268.0,Stable Salary & Increasing Fixed Expenses,161106,80258.0,40611,120869.0,40237.0,24.98,-0.05,Medium Risk
U816,2024,5,338505.0,Stable Salary & Increasing Fixed Expenses,161106,80258.0,35997,116255.0,44851.0,27.84,-0.02,Low Risk
U816,2024,6,383356.0,Stable Salary & Increasing Fixed Expenses,161106,80258.0,47138,127396.0,33710.0,20.92,0.03,Medium Risk
U816,2024,7,417066.0,Stable Salary & Increasing Fixed Expenses,161106,80258.0,38475,118733.0,42373.0,26.3,-0.01,Low Risk
U816,2024,8,459439.0,Stable Salary & Increasing Fixed Expenses,161106,80258.0,38352,118610.0,42496.0,26.38,0.04,Low Risk
U816,2024,9,501935.0,Stable Salary & Increasing Fixed Expenses,161106,80258.0,44289,124547.0,36559.0,22.69,-0.01,Medium Risk
U816,2024,10,538494.0,Stable Salary & Increasing Fixed Expenses,161106,80258.0,51705,131963.0,29143.0,18.09,0.04,Medium Risk
U816,2024,11,567637.0,Stable Salary & Increasing Fixed Expenses,161106,80258.0,34822,115080.0,46026.0,28.57,-0.02,Low Risk
U816,2024,12,613663.0,Stable Salary & Increasing Fixed Expenses,161106,80258.0,47748,128006.0,33100.0,20.55,-0.01,Medium Risk
U817,2024,1,250000.0,Salary Increases & Fixed Expenses Remain Stable,254680,68945.0,105377,174322.0,80358.0,31.55,0.04,Low Risk
U817,2024,2,330358.0,Salary Increases & Fixed Expenses Remain Stable,254680,68945.0,82228,151173.0,103507.0,40.64,0.0,Low Risk
U817,2024,3,433865.0,Salary Increases & Fixed Expenses Remain Stable,254680,68945.0,127881,196826.0,57854.0,22.72,-0.01,Medium Risk
U817,2024,4,491719.0,Salary Increases & Fixed Expenses Remain Stable,254680,68945.0,111912,180857.0,73823.0,28.99,-0.04,Low Risk
U817,2024,5,565542.0,Salary Increases & Fixed Expenses Remain Stable,254680,68945.0,96119,165064.0,89616.0,35.19,0.0,Low Risk
U817,2024,6,655158.0,Salary Increases & Fixed Expenses Remain Stable,268773,68945.0,120884,189829.0,78944.0,29.37,-0.05,Low Risk
U817,2024,7,734102.0,Salary Increases & Fixed Expenses Remain Stable,268773,68945.0,96801,165746.0,103027.0,38.33,0.05,Low Risk
U817,2024,8,837129.0,Salary Increases & Fixed Expenses Remain Stable,268773,68945.0,123632,192577.0,76196.0,28.35,0.02,Low Risk
U817,2024,9,913325.0,Salary Increases & Fixed Expenses Remain Stable,268773,68945.0,117155,186100.0,82673.0,30.76,0.02,Low Risk
U817,2024,10,995998.0,Salary Increases & Fixed Expenses Remain Stable,268773,68945.0,117843,186788.0,81985.0,30.5,0.03,Low Risk
U817,2024,11,1077983.0,Salary Increases & Fixed Expenses Remain Stable,268773,68945.0,111668,180613.0,88160.0,32.8,-0.0,Low Risk
U817,2024,12,1166143.0,Salary Increases & Fixed Expenses Remain Stable,268773,68945.0,158606,227551.0,41222.0,15.34,-0.02,Medium Risk
U818,2024,1,133226.0,Salary Increases & Fixed Expenses Remain Stable,123946,52906.0,30403,83309.0,40637.0,32.79,0.0,Low Risk
U818,2024,2,173863.0,Salary Increases & Fixed Expenses Remain Stable,123946,52906.0,25815,78721.0,45225.0,36.49,0.04,Low Risk
U818,2024,3,219088.0,Salary Increases & Fixed Expenses Remain Stable,150979,52906.0,46272,99178.0,51801.0,34.31,0.02,Low Risk
U818,2024,4,270889.0,Salary Increases & Fixed Expenses Remain Stable,150979,52906.0,30926,83832.0,67147.0,44.47,-0.0,Low Risk
U818,2024,5,338036.0,Salary Increases & Fixed Expenses Remain Stable,150979,52906.0,40900,93806.0,57173.0,37.87,0.04,Low Risk
U818,2024,6,395209.0,Salary Increases & Fixed Expenses Remain Stable,150979,52906.0,40717,93623.0,57356.0,37.99,-0.04,Low Risk
U818,2024,7,452565.0,Salary Increases & Fixed Expenses Remain Stable,150979,52906.0,39442,92348.0,58631.0,38.83,0.01,Low Risk
U818,2024,8,511196.0,Salary Increases & Fixed Expenses Remain Stable,150979,52906.0,34677,87583.0,63396.0,41.99,0.05,Low Risk
U818,2024,9,574592.0,Salary Increases & Fixed Expenses Remain Stable,150979,52906.0,35861,88767.0,62212.0,41.21,0.02,Low Risk
U818,2024,10,636804.0,Salary Increases & Fixed Expenses Remain Stable,150979,52906.0,36404,89310.0,61669.0,40.85,-0.0,Low Risk
U818,2024,11,698473.0,Salary Increases & Fixed Expenses Remain Stable,150979,52906.0,36979,89885.0,61094.0,40.47,-0.04,Low Risk
U818,2024,12,759567.0,Salary Increases & Fixed Expenses Remain Stable,150979,52906.0,44718,97624.0,53355.0,35.34,0.01,Low Risk
U819,2024,1,245162.0,Salary Increases & Fixed Expenses Increase,182908,71731.0,42461,114192.0,68716.0,37.57,-0.01,Low Risk
U819,2024,2,313878.0,Salary Increases & Fixed Expenses Increase,182908,71731.0,50959,122690.0,60218.0,32.92,0.04,Low Risk
U819,2024,3,374096.0,Salary Increases & Fixed Expenses Increase,182908,73270.0,65077,138347.0,44561.0,24.36,-0.05,Medium Risk
U819,2024,4,418657.0,Salary Increases & Fixed Expenses Increase,189552,74479.0,38267,112746.0,76806.0,40.52,-0.03,Low Risk
U819,2024,5,495463.0,Salary Increases & Fixed Expenses Increase,189552,74479.0,39924,114403.0,75149.0,39.65,0.05,Low Risk
U819,2024,6,570612.0,Salary Increases & Fixed Expenses Increase,189552,75147.0,39006,114153.0,75399.0,39.78,0.02,Low Risk
U819,2024,7,646011.0,Salary Increases & Fixed Expenses Increase,189552,75147.0,44083,119230.0,70322.0,37.1,-0.02,Low Risk
U819,2024,8,716333.0,Salary Increases & Fixed Expenses Increase,189552,75147.0,43732,118879.0,70673.0,37.28,-0.01,Low Risk
U819,2024,9,787006.0,Salary Increases & Fixed Expenses Increase,189552,75147.0,47920,123067.0,66485.0,35.07,0.0,Low Risk
U819,2024,10,853491.0,Salary Increases & Fixed Expenses Increase,189552,75147.0,63532,138679.0,50873.0,26.84,0.0,Low Risk
U819,2024,11,904364.0,Salary Increases & Fixed Expenses Increase,189552,75147.0,47909,123056.0,66496.0,35.08,-0.02,Low Risk
U819,2024,12,970860.0,Salary Increases & Fixed Expenses Increase,189552,75147.0,51811,126958.0,62594.0,33.02,0.01,Low Risk
U820,2024,1,179317.0,Salary Increases & Fixed Expenses Remain Stable,82079,38175.0,35558,73733.0,8346.0,10.17,-0.0,High Risk
U820,2024,2,187663.0,Salary Increases & Fixed Expenses Remain Stable,82079,38175.0,26930,65105.0,16974.0,20.68,-0.03,Medium Risk
U820,2024,3,204637.0,Salary Increases & Fixed Expenses Remain Stable,99578,38175.0,34061,72236.0,27342.0,27.46,0.04,Low Risk
U820,2024,4,231979.0,Salary Increases & Fixed Expenses Remain Stable,99578,38175.0,32285,70460.0,29118.0,29.24,0.01,Low Risk
U820,2024,5,261097.0,Salary Increases & Fixed Expenses Remain Stable,99578,38175.0,36882,75057.0,24521.0,24.62,-0.01,Medium Risk
U820,2024,6,285618.0,Salary Increases & Fixed Expenses Remain Stable,99578,38175.0,38233,76408.0,23170.0,23.27,0.01,Medium Risk
U820,2024,7,308788.0,Salary Increases & Fixed Expenses Remain Stable,99578,38175.0,33408,71583.0,27995.0,28.11,0.02,Low Risk
U820,2024,8,336783.0,Salary Increases & Fixed Expenses Remain Stable,99578,38175.0,37916,76091.0,23487.0,23.59,-0.04,Medium Risk
U820,2024,9,360270.0,Salary Increases & Fixed Expenses Remain Stable,99578,38175.0,32484,70659.0,28919.0,29.04,0.05,Low Risk
U820,2024,10,389189.0,Salary Increases & Fixed Expenses Remain Stable,99578,38175.0,40875,79050.0,20528.0,20.61,-0.05,Medium Risk
U820,2024,11,409717.0,Salary Increases & Fixed Expenses Remain Stable,99578,38175.0,48410,86585.0,12993.0,13.05,0.01,High Risk
U820,2024,12,422710.0,Salary Increases & Fixed Expenses Remain Stable,99578,38175.0,38270,76445.0,23133.0,23.23,0.02,Medium Risk
U821,2024,1,78325.0,Salary Increases & Fixed Expenses Remain Stable,29389,15901.0,11588,27489.0,1900.0,6.47,0.02,High Risk
U821,2024,2,80225.0,Salary Increases & Fixed Expenses Remain Stable,29389,15901.0,9360,25261.0,4128.0,14.05,0.01,High Risk
U821,2024,3,84353.0,Salary Increases & Fixed Expenses Remain Stable,29389,15901.0,12619,28520.0,869.0,2.96,-0.02,High Risk
U821,2024,4,85222.0,Salary Increases & Fixed Expenses Remain Stable,29389,15901.0,12493,28394.0,995.0,3.39,-0.02,High Risk
U821,2024,5,86217.0,Salary Increases & Fixed Expenses Remain Stable,45683,15901.0,15663,31564.0,14119.0,30.91,-0.03,Low Risk
U821,2024,6,100336.0,Salary Increases & Fixed Expenses Remain Stable,45683,15901.0,20529,36430.0,9253.0,20.25,0.0,Medium Risk
U821,2024,7,109589.0,Salary Increases & Fixed Expenses Remain Stable,45683,15901.0,16931,32832.0,12851.0,28.13,-0.02,Low Risk
U821,2024,8,122440.0,Salary Increases & Fixed Expenses Remain Stable,45683,15901.0,19431,35332.0,10351.0,22.66,0.0,Medium Risk
U821,2024,9,132791.0,Salary Increases & Fixed Expenses Remain Stable,45683,15901.0,16524,32425.0,13258.0,29.02,0.02,Low Risk
U821,2024,10,146049.0,Salary Increases & Fixed Expenses Remain Stable,45683,15901.0,15581,31482.0,14201.0,31.09,-0.01,Low Risk
U821,2024,11,160250.0,Salary Increases & Fixed Expenses Remain Stable,45683,15901.0,16874,32775.0,12908.0,28.26,0.05,Low Risk
U821,2024,12,173158.0,Salary Increases & Fixed Expenses Remain Stable,45683,15901.0,17211,33112.0,12571.0,27.52,-0.01,Low Risk
U822,2024,1,200272.0,Salary Increases & Fixed Expenses Remain Stable,25186,21997.0,14117,36114.0,-10928.0,-43.39,-0.04,High Risk
U822,2024,2,189344.0,Salary Increases & Fixed Expenses Remain Stable,25186,21997.0,13996,35993.0,-10807.0,-42.91,0.0,High Risk
U822,2024,3,178537.0,Salary Increases & Fixed Expenses Remain Stable,53775,21997.0,39997,61994.0,-8219.0,-15.28,0.0,High Risk
U822,2024,4,170318.0,Salary Increases & Fixed Expenses Remain Stable,53775,21997.0,31324,53321.0,454.0,0.84,-0.03,High Risk
U822,2024,5,170772.0,Salary Increases & Fixed Expenses Remain Stable,53775,21997.0,30632,52629.0,1146.0,2.13,-0.04,High Risk
U822,2024,6,171918.0,Salary Increases & Fixed Expenses Remain Stable,53775,21997.0,36754,58751.0,-4976.0,-9.25,-0.01,High Risk
U822,2024,7,166942.0,Salary Increases & Fixed Expenses Remain Stable,53775,21997.0,33101,55098.0,-1323.0,-2.46,-0.01,High Risk
U822,2024,8,165619.0,Salary Increases & Fixed Expenses Remain Stable,53775,21997.0,30267,52264.0,1511.0,2.81,0.05,High Risk
U822,2024,9,167130.0,Salary Increases & Fixed Expenses Remain Stable,53775,21997.0,35327,57324.0,-3549.0,-6.6,0.0,High Risk
U822,2024,10,163581.0,Salary Increases & Fixed Expenses Remain Stable,53775,21997.0,38452,60449.0,-6674.0,-12.41,-0.01,High Risk
U822,2024,11,156907.0,Salary Increases & Fixed Expenses Remain Stable,53775,21997.0,34908,56905.0,-3130.0,-5.82,-0.05,High Risk
U822,2024,12,153777.0,Salary Increases & Fixed Expenses Remain Stable,53775,21997.0,33698,55695.0,-1920.0,-3.57,-0.03,High Risk
U823,2024,1,137457.0,Stable Salary & Increasing Fixed Expenses,66020,36981.0,41812,78793.0,-12773.0,-19.35,0.02,High Risk
U823,2024,2,124684.0,Stable Salary & Increasing Fixed Expenses,66020,36981.0,43684,80665.0,-14645.0,-22.18,-0.02,High Risk
U823,2024,3,110039.0,Stable Salary & Increasing Fixed Expenses,66020,36981.0,45342,82323.0,-16303.0,-24.69,-0.05,High Risk
U823,2024,4,93736.0,Stable Salary & Increasing Fixed Expenses,66020,36981.0,38304,75285.0,-9265.0,-14.03,0.0,High Risk
U823,2024,5,84471.0,Stable Salary & Increasing Fixed Expenses,66020,36981.0,37319,74300.0,-8280.0,-12.54,-0.01,High Risk
U823,2024,6,76191.0,Stable Salary & Increasing Fixed Expenses,66020,36981.0,36894,73875.0,-7855.0,-11.9,0.01,High Risk
U823,2024,7,68336.0,Stable Salary & Increasing Fixed Expenses,66020,36981.0,45885,82866.0,-16846.0,-25.52,0.01,High Risk
U823,2024,8,51490.0,Stable Salary & Increasing Fixed Expenses,66020,36981.0,38055,75036.0,-9016.0,-13.66,0.04,High Risk
U823,2024,9,42474.0,Stable Salary & Increasing Fixed Expenses,66020,36981.0,40127,77108.0,-11088.0,-16.79,0.04,High Risk
U823,2024,10,31386.0,Stable Salary & Increasing Fixed Expenses,66020,36981.0,47906,84887.0,-18867.0,-28.58,-0.01,High Risk
U823,2024,11,12519.0,Stable Salary & Increasing Fixed Expenses,66020,36981.0,47772,84753.0,-18733.0,-28.37,0.01,High Risk
U823,2024,12,-6214.0,Stable Salary & Increasing Fixed Expenses,66020,36981.0,50905,87886.0,-21866.0,-33.12,-0.02,High Risk
U824,2024,1,250000.0,Stable Salary & Decreasing Fixed Expenses,278404,99415.0,101717,201132.0,77272.0,27.76,0.04,Low Risk
U824,2024,2,327272.0,Stable Salary & Decreasing Fixed Expenses,278404,99415.0,88176,187591.0,90813.0,32.62,0.02,Low Risk
U824,2024,3,418085.0,Stable Salary & Decreasing Fixed Expenses,278404,99415.0,126672,226087.0,52317.0,18.79,0.01,Medium Risk
U824,2024,4,470402.0,Stable Salary & Decreasing Fixed Expenses,278404,99415.0,120825,220240.0,58164.0,20.89,0.01,Medium Risk
U824,2024,5,528566.0,Stable Salary & Decreasing Fixed Expenses,278404,99415.0,136315,235730.0,42674.0,15.33,-0.02,Medium Risk
U824,2024,6,571240.0,Stable Salary & Decreasing Fixed Expenses,278404,99415.0,112284,211699.0,66705.0,23.96,-0.02,Medium Risk
U824,2024,7,637945.0,Stable Salary & Decreasing Fixed Expenses,278404,99415.0,108444,207859.0,70545.0,25.34,-0.04,Low Risk
U824,2024,8,708490.0,Stable Salary & Decreasing Fixed Expenses,278404,99415.0,92905,192320.0,86084.0,30.92,0.02,Low Risk
U824,2024,9,794574.0,Stable Salary & Decreasing Fixed Expenses,278404,99415.0,148409,247824.0,30580.0,10.98,0.01,High Risk
U824,2024,10,825154.0,Stable Salary & Decreasing Fixed Expenses,278404,99415.0,92919,192334.0,86070.0,30.92,0.04,Low Risk
U824,2024,11,911224.0,Stable Salary & Decreasing Fixed Expenses,278404,99415.0,109866,209281.0,69123.0,24.83,-0.03,Medium Risk
U824,2024,12,980347.0,Stable Salary & Decreasing Fixed Expenses,278404,99415.0,104159,203574.0,74830.0,26.88,0.03,Low Risk
U825,2024,1,185584.0,Salary Increases & Fixed Expenses Increase,167538,40862.0,47837,88699.0,78839.0,47.06,-0.0,Low Risk
U825,2024,2,264423.0,Salary Increases & Fixed Expenses Increase,167538,40862.0,44720,85582.0,81956.0,48.92,-0.05,Low Risk
U825,2024,3,346379.0,Salary Increases & Fixed Expenses Increase,167538,40862.0,46863,87725.0,79813.0,47.64,0.02,Low Risk
U825,2024,4,426192.0,Salary Increases & Fixed Expenses Increase,193446,40862.0,54153,95015.0,98431.0,50.88,-0.02,Low Risk
U825,2024,5,524623.0,Salary Increases & Fixed Expenses Increase,193446,40862.0,47986,88848.0,104598.0,54.07,0.0,Low Risk
U825,2024,6,629221.0,Salary Increases & Fixed Expenses Increase,193446,40862.0,40105,80967.0,112479.0,58.14,-0.04,Low Risk
U825,2024,7,741700.0,Salary Increases & Fixed Expenses Increase,193446,40862.0,45255,86117.0,107329.0,55.48,0.05,Low Risk
U825,2024,8,849029.0,Salary Increases & Fixed Expenses Increase,193446,40862.0,50108,90970.0,102476.0,52.97,-0.04,Low Risk
U825,2024,9,951505.0,Salary Increases & Fixed Expenses Increase,193446,40862.0,55011,95873.0,97573.0,50.44,0.05,Low Risk
U825,2024,10,1049078.0,Salary Increases & Fixed Expenses Increase,193446,42698.0,55750,98448.0,94998.0,49.11,0.01,Low Risk
U825,2024,11,1144076.0,Salary Increases & Fixed Expenses Increase,193446,42698.0,54940,97638.0,95808.0,49.53,0.03,Low Risk
U825,2024,12,1239884.0,Salary Increases & Fixed Expenses Increase,193446,42698.0,63129,105827.0,87619.0,45.29,-0.02,Low Risk
U826,2024,1,46689.0,Stable Salary & Increasing Fixed Expenses,35296,11590.0,8035,19625.0,15671.0,44.4,-0.01,Low Risk
U826,2024,2,62360.0,Stable Salary & Increasing Fixed Expenses,35296,11590.0,7178,18768.0,16528.0,46.83,0.02,Low Risk
U826,2024,3,78888.0,Stable Salary & Increasing Fixed Expenses,35296,13099.0,9395,22494.0,12802.0,36.27,-0.03,Low Risk
U826,2024,4,91690.0,Stable Salary & Increasing Fixed Expenses,35296,13099.0,10084,23183.0,12113.0,34.32,0.05,Low Risk
U826,2024,5,103803.0,Stable Salary & Increasing Fixed Expenses,35296,13099.0,7659,20758.0,14538.0,41.19,-0.05,Low Risk
U826,2024,6,118341.0,Stable Salary & Increasing Fixed Expenses,35296,13947.0,8823,22770.0,12526.0,35.49,0.05,Low Risk
U826,2024,7,130867.0,Stable Salary & Increasing Fixed Expenses,35296,13947.0,7451,21398.0,13898.0,39.38,0.01,Low Risk
U826,2024,8,144765.0,Stable Salary & Increasing Fixed Expenses,35296,13947.0,8341,22288.0,13008.0,36.85,0.04,Low Risk
U826,2024,9,157773.0,Stable Salary & Increasing Fixed Expenses,35296,13947.0,8611,22558.0,12738.0,36.09,-0.02,Low Risk
U826,2024,10,170511.0,Stable Salary & Increasing Fixed Expenses,35296,13947.0,9259,23206.0,12090.0,34.25,0.01,Low Risk
U826,2024,11,182601.0,Stable Salary & Increasing Fixed Expenses,35296,13947.0,10581,24528.0,10768.0,30.51,0.03,Low Risk
U826,2024,12,193369.0,Stable Salary & Increasing Fixed Expenses,35296,13947.0,9417,23364.0,11932.0,33.81,-0.04,Low Risk
U827,2024,1,250000.0,Stable Salary & Increasing Fixed Expenses,271806,111586.0,115591,227177.0,44629.0,16.42,0.04,Medium Risk
U827,2024,2,294629.0,Stable Salary & Increasing Fixed Expenses,271806,112488.0,134199,246687.0,25119.0,9.24,-0.03,High Risk
U827,2024,3,319748.0,Stable Salary & Increasing Fixed Expenses,271806,113617.0,94158,207775.0,64031.0,23.56,0.04,Medium Risk
U827,2024,4,383779.0,Stable Salary & Increasing Fixed Expenses,271806,113617.0,82161,195778.0,76028.0,27.97,-0.01,Low Risk
U827,2024,5,459807.0,Stable Salary & Increasing Fixed Expenses,271806,113617.0,86076,199693.0,72113.0,26.53,-0.0,Low Risk
U827,2024,6,531920.0,Stable Salary & Increasing Fixed Expenses,271806,113617.0,130885,244502.0,27304.0,10.05,-0.03,High Risk
U827,2024,7,559224.0,Stable Salary & Increasing Fixed Expenses,271806,115158.0,128494,243652.0,28154.0,10.36,0.04,High Risk
U827,2024,8,587378.0,Stable Salary & Increasing Fixed Expenses,271806,115158.0,86316,201474.0,70332.0,25.88,-0.02,Low Risk
U827,2024,9,657710.0,Stable Salary & Increasing Fixed Expenses,271806,115158.0,81633,196791.0,75015.0,27.6,0.02,Low Risk
U827,2024,10,732725.0,Stable Salary & Increasing Fixed Expenses,271806,115158.0,82435,197593.0,74213.0,27.3,-0.05,Low Risk
U827,2024,11,806938.0,Stable Salary & Increasing Fixed Expenses,271806,115158.0,85215,200373.0,71433.0,26.28,0.03,Low Risk
U827,2024,12,878371.0,Stable Salary & Increasing Fixed Expenses,271806,115158.0,86131,201289.0,70517.0,25.94,-0.03,Low Risk
U828,2024,1,250000.0,Stable Salary & Increasing Fixed Expenses,272404,110632.0,56267,166899.0,105505.0,38.73,-0.04,Low Risk
U828,2024,2,355505.0,Stable Salary & Increasing Fixed Expenses,272404,110632.0,58375,169007.0,103397.0,37.96,0.02,Low Risk
U828,2024,3,458902.0,Stable Salary & Increasing Fixed Expenses,272404,111168.0,80126,191294.0,81110.0,29.78,-0.0,Low Risk
U828,2024,4,540012.0,Stable Salary & Increasing Fixed Expenses,272404,111168.0,64288,175456.0,96948.0,35.59,-0.05,Low Risk
U828,2024,5,636960.0,Stable Salary & Increasing Fixed Expenses,272404,111168.0,56065,167233.0,105171.0,38.61,-0.02,Low Risk
U828,2024,6,742131.0,Stable Salary & Increasing Fixed Expenses,272404,111168.0,78887,190055.0,82349.0,30.23,0.04,Low Risk
U828,2024,7,824480.0,Stable Salary & Increasing Fixed Expenses,272404,111168.0,58489,169657.0,102747.0,37.72,0.0,Low Risk
U828,2024,8,927227.0,Stable Salary & Increasing Fixed Expenses,272404,111168.0,81716,192884.0,79520.0,29.19,0.02,Low Risk
U828,2024,9,1006747.0,Stable Salary & Increasing Fixed Expenses,272404,111168.0,75903,187071.0,85333.0,31.33,-0.03,Low Risk
U828,2024,10,1092080.0,Stable Salary & Increasing Fixed Expenses,272404,111168.0,55254,166422.0,105982.0,38.91,0.01,Low Risk
U828,2024,11,1198062.0,Stable Salary & Increasing Fixed Expenses,272404,111168.0,69425,180593.0,91811.0,33.7,0.03,Low Risk
U828,2024,12,1289873.0,Stable Salary & Increasing Fixed Expenses,272404,111168.0,75610,186778.0,85626.0,31.43,0.02,Low Risk
U829,2024,1,220471.0,Stable Salary & Increasing Fixed Expenses,156434,55809.0,34571,90380.0,66054.0,42.22,-0.03,Low Risk
U829,2024,2,286525.0,Stable Salary & Increasing Fixed Expenses,156434,55809.0,40346,96155.0,60279.0,38.53,-0.04,Low Risk
U829,2024,3,346804.0,Stable Salary & Increasing Fixed Expenses,156434,55809.0,38885,94694.0,61740.0,39.47,-0.05,Low Risk
U829,2024,4,408544.0,Stable Salary & Increasing Fixed Expenses,156434,55809.0,33954,89763.0,66671.0,42.62,-0.05,Low Risk
U829,2024,5,475215.0,Stable Salary & Increasing Fixed Expenses,156434,57454.0,39235,96689.0,59745.0,38.19,-0.03,Low Risk
U829,2024,6,534960.0,Stable Salary & Increasing Fixed Expenses,156434,58953.0,43995,102948.0,53486.0,34.19,0.03,Low Risk
U829,2024,7,588446.0,Stable Salary & Increasing Fixed Expenses,156434,58953.0,36885,95838.0,60596.0,38.74,-0.02,Low Risk
U829,2024,8,649042.0,Stable Salary & Increasing Fixed Expenses,156434,58953.0,44348,103301.0,53133.0,33.97,0.03,Low Risk
U829,2024,9,702175.0,Stable Salary & Increasing Fixed Expenses,156434,58953.0,52384,111337.0,45097.0,28.83,-0.03,Low Risk
U829,2024,10,747272.0,Stable Salary & Increasing Fixed Expenses,156434,58953.0,36482,95435.0,60999.0,38.99,0.01,Low Risk
U829,2024,11,808271.0,Stable Salary & Increasing Fixed Expenses,156434,60091.0,35874,95965.0,60469.0,38.65,-0.03,Low Risk
U829,2024,12,868740.0,Stable Salary & Increasing Fixed Expenses,156434,60091.0,35967,96058.0,60376.0,38.6,-0.03,Low Risk
U830,2024,1,240591.0,Salary Increases & Fixed Expenses Remain Stable,88689,32032.0,18143,50175.0,38514.0,43.43,0.03,Low Risk
U830,2024,2,279105.0,Salary Increases & Fixed Expenses Remain Stable,88689,32032.0,18130,50162.0,38527.0,43.44,-0.02,Low Risk
U830,2024,3,317632.0,Salary Increases & Fixed Expenses Remain Stable,88689,32032.0,23997,56029.0,32660.0,36.83,-0.04,Low Risk
U830,2024,4,350292.0,Salary Increases & Fixed Expenses Remain Stable,105619,32032.0,26636,58668.0,46951.0,44.45,-0.05,Low Risk
U830,2024,5,397243.0,Salary Increases & Fixed Expenses Remain Stable,105619,32032.0,23028,55060.0,50559.0,47.87,-0.01,Low Risk
U830,2024,6,447802.0,Salary Increases & Fixed Expenses Remain Stable,105619,32032.0,29084,61116.0,44503.0,42.14,0.04,Low Risk
U830,2024,7,492305.0,Salary Increases & Fixed Expenses Remain Stable,105619,32032.0,28687,60719.0,44900.0,42.51,0.04,Low Risk
U830,2024,8,537205.0,Salary Increases & Fixed Expenses Remain Stable,105619,32032.0,25011,57043.0,48576.0,45.99,-0.05,Low Risk
U830,2024,9,585781.0,Salary Increases & Fixed Expenses Remain Stable,105619,32032.0,32215,64247.0,41372.0,39.17,0.01,Low Risk
U830,2024,10,627153.0,Salary Increases & Fixed Expenses Remain Stable,105619,32032.0,31641,63673.0,41946.0,39.71,-0.01,Low Risk
U830,2024,11,669099.0,Salary Increases & Fixed Expenses Remain Stable,105619,32032.0,33616,65648.0,39971.0,37.84,-0.0,Low Risk
U830,2024,12,709070.0,Salary Increases & Fixed Expenses Remain Stable,105619,32032.0,33093,65125.0,40494.0,38.34,-0.04,Low Risk
U831,2024,1,243655.0,Salary Increases & Fixed Expenses Increase,193464,46717.0,129462,176179.0,17285.0,8.93,-0.01,High Risk
U831,2024,2,260940.0,Salary Increases & Fixed Expenses Increase,193464,46717.0,106958,153675.0,39789.0,20.57,-0.04,Medium Risk
U831,2024,3,300729.0,Salary Increases & Fixed Expenses Increase,193464,47666.0,110293,157959.0,35505.0,18.35,0.05,Medium Risk
U831,2024,4,336234.0,Salary Increases & Fixed Expenses Increase,223273,47666.0,122092,169758.0,53515.0,23.97,0.01,Medium Risk
U831,2024,5,389749.0,Salary Increases & Fixed Expenses Increase,223273,49638.0,123245,172883.0,50390.0,22.57,0.02,Medium Risk
U831,2024,6,440139.0,Salary Increases & Fixed Expenses Increase,223273,49638.0,117172,166810.0,56463.0,25.29,0.01,Low Risk
U831,2024,7,496602.0,Salary Increases & Fixed Expenses Increase,223273,49638.0,112791,162429.0,60844.0,27.25,-0.01,Low Risk
U831,2024,8,557446.0,Salary Increases & Fixed Expenses Increase,223273,49638.0,147407,197045.0,26228.0,11.75,0.04,High Risk
U831,2024,9,583674.0,Salary Increases & Fixed Expenses Increase,223273,49638.0,153259,202897.0,20376.0,9.13,0.01,High Risk
U831,2024,10,604050.0,Salary Increases & Fixed Expenses Increase,223273,49638.0,115676,165314.0,57959.0,25.96,0.04,Low Risk
U831,2024,11,662009.0,Salary Increases & Fixed Expenses Increase,223273,49638.0,134958,184596.0,38677.0,17.32,-0.04,Medium Risk
U831,2024,12,700686.0,Salary Increases & Fixed Expenses Increase,223273,49638.0,144348,193986.0,29287.0,13.12,0.05,High Risk
U832,2024,1,250000.0,Salary Increases & Fixed Expenses Remain Stable,275818,109284.0,159019,268303.0,7515.0,2.72,0.04,High Risk
U832,2024,2,257515.0,Salary Increases & Fixed Expenses Remain Stable,275818,109284.0,191393,300677.0,-24859.0,-9.01,0.03,High Risk
U832,2024,3,232656.0,Salary Increases & Fixed Expenses Remain Stable,275818,109284.0,140752,250036.0,25782.0,9.35,-0.01,High Risk
U832,2024,4,258438.0,Salary Increases & Fixed Expenses Remain Stable,275818,109284.0,168085,277369.0,-1551.0,-0.56,-0.04,High Risk
U832,2024,5,256887.0,Salary Increases & Fixed Expenses Remain Stable,275818,109284.0,164808,274092.0,1726.0,0.63,-0.03,High Risk
U832,2024,6,258613.0,Salary Increases & Fixed Expenses Remain Stable,275818,109284.0,139088,248372.0,27446.0,9.95,0.02,High Risk
U832,2024,7,286059.0,Salary Increases & Fixed Expenses Remain Stable,275818,109284.0,160985,270269.0,5549.0,2.01,0.03,High Risk
U832,2024,8,291608.0,Salary Increases & Fixed Expenses Remain Stable,293515,109284.0,170218,279502.0,14013.0,4.77,0.01,High Risk
U832,2024,9,305621.0,Salary Increases & Fixed Expenses Remain Stable,293515,109284.0,154537,263821.0,29694.0,10.12,-0.05,High Risk
U832,2024,10,335315.0,Salary Increases & Fixed Expenses Remain Stable,293515,109284.0,183286,292570.0,945.0,0.32,-0.04,High Risk
U832,2024,11,336260.0,Salary Increases & Fixed Expenses Remain Stable,293515,109284.0,197938,307222.0,-13707.0,-4.67,0.04,High Risk
U832,2024,12,322553.0,Salary Increases & Fixed Expenses Remain Stable,293515,109284.0,159058,268342.0,25173.0,8.58,-0.05,High Risk
U833,2024,1,183061.0,Stable Salary & Increasing Fixed Expenses,56644,36820.0,31169,67989.0,-11345.0,-20.03,0.02,High Risk
U833,2024,2,171716.0,Stable Salary & Increasing Fixed Expenses,56644,36820.0,37246,74066.0,-17422.0,-30.76,0.04,High Risk
U833,2024,3,154294.0,Stable Salary & Increasing Fixed Expenses,56644,36820.0,38136,74956.0,-18312.0,-32.33,0.04,High Risk
U833,2024,4,135982.0,Stable Salary & Increasing Fixed Expenses,56644,36820.0,34375,71195.0,-14551.0,-25.69,-0.01,High Risk
U833,2024,5,121431.0,Stable Salary & Increasing Fixed Expenses,56644,36820.0,31183,68003.0,-11359.0,-20.05,-0.03,High Risk
U833,2024,6,110072.0,Stable Salary & Increasing Fixed Expenses,56644,36820.0,35117,71937.0,-15293.0,-27.0,-0.02,High Risk
U833,2024,7,94779.0,Stable Salary & Increasing Fixed Expenses,56644,36820.0,38263,75083.0,-18439.0,-32.55,0.02,High Risk
U833,2024,8,76340.0,Stable Salary & Increasing Fixed Expenses,56644,36820.0,39245,76065.0,-19421.0,-34.29,-0.04,High Risk
U833,2024,9,56919.0,Stable Salary & Increasing Fixed Expenses,56644,36820.0,40463,77283.0,-20639.0,-36.44,0.05,High Risk
U833,2024,10,36280.0,Stable Salary & Increasing Fixed Expenses,56644,38192.0,35712,73904.0,-17260.0,-30.47,0.02,High Risk
U833,2024,11,19020.0,Stable Salary & Increasing Fixed Expenses,56644,38192.0,32561,70753.0,-14109.0,-24.91,0.05,High Risk
U833,2024,12,4911.0,Stable Salary & Increasing Fixed Expenses,56644,38192.0,30383,68575.0,-11931.0,-21.06,-0.05,High Risk
U834,2024,1,241309.0,Stable Salary & Increasing Fixed Expenses,218025,113893.0,86869,200762.0,17263.0,7.92,-0.01,High Risk
U834,2024,2,258572.0,Stable Salary & Increasing Fixed Expenses,218025,113893.0,101325,215218.0,2807.0,1.29,0.01,High Risk
U834,2024,3,261379.0,Stable Salary & Increasing Fixed Expenses,218025,115504.0,77823,193327.0,24698.0,11.33,-0.05,High Risk
U834,2024,4,286077.0,Stable Salary & Increasing Fixed Expenses,218025,115504.0,68914,184418.0,33607.0,15.41,0.02,Medium Risk
U834,2024,5,319684.0,Stable Salary & Increasing Fixed Expenses,218025,115504.0,75571,191075.0,26950.0,12.36,0.04,High Risk
U834,2024,6,346634.0,Stable Salary & Increasing Fixed Expenses,218025,115504.0,83886,199390.0,18635.0,8.55,-0.04,High Risk
U834,2024,7,365269.0,Stable Salary & Increasing Fixed Expenses,218025,115504.0,104987,220491.0,-2466.0,-1.13,0.01,High Risk
U834,2024,8,362803.0,Stable Salary & Increasing Fixed Expenses,218025,115504.0,108662,224166.0,-6141.0,-2.82,0.02,High Risk
U834,2024,9,356662.0,Stable Salary & Increasing Fixed Expenses,218025,115504.0,68643,184147.0,33878.0,15.54,0.0,Medium Risk
U834,2024,10,390540.0,Stable Salary & Increasing Fixed Expenses,218025,115504.0,67738,183242.0,34783.0,15.95,-0.01,Medium Risk
U834,2024,11,425323.0,Stable Salary & Increasing Fixed Expenses,218025,116477.0,95412,211889.0,6136.0,2.81,0.03,High Risk
U834,2024,12,431459.0,Stable Salary & Increasing Fixed Expenses,218025,116477.0,86663,203140.0,14885.0,6.83,-0.04,High Risk
U835,2024,1,250000.0,Salary Increases & Fixed Expenses Remain Stable,297540,65685.0,133157,198842.0,98698.0,33.17,0.03,Low Risk
U835,2024,2,348698.0,Salary Increases & Fixed Expenses Remain Stable,297540,65685.0,122263,187948.0,109592.0,36.83,0.04,Low Risk
U835,2024,3,458290.0,Salary Increases & Fixed Expenses Remain Stable,297540,65685.0,147410,213095.0,84445.0,28.38,0.0,Low Risk
U835,2024,4,542735.0,Salary Increases & Fixed Expenses Remain Stable,297540,65685.0,136027,201712.0,95828.0,32.21,-0.03,Low Risk
U835,2024,5,638563.0,Salary Increases & Fixed Expenses Remain Stable,297540,65685.0,90650,156335.0,141205.0,47.46,-0.0,Low Risk
U835,2024,6,779768.0,Salary Increases & Fixed Expenses Remain Stable,297540,65685.0,136569,202254.0,95286.0,32.02,0.01,Low Risk
U835,2024,7,875054.0,Salary Increases & Fixed Expenses Remain Stable,297540,65685.0,123978,189663.0,107877.0,36.26,-0.0,Low Risk
U835,2024,8,982931.0,Salary Increases & Fixed Expenses Remain Stable,313059,65685.0,128510,194195.0,118864.0,37.97,-0.01,Low Risk
U835,2024,9,1101795.0,Salary Increases & Fixed Expenses Remain Stable,313059,65685.0,124870,190555.0,122504.0,39.13,0.03,Low Risk
U835,2024,10,1224299.0,Salary Increases & Fixed Expenses Remain Stable,313059,65685.0,111863,177548.0,135511.0,43.29,0.02,Low Risk
U835,2024,11,1359810.0,Salary Increases & Fixed Expenses Remain Stable,313059,65685.0,134123,199808.0,113251.0,36.18,-0.04,Low Risk
U835,2024,12,1473061.0,Salary Increases & Fixed Expenses Remain Stable,313059,65685.0,133448,199133.0,113926.0,36.39,-0.02,Low Risk
U836,2024,1,250000.0,Salary Increases & Fixed Expenses Remain Stable,256917,78388.0,56606,134994.0,121923.0,47.46,-0.0,Low Risk
U836,2024,2,371923.0,Salary Increases & Fixed Expenses Remain Stable,256917,78388.0,64710,143098.0,113819.0,44.3,-0.04,Low Risk
U836,2024,3,485742.0,Salary Increases & Fixed Expenses Remain Stable,256917,78388.0,69962,148350.0,108567.0,42.26,0.0,Low Risk
U836,2024,4,594309.0,Salary Increases & Fixed Expenses Remain Stable,256917,78388.0,56034,134422.0,122495.0,47.68,-0.02,Low Risk
U836,2024,5,716804.0,Salary Increases & Fixed Expenses Remain Stable,286517,78388.0,70643,149031.0,137486.0,47.99,0.05,Low Risk
U836,2024,6,854290.0,Salary Increases & Fixed Expenses Remain Stable,286517,78388.0,73603,151991.0,134526.0,46.95,-0.03,Low Risk
U836,2024,7,988816.0,Salary Increases & Fixed Expenses Remain Stable,286517,78388.0,85685,164073.0,122444.0,42.74,0.01,Low Risk
U836,2024,8,1111260.0,Salary Increases & Fixed Expenses Remain Stable,286517,78388.0,60156,138544.0,147973.0,51.65,0.01,Low Risk
U836,2024,9,1259233.0,Salary Increases & Fixed Expenses Remain Stable,286517,78388.0,63837,142225.0,144292.0,50.36,-0.01,Low Risk
U836,2024,10,1403525.0,Salary Increases & Fixed Expenses Remain Stable,286517,78388.0,84357,162745.0,123772.0,43.2,0.03,Low Risk
U836,2024,11,1527297.0,Salary Increases & Fixed Expenses Remain Stable,286517,78388.0,87098,165486.0,121031.0,42.24,0.0,Low Risk
U836,2024,12,1648328.0,Salary Increases & Fixed Expenses Remain Stable,286517,78388.0,67424,145812.0,140705.0,49.11,0.0,Low Risk
U837,2024,1,250000.0,Salary Increases & Fixed Expenses Increase,294823,106919.0,133751,240670.0,54153.0,18.37,-0.02,Medium Risk
U837,2024,2,304153.0,Salary Increases & Fixed Expenses Increase,294823,106919.0,125202,232121.0,62702.0,21.27,-0.04,Medium Risk
U837,2024,3,366855.0,Salary Increases & Fixed Expenses Increase,294823,106919.0,130919,237838.0,56985.0,19.33,0.0,Medium Risk
U837,2024,4,423840.0,Salary Increases & Fixed Expenses Increase,294823,106919.0,119218,226137.0,68686.0,23.3,0.02,Medium Risk
U837,2024,5,492526.0,Salary Increases & Fixed Expenses Increase,294823,106919.0,89035,195954.0,98869.0,33.54,0.04,Low Risk
U837,2024,6,591395.0,Salary Increases & Fixed Expenses Increase,308990,106919.0,149715,256634.0,52356.0,16.94,0.03,Medium Risk
U837,2024,7,643751.0,Salary Increases & Fixed Expenses Increase,308990,108615.0,131817,240432.0,68558.0,22.19,0.04,Medium Risk
U837,2024,8,712309.0,Salary Increases & Fixed Expenses Increase,308990,108615.0,115843,224458.0,84532.0,27.36,0.01,Low Risk
U837,2024,9,796841.0,Salary Increases & Fixed Expenses Increase,308990,110309.0,112249,222558.0,86432.0,27.97,-0.0,Low Risk
U837,2024,10,883273.0,Salary Increases & Fixed Expenses Increase,308990,110309.0,131386,241695.0,67295.0,21.78,0.01,Medium Risk
U837,2024,11,950568.0,Salary Increases & Fixed Expenses Increase,308990,110309.0,138007,248316.0,60674.0,19.64,0.03,Medium Risk
U837,2024,12,1011242.0,Salary Increases & Fixed Expenses Increase,308990,110309.0,150021,260330.0,48660.0,15.75,-0.03,Medium Risk
U838,2024,1,197116.0,Stable Salary & Increasing Fixed Expenses,166638,74157.0,35699,109856.0,56782.0,34.08,-0.03,Low Risk
U838,2024,2,253898.0,Stable Salary & Increasing Fixed Expenses,166638,74157.0,45512,119669.0,46969.0,28.19,-0.02,Low Risk
U838,2024,3,300867.0,Stable Salary & Increasing Fixed Expenses,166638,74157.0,46007,120164.0,46474.0,27.89,0.04,Low Risk
U838,2024,4,347341.0,Stable Salary & Increasing Fixed Expenses,166638,74157.0,42743,116900.0,49738.0,29.85,0.03,Low Risk
U838,2024,5,397079.0,Stable Salary & Increasing Fixed Expenses,166638,74157.0,49434,123591.0,43047.0,25.83,0.0,Low Risk
U838,2024,6,440126.0,Stable Salary & Increasing Fixed Expenses,166638,74157.0,40886,115043.0,51595.0,30.96,0.04,Low Risk
U838,2024,7,491721.0,Stable Salary & Increasing Fixed Expenses,166638,74157.0,37131,111288.0,55350.0,33.22,0.02,Low Risk
U838,2024,8,547071.0,Stable Salary & Increasing Fixed Expenses,166638,74157.0,38256,112413.0,54225.0,32.54,-0.0,Low Risk
U838,2024,9,601296.0,Stable Salary & Increasing Fixed Expenses,166638,75374.0,50590,125964.0,40674.0,24.41,0.02,Medium Risk
U838,2024,10,641970.0,Stable Salary & Increasing Fixed Expenses,166638,75374.0,41906,117280.0,49358.0,29.62,-0.05,Low Risk
U838,2024,11,691328.0,Stable Salary & Increasing Fixed Expenses,166638,76545.0,53457,130002.0,36636.0,21.99,-0.02,Medium Risk
U838,2024,12,727964.0,Stable Salary & Increasing Fixed Expenses,166638,76545.0,52675,129220.0,37418.0,22.45,0.04,Medium Risk
U839,2024,1,163666.0,Salary Increases & Fixed Expenses Remain Stable,91146,28696.0,44971,73667.0,17479.0,19.18,0.04,Medium Risk
U839,2024,2,181145.0,Salary Increases & Fixed Expenses Remain Stable,91146,28696.0,35571,64267.0,26879.0,29.49,0.04,Low Risk
U839,2024,3,208024.0,Salary Increases & Fixed Expenses Remain Stable,91146,28696.0,44516,73212.0,17934.0,19.68,0.02,Medium Risk
U839,2024,4,225958.0,Salary Increases & Fixed Expenses Remain Stable,107235,28696.0,37415,66111.0,41124.0,38.35,0.01,Low Risk
U839,2024,5,267082.0,Salary Increases & Fixed Expenses Remain Stable,107235,28696.0,44942,73638.0,33597.0,31.33,-0.02,Low Risk
U839,2024,6,300679.0,Salary Increases & Fixed Expenses Remain Stable,107235,28696.0,42089,70785.0,36450.0,33.99,-0.0,Low Risk
U839,2024,7,337129.0,Salary Increases & Fixed Expenses Remain Stable,107235,28696.0,41430,70126.0,37109.0,34.61,-0.01,Low Risk
U839,2024,8,374238.0,Salary Increases & Fixed Expenses Remain Stable,107235,28696.0,41467,70163.0,37072.0,34.57,-0.04,Low Risk
U839,2024,9,411310.0,Salary Increases & Fixed Expenses Remain Stable,107235,28696.0,51703,80399.0,26836.0,25.03,0.03,Low Risk
U839,2024,10,438146.0,Salary Increases & Fixed Expenses Remain Stable,107235,28696.0,42387,71083.0,36152.0,33.71,0.05,Low Risk
U839,2024,11,474298.0,Salary Increases & Fixed Expenses Remain Stable,107235,28696.0,39483,68179.0,39056.0,36.42,0.01,Low Risk
U839,2024,12,513354.0,Salary Increases & Fixed Expenses Remain Stable,107235,28696.0,43605,72301.0,34934.0,32.58,0.03,Low Risk
U840,2024,1,244038.0,Stable Salary & Stable Fixed Expenses,149024,58630.0,44590,103220.0,45804.0,30.74,0.04,Low Risk
U840,2024,2,289842.0,Stable Salary & Stable Fixed Expenses,149024,58630.0,40481,99111.0,49913.0,33.49,-0.02,Low Risk
U840,2024,3,339755.0,Stable Salary & Stable Fixed Expenses,149024,58630.0,38799,97429.0,51595.0,34.62,-0.02,Low Risk
U840,2024,4,391350.0,Stable Salary & Stable Fixed Expenses,149024,58630.0,36806,95436.0,53588.0,35.96,0.04,Low Risk
U840,2024,5,444938.0,Stable Salary & Stable Fixed Expenses,149024,58630.0,36529,95159.0,53865.0,36.15,0.0,Low Risk
U840,2024,6,498803.0,Stable Salary & Stable Fixed Expenses,149024,58630.0,32007,90637.0,58387.0,39.18,0.03,Low Risk
U840,2024,7,557190.0,Stable Salary & Stable Fixed Expenses,149024,58630.0,38757,97387.0,51637.0,34.65,0.02,Low Risk
U840,2024,8,608827.0,Stable Salary & Stable Fixed Expenses,149024,58630.0,44160,102790.0,46234.0,31.02,-0.03,Low Risk
U840,2024,9,655061.0,Stable Salary & Stable Fixed Expenses,149024,58630.0,35166,93796.0,55228.0,37.06,-0.01,Low Risk
U840,2024,10,710289.0,Stable Salary & Stable Fixed Expenses,149024,58630.0,30858,89488.0,59536.0,39.95,-0.02,Low Risk
U840,2024,11,769825.0,Stable Salary & Stable Fixed Expenses,149024,58630.0,45863,104493.0,44531.0,29.88,0.01,Low Risk
U840,2024,12,814356.0,Stable Salary & Stable Fixed Expenses,149024,58630.0,36180,94810.0,54214.0,36.38,0.0,Low Risk
U841,2024,1,222005.0,Salary Increases & Fixed Expenses Increase,220070,67377.0,51722,119099.0,100971.0,45.88,0.03,Low Risk
U841,2024,2,322976.0,Salary Increases & Fixed Expenses Increase,220070,67377.0,51394,118771.0,101299.0,46.03,0.05,Low Risk
U841,2024,3,424275.0,Salary Increases & Fixed Expenses Increase,220070,67377.0,56452,123829.0,96241.0,43.73,0.05,Low Risk
U841,2024,4,520516.0,Salary Increases & Fixed Expenses Increase,220070,68478.0,56852,125330.0,94740.0,43.05,-0.04,Low Risk
U841,2024,5,615256.0,Salary Increases & Fixed Expenses Increase,220070,68478.0,51419,119897.0,100173.0,45.52,-0.0,Low Risk
U841,2024,6,715429.0,Salary Increases & Fixed Expenses Increase,220070,68478.0,62162,130640.0,89430.0,40.64,0.0,Low Risk
U841,2024,7,804859.0,Salary Increases & Fixed Expenses Increase,220070,68478.0,51362,119840.0,100230.0,45.54,-0.0,Low Risk
U841,2024,8,905089.0,Salary Increases & Fixed Expenses Increase,238939,68478.0,65980,134458.0,104481.0,43.73,-0.01,Low Risk
U841,2024,9,1009570.0,Salary Increases & Fixed Expenses Increase,238939,68478.0,56507,124985.0,113954.0,47.69,-0.02,Low Risk
U841,2024,10,1123524.0,Salary Increases & Fixed Expenses Increase,238939,68478.0,66013,134491.0,104448.0,43.71,0.02,Low Risk
U841,2024,11,1227972.0,Salary Increases & Fixed Expenses Increase,238939,68478.0,74235,142713.0,96226.0,40.27,0.0,Low Risk
U841,2024,12,1324198.0,Salary Increases & Fixed Expenses Increase,238939,68478.0,58285,126763.0,112176.0,46.95,-0.01,Low Risk
U842,2024,1,250000.0,Stable Salary & Increasing Fixed Expenses,284867,71497.0,175036,246533.0,38334.0,13.46,-0.04,High Risk
U842,2024,2,288334.0,Stable Salary & Increasing Fixed Expenses,284867,71497.0,160176,231673.0,53194.0,18.67,-0.03,Medium Risk
U842,2024,3,341528.0,Stable Salary & Increasing Fixed Expenses,284867,71497.0,166670,238167.0,46700.0,16.39,-0.02,Medium Risk
U842,2024,4,388228.0,Stable Salary & Increasing Fixed Expenses,284867,73163.0,166770,239933.0,44934.0,15.77,-0.03,Medium Risk
U842,2024,5,433162.0,Stable Salary & Increasing Fixed Expenses,284867,73163.0,149984,223147.0,61720.0,21.67,0.0,Medium Risk
U842,2024,6,494882.0,Stable Salary & Increasing Fixed Expenses,284867,73163.0,168935,242098.0,42769.0,15.01,0.04,Medium Risk
U842,2024,7,537651.0,Stable Salary & Increasing Fixed Expenses,284867,73163.0,151170,224333.0,60534.0,21.25,-0.01,Medium Risk
U842,2024,8,598185.0,Stable Salary & Increasing Fixed Expenses,284867,74635.0,199028,273663.0,11204.0,3.93,0.01,High Risk
U842,2024,9,609389.0,Stable Salary & Increasing Fixed Expenses,284867,74635.0,178458,253093.0,31774.0,11.15,-0.04,High Risk
U842,2024,10,641163.0,Stable Salary & Increasing Fixed Expenses,284867,75490.0,166958,242448.0,42419.0,14.89,-0.04,High Risk
U842,2024,11,683582.0,Stable Salary & Increasing Fixed Expenses,284867,75490.0,175062,250552.0,34315.0,12.05,-0.03,High Risk
U842,2024,12,717897.0,Stable Salary & Increasing Fixed Expenses,284867,75490.0,144319,219809.0,65058.0,22.84,-0.04,Medium Risk
U843,2024,1,240707.0,Salary Increases & Fixed Expenses Increase,219908,98951.0,79922,178873.0,41035.0,18.66,0.01,Medium Risk
U843,2024,2,281742.0,Salary Increases & Fixed Expenses Increase,219908,99751.0,92634,192385.0,27523.0,12.52,0.0,High Risk
U843,2024,3,309265.0,Salary Increases & Fixed Expenses Increase,219908,99751.0,107948,207699.0,12209.0,5.55,0.03,High Risk
U843,2024,4,321474.0,Salary Increases & Fixed Expenses Increase,219908,99751.0,102596,202347.0,17561.0,7.99,0.01,High Risk
U843,2024,5,339035.0,Salary Increases & Fixed Expenses Increase,219908,99751.0,69993,169744.0,50164.0,22.81,0.01,Medium Risk
U843,2024,6,389199.0,Salary Increases & Fixed Expenses Increase,219908,99751.0,83748,183499.0,36409.0,16.56,0.01,Medium Risk
U843,2024,7,425608.0,Salary Increases & Fixed Expenses Increase,219908,99751.0,92973,192724.0,27184.0,12.36,-0.02,High Risk
U843,2024,8,452792.0,Salary Increases & Fixed Expenses Increase,235714,99751.0,86022,185773.0,49941.0,21.19,-0.03,Medium Risk
U843,2024,9,502733.0,Salary Increases & Fixed Expenses Increase,235714,99751.0,120684,220435.0,15279.0,6.48,0.03,High Risk
U843,2024,10,518012.0,Salary Increases & Fixed Expenses Increase,235714,99751.0,88706,188457.0,47257.0,20.05,-0.03,Medium Risk
U843,2024,11,565269.0,Salary Increases & Fixed Expenses Increase,235714,99751.0,99551,199302.0,36412.0,15.45,0.04,Medium Risk
U843,2024,12,601681.0,Salary Increases & Fixed Expenses Increase,235714,99751.0,89980,189731.0,45983.0,19.51,-0.04,Medium Risk
U844,2024,1,193384.0,Stable Salary & Stable Fixed Expenses,163612,65353.0,62165,127518.0,36094.0,22.06,0.04,Medium Risk
U844,2024,2,229478.0,Stable Salary & Stable Fixed Expenses,163612,65353.0,62502,127855.0,35757.0,21.85,-0.01,Medium Risk
U844,2024,3,265235.0,Stable Salary & Stable Fixed Expenses,163612,65353.0,76115,141468.0,22144.0,13.53,0.01,High Risk
U844,2024,4,287379.0,Stable Salary & Stable Fixed Expenses,163612,65353.0,69775,135128.0,28484.0,17.41,-0.01,Medium Risk
U844,2024,5,315863.0,Stable Salary & Stable Fixed Expenses,163612,65353.0,76164,141517.0,22095.0,13.5,-0.0,High Risk
U844,2024,6,337958.0,Stable Salary & Stable Fixed Expenses,163612,65353.0,58706,124059.0,39553.0,24.17,-0.02,Medium Risk
U844,2024,7,377511.0,Stable Salary & Stable Fixed Expenses,163612,65353.0,75573,140926.0,22686.0,13.87,0.0,High Risk
U844,2024,8,400197.0,Stable Salary & Stable Fixed Expenses,163612,65353.0,68916,134269.0,29343.0,17.93,-0.02,Medium Risk
U844,2024,9,429540.0,Stable Salary & Stable Fixed Expenses,163612,65353.0,54733,120086.0,43526.0,26.6,0.05,Low Risk
U844,2024,10,473066.0,Stable Salary & Stable Fixed Expenses,163612,65353.0,63991,129344.0,34268.0,20.94,-0.01,Medium Risk
U844,2024,11,507334.0,Stable Salary & Stable Fixed Expenses,163612,65353.0,60699,126052.0,37560.0,22.96,-0.02,Medium Risk
U844,2024,12,544894.0,Stable Salary & Stable Fixed Expenses,163612,65353.0,64556,129909.0,33703.0,20.6,-0.03,Medium Risk
U845,2024,1,100871.0,Salary Increases & Fixed Expenses Increase,48382,20368.0,9769,30137.0,18245.0,37.71,0.04,Low Risk
U845,2024,2,119116.0,Salary Increases & Fixed Expenses Increase,48382,20368.0,12356,32724.0,15658.0,32.36,0.0,Low Risk
U845,2024,3,134774.0,Salary Increases & Fixed Expenses Increase,48382,20368.0,12668,33036.0,15346.0,31.72,-0.02,Low Risk
U845,2024,4,150120.0,Salary Increases & Fixed Expenses Increase,48382,20368.0,13619,33987.0,14395.0,29.75,-0.02,Low Risk
U845,2024,5,164515.0,Salary Increases & Fixed Expenses Increase,48382,21705.0,10224,31929.0,16453.0,34.01,-0.05,Low Risk
U845,2024,6,180968.0,Salary Increases & Fixed Expenses Increase,48382,23215.0,10804,34019.0,14363.0,29.69,0.03,Low Risk
U845,2024,7,195331.0,Salary Increases & Fixed Expenses Increase,73059,23215.0,16165,39380.0,33679.0,46.1,-0.04,Low Risk
U845,2024,8,229010.0,Salary Increases & Fixed Expenses Increase,73059,23215.0,16421,39636.0,33423.0,45.75,0.05,Low Risk
U845,2024,9,262433.0,Salary Increases & Fixed Expenses Increase,73059,23215.0,23411,46626.0,26433.0,36.18,-0.0,Low Risk
U845,2024,10,288866.0,Salary Increases & Fixed Expenses Increase,73059,23215.0,21685,44900.0,28159.0,38.54,0.01,Low Risk
U845,2024,11,317025.0,Salary Increases & Fixed Expenses Increase,73059,23215.0,19776,42991.0,30068.0,41.16,0.01,Low Risk
U845,2024,12,347093.0,Salary Increases & Fixed Expenses Increase,73059,23215.0,19649,42864.0,30195.0,41.33,-0.02,Low Risk
U846,2024,1,63969.0,Stable Salary & Stable Fixed Expenses,38734,16388.0,10023,26411.0,12323.0,31.81,-0.01,Low Risk
U846,2024,2,76292.0,Stable Salary & Stable Fixed Expenses,38734,16388.0,10760,27148.0,11586.0,29.91,0.05,Low Risk
U846,2024,3,87878.0,Stable Salary & Stable Fixed Expenses,38734,16388.0,9765,26153.0,12581.0,32.48,-0.01,Low Risk
U846,2024,4,100459.0,Stable Salary & Stable Fixed Expenses,38734,16388.0,8000,24388.0,14346.0,37.04,0.01,Low Risk
U846,2024,5,114805.0,Stable Salary & Stable Fixed Expenses,38734,16388.0,8315,24703.0,14031.0,36.22,-0.0,Low Risk
U846,2024,6,128836.0,Stable Salary & Stable Fixed Expenses,38734,16388.0,9673,26061.0,12673.0,32.72,-0.01,Low Risk
U846,2024,7,141509.0,Stable Salary & Stable Fixed Expenses,38734,16388.0,10771,27159.0,11575.0,29.88,-0.02,Low Risk
U846,2024,8,153084.0,Stable Salary & Stable Fixed Expenses,38734,16388.0,8418,24806.0,13928.0,35.96,-0.01,Low Risk
U846,2024,9,167012.0,Stable Salary & Stable Fixed Expenses,38734,16388.0,11536,27924.0,10810.0,27.91,-0.03,Low Risk
U846,2024,10,177822.0,Stable Salary & Stable Fixed Expenses,38734,16388.0,7773,24161.0,14573.0,37.62,0.03,Low Risk
U846,2024,11,192395.0,Stable Salary & Stable Fixed Expenses,38734,16388.0,9334,25722.0,13012.0,33.59,0.01,Low Risk
U846,2024,12,205407.0,Stable Salary & Stable Fixed Expenses,38734,16388.0,10226,26614.0,12120.0,31.29,0.04,Low Risk
U847,2024,1,204083.0,Salary Increases & Fixed Expenses Increase,196102,62514.0,89104,151618.0,44484.0,22.68,-0.05,Medium Risk
U847,2024,2,248567.0,Salary Increases & Fixed Expenses Increase,196102,62514.0,61623,124137.0,71965.0,36.7,-0.01,Low Risk
U847,2024,3,320532.0,Salary Increases & Fixed Expenses Increase,196102,64257.0,84570,148827.0,47275.0,24.11,-0.05,Medium Risk
U847,2024,4,367807.0,Salary Increases & Fixed Expenses Increase,196102,64257.0,58879,123136.0,72966.0,37.21,-0.03,Low Risk
U847,2024,5,440773.0,Salary Increases & Fixed Expenses Increase,196102,64257.0,72100,136357.0,59745.0,30.47,-0.03,Low Risk
U847,2024,6,500518.0,Salary Increases & Fixed Expenses Increase,196102,64257.0,91962,156219.0,39883.0,20.34,0.01,Medium Risk
U847,2024,7,540401.0,Salary Increases & Fixed Expenses Increase,225538,64257.0,99954,164211.0,61327.0,27.19,0.0,Low Risk
U847,2024,8,601728.0,Salary Increases & Fixed Expenses Increase,225538,64257.0,83215,147472.0,78066.0,34.61,0.0,Low Risk
U847,2024,9,679794.0,Salary Increases & Fixed Expenses Increase,225538,64257.0,107680,171937.0,53601.0,23.77,0.01,Medium Risk
U847,2024,10,733395.0,Salary Increases & Fixed Expenses Increase,225538,65934.0,94090,160024.0,65514.0,29.05,0.02,Low Risk
U847,2024,11,798909.0,Salary Increases & Fixed Expenses Increase,225538,65934.0,113889,179823.0,45715.0,20.27,-0.0,Medium Risk
U847,2024,12,844624.0,Salary Increases & Fixed Expenses Increase,225538,65934.0,68770,134704.0,90834.0,40.27,0.02,Low Risk
U848,2024,1,150389.0,Stable Salary & Decreasing Fixed Expenses,21281,13390.0,4543,17933.0,3348.0,15.73,0.03,Medium Risk
U848,2024,2,153737.0,Stable Salary & Decreasing Fixed Expenses,21281,13390.0,5991,19381.0,1900.0,8.93,-0.04,High Risk
U848,2024,3,155637.0,Stable Salary & Decreasing Fixed Expenses,21281,13390.0,5696,19086.0,2195.0,10.31,0.02,High Risk
U848,2024,4,157832.0,Stable Salary & Decreasing Fixed Expenses,21281,13390.0,5861,19251.0,2030.0,9.54,-0.0,High Risk
U848,2024,5,159862.0,Stable Salary & Decreasing Fixed Expenses,21281,13390.0,4640,18030.0,3251.0,15.28,0.03,Medium Risk
U848,2024,6,163113.0,Stable Salary & Decreasing Fixed Expenses,21281,13390.0,4689,18079.0,3202.0,15.05,-0.04,Medium Risk
U848,2024,7,166315.0,Stable Salary & Decreasing Fixed Expenses,21281,13390.0,5240,18630.0,2651.0,12.46,-0.05,High Risk
U848,2024,8,168966.0,Stable Salary & Decreasing Fixed Expenses,21281,13390.0,5941,19331.0,1950.0,9.16,0.01,High Risk
U848,2024,9,170916.0,Stable Salary & Decreasing Fixed Expenses,21281,13390.0,6380,19770.0,1511.0,7.1,0.03,High Risk
U848,2024,10,172427.0,Stable Salary & Decreasing Fixed Expenses,21281,13390.0,4931,18321.0,2960.0,13.91,0.01,High Risk
U848,2024,11,175387.0,Stable Salary & Decreasing Fixed Expenses,21281,13390.0,6091,19481.0,1800.0,8.46,-0.02,High Risk
U848,2024,12,177187.0,Stable Salary & Decreasing Fixed Expenses,21281,13390.0,5057,18447.0,2834.0,13.32,0.04,High Risk
U849,2024,1,224616.0,Salary Increases & Fixed Expenses Increase,196974,53587.0,73197,126784.0,70190.0,35.63,-0.0,Low Risk
U849,2024,2,294806.0,Salary Increases & Fixed Expenses Increase,196974,53587.0,73389,126976.0,69998.0,35.54,0.0,Low Risk
U849,2024,3,364804.0,Salary Increases & Fixed Expenses Increase,196974,53587.0,90410,143997.0,52977.0,26.9,0.02,Low Risk
U849,2024,4,417781.0,Salary Increases & Fixed Expenses Increase,196974,53587.0,67459,121046.0,75928.0,38.55,0.04,Low Risk
U849,2024,5,493709.0,Salary Increases & Fixed Expenses Increase,220339,55462.0,66169,121631.0,98708.0,44.8,-0.01,Low Risk
U849,2024,6,592417.0,Salary Increases & Fixed Expenses Increase,220339,56574.0,104472,161046.0,59293.0,26.91,0.04,Low Risk
U849,2024,7,651710.0,Salary Increases & Fixed Expenses Increase,220339,56574.0,109200,165774.0,54565.0,24.76,-0.04,Medium Risk
U849,2024,8,706275.0,Salary Increases & Fixed Expenses Increase,220339,56574.0,103840,160414.0,59925.0,27.2,-0.01,Low Risk
U849,2024,9,766200.0,Salary Increases & Fixed Expenses Increase,220339,56574.0,75871,132445.0,87894.0,39.89,-0.0,Low Risk
U849,2024,10,854094.0,Salary Increases & Fixed Expenses Increase,220339,56574.0,103457,160031.0,60308.0,27.37,0.03,Low Risk
U849,2024,11,914402.0,Salary Increases & Fixed Expenses Increase,220339,56574.0,78412,134986.0,85353.0,38.74,0.02,Low Risk
U849,2024,12,999755.0,Salary Increases & Fixed Expenses Increase,220339,56574.0,107002,163576.0,56763.0,25.76,0.0,Low Risk
U850,2024,1,250000.0,Stable Salary & Increasing Fixed Expenses,255605,81676.0,78796,160472.0,95133.0,37.22,-0.03,Low Risk
U850,2024,2,345133.0,Stable Salary & Increasing Fixed Expenses,255605,81676.0,102584,184260.0,71345.0,27.91,0.04,Low Risk
U850,2024,3,416478.0,Stable Salary & Increasing Fixed Expenses,255605,81676.0,102701,184377.0,71228.0,27.87,0.04,Low Risk
U850,2024,4,487706.0,Stable Salary & Increasing Fixed Expenses,255605,81676.0,80388,162064.0,93541.0,36.6,-0.04,Low Risk
U850,2024,5,581247.0,Stable Salary & Increasing Fixed Expenses,255605,81676.0,116231,197907.0,57698.0,22.57,0.04,Medium Risk
U850,2024,6,638945.0,Stable Salary & Increasing Fixed Expenses,255605,82376.0,100987,183363.0,72242.0,28.26,0.02,Low Risk
U850,2024,7,711187.0,Stable Salary & Increasing Fixed Expenses,255605,82376.0,81717,164093.0,91512.0,35.8,-0.04,Low Risk
U850,2024,8,802699.0,Stable Salary & Increasing Fixed Expenses,255605,82376.0,107945,190321.0,65284.0,25.54,-0.05,Low Risk
U850,2024,9,867983.0,Stable Salary & Increasing Fixed Expenses,255605,82878.0,119750,202628.0,52977.0,20.73,0.0,Medium Risk
U850,2024,10,920960.0,Stable Salary & Increasing Fixed Expenses,255605,82878.0,125355,208233.0,47372.0,18.53,0.04,Medium Risk
U850,2024,11,968332.0,Stable Salary & Increasing Fixed Expenses,255605,82878.0,96126,179004.0,76601.0,29.97,-0.03,Low Risk
U850,2024,12,1044933.0,Stable Salary & Increasing Fixed Expenses,255605,82878.0,86043,168921.0,86684.0,33.91,0.05,Low Risk
U851,2024,1,207057.0,Salary Increases & Fixed Expenses Remain Stable,69829,34850.0,20742,55592.0,14237.0,20.39,-0.01,Medium Risk
U851,2024,2,221294.0,Salary Increases & Fixed Expenses Remain Stable,69829,34850.0,15907,50757.0,19072.0,27.31,0.0,Low Risk
U851,2024,3,240366.0,Salary Increases & Fixed Expenses Remain Stable,69829,34850.0,18273,53123.0,16706.0,23.92,0.02,Medium Risk
U851,2024,4,257072.0,Salary Increases & Fixed Expenses Remain Stable,69829,34850.0,20203,55053.0,14776.0,21.16,-0.03,Medium Risk
U851,2024,5,271848.0,Salary Increases & Fixed Expenses Remain Stable,69829,34850.0,20740,55590.0,14239.0,20.39,0.01,Medium Risk
U851,2024,6,286087.0,Salary Increases & Fixed Expenses Remain Stable,69829,34850.0,14048,48898.0,20931.0,29.97,0.04,Low Risk
U851,2024,7,307018.0,Salary Increases & Fixed Expenses Remain Stable,69829,34850.0,18874,53724.0,16105.0,23.06,-0.0,Medium Risk
U851,2024,8,323123.0,Salary Increases & Fixed Expenses Remain Stable,99779,34850.0,27932,62782.0,36997.0,37.08,0.03,Low Risk
U851,2024,9,360120.0,Salary Increases & Fixed Expenses Remain Stable,99779,34850.0,29824,64674.0,35105.0,35.18,0.01,Low Risk
U851,2024,10,395225.0,Salary Increases & Fixed Expenses Remain Stable,99779,34850.0,24179,59029.0,40750.0,40.84,-0.03,Low Risk
U851,2024,11,435975.0,Salary Increases & Fixed Expenses Remain Stable,99779,34850.0,29468,64318.0,35461.0,35.54,-0.03,Low Risk
U851,2024,12,471436.0,Salary Increases & Fixed Expenses Remain Stable,99779,34850.0,25586,60436.0,39343.0,39.43,-0.01,Low Risk
U852,2024,1,227529.0,Salary Increases & Fixed Expenses Remain Stable,69986,27854.0,21283,49137.0,20849.0,29.79,0.01,Low Risk
U852,2024,2,248378.0,Salary Increases & Fixed Expenses Remain Stable,69986,27854.0,22853,50707.0,19279.0,27.55,-0.04,Low Risk
U852,2024,3,267657.0,Salary Increases & Fixed Expenses Remain Stable,69986,27854.0,28098,55952.0,14034.0,20.05,0.05,Medium Risk
U852,2024,4,281691.0,Salary Increases & Fixed Expenses Remain Stable,81732,27854.0,39181,67035.0,14697.0,17.98,-0.04,Medium Risk
U852,2024,5,296388.0,Salary Increases & Fixed Expenses Remain Stable,81732,27854.0,36666,64520.0,17212.0,21.06,0.01,Medium Risk
U852,2024,6,313600.0,Salary Increases & Fixed Expenses Remain Stable,81732,27854.0,40331,68185.0,13547.0,16.57,0.02,Medium Risk
U852,2024,7,327147.0,Salary Increases & Fixed Expenses Remain Stable,81732,27854.0,29429,57283.0,24449.0,29.91,0.05,Low Risk
U852,2024,8,351596.0,Salary Increases & Fixed Expenses Remain Stable,81732,27854.0,35091,62945.0,18787.0,22.99,-0.03,Medium Risk
U852,2024,9,370383.0,Salary Increases & Fixed Expenses Remain Stable,81732,27854.0,35172,63026.0,18706.0,22.89,-0.03,Medium Risk
U852,2024,10,389089.0,Salary Increases & Fixed Expenses Remain Stable,81732,27854.0,35050,62904.0,18828.0,23.04,0.05,Medium Risk
U852,2024,11,407917.0,Salary Increases & Fixed Expenses Remain Stable,81732,27854.0,33898,61752.0,19980.0,24.45,-0.0,Medium Risk
U852,2024,12,427897.0,Salary Increases & Fixed Expenses Remain Stable,81732,27854.0,37513,65367.0,16365.0,20.02,0.02,Medium Risk
U853,2024,1,242463.0,Salary Increases & Fixed Expenses Remain Stable,180635,70729.0,81748,152477.0,28158.0,15.59,-0.02,Medium Risk
U853,2024,2,270621.0,Salary Increases & Fixed Expenses Remain Stable,180635,70729.0,72925,143654.0,36981.0,20.47,0.01,Medium Risk
U853,2024,3,307602.0,Salary Increases & Fixed Expenses Remain Stable,180635,70729.0,56966,127695.0,52940.0,29.31,-0.0,Low Risk
U853,2024,4,360542.0,Salary Increases & Fixed Expenses Remain Stable,180635,70729.0,89594,160323.0,20312.0,11.24,-0.03,High Risk
U853,2024,5,380854.0,Salary Increases & Fixed Expenses Remain Stable,180635,70729.0,81847,152576.0,28059.0,15.53,-0.04,Medium Risk
U853,2024,6,408913.0,Salary Increases & Fixed Expenses Remain Stable,180635,70729.0,86801,157530.0,23105.0,12.79,-0.01,High Risk
U853,2024,7,432018.0,Salary Increases & Fixed Expenses Remain Stable,207609,70729.0,88177,158906.0,48703.0,23.46,0.01,Medium Risk
U853,2024,8,480721.0,Salary Increases & Fixed Expenses Remain Stable,207609,70729.0,93958,164687.0,42922.0,20.67,-0.03,Medium Risk
U853,2024,9,523643.0,Salary Increases & Fixed Expenses Remain Stable,207609,70729.0,104775,175504.0,32105.0,15.46,0.01,Medium Risk
U853,2024,10,555748.0,Salary Increases & Fixed Expenses Remain Stable,207609,70729.0,65242,135971.0,71638.0,34.51,0.01,Low Risk
U853,2024,11,627386.0,Salary Increases & Fixed Expenses Remain Stable,207609,70729.0,77693,148422.0,59187.0,28.51,-0.0,Low Risk
U853,2024,12,686573.0,Salary Increases & Fixed Expenses Remain Stable,207609,70729.0,62465,133194.0,74415.0,35.84,-0.0,Low Risk
U854,2024,1,112190.0,Salary Increases & Fixed Expenses Remain Stable,20422,11752.0,4740,16492.0,3930.0,19.24,-0.0,Medium Risk
U854,2024,2,116120.0,Salary Increases & Fixed Expenses Remain Stable,20422,11752.0,5867,17619.0,2803.0,13.73,-0.02,High Risk
U854,2024,3,118923.0,Salary Increases & Fixed Expenses Remain Stable,20422,11752.0,6048,17800.0,2622.0,12.84,0.0,High Risk
U854,2024,4,121545.0,Salary Increases & Fixed Expenses Remain Stable,20422,11752.0,5324,17076.0,3346.0,16.38,0.03,Medium Risk
U854,2024,5,124891.0,Salary Increases & Fixed Expenses Remain Stable,20422,11752.0,4948,16700.0,3722.0,18.23,0.05,Medium Risk
U854,2024,6,128613.0,Salary Increases & Fixed Expenses Remain Stable,20422,11752.0,4402,16154.0,4268.0,20.9,0.04,Medium Risk
U854,2024,7,132881.0,Salary Increases & Fixed Expenses Remain Stable,48783,11752.0,14261,26013.0,22770.0,46.68,0.02,Low Risk
U854,2024,8,155651.0,Salary Increases & Fixed Expenses Remain Stable,48783,11752.0,14596,26348.0,22435.0,45.99,0.03,Low Risk
U854,2024,9,178086.0,Salary Increases & Fixed Expenses Remain Stable,48783,11752.0,12525,24277.0,24506.0,50.23,-0.0,Low Risk
U854,2024,10,202592.0,Salary Increases & Fixed Expenses Remain Stable,48783,11752.0,13339,25091.0,23692.0,48.57,0.04,Low Risk
U854,2024,11,226284.0,Salary Increases & Fixed Expenses Remain Stable,48783,11752.0,11279,23031.0,25752.0,52.79,0.04,Low Risk
U854,2024,12,252036.0,Salary Increases & Fixed Expenses Remain Stable,48783,11752.0,10258,22010.0,26773.0,54.88,-0.03,Low Risk
U855,2024,1,222014.0,Stable Salary & Stable Fixed Expenses,139699,71809.0,75468,147277.0,-7578.0,-5.42,-0.02,High Risk
U855,2024,2,214436.0,Stable Salary & Stable Fixed Expenses,139699,71809.0,72725,144534.0,-4835.0,-3.46,0.02,High Risk
U855,2024,3,209601.0,Stable Salary & Stable Fixed Expenses,139699,71809.0,120991,192800.0,-53101.0,-38.01,0.04,High Risk
U855,2024,4,156500.0,Stable Salary & Stable Fixed Expenses,139699,71809.0,85728,157537.0,-17838.0,-12.77,-0.03,High Risk
U855,2024,5,138662.0,Stable Salary & Stable Fixed Expenses,139699,71809.0,91223,163032.0,-23333.0,-16.7,0.01,High Risk
U855,2024,6,115329.0,Stable Salary & Stable Fixed Expenses,139699,71809.0,85707,157516.0,-17817.0,-12.75,-0.02,High Risk
U855,2024,7,97512.0,Stable Salary & Stable Fixed Expenses,139699,71809.0,89719,161528.0,-21829.0,-15.63,0.04,High Risk
U855,2024,8,75683.0,Stable Salary & Stable Fixed Expenses,139699,71809.0,81731,153540.0,-13841.0,-9.91,-0.0,High Risk
U855,2024,9,61842.0,Stable Salary & Stable Fixed Expenses,139699,71809.0,91487,163296.0,-23597.0,-16.89,0.05,High Risk
U855,2024,10,38245.0,Stable Salary & Stable Fixed Expenses,139699,71809.0,108252,180061.0,-40362.0,-28.89,0.0,High Risk
U855,2024,11,-2117.0,Stable Salary & Stable Fixed Expenses,139699,71809.0,102590,174399.0,-34700.0,-24.84,0.03,High Risk
U855,2024,12,-36817.0,Stable Salary & Stable Fixed Expenses,139699,71809.0,107937,179746.0,-40047.0,-28.67,0.02,High Risk
U856,2024,1,229652.0,Stable Salary & Stable Fixed Expenses,35891,19051.0,8568,27619.0,8272.0,23.05,0.02,Medium Risk
U856,2024,2,237924.0,Stable Salary & Stable Fixed Expenses,35891,19051.0,8223,27274.0,8617.0,24.01,0.02,Medium Risk
U856,2024,3,246541.0,Stable Salary & Stable Fixed Expenses,35891,19051.0,11510,30561.0,5330.0,14.85,0.02,High Risk
U856,2024,4,251871.0,Stable Salary & Stable Fixed Expenses,35891,19051.0,10617,29668.0,6223.0,17.34,-0.01,Medium Risk
U856,2024,5,258094.0,Stable Salary & Stable Fixed Expenses,35891,19051.0,10545,29596.0,6295.0,17.54,-0.04,Medium Risk
U856,2024,6,264389.0,Stable Salary & Stable Fixed Expenses,35891,19051.0,8070,27121.0,8770.0,24.44,-0.02,Medium Risk
U856,2024,7,273159.0,Stable Salary & Stable Fixed Expenses,35891,19051.0,8741,27792.0,8099.0,22.57,-0.03,Medium Risk
U856,2024,8,281258.0,Stable Salary & Stable Fixed Expenses,35891,19051.0,8574,27625.0,8266.0,23.03,0.03,Medium Risk
U856,2024,9,289524.0,Stable Salary & Stable Fixed Expenses,35891,19051.0,12313,31364.0,4527.0,12.61,0.05,High Risk
U856,2024,10,294051.0,Stable Salary & Stable Fixed Expenses,35891,19051.0,8439,27490.0,8401.0,23.41,-0.04,Medium Risk
U856,2024,11,302452.0,Stable Salary & Stable Fixed Expenses,35891,19051.0,8485,27536.0,8355.0,23.28,0.03,Medium Risk
U856,2024,12,310807.0,Stable Salary & Stable Fixed Expenses,35891,19051.0,10887,29938.0,5953.0,16.59,-0.03,Medium Risk
U857,2024,1,236415.0,Salary Increases & Fixed Expenses Increase,198892,53302.0,129516,182818.0,16074.0,8.08,0.03,High Risk
U857,2024,2,252489.0,Salary Increases & Fixed Expenses Increase,198892,53302.0,126593,179895.0,18997.0,9.55,-0.04,High Risk
U857,2024,3,271486.0,Salary Increases & Fixed Expenses Increase,198892,53302.0,129773,183075.0,15817.0,7.95,0.02,High Risk
U857,2024,4,287303.0,Salary Increases & Fixed Expenses Increase,198892,53302.0,127473,180775.0,18117.0,9.11,0.01,High Risk
U857,2024,5,305420.0,Salary Increases & Fixed Expenses Increase,198892,54279.0,117128,171407.0,27485.0,13.82,0.0,High Risk
U857,2024,6,332905.0,Salary Increases & Fixed Expenses Increase,204215,54279.0,110937,165216.0,38999.0,19.1,0.01,Medium Risk
U857,2024,7,371904.0,Salary Increases & Fixed Expenses Increase,204215,54279.0,125797,180076.0,24139.0,11.82,0.03,High Risk
U857,2024,8,396043.0,Salary Increases & Fixed Expenses Increase,204215,54279.0,134348,188627.0,15588.0,7.63,0.05,High Risk
U857,2024,9,411631.0,Salary Increases & Fixed Expenses Increase,204215,54279.0,125533,179812.0,24403.0,11.95,-0.01,High Risk
U857,2024,10,436034.0,Salary Increases & Fixed Expenses Increase,204215,54842.0,138952,193794.0,10421.0,5.1,-0.03,High Risk
U857,2024,11,446455.0,Salary Increases & Fixed Expenses Increase,204215,54842.0,128758,183600.0,20615.0,10.09,0.02,High Risk
U857,2024,12,467070.0,Salary Increases & Fixed Expenses Increase,204215,54842.0,107433,162275.0,41940.0,20.54,0.03,Medium Risk
U858,2024,1,67269.0,Salary Increases & Fixed Expenses Remain Stable,33924,22795.0,8041,30836.0,3088.0,9.1,0.01,High Risk
U858,2024,2,70357.0,Salary Increases & Fixed Expenses Remain Stable,33924,22795.0,9279,32074.0,1850.0,5.45,0.0,High Risk
U858,2024,3,72207.0,Salary Increases & Fixed Expenses Remain Stable,33924,22795.0,9666,32461.0,1463.0,4.31,-0.02,High Risk
U858,2024,4,73670.0,Salary Increases & Fixed Expenses Remain Stable,33924,22795.0,9784,32579.0,1345.0,3.96,0.02,High Risk
U858,2024,5,75015.0,Salary Increases & Fixed Expenses Remain Stable,33924,22795.0,7865,30660.0,3264.0,9.62,-0.04,High Risk
U858,2024,6,78279.0,Salary Increases & Fixed Expenses Remain Stable,33924,22795.0,9764,32559.0,1365.0,4.02,0.03,High Risk
U858,2024,7,79644.0,Salary Increases & Fixed Expenses Remain Stable,33924,22795.0,8928,31723.0,2201.0,6.49,0.01,High Risk
U858,2024,8,81845.0,Salary Increases & Fixed Expenses Remain Stable,54436,22795.0,15059,37854.0,16582.0,30.46,0.03,Low Risk
U858,2024,9,98427.0,Salary Increases & Fixed Expenses Remain Stable,54436,22795.0,15137,37932.0,16504.0,30.32,-0.01,Low Risk
U858,2024,10,114931.0,Salary Increases & Fixed Expenses Remain Stable,54436,22795.0,13842,36637.0,17799.0,32.7,0.01,Low Risk
U858,2024,11,132730.0,Salary Increases & Fixed Expenses Remain Stable,54436,22795.0,17499,40294.0,14142.0,25.98,-0.02,Low Risk
U858,2024,12,146872.0,Salary Increases & Fixed Expenses Remain Stable,54436,22795.0,16002,38797.0,15639.0,28.73,0.04,Low Risk
U859,2024,1,239437.0,Salary Increases & Fixed Expenses Increase,236836,68035.0,74075,142110.0,94726.0,40.0,0.01,Low Risk
U859,2024,2,334163.0,Salary Increases & Fixed Expenses Increase,236836,69350.0,79709,149059.0,87777.0,37.06,0.02,Low Risk
U859,2024,3,421940.0,Salary Increases & Fixed Expenses Increase,236836,70998.0,108914,179912.0,56924.0,24.04,0.05,Medium Risk
U859,2024,4,478864.0,Salary Increases & Fixed Expenses Increase,258182,70998.0,122053,193051.0,65131.0,25.23,-0.02,Low Risk
U859,2024,5,543995.0,Salary Increases & Fixed Expenses Increase,258182,71644.0,89027,160671.0,97511.0,37.77,0.01,Low Risk
U859,2024,6,641506.0,Salary Increases & Fixed Expenses Increase,258182,71644.0,109273,180917.0,77265.0,29.93,-0.01,Low Risk
U859,2024,7,718771.0,Salary Increases & Fixed Expenses Increase,258182,71644.0,80568,152212.0,105970.0,41.04,0.04,Low Risk
U859,2024,8,824741.0,Salary Increases & Fixed Expenses Increase,258182,71644.0,122332,193976.0,64206.0,24.87,0.01,Medium Risk
U859,2024,9,888947.0,Salary Increases & Fixed Expenses Increase,258182,71644.0,111431,183075.0,75107.0,29.09,0.04,Low Risk
U859,2024,10,964054.0,Salary Increases & Fixed Expenses Increase,258182,71644.0,79840,151484.0,106698.0,41.33,-0.02,Low Risk
U859,2024,11,1070752.0,Salary Increases & Fixed Expenses Increase,258182,71644.0,108066,179710.0,78472.0,30.39,-0.01,Low Risk
U859,2024,12,1149224.0,Salary Increases & Fixed Expenses Increase,258182,71644.0,112313,183957.0,74225.0,28.75,0.01,Low Risk
U860,2024,1,81354.0,Stable Salary & Stable Fixed Expenses,76173,26723.0,17128,43851.0,32322.0,42.43,-0.05,Low Risk
U860,2024,2,113676.0,Stable Salary & Stable Fixed Expenses,76173,26723.0,22229,48952.0,27221.0,35.74,-0.03,Low Risk
U860,2024,3,140897.0,Stable Salary & Stable Fixed Expenses,76173,26723.0,16323,43046.0,33127.0,43.49,0.02,Low Risk
U860,2024,4,174024.0,Stable Salary & Stable Fixed Expenses,76173,26723.0,20073,46796.0,29377.0,38.57,-0.04,Low Risk
U860,2024,5,203401.0,Stable Salary & Stable Fixed Expenses,76173,26723.0,19116,45839.0,30334.0,39.82,-0.02,Low Risk
U860,2024,6,233735.0,Stable Salary & Stable Fixed Expenses,76173,26723.0,19139,45862.0,30311.0,39.79,-0.02,Low Risk
U860,2024,7,264046.0,Stable Salary & Stable Fixed Expenses,76173,26723.0,21848,48571.0,27602.0,36.24,-0.05,Low Risk
U860,2024,8,291648.0,Stable Salary & Stable Fixed Expenses,76173,26723.0,19211,45934.0,30239.0,39.7,-0.04,Low Risk
U860,2024,9,321887.0,Stable Salary & Stable Fixed Expenses,76173,26723.0,24307,51030.0,25143.0,33.01,-0.02,Low Risk
U860,2024,10,347030.0,Stable Salary & Stable Fixed Expenses,76173,26723.0,20810,47533.0,28640.0,37.6,-0.0,Low Risk
U860,2024,11,375670.0,Stable Salary & Stable Fixed Expenses,76173,26723.0,23795,50518.0,25655.0,33.68,-0.01,Low Risk
U860,2024,12,401325.0,Stable Salary & Stable Fixed Expenses,76173,26723.0,22339,49062.0,27111.0,35.59,0.02,Low Risk
U861,2024,1,241020.0,Salary Increases & Fixed Expenses Remain Stable,137418,40931.0,35760,76691.0,60727.0,44.19,-0.04,Low Risk
U861,2024,2,301747.0,Salary Increases & Fixed Expenses Remain Stable,137418,40931.0,30100,71031.0,66387.0,48.31,0.01,Low Risk
U861,2024,3,368134.0,Salary Increases & Fixed Expenses Remain Stable,137418,40931.0,33732,74663.0,62755.0,45.67,-0.03,Low Risk
U861,2024,4,430889.0,Salary Increases & Fixed Expenses Remain Stable,151825,40931.0,31398,72329.0,79496.0,52.36,0.02,Low Risk
U861,2024,5,510385.0,Salary Increases & Fixed Expenses Remain Stable,151825,40931.0,31016,71947.0,79878.0,52.61,0.01,Low Risk
U861,2024,6,590263.0,Salary Increases & Fixed Expenses Remain Stable,151825,40931.0,42258,83189.0,68636.0,45.21,-0.05,Low Risk
U861,2024,7,658899.0,Salary Increases & Fixed Expenses Remain Stable,151825,40931.0,43929,84860.0,66965.0,44.11,0.03,Low Risk
U861,2024,8,725864.0,Salary Increases & Fixed Expenses Remain Stable,151825,40931.0,38447,79378.0,72447.0,47.72,-0.02,Low Risk
U861,2024,9,798311.0,Salary Increases & Fixed Expenses Remain Stable,151825,40931.0,46524,87455.0,64370.0,42.4,-0.02,Low Risk
U861,2024,10,862681.0,Salary Increases & Fixed Expenses Remain Stable,151825,40931.0,30760,71691.0,80134.0,52.78,-0.01,Low Risk
U861,2024,11,942815.0,Salary Increases & Fixed Expenses Remain Stable,151825,40931.0,36155,77086.0,74739.0,49.23,-0.02,Low Risk
U861,2024,12,1017554.0,Salary Increases & Fixed Expenses Remain Stable,151825,40931.0,42231,83162.0,68663.0,45.23,-0.03,Low Risk
U862,2024,1,213907.0,Salary Increases & Fixed Expenses Remain Stable,28488,22852.0,13655,36507.0,-8019.0,-28.15,-0.04,High Risk
U862,2024,2,205888.0,Salary Increases & Fixed Expenses Remain Stable,28488,22852.0,10031,32883.0,-4395.0,-15.43,-0.04,High Risk
U862,2024,3,201493.0,Salary Increases & Fixed Expenses Remain Stable,28488,22852.0,12156,35008.0,-6520.0,-22.89,0.05,High Risk
U862,2024,4,194973.0,Salary Increases & Fixed Expenses Remain Stable,28488,22852.0,13143,35995.0,-7507.0,-26.35,-0.04,High Risk
U862,2024,5,187466.0,Salary Increases & Fixed Expenses Remain Stable,28488,22852.0,8560,31412.0,-2924.0,-10.26,0.04,High Risk
U862,2024,6,184542.0,Salary Increases & Fixed Expenses Remain Stable,28488,22852.0,12768,35620.0,-7132.0,-25.04,-0.04,High Risk
U862,2024,7,177410.0,Salary Increases & Fixed Expenses Remain Stable,35384,22852.0,14573,37425.0,-2041.0,-5.77,0.04,High Risk
U862,2024,8,175369.0,Salary Increases & Fixed Expenses Remain Stable,35384,22852.0,15948,38800.0,-3416.0,-9.65,-0.01,High Risk
U862,2024,9,171953.0,Salary Increases & Fixed Expenses Remain Stable,35384,22852.0,16280,39132.0,-3748.0,-10.59,-0.04,High Risk
U862,2024,10,168205.0,Salary Increases & Fixed Expenses Remain Stable,35384,22852.0,13354,36206.0,-822.0,-2.32,0.05,High Risk
U862,2024,11,167383.0,Salary Increases & Fixed Expenses Remain Stable,35384,22852.0,17296,40148.0,-4764.0,-13.46,-0.0,High Risk
U862,2024,12,162619.0,Salary Increases & Fixed Expenses Remain Stable,35384,22852.0,11848,34700.0,684.0,1.93,0.01,High Risk
U863,2024,1,235324.0,Salary Increases & Fixed Expenses Remain Stable,102664,58697.0,46584,105281.0,-2617.0,-2.55,0.02,High Risk
U863,2024,2,232707.0,Salary Increases & Fixed Expenses Remain Stable,102664,58697.0,44278,102975.0,-311.0,-0.3,0.02,High Risk
U863,2024,3,232396.0,Salary Increases & Fixed Expenses Remain Stable,102664,58697.0,47424,106121.0,-3457.0,-3.37,-0.03,High Risk
U863,2024,4,228939.0,Salary Increases & Fixed Expenses Remain Stable,102664,58697.0,43865,102562.0,102.0,0.1,-0.01,High Risk
U863,2024,5,229041.0,Salary Increases & Fixed Expenses Remain Stable,110660,58697.0,45218,103915.0,6745.0,6.1,0.05,High Risk
U863,2024,6,235786.0,Salary Increases & Fixed Expenses Remain Stable,110660,58697.0,34692,93389.0,17271.0,15.61,-0.04,Medium Risk
U863,2024,7,253057.0,Salary Increases & Fixed Expenses Remain Stable,110660,58697.0,44306,103003.0,7657.0,6.92,-0.03,High Risk
U863,2024,8,260714.0,Salary Increases & Fixed Expenses Remain Stable,110660,58697.0,38281,96978.0,13682.0,12.36,0.01,High Risk
U863,2024,9,274396.0,Salary Increases & Fixed Expenses Remain Stable,110660,58697.0,42177,100874.0,9786.0,8.84,-0.03,High Risk
U863,2024,10,284182.0,Salary Increases & Fixed Expenses Remain Stable,110660,58697.0,45463,104160.0,6500.0,5.87,0.05,High Risk
U863,2024,11,290682.0,Salary Increases & Fixed Expenses Remain Stable,110660,58697.0,55332,114029.0,-3369.0,-3.04,0.02,High Risk
U863,2024,12,287313.0,Salary Increases & Fixed Expenses Remain Stable,110660,58697.0,40579,99276.0,11384.0,10.29,0.01,High Risk
U864,2024,1,146137.0,Stable Salary & Decreasing Fixed Expenses,97741,27923.0,45066,72989.0,24752.0,25.32,-0.04,Low Risk
U864,2024,2,170889.0,Stable Salary & Decreasing Fixed Expenses,97741,27923.0,32972,60895.0,36846.0,37.7,-0.0,Low Risk
U864,2024,3,207735.0,Stable Salary & Decreasing Fixed Expenses,97741,27923.0,37827,65750.0,31991.0,32.73,0.01,Low Risk
U864,2024,4,239726.0,Stable Salary & Decreasing Fixed Expenses,97741,27923.0,45976,73899.0,23842.0,24.39,-0.03,Medium Risk
U864,2024,5,263568.0,Stable Salary & Decreasing Fixed Expenses,97741,27923.0,39586,67509.0,30232.0,30.93,0.02,Low Risk
U864,2024,6,293800.0,Stable Salary & Decreasing Fixed Expenses,97741,27923.0,45531,73454.0,24287.0,24.85,-0.01,Medium Risk
U864,2024,7,318087.0,Stable Salary & Decreasing Fixed Expenses,97741,27923.0,48379,76302.0,21439.0,21.93,0.02,Medium Risk
U864,2024,8,339526.0,Stable Salary & Decreasing Fixed Expenses,97741,27923.0,32821,60744.0,36997.0,37.85,-0.03,Low Risk
U864,2024,9,376523.0,Stable Salary & Decreasing Fixed Expenses,97741,27923.0,39972,67895.0,29846.0,30.54,0.02,Low Risk
U864,2024,10,406369.0,Stable Salary & Decreasing Fixed Expenses,97741,27923.0,53302,81225.0,16516.0,16.9,-0.03,Medium Risk
U864,2024,11,422885.0,Stable Salary & Decreasing Fixed Expenses,97741,27923.0,52940,80863.0,16878.0,17.27,-0.01,Medium Risk
U864,2024,12,439763.0,Stable Salary & Decreasing Fixed Expenses,97741,27923.0,50235,78158.0,19583.0,20.04,0.03,Medium Risk
U865,2024,1,160199.0,Salary Increases & Fixed Expenses Increase,150928,45237.0,71808,117045.0,33883.0,22.45,-0.01,Medium Risk
U865,2024,2,194082.0,Salary Increases & Fixed Expenses Increase,150928,45237.0,65962,111199.0,39729.0,26.32,0.02,Low Risk
U865,2024,3,233811.0,Salary Increases & Fixed Expenses Increase,150928,45939.0,71459,117398.0,33530.0,22.22,0.04,Medium Risk
U865,2024,4,267341.0,Salary Increases & Fixed Expenses Increase,162617,45939.0,76478,122417.0,40200.0,24.72,-0.0,Medium Risk
U865,2024,5,307541.0,Salary Increases & Fixed Expenses Increase,162617,45939.0,51426,97365.0,65252.0,40.13,-0.01,Low Risk
U865,2024,6,372793.0,Salary Increases & Fixed Expenses Increase,162617,45939.0,71051,116990.0,45627.0,28.06,0.02,Low Risk
U865,2024,7,418420.0,Salary Increases & Fixed Expenses Increase,162617,45939.0,77001,122940.0,39677.0,24.4,0.04,Medium Risk
U865,2024,8,458097.0,Salary Increases & Fixed Expenses Increase,162617,45939.0,73699,119638.0,42979.0,26.43,-0.02,Low Risk
U865,2024,9,501076.0,Salary Increases & Fixed Expenses Increase,162617,45939.0,84871,130810.0,31807.0,19.56,0.03,Medium Risk
U865,2024,10,532883.0,Salary Increases & Fixed Expenses Increase,162617,45939.0,68552,114491.0,48126.0,29.59,0.01,Low Risk
U865,2024,11,581009.0,Salary Increases & Fixed Expenses Increase,162617,45939.0,79383,125322.0,37295.0,22.93,-0.03,Medium Risk
U865,2024,12,618304.0,Salary Increases & Fixed Expenses Increase,162617,45939.0,53065,99004.0,63613.0,39.12,0.04,Low Risk
U866,2024,1,233838.0,Stable Salary & Stable Fixed Expenses,135449,72054.0,46780,118834.0,16615.0,12.27,-0.02,High Risk
U866,2024,2,250453.0,Stable Salary & Stable Fixed Expenses,135449,72054.0,57773,129827.0,5622.0,4.15,0.03,High Risk
U866,2024,3,256075.0,Stable Salary & Stable Fixed Expenses,135449,72054.0,53876,125930.0,9519.0,7.03,0.04,High Risk
U866,2024,4,265594.0,Stable Salary & Stable Fixed Expenses,135449,72054.0,47686,119740.0,15709.0,11.6,-0.01,High Risk
U866,2024,5,281303.0,Stable Salary & Stable Fixed Expenses,135449,72054.0,53324,125378.0,10071.0,7.44,-0.01,High Risk
U866,2024,6,291374.0,Stable Salary & Stable Fixed Expenses,135449,72054.0,57607,129661.0,5788.0,4.27,-0.02,High Risk
U866,2024,7,297162.0,Stable Salary & Stable Fixed Expenses,135449,72054.0,65513,137567.0,-2118.0,-1.56,0.01,High Risk
U866,2024,8,295044.0,Stable Salary & Stable Fixed Expenses,135449,72054.0,43129,115183.0,20266.0,14.96,0.03,High Risk
U866,2024,9,315310.0,Stable Salary & Stable Fixed Expenses,135449,72054.0,52798,124852.0,10597.0,7.82,0.01,High Risk
U866,2024,10,325907.0,Stable Salary & Stable Fixed Expenses,135449,72054.0,40753,112807.0,22642.0,16.72,-0.01,Medium Risk
U866,2024,11,348549.0,Stable Salary & Stable Fixed Expenses,135449,72054.0,50363,122417.0,13032.0,9.62,0.04,High Risk
U866,2024,12,361581.0,Stable Salary & Stable Fixed Expenses,135449,72054.0,59244,131298.0,4151.0,3.06,-0.02,High Risk
U867,2024,1,95492.0,Salary Increases & Fixed Expenses Remain Stable,90821,32429.0,31520,63949.0,26872.0,29.59,-0.01,Low Risk
U867,2024,2,122364.0,Salary Increases & Fixed Expenses Remain Stable,90821,32429.0,42022,74451.0,16370.0,18.02,-0.02,Medium Risk
U867,2024,3,138734.0,Salary Increases & Fixed Expenses Remain Stable,90821,32429.0,42302,74731.0,16090.0,17.72,0.05,Medium Risk
U867,2024,4,154824.0,Salary Increases & Fixed Expenses Remain Stable,90821,32429.0,33888,66317.0,24504.0,26.98,0.01,Low Risk
U867,2024,5,179328.0,Salary Increases & Fixed Expenses Remain Stable,103062,32429.0,45481,77910.0,25152.0,24.4,-0.04,Medium Risk
U867,2024,6,204480.0,Salary Increases & Fixed Expenses Remain Stable,103062,32429.0,31320,63749.0,39313.0,38.15,-0.02,Low Risk
U867,2024,7,243793.0,Salary Increases & Fixed Expenses Remain Stable,103062,32429.0,48592,81021.0,22041.0,21.39,0.04,Medium Risk
U867,2024,8,265834.0,Salary Increases & Fixed Expenses Remain Stable,103062,32429.0,37079,69508.0,33554.0,32.56,-0.01,Low Risk
U867,2024,9,299388.0,Salary Increases & Fixed Expenses Remain Stable,103062,32429.0,39615,72044.0,31018.0,30.1,-0.04,Low Risk
U867,2024,10,330406.0,Salary Increases & Fixed Expenses Remain Stable,103062,32429.0,36097,68526.0,34536.0,33.51,0.02,Low Risk
U867,2024,11,364942.0,Salary Increases & Fixed Expenses Remain Stable,103062,32429.0,44142,76571.0,26491.0,25.7,-0.02,Low Risk
U867,2024,12,391433.0,Salary Increases & Fixed Expenses Remain Stable,103062,32429.0,31695,64124.0,38938.0,37.78,-0.02,Low Risk
U868,2024,1,174424.0,Salary Increases & Fixed Expenses Remain Stable,74771,32913.0,17932,50845.0,23926.0,32.0,-0.03,Low Risk
U868,2024,2,198350.0,Salary Increases & Fixed Expenses Remain Stable,74771,32913.0,21103,54016.0,20755.0,27.76,0.05,Low Risk
U868,2024,3,219105.0,Salary Increases & Fixed Expenses Remain Stable,74771,32913.0,20486,53399.0,21372.0,28.58,0.01,Low Risk
U868,2024,4,240477.0,Salary Increases & Fixed Expenses Remain Stable,74771,32913.0,17807,50720.0,24051.0,32.17,0.05,Low Risk
U868,2024,5,264528.0,Salary Increases & Fixed Expenses Remain Stable,74771,32913.0,19022,51935.0,22836.0,30.54,0.01,Low Risk
U868,2024,6,287364.0,Salary Increases & Fixed Expenses Remain Stable,95987,32913.0,27058,59971.0,36016.0,37.52,-0.02,Low Risk
U868,2024,7,323380.0,Salary Increases & Fixed Expenses Remain Stable,95987,32913.0,24875,57788.0,38199.0,39.8,0.0,Low Risk
U868,2024,8,361579.0,Salary Increases & Fixed Expenses Remain Stable,95987,32913.0,27637,60550.0,35437.0,36.92,0.02,Low Risk
U868,2024,9,397016.0,Salary Increases & Fixed Expenses Remain Stable,95987,32913.0,21691,54604.0,41383.0,43.11,0.01,Low Risk
U868,2024,10,438399.0,Salary Increases & Fixed Expenses Remain Stable,95987,32913.0,19979,52892.0,43095.0,44.9,0.04,Low Risk
U868,2024,11,481494.0,Salary Increases & Fixed Expenses Remain Stable,95987,32913.0,29082,61995.0,33992.0,35.41,-0.04,Low Risk
U868,2024,12,515486.0,Salary Increases & Fixed Expenses Remain Stable,95987,32913.0,24548,57461.0,38526.0,40.14,0.01,Low Risk
U869,2024,1,211819.0,Stable Salary & Stable Fixed Expenses,93896,33735.0,43497,77232.0,16664.0,17.75,0.03,Medium Risk
U869,2024,2,228483.0,Stable Salary & Stable Fixed Expenses,93896,33735.0,39164,72899.0,20997.0,22.36,-0.03,Medium Risk
U869,2024,3,249480.0,Stable Salary & Stable Fixed Expenses,93896,33735.0,49530,83265.0,10631.0,11.32,0.04,High Risk
U869,2024,4,260111.0,Stable Salary & Stable Fixed Expenses,93896,33735.0,33655,67390.0,26506.0,28.23,0.01,Low Risk
U869,2024,5,286617.0,Stable Salary & Stable Fixed Expenses,93896,33735.0,36699,70434.0,23462.0,24.99,0.01,Medium Risk
U869,2024,6,310079.0,Stable Salary & Stable Fixed Expenses,93896,33735.0,28547,62282.0,31614.0,33.67,-0.01,Low Risk
U869,2024,7,341693.0,Stable Salary & Stable Fixed Expenses,93896,33735.0,43279,77014.0,16882.0,17.98,0.02,Medium Risk
U869,2024,8,358575.0,Stable Salary & Stable Fixed Expenses,93896,33735.0,39741,73476.0,20420.0,21.75,-0.01,Medium Risk
U869,2024,9,378995.0,Stable Salary & Stable Fixed Expenses,93896,33735.0,35040,68775.0,25121.0,26.75,-0.0,Low Risk
U869,2024,10,404116.0,Stable Salary & Stable Fixed Expenses,93896,33735.0,50879,84614.0,9282.0,9.89,0.02,High Risk
U869,2024,11,413398.0,Stable Salary & Stable Fixed Expenses,93896,33735.0,45788,79523.0,14373.0,15.31,0.0,Medium Risk
U869,2024,12,427771.0,Stable Salary & Stable Fixed Expenses,93896,33735.0,39166,72901.0,20995.0,22.36,-0.02,Medium Risk
U870,2024,1,208002.0,Stable Salary & Stable Fixed Expenses,180115,48926.0,36529,85455.0,94660.0,52.56,-0.03,Low Risk
U870,2024,2,302662.0,Stable Salary & Stable Fixed Expenses,180115,48926.0,44510,93436.0,86679.0,48.12,-0.04,Low Risk
U870,2024,3,389341.0,Stable Salary & Stable Fixed Expenses,180115,48926.0,53751,102677.0,77438.0,42.99,-0.01,Low Risk
U870,2024,4,466779.0,Stable Salary & Stable Fixed Expenses,180115,48926.0,50262,99188.0,80927.0,44.93,0.04,Low Risk
U870,2024,5,547706.0,Stable Salary & Stable Fixed Expenses,180115,48926.0,38970,87896.0,92219.0,51.2,-0.03,Low Risk
U870,2024,6,639925.0,Stable Salary & Stable Fixed Expenses,180115,48926.0,41513,90439.0,89676.0,49.79,-0.03,Low Risk
U870,2024,7,729601.0,Stable Salary & Stable Fixed Expenses,180115,48926.0,50882,99808.0,80307.0,44.59,0.02,Low Risk
U870,2024,8,809908.0,Stable Salary & Stable Fixed Expenses,180115,48926.0,41295,90221.0,89894.0,49.91,-0.04,Low Risk
U870,2024,9,899802.0,Stable Salary & Stable Fixed Expenses,180115,48926.0,46894,95820.0,84295.0,46.8,0.02,Low Risk
U870,2024,10,984097.0,Stable Salary & Stable Fixed Expenses,180115,48926.0,61799,110725.0,69390.0,38.53,-0.04,Low Risk
U870,2024,11,1053487.0,Stable Salary & Stable Fixed Expenses,180115,48926.0,47606,96532.0,83583.0,46.41,-0.02,Low Risk
U870,2024,12,1137070.0,Stable Salary & Stable Fixed Expenses,180115,48926.0,46175,95101.0,85014.0,47.2,-0.03,Low Risk
U871,2024,1,222738.0,Stable Salary & Increasing Fixed Expenses,189245,55620.0,68465,124085.0,65160.0,34.43,0.02,Low Risk
U871,2024,2,287898.0,Stable Salary & Increasing Fixed Expenses,189245,55620.0,58761,114381.0,74864.0,39.56,-0.04,Low Risk
U871,2024,3,362762.0,Stable Salary & Increasing Fixed Expenses,189245,55620.0,74260,129880.0,59365.0,31.37,-0.04,Low Risk
U871,2024,4,422127.0,Stable Salary & Increasing Fixed Expenses,189245,55620.0,57795,113415.0,75830.0,40.07,-0.02,Low Risk
U871,2024,5,497957.0,Stable Salary & Increasing Fixed Expenses,189245,55620.0,82696,138316.0,50929.0,26.91,0.0,Low Risk
U871,2024,6,548886.0,Stable Salary & Increasing Fixed Expenses,189245,55620.0,66574,122194.0,67051.0,35.43,0.02,Low Risk
U871,2024,7,615937.0,Stable Salary & Increasing Fixed Expenses,189245,55620.0,70958,126578.0,62667.0,33.11,0.03,Low Risk
U871,2024,8,678604.0,Stable Salary & Increasing Fixed Expenses,189245,55620.0,59970,115590.0,73655.0,38.92,0.02,Low Risk
U871,2024,9,752259.0,Stable Salary & Increasing Fixed Expenses,189245,55620.0,65850,121470.0,67775.0,35.81,0.02,Low Risk
U871,2024,10,820034.0,Stable Salary & Increasing Fixed Expenses,189245,55620.0,63289,118909.0,70336.0,37.17,-0.04,Low Risk
U871,2024,11,890370.0,Stable Salary & Increasing Fixed Expenses,189245,55620.0,101415,157035.0,32210.0,17.02,-0.05,Medium Risk
U871,2024,12,922580.0,Stable Salary & Increasing Fixed Expenses,189245,55620.0,86219,141839.0,47406.0,25.05,0.01,Low Risk
U872,2024,1,122168.0,Stable Salary & Increasing Fixed Expenses,118658,56247.0,57106,113353.0,5305.0,4.47,-0.04,High Risk
U872,2024,2,127473.0,Stable Salary & Increasing Fixed Expenses,118658,56247.0,53829,110076.0,8582.0,7.23,0.01,High Risk
U872,2024,3,136055.0,Stable Salary & Increasing Fixed Expenses,118658,56247.0,45369,101616.0,17042.0,14.36,-0.02,High Risk
U872,2024,4,153097.0,Stable Salary & Increasing Fixed Expenses,118658,56247.0,56757,113004.0,5654.0,4.76,-0.02,High Risk
U872,2024,5,158751.0,Stable Salary & Increasing Fixed Expenses,118658,56247.0,43637,99884.0,18774.0,15.82,-0.0,Medium Risk
U872,2024,6,177525.0,Stable Salary & Increasing Fixed Expenses,118658,57086.0,56583,113669.0,4989.0,4.2,-0.0,High Risk
U872,2024,7,182514.0,Stable Salary & Increasing Fixed Expenses,118658,57086.0,37219,94305.0,24353.0,20.52,-0.01,Medium Risk
U872,2024,8,206867.0,Stable Salary & Increasing Fixed Expenses,118658,57086.0,39060,96146.0,22512.0,18.97,0.01,Medium Risk
U872,2024,9,229379.0,Stable Salary & Increasing Fixed Expenses,118658,57086.0,58369,115455.0,3203.0,2.7,-0.04,High Risk
U872,2024,10,232582.0,Stable Salary & Increasing Fixed Expenses,118658,57086.0,64011,121097.0,-2439.0,-2.06,0.0,High Risk
U872,2024,11,230143.0,Stable Salary & Increasing Fixed Expenses,118658,57086.0,52627,109713.0,8945.0,7.54,0.02,High Risk
U872,2024,12,239088.0,Stable Salary & Increasing Fixed Expenses,118658,58718.0,52709,111427.0,7231.0,6.09,0.03,High Risk
U873,2024,1,225676.0,Salary Increases & Fixed Expenses Increase,61569,27886.0,28642,56528.0,5041.0,8.19,0.03,High Risk
U873,2024,2,230717.0,Salary Increases & Fixed Expenses Increase,61569,27886.0,26875,54761.0,6808.0,11.06,-0.02,High Risk
U873,2024,3,237525.0,Salary Increases & Fixed Expenses Increase,77621,27886.0,27264,55150.0,22471.0,28.95,-0.04,Low Risk
U873,2024,4,259996.0,Salary Increases & Fixed Expenses Increase,77621,28948.0,27248,56196.0,21425.0,27.6,-0.02,Low Risk
U873,2024,5,281421.0,Salary Increases & Fixed Expenses Increase,77621,28948.0,26131,55079.0,22542.0,29.04,-0.0,Low Risk
U873,2024,6,303963.0,Salary Increases & Fixed Expenses Increase,77621,28948.0,38758,67706.0,9915.0,12.77,0.04,High Risk
U873,2024,7,313878.0,Salary Increases & Fixed Expenses Increase,77621,30761.0,23668,54429.0,23192.0,29.88,0.03,Low Risk
U873,2024,8,337070.0,Salary Increases & Fixed Expenses Increase,77621,31925.0,27636,59561.0,18060.0,23.27,0.04,Medium Risk
U873,2024,9,355130.0,Salary Increases & Fixed Expenses Increase,77621,31925.0,33357,65282.0,12339.0,15.9,-0.04,Medium Risk
U873,2024,10,367469.0,Salary Increases & Fixed Expenses Increase,77621,31925.0,36636,68561.0,9060.0,11.67,0.03,High Risk
U873,2024,11,376529.0,Salary Increases & Fixed Expenses Increase,77621,31925.0,35811,67736.0,9885.0,12.73,-0.0,High Risk
U873,2024,12,386414.0,Salary Increases & Fixed Expenses Increase,77621,31925.0,30990,62915.0,14706.0,18.95,0.0,Medium Risk
U874,2024,1,250000.0,Stable Salary & Increasing Fixed Expenses,283571,79346.0,84419,163765.0,119806.0,42.25,0.05,Low Risk
U874,2024,2,369806.0,Stable Salary & Increasing Fixed Expenses,283571,79346.0,84372,163718.0,119853.0,42.27,-0.02,Low Risk
U874,2024,3,489659.0,Stable Salary & Increasing Fixed Expenses,283571,80113.0,100650,180763.0,102808.0,36.25,0.03,Low Risk
U874,2024,4,592467.0,Stable Salary & Increasing Fixed Expenses,283571,81260.0,65362,146622.0,136949.0,48.29,0.04,Low Risk
U874,2024,5,729416.0,Stable Salary & Increasing Fixed Expenses,283571,81260.0,71298,152558.0,131013.0,46.2,-0.03,Low Risk
U874,2024,6,860429.0,Stable Salary & Increasing Fixed Expenses,283571,81260.0,58379,139639.0,143932.0,50.76,0.05,Low Risk
U874,2024,7,1004361.0,Stable Salary & Increasing Fixed Expenses,283571,81260.0,61814,143074.0,140497.0,49.55,-0.04,Low Risk
U874,2024,8,1144858.0,Stable Salary & Increasing Fixed Expenses,283571,81260.0,65699,146959.0,136612.0,48.18,0.04,Low Risk
U874,2024,9,1281470.0,Stable Salary & Increasing Fixed Expenses,283571,81260.0,80950,162210.0,121361.0,42.8,-0.01,Low Risk
U874,2024,10,1402831.0,Stable Salary & Increasing Fixed Expenses,283571,82549.0,75115,157664.0,125907.0,44.4,0.03,Low Risk
U874,2024,11,1528738.0,Stable Salary & Increasing Fixed Expenses,283571,82549.0,74076,156625.0,126946.0,44.77,-0.04,Low Risk
U874,2024,12,1655684.0,Stable Salary & Increasing Fixed Expenses,283571,82549.0,94633,177182.0,106389.0,37.52,0.0,Low Risk
U875,2024,1,242799.0,Salary Increases & Fixed Expenses Increase,196781,73441.0,54495,127936.0,68845.0,34.99,0.03,Low Risk
U875,2024,2,311644.0,Salary Increases & Fixed Expenses Increase,196781,73441.0,56038,129479.0,67302.0,34.2,0.01,Low Risk
U875,2024,3,378946.0,Salary Increases & Fixed Expenses Increase,196781,73441.0,59004,132445.0,64336.0,32.69,0.02,Low Risk
U875,2024,4,443282.0,Salary Increases & Fixed Expenses Increase,196781,73441.0,54612,128053.0,68728.0,34.93,-0.03,Low Risk
U875,2024,5,512010.0,Salary Increases & Fixed Expenses Increase,196781,73441.0,53756,127197.0,69584.0,35.36,0.01,Low Risk
U875,2024,6,581594.0,Salary Increases & Fixed Expenses Increase,196781,73441.0,54388,127829.0,68952.0,35.04,0.01,Low Risk
U875,2024,7,650546.0,Salary Increases & Fixed Expenses Increase,196781,73441.0,49518,122959.0,73822.0,37.51,-0.03,Low Risk
U875,2024,8,724368.0,Salary Increases & Fixed Expenses Increase,219635,73441.0,48570,122011.0,97624.0,44.45,0.03,Low Risk
U875,2024,9,821992.0,Salary Increases & Fixed Expenses Increase,219635,74855.0,51121,125976.0,93659.0,42.64,-0.03,Low Risk
U875,2024,10,915651.0,Salary Increases & Fixed Expenses Increase,219635,74855.0,46887,121742.0,97893.0,44.57,-0.0,Low Risk
U875,2024,11,1013544.0,Salary Increases & Fixed Expenses Increase,219635,74855.0,56517,131372.0,88263.0,40.19,0.03,Low Risk
U875,2024,12,1101807.0,Salary Increases & Fixed Expenses Increase,219635,74855.0,58986,133841.0,85794.0,39.06,-0.02,Low Risk
U876,2024,1,233793.0,Salary Increases & Fixed Expenses Increase,223117,96819.0,152248,249067.0,-25950.0,-11.63,-0.04,High Risk
U876,2024,2,207843.0,Salary Increases & Fixed Expenses Increase,223117,96819.0,136100,232919.0,-9802.0,-4.39,0.02,High Risk
U876,2024,3,198041.0,Salary Increases & Fixed Expenses Increase,223117,96819.0,136858,233677.0,-10560.0,-4.73,-0.03,High Risk
U876,2024,4,187481.0,Salary Increases & Fixed Expenses Increase,223117,96819.0,136783,233602.0,-10485.0,-4.7,-0.01,High Risk
U876,2024,5,176996.0,Salary Increases & Fixed Expenses Increase,223117,96819.0,120214,217033.0,6084.0,2.73,0.03,High Risk
U876,2024,6,183080.0,Salary Increases & Fixed Expenses Increase,231003,96819.0,155840,252659.0,-21656.0,-9.37,0.04,High Risk
U876,2024,7,161424.0,Salary Increases & Fixed Expenses Increase,231003,98565.0,117983,216548.0,14455.0,6.26,0.0,High Risk
U876,2024,8,175879.0,Salary Increases & Fixed Expenses Increase,231003,98565.0,147586,246151.0,-15148.0,-6.56,-0.03,High Risk
U876,2024,9,160731.0,Salary Increases & Fixed Expenses Increase,231003,98565.0,154589,253154.0,-22151.0,-9.59,-0.01,High Risk
U876,2024,10,138580.0,Salary Increases & Fixed Expenses Increase,231003,98565.0,125035,223600.0,7403.0,3.2,-0.01,High Risk
U876,2024,11,145983.0,Salary Increases & Fixed Expenses Increase,231003,99996.0,157888,257884.0,-26881.0,-11.64,-0.04,High Risk
U876,2024,12,119102.0,Salary Increases & Fixed Expenses Increase,231003,99996.0,130896,230892.0,111.0,0.05,0.02,High Risk
U877,2024,1,231752.0,Stable Salary & Stable Fixed Expenses,191410,75080.0,53043,128123.0,63287.0,33.06,0.05,Low Risk
U877,2024,2,295039.0,Stable Salary & Stable Fixed Expenses,191410,75080.0,52204,127284.0,64126.0,33.5,-0.04,Low Risk
U877,2024,3,359165.0,Stable Salary & Stable Fixed Expenses,191410,75080.0,38918,113998.0,77412.0,40.44,0.02,Low Risk
U877,2024,4,436577.0,Stable Salary & Stable Fixed Expenses,191410,75080.0,51778,126858.0,64552.0,33.72,-0.04,Low Risk
U877,2024,5,501129.0,Stable Salary & Stable Fixed Expenses,191410,75080.0,49375,124455.0,66955.0,34.98,0.02,Low Risk
U877,2024,6,568084.0,Stable Salary & Stable Fixed Expenses,191410,75080.0,41195,116275.0,75135.0,39.25,0.05,Low Risk
U877,2024,7,643219.0,Stable Salary & Stable Fixed Expenses,191410,75080.0,49701,124781.0,66629.0,34.81,0.03,Low Risk
U877,2024,8,709848.0,Stable Salary & Stable Fixed Expenses,191410,75080.0,47695,122775.0,68635.0,35.86,0.04,Low Risk
U877,2024,9,778483.0,Stable Salary & Stable Fixed Expenses,191410,75080.0,48256,123336.0,68074.0,35.56,0.03,Low Risk
U877,2024,10,846557.0,Stable Salary & Stable Fixed Expenses,191410,75080.0,41314,116394.0,75016.0,39.19,0.04,Low Risk
U877,2024,11,921573.0,Stable Salary & Stable Fixed Expenses,191410,75080.0,47384,122464.0,68946.0,36.02,-0.04,Low Risk
U877,2024,12,990519.0,Stable Salary & Stable Fixed Expenses,191410,75080.0,49604,124684.0,66726.0,34.86,0.04,Low Risk
U878,2024,1,243689.0,Salary Increases & Fixed Expenses Remain Stable,234116,61571.0,59731,121302.0,112814.0,48.19,0.0,Low Risk
U878,2024,2,356503.0,Salary Increases & Fixed Expenses Remain Stable,234116,61571.0,63460,125031.0,109085.0,46.59,0.04,Low Risk
U878,2024,3,465588.0,Salary Increases & Fixed Expenses Remain Stable,234116,61571.0,62540,124111.0,110005.0,46.99,-0.0,Low Risk
U878,2024,4,575593.0,Salary Increases & Fixed Expenses Remain Stable,252858,61571.0,62462,124033.0,128825.0,50.95,-0.0,Low Risk
U878,2024,5,704418.0,Salary Increases & Fixed Expenses Remain Stable,252858,61571.0,72752,134323.0,118535.0,46.88,0.01,Low Risk
U878,2024,6,822953.0,Salary Increases & Fixed Expenses Remain Stable,252858,61571.0,73010,134581.0,118277.0,46.78,0.03,Low Risk
U878,2024,7,941230.0,Salary Increases & Fixed Expenses Remain Stable,252858,61571.0,65775,127346.0,125512.0,49.64,-0.02,Low Risk
U878,2024,8,1066742.0,Salary Increases & Fixed Expenses Remain Stable,252858,61571.0,72460,134031.0,118827.0,46.99,0.03,Low Risk
U878,2024,9,1185569.0,Salary Increases & Fixed Expenses Remain Stable,252858,61571.0,79392,140963.0,111895.0,44.25,0.0,Low Risk
U878,2024,10,1297464.0,Salary Increases & Fixed Expenses Remain Stable,252858,61571.0,75650,137221.0,115637.0,45.73,0.04,Low Risk
U878,2024,11,1413101.0,Salary Increases & Fixed Expenses Remain Stable,252858,61571.0,80624,142195.0,110663.0,43.76,0.05,Low Risk
U878,2024,12,1523764.0,Salary Increases & Fixed Expenses Remain Stable,252858,61571.0,67835,129406.0,123452.0,48.82,0.02,Low Risk
U879,2024,1,151237.0,Salary Increases & Fixed Expenses Increase,51446,33369.0,17304,50673.0,773.0,1.5,-0.04,High Risk
U879,2024,2,152010.0,Salary Increases & Fixed Expenses Increase,51446,33369.0,25427,58796.0,-7350.0,-14.29,0.01,High Risk
U879,2024,3,144660.0,Salary Increases & Fixed Expenses Increase,51446,33369.0,32003,65372.0,-13926.0,-27.07,0.01,High Risk
U879,2024,4,130734.0,Salary Increases & Fixed Expenses Increase,51446,33369.0,21068,54437.0,-2991.0,-5.81,-0.05,High Risk
U879,2024,5,127743.0,Salary Increases & Fixed Expenses Increase,51446,33369.0,20143,53512.0,-2066.0,-4.02,-0.03,High Risk
U879,2024,6,125677.0,Salary Increases & Fixed Expenses Increase,51446,33369.0,18690,52059.0,-613.0,-1.19,0.01,High Risk
U879,2024,7,125064.0,Salary Increases & Fixed Expenses Increase,51446,35352.0,25470,60822.0,-9376.0,-18.22,0.04,High Risk
U879,2024,8,115688.0,Salary Increases & Fixed Expenses Increase,72295,35352.0,28324,63676.0,8619.0,11.92,-0.0,High Risk
U879,2024,9,124307.0,Salary Increases & Fixed Expenses Increase,72295,35352.0,31695,67047.0,5248.0,7.26,0.0,High Risk
U879,2024,10,129555.0,Salary Increases & Fixed Expenses Increase,72295,35352.0,40304,75656.0,-3361.0,-4.65,-0.01,High Risk
U879,2024,11,126194.0,Salary Increases & Fixed Expenses Increase,72295,35352.0,36340,71692.0,603.0,0.83,0.0,High Risk
U879,2024,12,126797.0,Salary Increases & Fixed Expenses Increase,72295,36297.0,27165,63462.0,8833.0,12.22,0.03,High Risk
U880,2024,1,214059.0,Salary Increases & Fixed Expenses Increase,158549,65401.0,100219,165620.0,-7071.0,-4.46,-0.01,High Risk
U880,2024,2,206988.0,Salary Increases & Fixed Expenses Increase,158549,65401.0,95285,160686.0,-2137.0,-1.35,0.04,High Risk
U880,2024,3,204851.0,Salary Increases & Fixed Expenses Increase,158549,65401.0,129295,194696.0,-36147.0,-22.8,0.05,High Risk
U880,2024,4,168704.0,Salary Increases & Fixed Expenses Increase,158549,65401.0,85022,150423.0,8126.0,5.13,0.04,High Risk
U880,2024,5,176830.0,Salary Increases & Fixed Expenses Increase,174826,65401.0,100662,166063.0,8763.0,5.01,0.02,High Risk
U880,2024,6,185593.0,Salary Increases & Fixed Expenses Increase,174826,65401.0,109127,174528.0,298.0,0.17,-0.04,High Risk
U880,2024,7,185891.0,Salary Increases & Fixed Expenses Increase,174826,65401.0,120067,185468.0,-10642.0,-6.09,0.02,High Risk
U880,2024,8,175249.0,Salary Increases & Fixed Expenses Increase,174826,67046.0,88094,155140.0,19686.0,11.26,-0.01,High Risk
U880,2024,9,194935.0,Salary Increases & Fixed Expenses Increase,174826,67618.0,133701,201319.0,-26493.0,-15.15,0.05,High Risk
U880,2024,10,168442.0,Salary Increases & Fixed Expenses Increase,174826,67618.0,158121,225739.0,-50913.0,-29.12,-0.03,High Risk
U880,2024,11,117529.0,Salary Increases & Fixed Expenses Increase,174826,67618.0,100465,168083.0,6743.0,3.86,-0.0,High Risk
U880,2024,12,124272.0,Salary Increases & Fixed Expenses Increase,174826,67618.0,135517,203135.0,-28309.0,-16.19,-0.02,High Risk
U881,2024,1,248923.0,Salary Increases & Fixed Expenses Remain Stable,209599,65065.0,100816,165881.0,43718.0,20.86,0.02,Medium Risk
U881,2024,2,292641.0,Salary Increases & Fixed Expenses Remain Stable,209599,65065.0,74755,139820.0,69779.0,33.29,0.01,Low Risk
U881,2024,3,362420.0,Salary Increases & Fixed Expenses Remain Stable,209599,65065.0,113284,178349.0,31250.0,14.91,0.0,High Risk
U881,2024,4,393670.0,Salary Increases & Fixed Expenses Remain Stable,216607,65065.0,74677,139742.0,76865.0,35.49,0.02,Low Risk
U881,2024,5,470535.0,Salary Increases & Fixed Expenses Remain Stable,216607,65065.0,77240,142305.0,74302.0,34.3,0.03,Low Risk
U881,2024,6,544837.0,Salary Increases & Fixed Expenses Remain Stable,216607,65065.0,72534,137599.0,79008.0,36.48,-0.02,Low Risk
U881,2024,7,623845.0,Salary Increases & Fixed Expenses Remain Stable,216607,65065.0,75822,140887.0,75720.0,34.96,0.01,Low Risk
U881,2024,8,699565.0,Salary Increases & Fixed Expenses Remain Stable,216607,65065.0,106321,171386.0,45221.0,20.88,0.01,Medium Risk
U881,2024,9,744786.0,Salary Increases & Fixed Expenses Remain Stable,216607,65065.0,88959,154024.0,62583.0,28.89,0.05,Low Risk
U881,2024,10,807369.0,Salary Increases & Fixed Expenses Remain Stable,216607,65065.0,112704,177769.0,38838.0,17.93,0.04,Medium Risk
U881,2024,11,846207.0,Salary Increases & Fixed Expenses Remain Stable,216607,65065.0,96862,161927.0,54680.0,25.24,-0.04,Low Risk
U881,2024,12,900887.0,Salary Increases & Fixed Expenses Remain Stable,216607,65065.0,125127,190192.0,26415.0,12.19,-0.04,High Risk
U882,2024,1,245649.0,Stable Salary & Decreasing Fixed Expenses,166226,65912.0,38707,104619.0,61607.0,37.06,0.01,Low Risk
U882,2024,2,307256.0,Stable Salary & Decreasing Fixed Expenses,166226,65912.0,37467,103379.0,62847.0,37.81,-0.04,Low Risk
U882,2024,3,370103.0,Stable Salary & Decreasing Fixed Expenses,166226,65912.0,48808,114720.0,51506.0,30.99,0.04,Low Risk
U882,2024,4,421609.0,Stable Salary & Decreasing Fixed Expenses,166226,65912.0,46781,112693.0,53533.0,32.2,0.02,Low Risk
U882,2024,5,475142.0,Stable Salary & Decreasing Fixed Expenses,166226,65912.0,46824,112736.0,53490.0,32.18,0.04,Low Risk
U882,2024,6,528632.0,Stable Salary & Decreasing Fixed Expenses,166226,65912.0,36959,102871.0,63355.0,38.11,0.05,Low Risk
U882,2024,7,591987.0,Stable Salary & Decreasing Fixed Expenses,166226,65912.0,38576,104488.0,61738.0,37.14,-0.0,Low Risk
U882,2024,8,653725.0,Stable Salary & Decreasing Fixed Expenses,166226,65912.0,34607,100519.0,65707.0,39.53,-0.05,Low Risk
U882,2024,9,719432.0,Stable Salary & Decreasing Fixed Expenses,166226,65912.0,40968,106880.0,59346.0,35.7,-0.03,Low Risk
U882,2024,10,778778.0,Stable Salary & Decreasing Fixed Expenses,166226,65912.0,45161,111073.0,55153.0,33.18,-0.02,Low Risk
U882,2024,11,833931.0,Stable Salary & Decreasing Fixed Expenses,166226,65912.0,47841,113753.0,52473.0,31.57,-0.01,Low Risk
U882,2024,12,886404.0,Stable Salary & Decreasing Fixed Expenses,166226,65912.0,35919,101831.0,64395.0,38.74,-0.03,Low Risk
U883,2024,1,246484.0,Salary Increases & Fixed Expenses Increase,238151,92313.0,136632,228945.0,9206.0,3.87,-0.03,High Risk
U883,2024,2,255690.0,Salary Increases & Fixed Expenses Increase,238151,92313.0,155197,247510.0,-9359.0,-3.93,-0.02,High Risk
U883,2024,3,246331.0,Salary Increases & Fixed Expenses Increase,238151,92313.0,124118,216431.0,21720.0,9.12,-0.01,High Risk
U883,2024,4,268051.0,Salary Increases & Fixed Expenses Increase,238151,92313.0,124642,216955.0,21196.0,8.9,0.04,High Risk
U883,2024,5,289247.0,Salary Increases & Fixed Expenses Increase,238151,92313.0,135981,228294.0,9857.0,4.14,-0.0,High Risk
U883,2024,6,299104.0,Salary Increases & Fixed Expenses Increase,238151,92313.0,130213,222526.0,15625.0,6.56,-0.02,High Risk
U883,2024,7,314729.0,Salary Increases & Fixed Expenses Increase,238151,92313.0,144623,236936.0,1215.0,0.51,0.01,High Risk
U883,2024,8,315944.0,Salary Increases & Fixed Expenses Increase,253845,92313.0,132321,224634.0,29211.0,11.51,0.02,High Risk
U883,2024,9,345155.0,Salary Increases & Fixed Expenses Increase,253845,92313.0,164911,257224.0,-3379.0,-1.33,-0.0,High Risk
U883,2024,10,341776.0,Salary Increases & Fixed Expenses Increase,253845,92313.0,151351,243664.0,10181.0,4.01,-0.04,High Risk
U883,2024,11,351957.0,Salary Increases & Fixed Expenses Increase,253845,93592.0,165326,258918.0,-5073.0,-2.0,-0.01,High Risk
U883,2024,12,346884.0,Salary Increases & Fixed Expenses Increase,253845,94620.0,138197,232817.0,21028.0,8.28,-0.01,High Risk
U884,2024,1,213144.0,Salary Increases & Fixed Expenses Remain Stable,113656,53868.0,29099,82967.0,30689.0,27.0,0.03,Low Risk
U884,2024,2,243833.0,Salary Increases & Fixed Expenses Remain Stable,113656,53868.0,23079,76947.0,36709.0,32.3,0.03,Low Risk
U884,2024,3,280542.0,Salary Increases & Fixed Expenses Remain Stable,113656,53868.0,30998,84866.0,28790.0,25.33,0.04,Low Risk
U884,2024,4,309332.0,Salary Increases & Fixed Expenses Remain Stable,132635,53868.0,38396,92264.0,40371.0,30.44,0.0,Low Risk
U884,2024,5,349703.0,Salary Increases & Fixed Expenses Remain Stable,132635,53868.0,27085,80953.0,51682.0,38.97,-0.01,Low Risk
U884,2024,6,401385.0,Salary Increases & Fixed Expenses Remain Stable,132635,53868.0,39096,92964.0,39671.0,29.91,-0.02,Low Risk
U884,2024,7,441056.0,Salary Increases & Fixed Expenses Remain Stable,132635,53868.0,39759,93627.0,39008.0,29.41,-0.01,Low Risk
U884,2024,8,480064.0,Salary Increases & Fixed Expenses Remain Stable,132635,53868.0,30576,84444.0,48191.0,36.33,-0.02,Low Risk
U884,2024,9,528255.0,Salary Increases & Fixed Expenses Remain Stable,132635,53868.0,28872,82740.0,49895.0,37.62,-0.02,Low Risk
U884,2024,10,578150.0,Salary Increases & Fixed Expenses Remain Stable,132635,53868.0,33333,87201.0,45434.0,34.25,-0.05,Low Risk
U884,2024,11,623584.0,Salary Increases & Fixed Expenses Remain Stable,132635,53868.0,33249,87117.0,45518.0,34.32,0.02,Low Risk
U884,2024,12,669102.0,Salary Increases & Fixed Expenses Remain Stable,132635,53868.0,35921,89789.0,42846.0,32.3,-0.05,Low Risk
U885,2024,1,217387.0,Salary Increases & Fixed Expenses Remain Stable,172154,79086.0,43854,122940.0,49214.0,28.59,-0.03,Low Risk
U885,2024,2,266601.0,Salary Increases & Fixed Expenses Remain Stable,172154,79086.0,47513,126599.0,45555.0,26.46,-0.04,Low Risk
U885,2024,3,312156.0,Salary Increases & Fixed Expenses Remain Stable,172154,79086.0,48552,127638.0,44516.0,25.86,-0.01,Low Risk
U885,2024,4,356672.0,Salary Increases & Fixed Expenses Remain Stable,172154,79086.0,34506,113592.0,58562.0,34.02,-0.04,Low Risk
U885,2024,5,415234.0,Salary Increases & Fixed Expenses Remain Stable,172154,79086.0,37775,116861.0,55293.0,32.12,0.03,Low Risk
U885,2024,6,470527.0,Salary Increases & Fixed Expenses Remain Stable,172154,79086.0,34719,113805.0,58349.0,33.89,-0.04,Low Risk
U885,2024,7,528876.0,Salary Increases & Fixed Expenses Remain Stable,172154,79086.0,35852,114938.0,57216.0,33.24,-0.03,Low Risk
U885,2024,8,586092.0,Salary Increases & Fixed Expenses Remain Stable,201560,79086.0,47616,126702.0,74858.0,37.14,0.01,Low Risk
U885,2024,9,660950.0,Salary Increases & Fixed Expenses Remain Stable,201560,79086.0,47833,126919.0,74641.0,37.03,-0.03,Low Risk
U885,2024,10,735591.0,Salary Increases & Fixed Expenses Remain Stable,201560,79086.0,58416,137502.0,64058.0,31.78,0.01,Low Risk
U885,2024,11,799649.0,Salary Increases & Fixed Expenses Remain Stable,201560,79086.0,48147,127233.0,74327.0,36.88,0.03,Low Risk
U885,2024,12,873976.0,Salary Increases & Fixed Expenses Remain Stable,201560,79086.0,58086,137172.0,64388.0,31.94,-0.04,Low Risk
U886,2024,1,249271.0,Stable Salary & Stable Fixed Expenses,215330,73707.0,84910,158617.0,56713.0,26.34,-0.01,Low Risk
U886,2024,2,305984.0,Stable Salary & Stable Fixed Expenses,215330,73707.0,74592,148299.0,67031.0,31.13,-0.03,Low Risk
U886,2024,3,373015.0,Stable Salary & Stable Fixed Expenses,215330,73707.0,94152,167859.0,47471.0,22.05,0.04,Medium Risk
U886,2024,4,420486.0,Stable Salary & Stable Fixed Expenses,215330,73707.0,97456,171163.0,44167.0,20.51,0.05,Medium Risk
U886,2024,5,464653.0,Stable Salary & Stable Fixed Expenses,215330,73707.0,81934,155641.0,59689.0,27.72,-0.04,Low Risk
U886,2024,6,524342.0,Stable Salary & Stable Fixed Expenses,215330,73707.0,82193,155900.0,59430.0,27.6,-0.02,Low Risk
U886,2024,7,583772.0,Stable Salary & Stable Fixed Expenses,215330,73707.0,72561,146268.0,69062.0,32.07,0.02,Low Risk
U886,2024,8,652834.0,Stable Salary & Stable Fixed Expenses,215330,73707.0,102637,176344.0,38986.0,18.11,-0.04,Medium Risk
U886,2024,9,691820.0,Stable Salary & Stable Fixed Expenses,215330,73707.0,111140,184847.0,30483.0,14.16,0.04,High Risk
U886,2024,10,722303.0,Stable Salary & Stable Fixed Expenses,215330,73707.0,70115,143822.0,71508.0,33.21,0.02,Low Risk
U886,2024,11,793811.0,Stable Salary & Stable Fixed Expenses,215330,73707.0,100348,174055.0,41275.0,19.17,0.03,Medium Risk
U886,2024,12,835086.0,Stable Salary & Stable Fixed Expenses,215330,73707.0,89711,163418.0,51912.0,24.11,-0.02,Medium Risk
U887,2024,1,149928.0,Salary Increases & Fixed Expenses Remain Stable,137388,76850.0,47051,123901.0,13487.0,9.82,0.02,High Risk
U887,2024,2,163415.0,Salary Increases & Fixed Expenses Remain Stable,137388,76850.0,60622,137472.0,-84.0,-0.06,-0.03,High Risk
U887,2024,3,163331.0,Salary Increases & Fixed Expenses Remain Stable,137388,76850.0,61612,138462.0,-1074.0,-0.78,-0.03,High Risk
U887,2024,4,162257.0,Salary Increases & Fixed Expenses Remain Stable,137388,76850.0,68487,145337.0,-7949.0,-5.79,0.04,High Risk
U887,2024,5,154308.0,Salary Increases & Fixed Expenses Remain Stable,157513,76850.0,56102,132952.0,24561.0,15.59,0.02,Medium Risk
U887,2024,6,178869.0,Salary Increases & Fixed Expenses Remain Stable,157513,76850.0,48347,125197.0,32316.0,20.52,-0.01,Medium Risk
U887,2024,7,211185.0,Salary Increases & Fixed Expenses Remain Stable,157513,76850.0,56371,133221.0,24292.0,15.42,-0.04,Medium Risk
U887,2024,8,235477.0,Salary Increases & Fixed Expenses Remain Stable,157513,76850.0,76550,153400.0,4113.0,2.61,0.01,High Risk
U887,2024,9,239590.0,Salary Increases & Fixed Expenses Remain Stable,157513,76850.0,62014,138864.0,18649.0,11.84,0.01,High Risk
U887,2024,10,258239.0,Salary Increases & Fixed Expenses Remain Stable,157513,76850.0,95675,172525.0,-15012.0,-9.53,0.02,High Risk
U887,2024,11,243227.0,Salary Increases & Fixed Expenses Remain Stable,157513,76850.0,82586,159436.0,-1923.0,-1.22,-0.03,High Risk
U887,2024,12,241304.0,Salary Increases & Fixed Expenses Remain Stable,157513,76850.0,63262,140112.0,17401.0,11.05,-0.03,High Risk
U888,2024,1,250000.0,Salary Increases & Fixed Expenses Increase,254966,93753.0,67170,160923.0,94043.0,36.88,0.01,Low Risk
U888,2024,2,344043.0,Salary Increases & Fixed Expenses Increase,254966,93753.0,61177,154930.0,100036.0,39.24,-0.05,Low Risk
U888,2024,3,444079.0,Salary Increases & Fixed Expenses Increase,284852,93753.0,74647,168400.0,116452.0,40.88,0.04,Low Risk
U888,2024,4,560531.0,Salary Increases & Fixed Expenses Increase,284852,93753.0,76545,170298.0,114554.0,40.22,-0.05,Low Risk
U888,2024,5,675085.0,Salary Increases & Fixed Expenses Increase,284852,93753.0,63275,157028.0,127824.0,44.87,0.0,Low Risk
U888,2024,6,802909.0,Salary Increases & Fixed Expenses Increase,284852,93753.0,63623,157376.0,127476.0,44.75,0.04,Low Risk
U888,2024,7,930385.0,Salary Increases & Fixed Expenses Increase,284852,94627.0,84524,179151.0,105701.0,37.11,0.01,Low Risk
U888,2024,8,1036086.0,Salary Increases & Fixed Expenses Increase,284852,94627.0,57105,151732.0,133120.0,46.73,0.02,Low Risk
U888,2024,9,1169206.0,Salary Increases & Fixed Expenses Increase,284852,94627.0,73870,168497.0,116355.0,40.85,0.0,Low Risk
U888,2024,10,1285561.0,Salary Increases & Fixed Expenses Increase,284852,94627.0,77797,172424.0,112428.0,39.47,-0.05,Low Risk
U888,2024,11,1397989.0,Salary Increases & Fixed Expenses Increase,284852,96403.0,85016,181419.0,103433.0,36.31,-0.01,Low Risk
U888,2024,12,1501422.0,Salary Increases & Fixed Expenses Increase,284852,96403.0,63575,159978.0,124874.0,43.84,0.01,Low Risk
U889,2024,1,241149.0,Salary Increases & Fixed Expenses Increase,226855,107224.0,56497,163721.0,63134.0,27.83,-0.01,Low Risk
U889,2024,2,304283.0,Salary Increases & Fixed Expenses Increase,226855,107905.0,56645,164550.0,62305.0,27.46,0.01,Low Risk
U889,2024,3,366588.0,Salary Increases & Fixed Expenses Increase,226855,107905.0,63979,171884.0,54971.0,24.23,0.05,Medium Risk
U889,2024,4,421559.0,Salary Increases & Fixed Expenses Increase,236345,109656.0,62803,172459.0,63886.0,27.03,0.0,Low Risk
U889,2024,5,485445.0,Salary Increases & Fixed Expenses Increase,236345,110624.0,63528,174152.0,62193.0,26.31,-0.01,Low Risk
U889,2024,6,547638.0,Salary Increases & Fixed Expenses Increase,236345,110624.0,56320,166944.0,69401.0,29.36,0.01,Low Risk
U889,2024,7,617039.0,Salary Increases & Fixed Expenses Increase,236345,110624.0,53428,164052.0,72293.0,30.59,-0.05,Low Risk
U889,2024,8,689332.0,Salary Increases & Fixed Expenses Increase,236345,110624.0,69593,180217.0,56128.0,23.75,-0.02,Medium Risk
U889,2024,9,745460.0,Salary Increases & Fixed Expenses Increase,236345,110624.0,71435,182059.0,54286.0,22.97,-0.05,Medium Risk
U889,2024,10,799746.0,Salary Increases & Fixed Expenses Increase,236345,112062.0,80819,192881.0,43464.0,18.39,-0.02,Medium Risk
U889,2024,11,843210.0,Salary Increases & Fixed Expenses Increase,236345,112062.0,65121,177183.0,59162.0,25.03,-0.03,Low Risk
U889,2024,12,902372.0,Salary Increases & Fixed Expenses Increase,236345,112062.0,82513,194575.0,41770.0,17.67,-0.0,Medium Risk
U890,2024,1,211401.0,Salary Increases & Fixed Expenses Remain Stable,101225,78119.0,27773,105892.0,-4667.0,-4.61,0.04,High Risk
U890,2024,2,206734.0,Salary Increases & Fixed Expenses Remain Stable,101225,78119.0,29639,107758.0,-6533.0,-6.45,0.05,High Risk
U890,2024,3,200201.0,Salary Increases & Fixed Expenses Remain Stable,101225,78119.0,20611,98730.0,2495.0,2.46,0.03,High Risk
U890,2024,4,202696.0,Salary Increases & Fixed Expenses Remain Stable,101225,78119.0,27554,105673.0,-4448.0,-4.39,0.02,High Risk
U890,2024,5,198248.0,Salary Increases & Fixed Expenses Remain Stable,109819,78119.0,25819,103938.0,5881.0,5.36,-0.02,High Risk
U890,2024,6,204129.0,Salary Increases & Fixed Expenses Remain Stable,109819,78119.0,22776,100895.0,8924.0,8.13,-0.03,High Risk
U890,2024,7,213053.0,Salary Increases & Fixed Expenses Remain Stable,109819,78119.0,25577,103696.0,6123.0,5.58,0.03,High Risk
U890,2024,8,219176.0,Salary Increases & Fixed Expenses Remain Stable,109819,78119.0,25183,103302.0,6517.0,5.93,0.03,High Risk
U890,2024,9,225693.0,Salary Increases & Fixed Expenses Remain Stable,109819,78119.0,29055,107174.0,2645.0,2.41,0.01,High Risk
U890,2024,10,228338.0,Salary Increases & Fixed Expenses Remain Stable,109819,78119.0,22240,100359.0,9460.0,8.61,-0.01,High Risk
U890,2024,11,237798.0,Salary Increases & Fixed Expenses Remain Stable,109819,78119.0,31444,109563.0,256.0,0.23,-0.02,High Risk
U890,2024,12,238054.0,Salary Increases & Fixed Expenses Remain Stable,109819,78119.0,27202,105321.0,4498.0,4.1,-0.01,High Risk
U891,2024,1,94386.0,Stable Salary & Stable Fixed Expenses,72609,36450.0,19022,55472.0,17137.0,23.6,-0.03,Medium Risk
U891,2024,2,111523.0,Stable Salary & Stable Fixed Expenses,72609,36450.0,15976,52426.0,20183.0,27.8,-0.01,Low Risk
U891,2024,3,131706.0,Stable Salary & Stable Fixed Expenses,72609,36450.0,20126,56576.0,16033.0,22.08,-0.05,Medium Risk
U891,2024,4,147739.0,Stable Salary & Stable Fixed Expenses,72609,36450.0,20932,57382.0,15227.0,20.97,-0.0,Medium Risk
U891,2024,5,162966.0,Stable Salary & Stable Fixed Expenses,72609,36450.0,20800,57250.0,15359.0,21.15,-0.04,Medium Risk
U891,2024,6,178325.0,Stable Salary & Stable Fixed Expenses,72609,36450.0,15461,51911.0,20698.0,28.51,0.04,Low Risk
U891,2024,7,199023.0,Stable Salary & Stable Fixed Expenses,72609,36450.0,17009,53459.0,19150.0,26.37,0.04,Low Risk
U891,2024,8,218173.0,Stable Salary & Stable Fixed Expenses,72609,36450.0,19326,55776.0,16833.0,23.18,-0.0,Medium Risk
U891,2024,9,235006.0,Stable Salary & Stable Fixed Expenses,72609,36450.0,22409,58859.0,13750.0,18.94,-0.04,Medium Risk
U891,2024,10,248756.0,Stable Salary & Stable Fixed Expenses,72609,36450.0,18980,55430.0,17179.0,23.66,0.03,Medium Risk
U891,2024,11,265935.0,Stable Salary & Stable Fixed Expenses,72609,36450.0,16827,53277.0,19332.0,26.62,-0.01,Low Risk
U891,2024,12,285267.0,Stable Salary & Stable Fixed Expenses,72609,36450.0,16479,52929.0,19680.0,27.1,0.05,Low Risk
U892,2024,1,163806.0,Stable Salary & Stable Fixed Expenses,21178,16872.0,5382,22254.0,-1076.0,-5.08,-0.03,High Risk
U892,2024,2,162730.0,Stable Salary & Stable Fixed Expenses,21178,16872.0,6309,23181.0,-2003.0,-9.46,0.04,High Risk
U892,2024,3,160727.0,Stable Salary & Stable Fixed Expenses,21178,16872.0,5770,22642.0,-1464.0,-6.91,0.04,High Risk
U892,2024,4,159263.0,Stable Salary & Stable Fixed Expenses,21178,16872.0,6010,22882.0,-1704.0,-8.05,0.02,High Risk
U892,2024,5,157559.0,Stable Salary & Stable Fixed Expenses,21178,16872.0,5820,22692.0,-1514.0,-7.15,0.01,High Risk
U892,2024,6,156045.0,Stable Salary & Stable Fixed Expenses,21178,16872.0,4920,21792.0,-614.0,-2.9,-0.03,High Risk
U892,2024,7,155431.0,Stable Salary & Stable Fixed Expenses,21178,16872.0,4479,21351.0,-173.0,-0.82,0.02,High Risk
U892,2024,8,155258.0,Stable Salary & Stable Fixed Expenses,21178,16872.0,6239,23111.0,-1933.0,-9.13,0.03,High Risk
U892,2024,9,153325.0,Stable Salary & Stable Fixed Expenses,21178,16872.0,5988,22860.0,-1682.0,-7.94,0.02,High Risk
U892,2024,10,151643.0,Stable Salary & Stable Fixed Expenses,21178,16872.0,5673,22545.0,-1367.0,-6.45,-0.02,High Risk
U892,2024,11,150276.0,Stable Salary & Stable Fixed Expenses,21178,16872.0,6439,23311.0,-2133.0,-10.07,-0.03,High Risk
U892,2024,12,148143.0,Stable Salary & Stable Fixed Expenses,21178,16872.0,4653,21525.0,-347.0,-1.64,0.05,High Risk
U893,2024,1,210850.0,Stable Salary & Stable Fixed Expenses,155188,64714.0,54407,119121.0,36067.0,23.24,0.02,Medium Risk
U893,2024,2,246917.0,Stable Salary & Stable Fixed Expenses,155188,64714.0,70201,134915.0,20273.0,13.06,-0.0,High Risk
U893,2024,3,267190.0,Stable Salary & Stable Fixed Expenses,155188,64714.0,69397,134111.0,21077.0,13.58,0.01,High Risk
U893,2024,4,288267.0,Stable Salary & Stable Fixed Expenses,155188,64714.0,51214,115928.0,39260.0,25.3,-0.05,Low Risk
U893,2024,5,327527.0,Stable Salary & Stable Fixed Expenses,155188,64714.0,76317,141031.0,14157.0,9.12,0.03,High Risk
U893,2024,6,341684.0,Stable Salary & Stable Fixed Expenses,155188,64714.0,62472,127186.0,28002.0,18.04,0.04,Medium Risk
U893,2024,7,369686.0,Stable Salary & Stable Fixed Expenses,155188,64714.0,54131,118845.0,36343.0,23.42,-0.01,Medium Risk
U893,2024,8,406029.0,Stable Salary & Stable Fixed Expenses,155188,64714.0,49214,113928.0,41260.0,26.59,0.01,Low Risk
U893,2024,9,447289.0,Stable Salary & Stable Fixed Expenses,155188,64714.0,54226,118940.0,36248.0,23.36,-0.01,Medium Risk
U893,2024,10,483537.0,Stable Salary & Stable Fixed Expenses,155188,64714.0,70533,135247.0,19941.0,12.85,0.03,High Risk
U893,2024,11,503478.0,Stable Salary & Stable Fixed Expenses,155188,64714.0,62997,127711.0,27477.0,17.71,0.03,Medium Risk
U893,2024,12,530955.0,Stable Salary & Stable Fixed Expenses,155188,64714.0,51581,116295.0,38893.0,25.06,0.05,Low Risk
U894,2024,1,236692.0,Salary Increases & Fixed Expenses Increase,201724,115448.0,105242,220690.0,-18966.0,-9.4,-0.04,High Risk
U894,2024,2,217726.0,Salary Increases & Fixed Expenses Increase,201724,115448.0,133155,248603.0,-46879.0,-23.24,0.03,High Risk
U894,2024,3,170847.0,Salary Increases & Fixed Expenses Increase,214009,115448.0,132784,248232.0,-34223.0,-15.99,-0.03,High Risk
U894,2024,4,136624.0,Salary Increases & Fixed Expenses Increase,214009,116646.0,120916,237562.0,-23553.0,-11.01,0.02,High Risk
U894,2024,5,113071.0,Salary Increases & Fixed Expenses Increase,214009,116646.0,119022,235668.0,-21659.0,-10.12,-0.02,High Risk
U894,2024,6,91412.0,Salary Increases & Fixed Expenses Increase,214009,116646.0,114566,231212.0,-17203.0,-8.04,0.04,High Risk
U894,2024,7,74209.0,Salary Increases & Fixed Expenses Increase,214009,116646.0,110343,226989.0,-12980.0,-6.07,0.02,High Risk
U894,2024,8,61229.0,Salary Increases & Fixed Expenses Increase,214009,117368.0,118971,236339.0,-22330.0,-10.43,-0.05,High Risk
U894,2024,9,38899.0,Salary Increases & Fixed Expenses Increase,214009,117368.0,132557,249925.0,-35916.0,-16.78,0.03,High Risk
U894,2024,10,2983.0,Salary Increases & Fixed Expenses Increase,214009,117368.0,130163,247531.0,-33522.0,-15.66,0.04,High Risk
U894,2024,11,-30539.0,Salary Increases & Fixed Expenses Increase,214009,117368.0,153831,271199.0,-57190.0,-26.72,0.02,High Risk
U894,2024,12,-87729.0,Salary Increases & Fixed Expenses Increase,214009,117368.0,121969,239337.0,-25328.0,-11.84,0.03,High Risk
U895,2024,1,250000.0,Salary Increases & Fixed Expenses Remain Stable,251815,104852.0,72067,176919.0,74896.0,29.74,-0.04,Low Risk
U895,2024,2,324896.0,Salary Increases & Fixed Expenses Remain Stable,251815,104852.0,52842,157694.0,94121.0,37.38,-0.04,Low Risk
U895,2024,3,419017.0,Salary Increases & Fixed Expenses Remain Stable,274235,104852.0,70149,175001.0,99234.0,36.19,-0.04,Low Risk
U895,2024,4,518251.0,Salary Increases & Fixed Expenses Remain Stable,274235,104852.0,60107,164959.0,109276.0,39.85,0.03,Low Risk
U895,2024,5,627527.0,Salary Increases & Fixed Expenses Remain Stable,274235,104852.0,68041,172893.0,101342.0,36.95,-0.03,Low Risk
U895,2024,6,728869.0,Salary Increases & Fixed Expenses Remain Stable,274235,104852.0,60868,165720.0,108515.0,39.57,-0.01,Low Risk
U895,2024,7,837384.0,Salary Increases & Fixed Expenses Remain Stable,274235,104852.0,78621,183473.0,90762.0,33.1,-0.01,Low Risk
U895,2024,8,928146.0,Salary Increases & Fixed Expenses Remain Stable,274235,104852.0,66202,171054.0,103181.0,37.63,0.03,Low Risk
U895,2024,9,1031327.0,Salary Increases & Fixed Expenses Remain Stable,274235,104852.0,80820,185672.0,88563.0,32.29,-0.03,Low Risk
U895,2024,10,1119890.0,Salary Increases & Fixed Expenses Remain Stable,274235,104852.0,60067,164919.0,109316.0,39.86,0.02,Low Risk
U895,2024,11,1229206.0,Salary Increases & Fixed Expenses Remain Stable,274235,104852.0,73074,177926.0,96309.0,35.12,-0.01,Low Risk
U895,2024,12,1325515.0,Salary Increases & Fixed Expenses Remain Stable,274235,104852.0,73844,178696.0,95539.0,34.84,-0.04,Low Risk
U896,2024,1,250000.0,Salary Increases & Fixed Expenses Remain Stable,263466,75968.0,95503,171471.0,91995.0,34.92,-0.01,Low Risk
U896,2024,2,341995.0,Salary Increases & Fixed Expenses Remain Stable,263466,75968.0,121121,197089.0,66377.0,25.19,-0.04,Low Risk
U896,2024,3,408372.0,Salary Increases & Fixed Expenses Remain Stable,263466,75968.0,113126,189094.0,74372.0,28.23,0.01,Low Risk
U896,2024,4,482744.0,Salary Increases & Fixed Expenses Remain Stable,263466,75968.0,93196,169164.0,94302.0,35.79,-0.01,Low Risk
U896,2024,5,577046.0,Salary Increases & Fixed Expenses Remain Stable,282688,75968.0,116642,192610.0,90078.0,31.86,0.05,Low Risk
U896,2024,6,667124.0,Salary Increases & Fixed Expenses Remain Stable,282688,75968.0,132606,208574.0,74114.0,26.22,-0.04,Low Risk
U896,2024,7,741238.0,Salary Increases & Fixed Expenses Remain Stable,282688,75968.0,118521,194489.0,88199.0,31.2,0.04,Low Risk
U896,2024,8,829437.0,Salary Increases & Fixed Expenses Remain Stable,282688,75968.0,128040,204008.0,78680.0,27.83,-0.05,Low Risk
U896,2024,9,908117.0,Salary Increases & Fixed Expenses Remain Stable,282688,75968.0,88041,164009.0,118679.0,41.98,0.01,Low Risk
U896,2024,10,1026796.0,Salary Increases & Fixed Expenses Remain Stable,282688,75968.0,96865,172833.0,109855.0,38.86,-0.03,Low Risk
U896,2024,11,1136651.0,Salary Increases & Fixed Expenses Remain Stable,282688,75968.0,123307,199275.0,83413.0,29.51,-0.03,Low Risk
U896,2024,12,1220064.0,Salary Increases & Fixed Expenses Remain Stable,282688,75968.0,118360,194328.0,88360.0,31.26,0.01,Low Risk
U897,2024,1,141204.0,Salary Increases & Fixed Expenses Increase,134849,63285.0,35281,98566.0,36283.0,26.91,-0.01,Low Risk
U897,2024,2,177487.0,Salary Increases & Fixed Expenses Increase,134849,63285.0,33634,96919.0,37930.0,28.13,-0.03,Low Risk
U897,2024,3,215417.0,Salary Increases & Fixed Expenses Increase,134849,63285.0,36991,100276.0,34573.0,25.64,0.04,Low Risk
U897,2024,4,249990.0,Salary Increases & Fixed Expenses Increase,134849,63285.0,30258,93543.0,41306.0,30.63,-0.03,Low Risk
U897,2024,5,291296.0,Salary Increases & Fixed Expenses Increase,134849,63285.0,31384,94669.0,40180.0,29.8,-0.01,Low Risk
U897,2024,6,331476.0,Salary Increases & Fixed Expenses Increase,134849,65058.0,27623,92681.0,42168.0,31.27,-0.02,Low Risk
U897,2024,7,373644.0,Salary Increases & Fixed Expenses Increase,134849,65058.0,37869,102927.0,31922.0,23.67,0.03,Medium Risk
U897,2024,8,405566.0,Salary Increases & Fixed Expenses Increase,158143,65058.0,31898,96956.0,61187.0,38.69,-0.04,Low Risk
U897,2024,9,466753.0,Salary Increases & Fixed Expenses Increase,158143,65058.0,39221,104279.0,53864.0,34.06,0.01,Low Risk
U897,2024,10,520617.0,Salary Increases & Fixed Expenses Increase,158143,65058.0,46525,111583.0,46560.0,29.44,-0.01,Low Risk
U897,2024,11,567177.0,Salary Increases & Fixed Expenses Increase,158143,65058.0,39402,104460.0,53683.0,33.95,-0.02,Low Risk
U897,2024,12,620860.0,Salary Increases & Fixed Expenses Increase,158143,65058.0,44696,109754.0,48389.0,30.6,-0.0,Low Risk
U898,2024,1,245163.0,Salary Increases & Fixed Expenses Remain Stable,167894,54955.0,43202,98157.0,69737.0,41.54,-0.04,Low Risk
U898,2024,2,314900.0,Salary Increases & Fixed Expenses Remain Stable,167894,54955.0,34466,89421.0,78473.0,46.74,-0.01,Low Risk
U898,2024,3,393373.0,Salary Increases & Fixed Expenses Remain Stable,167894,54955.0,47699,102654.0,65240.0,38.86,0.02,Low Risk
U898,2024,4,458613.0,Salary Increases & Fixed Expenses Remain Stable,189693,54955.0,41545,96500.0,93193.0,49.13,-0.02,Low Risk
U898,2024,5,551806.0,Salary Increases & Fixed Expenses Remain Stable,189693,54955.0,39795,94750.0,94943.0,50.05,-0.02,Low Risk
U898,2024,6,646749.0,Salary Increases & Fixed Expenses Remain Stable,189693,54955.0,48881,103836.0,85857.0,45.26,-0.01,Low Risk
U898,2024,7,732606.0,Salary Increases & Fixed Expenses Remain Stable,189693,54955.0,46790,101745.0,87948.0,46.36,-0.01,Low Risk
U898,2024,8,820554.0,Salary Increases & Fixed Expenses Remain Stable,189693,54955.0,46374,101329.0,88364.0,46.58,-0.05,Low Risk
U898,2024,9,908918.0,Salary Increases & Fixed Expenses Remain Stable,189693,54955.0,50836,105791.0,83902.0,44.23,-0.03,Low Risk
U898,2024,10,992820.0,Salary Increases & Fixed Expenses Remain Stable,189693,54955.0,69594,124549.0,65144.0,34.34,0.03,Low Risk
U898,2024,11,1057964.0,Salary Increases & Fixed Expenses Remain Stable,189693,54955.0,46523,101478.0,88215.0,46.5,0.04,Low Risk
U898,2024,12,1146179.0,Salary Increases & Fixed Expenses Remain Stable,189693,54955.0,51526,106481.0,83212.0,43.87,0.02,Low Risk
U899,2024,1,183248.0,Salary Increases & Fixed Expenses Remain Stable,125310,52462.0,25431,77893.0,47417.0,37.84,0.0,Low Risk
U899,2024,2,230665.0,Salary Increases & Fixed Expenses Remain Stable,125310,52462.0,35025,87487.0,37823.0,30.18,0.04,Low Risk
U899,2024,3,268488.0,Salary Increases & Fixed Expenses Remain Stable,125310,52462.0,37144,89606.0,35704.0,28.49,-0.04,Low Risk
U899,2024,4,304192.0,Salary Increases & Fixed Expenses Remain Stable,125310,52462.0,37084,89546.0,35764.0,28.54,0.03,Low Risk
U899,2024,5,339956.0,Salary Increases & Fixed Expenses Remain Stable,125310,52462.0,30266,82728.0,42582.0,33.98,-0.02,Low Risk
U899,2024,6,382538.0,Salary Increases & Fixed Expenses Remain Stable,143845,52462.0,31135,83597.0,60248.0,41.88,-0.01,Low Risk
U899,2024,7,442786.0,Salary Increases & Fixed Expenses Remain Stable,143845,52462.0,34393,86855.0,56990.0,39.62,0.01,Low Risk
U899,2024,8,499776.0,Salary Increases & Fixed Expenses Remain Stable,143845,52462.0,33008,85470.0,58375.0,40.58,0.03,Low Risk
U899,2024,9,558151.0,Salary Increases & Fixed Expenses Remain Stable,143845,52462.0,39363,91825.0,52020.0,36.16,0.02,Low Risk
U899,2024,10,610171.0,Salary Increases & Fixed Expenses Remain Stable,143845,52462.0,29392,81854.0,61991.0,43.1,0.01,Low Risk
U899,2024,11,672162.0,Salary Increases & Fixed Expenses Remain Stable,143845,52462.0,40915,93377.0,50468.0,35.08,0.04,Low Risk
U899,2024,12,722630.0,Salary Increases & Fixed Expenses Remain Stable,143845,52462.0,36385,88847.0,54998.0,38.23,-0.04,Low Risk
U900,2024,1,214985.0,Salary Increases & Fixed Expenses Remain Stable,77431,39181.0,34244,73425.0,4006.0,5.17,-0.04,High Risk
U900,2024,2,218991.0,Salary Increases & Fixed Expenses Remain Stable,77431,39181.0,24493,63674.0,13757.0,17.77,-0.01,Medium Risk
U900,2024,3,232748.0,Salary Increases & Fixed Expenses Remain Stable,77431,39181.0,35052,74233.0,3198.0,4.13,0.02,High Risk
U900,2024,4,235946.0,Salary Increases & Fixed Expenses Remain Stable,77431,39181.0,36953,76134.0,1297.0,1.68,0.01,High Risk
U900,2024,5,237243.0,Salary Increases & Fixed Expenses Remain Stable,77431,39181.0,23839,63020.0,14411.0,18.61,-0.04,Medium Risk
U900,2024,6,251654.0,Salary Increases & Fixed Expenses Remain Stable,77431,39181.0,29531,68712.0,8719.0,11.26,0.02,High Risk
U900,2024,7,260373.0,Salary Increases & Fixed Expenses Remain Stable,102448,39181.0,41899,81080.0,21368.0,20.86,-0.03,Medium Risk
U900,2024,8,281741.0,Salary Increases & Fixed Expenses Remain Stable,102448,39181.0,33017,72198.0,30250.0,29.53,-0.05,Low Risk
U900,2024,9,311991.0,Salary Increases & Fixed Expenses Remain Stable,102448,39181.0,45960,85141.0,17307.0,16.89,-0.01,Medium Risk
U900,2024,10,329298.0,Salary Increases & Fixed Expenses Remain Stable,102448,39181.0,37019,76200.0,26248.0,25.62,-0.05,Low Risk
U900,2024,11,355546.0,Salary Increases & Fixed Expenses Remain Stable,102448,39181.0,36404,75585.0,26863.0,26.22,0.03,Low Risk
U900,2024,12,382409.0,Salary Increases & Fixed Expenses Remain Stable,102448,39181.0,43495,82676.0,19772.0,19.3,-0.0,Medium Risk
U901,2024,1,250000.0,Stable Salary & Stable Fixed Expenses,294110,98250.0,99984,198234.0,95876.0,32.6,0.01,Low Risk
U901,2024,2,345876.0,Stable Salary & Stable Fixed Expenses,294110,98250.0,143768,242018.0,52092.0,17.71,-0.01,Medium Risk
U901,2024,3,397968.0,Stable Salary & Stable Fixed Expenses,294110,98250.0,161595,259845.0,34265.0,11.65,-0.01,High Risk
U901,2024,4,432233.0,Stable Salary & Stable Fixed Expenses,294110,98250.0,143410,241660.0,52450.0,17.83,0.01,Medium Risk
U901,2024,5,484683.0,Stable Salary & Stable Fixed Expenses,294110,98250.0,105499,203749.0,90361.0,30.72,-0.01,Low Risk
U901,2024,6,575044.0,Stable Salary & Stable Fixed Expenses,294110,98250.0,122692,220942.0,73168.0,24.88,0.02,Medium Risk
U901,2024,7,648212.0,Stable Salary & Stable Fixed Expenses,294110,98250.0,106526,204776.0,89334.0,30.37,0.02,Low Risk
U901,2024,8,737546.0,Stable Salary & Stable Fixed Expenses,294110,98250.0,131445,229695.0,64415.0,21.9,-0.05,Medium Risk
U901,2024,9,801961.0,Stable Salary & Stable Fixed Expenses,294110,98250.0,135120,233370.0,60740.0,20.65,0.05,Medium Risk
U901,2024,10,862701.0,Stable Salary & Stable Fixed Expenses,294110,98250.0,156096,254346.0,39764.0,13.52,-0.02,High Risk
U901,2024,11,902465.0,Stable Salary & Stable Fixed Expenses,294110,98250.0,124455,222705.0,71405.0,24.28,-0.01,Medium Risk
U901,2024,12,973870.0,Stable Salary & Stable Fixed Expenses,294110,98250.0,116174,214424.0,79686.0,27.09,-0.0,Low Risk
U902,2024,1,232982.0,Stable Salary & Stable Fixed Expenses,196777,68291.0,59025,127316.0,69461.0,35.3,0.03,Low Risk
U902,2024,2,302443.0,Stable Salary & Stable Fixed Expenses,196777,68291.0,53078,121369.0,75408.0,38.32,-0.02,Low Risk
U902,2024,3,377851.0,Stable Salary & Stable Fixed Expenses,196777,68291.0,75550,143841.0,52936.0,26.9,-0.03,Low Risk
U902,2024,4,430787.0,Stable Salary & Stable Fixed Expenses,196777,68291.0,54898,123189.0,73588.0,37.4,0.01,Low Risk
U902,2024,5,504375.0,Stable Salary & Stable Fixed Expenses,196777,68291.0,48255,116546.0,80231.0,40.77,0.02,Low Risk
U902,2024,6,584606.0,Stable Salary & Stable Fixed Expenses,196777,68291.0,40048,108339.0,88438.0,44.94,0.01,Low Risk
U902,2024,7,673044.0,Stable Salary & Stable Fixed Expenses,196777,68291.0,57758,126049.0,70728.0,35.94,0.0,Low Risk
U902,2024,8,743772.0,Stable Salary & Stable Fixed Expenses,196777,68291.0,49108,117399.0,79378.0,40.34,-0.01,Low Risk
U902,2024,9,823150.0,Stable Salary & Stable Fixed Expenses,196777,68291.0,49187,117478.0,79299.0,40.3,0.02,Low Risk
U902,2024,10,902449.0,Stable Salary & Stable Fixed Expenses,196777,68291.0,66827,135118.0,61659.0,31.33,-0.03,Low Risk
U902,2024,11,964108.0,Stable Salary & Stable Fixed Expenses,196777,68291.0,48657,116948.0,79829.0,40.57,-0.03,Low Risk
U902,2024,12,1043937.0,Stable Salary & Stable Fixed Expenses,196777,68291.0,68689,136980.0,59797.0,30.39,0.04,Low Risk
U903,2024,1,245035.0,Salary Increases & Fixed Expenses Increase,130955,56306.0,27128,83434.0,47521.0,36.29,-0.01,Low Risk
U903,2024,2,292556.0,Salary Increases & Fixed Expenses Increase,130955,56306.0,35528,91834.0,39121.0,29.87,0.02,Low Risk
U903,2024,3,331677.0,Salary Increases & Fixed Expenses Increase,130955,56306.0,34908,91214.0,39741.0,30.35,0.01,Low Risk
U903,2024,4,371418.0,Salary Increases & Fixed Expenses Increase,151153,56306.0,38961,95267.0,55886.0,36.97,-0.04,Low Risk
U903,2024,5,427304.0,Salary Increases & Fixed Expenses Increase,151153,57697.0,43617,101314.0,49839.0,32.97,0.02,Low Risk
U903,2024,6,477143.0,Salary Increases & Fixed Expenses Increase,151153,57697.0,30623,88320.0,62833.0,41.57,-0.0,Low Risk
U903,2024,7,539976.0,Salary Increases & Fixed Expenses Increase,151153,57697.0,36858,94555.0,56598.0,37.44,-0.01,Low Risk
U903,2024,8,596574.0,Salary Increases & Fixed Expenses Increase,151153,57697.0,43485,101182.0,49971.0,33.06,-0.04,Low Risk
U903,2024,9,646545.0,Salary Increases & Fixed Expenses Increase,151153,57697.0,38603,96300.0,54853.0,36.29,-0.03,Low Risk
U903,2024,10,701398.0,Salary Increases & Fixed Expenses Increase,151153,57697.0,38097,95794.0,55359.0,36.62,-0.05,Low Risk
U903,2024,11,756757.0,Salary Increases & Fixed Expenses Increase,151153,57697.0,34823,92520.0,58633.0,38.79,0.03,Low Risk
U903,2024,12,815390.0,Salary Increases & Fixed Expenses Increase,151153,57697.0,33912,91609.0,59544.0,39.39,0.01,Low Risk
U904,2024,1,92581.0,Stable Salary & Stable Fixed Expenses,89090,23570.0,36700,60270.0,28820.0,32.35,0.05,Low Risk
U904,2024,2,121401.0,Stable Salary & Stable Fixed Expenses,89090,23570.0,29975,53545.0,35545.0,39.9,0.04,Low Risk
U904,2024,3,156946.0,Stable Salary & Stable Fixed Expenses,89090,23570.0,48378,71948.0,17142.0,19.24,0.01,Medium Risk
U904,2024,4,174088.0,Stable Salary & Stable Fixed Expenses,89090,23570.0,28723,52293.0,36797.0,41.3,0.02,Low Risk
U904,2024,5,210885.0,Stable Salary & Stable Fixed Expenses,89090,23570.0,38031,61601.0,27489.0,30.86,-0.05,Low Risk
U904,2024,6,238374.0,Stable Salary & Stable Fixed Expenses,89090,23570.0,36510,60080.0,29010.0,32.56,-0.03,Low Risk
U904,2024,7,267384.0,Stable Salary & Stable Fixed Expenses,89090,23570.0,33175,56745.0,32345.0,36.31,-0.02,Low Risk
U904,2024,8,299729.0,Stable Salary & Stable Fixed Expenses,89090,23570.0,38269,61839.0,27251.0,30.59,-0.05,Low Risk
U904,2024,9,326980.0,Stable Salary & Stable Fixed Expenses,89090,23570.0,31218,54788.0,34302.0,38.5,-0.05,Low Risk
U904,2024,10,361282.0,Stable Salary & Stable Fixed Expenses,89090,23570.0,37580,61150.0,27940.0,31.36,-0.02,Low Risk
U904,2024,11,389222.0,Stable Salary & Stable Fixed Expenses,89090,23570.0,44178,67748.0,21342.0,23.96,-0.01,Medium Risk
U904,2024,12,410564.0,Stable Salary & Stable Fixed Expenses,89090,23570.0,40751,64321.0,24769.0,27.8,-0.03,Low Risk
U905,2024,1,239701.0,Salary Increases & Fixed Expenses Remain Stable,223314,74035.0,61115,135150.0,88164.0,39.48,0.04,Low Risk
U905,2024,2,327865.0,Salary Increases & Fixed Expenses Remain Stable,223314,74035.0,47900,121935.0,101379.0,45.4,0.01,Low Risk
U905,2024,3,429244.0,Salary Increases & Fixed Expenses Remain Stable,223314,74035.0,83821,157856.0,65458.0,29.31,0.03,Low Risk
U905,2024,4,494702.0,Salary Increases & Fixed Expenses Remain Stable,243918,74035.0,49080,123115.0,120803.0,49.53,0.05,Low Risk
U905,2024,5,615505.0,Salary Increases & Fixed Expenses Remain Stable,243918,74035.0,52224,126259.0,117659.0,48.24,0.0,Low Risk
U905,2024,6,733164.0,Salary Increases & Fixed Expenses Remain Stable,243918,74035.0,63651,137686.0,106232.0,43.55,-0.04,Low Risk
U905,2024,7,839396.0,Salary Increases & Fixed Expenses Remain Stable,243918,74035.0,73159,147194.0,96724.0,39.65,0.02,Low Risk
U905,2024,8,936120.0,Salary Increases & Fixed Expenses Remain Stable,243918,74035.0,49659,123694.0,120224.0,49.29,-0.05,Low Risk
U905,2024,9,1056344.0,Salary Increases & Fixed Expenses Remain Stable,243918,74035.0,74439,148474.0,95444.0,39.13,0.02,Low Risk
U905,2024,10,1151788.0,Salary Increases & Fixed Expenses Remain Stable,243918,74035.0,91831,165866.0,78052.0,32.0,0.02,Low Risk
U905,2024,11,1229840.0,Salary Increases & Fixed Expenses Remain Stable,243918,74035.0,71737,145772.0,98146.0,40.24,0.0,Low Risk
U905,2024,12,1327986.0,Salary Increases & Fixed Expenses Remain Stable,243918,74035.0,70490,144525.0,99393.0,40.75,0.05,Low Risk
U906,2024,1,202825.0,Stable Salary & Stable Fixed Expenses,89134,30287.0,58498,88785.0,349.0,0.39,0.03,High Risk
U906,2024,2,203174.0,Stable Salary & Stable Fixed Expenses,89134,30287.0,61270,91557.0,-2423.0,-2.72,0.01,High Risk
U906,2024,3,200751.0,Stable Salary & Stable Fixed Expenses,89134,30287.0,59753,90040.0,-906.0,-1.02,0.03,High Risk
U906,2024,4,199845.0,Stable Salary & Stable Fixed Expenses,89134,30287.0,56344,86631.0,2503.0,2.81,0.01,High Risk
U906,2024,5,202348.0,Stable Salary & Stable Fixed Expenses,89134,30287.0,57984,88271.0,863.0,0.97,-0.01,High Risk
U906,2024,6,203211.0,Stable Salary & Stable Fixed Expenses,89134,30287.0,58150,88437.0,697.0,0.78,-0.0,High Risk
U906,2024,7,203908.0,Stable Salary & Stable Fixed Expenses,89134,30287.0,56907,87194.0,1940.0,2.18,-0.01,High Risk
U906,2024,8,205848.0,Stable Salary & Stable Fixed Expenses,89134,30287.0,58777,89064.0,70.0,0.08,-0.02,High Risk
U906,2024,9,205918.0,Stable Salary & Stable Fixed Expenses,89134,30287.0,51893,82180.0,6954.0,7.8,0.02,High Risk
U906,2024,10,212872.0,Stable Salary & Stable Fixed Expenses,89134,30287.0,72237,102524.0,-13390.0,-15.02,-0.0,High Risk
U906,2024,11,199482.0,Stable Salary & Stable Fixed Expenses,89134,30287.0,68287,98574.0,-9440.0,-10.59,0.04,High Risk
U906,2024,12,190042.0,Stable Salary & Stable Fixed Expenses,89134,30287.0,70765,101052.0,-11918.0,-13.37,0.04,High Risk
U907,2024,1,194712.0,Stable Salary & Increasing Fixed Expenses,187508,74529.0,49920,124449.0,63059.0,33.63,-0.04,Low Risk
U907,2024,2,257771.0,Stable Salary & Increasing Fixed Expenses,187508,74529.0,44026,118555.0,68953.0,36.77,-0.0,Low Risk
U907,2024,3,326724.0,Stable Salary & Increasing Fixed Expenses,187508,74529.0,41601,116130.0,71378.0,38.07,-0.04,Low Risk
U907,2024,4,398102.0,Stable Salary & Increasing Fixed Expenses,187508,74529.0,43344,117873.0,69635.0,37.14,-0.01,Low Risk
U907,2024,5,467737.0,Stable Salary & Increasing Fixed Expenses,187508,74529.0,50371,124900.0,62608.0,33.39,-0.02,Low Risk
U907,2024,6,530345.0,Stable Salary & Increasing Fixed Expenses,187508,74529.0,44156,118685.0,68823.0,36.7,-0.02,Low Risk
U907,2024,7,599168.0,Stable Salary & Increasing Fixed Expenses,187508,75710.0,49347,125057.0,62451.0,33.31,0.02,Low Risk
U907,2024,8,661619.0,Stable Salary & Increasing Fixed Expenses,187508,75710.0,55788,131498.0,56010.0,29.87,-0.0,Low Risk
U907,2024,9,717629.0,Stable Salary & Increasing Fixed Expenses,187508,75710.0,41706,117416.0,70092.0,37.38,-0.03,Low Risk
U907,2024,10,787721.0,Stable Salary & Increasing Fixed Expenses,187508,75710.0,42468,118178.0,69330.0,36.97,0.01,Low Risk
U907,2024,11,857051.0,Stable Salary & Increasing Fixed Expenses,187508,75710.0,52066,127776.0,59732.0,31.86,0.04,Low Risk
U907,2024,12,916783.0,Stable Salary & Increasing Fixed Expenses,187508,75710.0,51942,127652.0,59856.0,31.92,-0.03,Low Risk
U908,2024,1,250000.0,Salary Increases & Fixed Expenses Remain Stable,263823,63458.0,130255,193713.0,70110.0,26.57,-0.02,Low Risk
U908,2024,2,320110.0,Salary Increases & Fixed Expenses Remain Stable,263823,63458.0,110164,173622.0,90201.0,34.19,0.0,Low Risk
U908,2024,3,410311.0,Salary Increases & Fixed Expenses Remain Stable,275365,63458.0,116988,180446.0,94919.0,34.47,0.0,Low Risk
U908,2024,4,505230.0,Salary Increases & Fixed Expenses Remain Stable,275365,63458.0,126701,190159.0,85206.0,30.94,0.05,Low Risk
U908,2024,5,590436.0,Salary Increases & Fixed Expenses Remain Stable,275365,63458.0,101154,164612.0,110753.0,40.22,0.01,Low Risk
U908,2024,6,701189.0,Salary Increases & Fixed Expenses Remain Stable,275365,63458.0,106717,170175.0,105190.0,38.2,-0.01,Low Risk
U908,2024,7,806379.0,Salary Increases & Fixed Expenses Remain Stable,275365,63458.0,120103,183561.0,91804.0,33.34,0.02,Low Risk
U908,2024,8,898183.0,Salary Increases & Fixed Expenses Remain Stable,275365,63458.0,107101,170559.0,104806.0,38.06,-0.02,Low Risk
U908,2024,9,1002989.0,Salary Increases & Fixed Expenses Remain Stable,275365,63458.0,137427,200885.0,74480.0,27.05,0.02,Low Risk
U908,2024,10,1077469.0,Salary Increases & Fixed Expenses Remain Stable,275365,63458.0,108604,172062.0,103303.0,37.51,-0.04,Low Risk
U908,2024,11,1180772.0,Salary Increases & Fixed Expenses Remain Stable,275365,63458.0,105560,169018.0,106347.0,38.62,-0.03,Low Risk
U908,2024,12,1287119.0,Salary Increases & Fixed Expenses Remain Stable,275365,63458.0,131994,195452.0,79913.0,29.02,-0.04,Low Risk
U909,2024,1,208066.0,Stable Salary & Increasing Fixed Expenses,113181,63516.0,26908,90424.0,22757.0,20.11,0.03,Medium Risk
U909,2024,2,230823.0,Stable Salary & Increasing Fixed Expenses,113181,63516.0,32004,95520.0,17661.0,15.6,-0.04,Medium Risk
U909,2024,3,248484.0,Stable Salary & Increasing Fixed Expenses,113181,63516.0,24319,87835.0,25346.0,22.39,0.04,Medium Risk
U909,2024,4,273830.0,Stable Salary & Increasing Fixed Expenses,113181,63516.0,24148,87664.0,25517.0,22.55,0.03,Medium Risk
U909,2024,5,299347.0,Stable Salary & Increasing Fixed Expenses,113181,63516.0,33080,96596.0,16585.0,14.65,-0.02,High Risk
U909,2024,6,315932.0,Stable Salary & Increasing Fixed Expenses,113181,63516.0,30642,94158.0,19023.0,16.81,0.03,Medium Risk
U909,2024,7,334955.0,Stable Salary & Increasing Fixed Expenses,113181,65161.0,25467,90628.0,22553.0,19.93,0.0,Medium Risk
U909,2024,8,357508.0,Stable Salary & Increasing Fixed Expenses,113181,65161.0,32012,97173.0,16008.0,14.14,0.05,High Risk
U909,2024,9,373516.0,Stable Salary & Increasing Fixed Expenses,113181,65161.0,23812,88973.0,24208.0,21.39,0.01,Medium Risk
U909,2024,10,397724.0,Stable Salary & Increasing Fixed Expenses,113181,65161.0,25690,90851.0,22330.0,19.73,-0.04,Medium Risk
U909,2024,11,420054.0,Stable Salary & Increasing Fixed Expenses,113181,66572.0,26567,93139.0,20042.0,17.71,-0.0,Medium Risk
U909,2024,12,440096.0,Stable Salary & Increasing Fixed Expenses,113181,66572.0,23281,89853.0,23328.0,20.61,0.04,Medium Risk
U910,2024,1,102747.0,Stable Salary & Stable Fixed Expenses,33094,11843.0,7106,18949.0,14145.0,42.74,-0.01,Low Risk
U910,2024,2,116892.0,Stable Salary & Stable Fixed Expenses,33094,11843.0,8161,20004.0,13090.0,39.55,-0.04,Low Risk
U910,2024,3,129982.0,Stable Salary & Stable Fixed Expenses,33094,11843.0,8628,20471.0,12623.0,38.14,-0.04,Low Risk
U910,2024,4,142605.0,Stable Salary & Stable Fixed Expenses,33094,11843.0,9184,21027.0,12067.0,36.46,-0.0,Low Risk
U910,2024,5,154672.0,Stable Salary & Stable Fixed Expenses,33094,11843.0,9258,21101.0,11993.0,36.24,-0.05,Low Risk
U910,2024,6,166665.0,Stable Salary & Stable Fixed Expenses,33094,11843.0,7780,19623.0,13471.0,40.71,0.02,Low Risk
U910,2024,7,180136.0,Stable Salary & Stable Fixed Expenses,33094,11843.0,9598,21441.0,11653.0,35.21,0.04,Low Risk
U910,2024,8,191789.0,Stable Salary & Stable Fixed Expenses,33094,11843.0,7246,19089.0,14005.0,42.32,0.03,Low Risk
U910,2024,9,205794.0,Stable Salary & Stable Fixed Expenses,33094,11843.0,10676,22519.0,10575.0,31.95,-0.04,Low Risk
U910,2024,10,216369.0,Stable Salary & Stable Fixed Expenses,33094,11843.0,12425,24268.0,8826.0,26.67,0.04,Low Risk
U910,2024,11,225195.0,Stable Salary & Stable Fixed Expenses,33094,11843.0,9595,21438.0,11656.0,35.22,0.01,Low Risk
U910,2024,12,236851.0,Stable Salary & Stable Fixed Expenses,33094,11843.0,9779,21622.0,11472.0,34.66,-0.03,Low Risk
U911,2024,1,162247.0,Stable Salary & Stable Fixed Expenses,138813,62429.0,60927,123356.0,15457.0,11.14,0.04,High Risk
U911,2024,2,177704.0,Stable Salary & Stable Fixed Expenses,138813,62429.0,68615,131044.0,7769.0,5.6,0.03,High Risk
U911,2024,3,185473.0,Stable Salary & Stable Fixed Expenses,138813,62429.0,48177,110606.0,28207.0,20.32,-0.02,Medium Risk
U911,2024,4,213680.0,Stable Salary & Stable Fixed Expenses,138813,62429.0,56077,118506.0,20307.0,14.63,-0.02,High Risk
U911,2024,5,233987.0,Stable Salary & Stable Fixed Expenses,138813,62429.0,62778,125207.0,13606.0,9.8,0.05,High Risk
U911,2024,6,247593.0,Stable Salary & Stable Fixed Expenses,138813,62429.0,58281,120710.0,18103.0,13.04,0.02,High Risk
U911,2024,7,265696.0,Stable Salary & Stable Fixed Expenses,138813,62429.0,53134,115563.0,23250.0,16.75,0.05,Medium Risk
U911,2024,8,288946.0,Stable Salary & Stable Fixed Expenses,138813,62429.0,43541,105970.0,32843.0,23.66,0.02,Medium Risk
U911,2024,9,321789.0,Stable Salary & Stable Fixed Expenses,138813,62429.0,61484,123913.0,14900.0,10.73,0.01,High Risk
U911,2024,10,336689.0,Stable Salary & Stable Fixed Expenses,138813,62429.0,64068,126497.0,12316.0,8.87,0.04,High Risk
U911,2024,11,349005.0,Stable Salary & Stable Fixed Expenses,138813,62429.0,45465,107894.0,30919.0,22.27,-0.03,Medium Risk
U911,2024,12,379924.0,Stable Salary & Stable Fixed Expenses,138813,62429.0,57460,119889.0,18924.0,13.63,0.01,High Risk
U912,2024,1,221820.0,Salary Increases & Fixed Expenses Increase,205296,109204.0,47810,157014.0,48282.0,23.52,0.04,Medium Risk
U912,2024,2,270102.0,Salary Increases & Fixed Expenses Increase,205296,109204.0,41972,151176.0,54120.0,26.36,-0.01,Low Risk
U912,2024,3,324222.0,Salary Increases & Fixed Expenses Increase,205296,109204.0,53761,162965.0,42331.0,20.62,0.02,Medium Risk
U912,2024,4,366553.0,Salary Increases & Fixed Expenses Increase,205296,109204.0,54938,164142.0,41154.0,20.05,-0.03,Medium Risk
U912,2024,5,407707.0,Salary Increases & Fixed Expenses Increase,210460,110544.0,49749,160293.0,50167.0,23.84,0.03,Medium Risk
U912,2024,6,457874.0,Salary Increases & Fixed Expenses Increase,210460,110544.0,48022,158566.0,51894.0,24.66,-0.04,Medium Risk
U912,2024,7,509768.0,Salary Increases & Fixed Expenses Increase,210460,110544.0,48197,158741.0,51719.0,24.57,-0.05,Medium Risk
U912,2024,8,561487.0,Salary Increases & Fixed Expenses Increase,210460,110544.0,51022,161566.0,48894.0,23.23,-0.05,Medium Risk
U912,2024,9,610381.0,Salary Increases & Fixed Expenses Increase,210460,110544.0,57038,167582.0,42878.0,20.37,-0.05,Medium Risk
U912,2024,10,653259.0,Salary Increases & Fixed Expenses Increase,210460,110544.0,46316,156860.0,53600.0,25.47,0.04,Low Risk
U912,2024,11,706859.0,Salary Increases & Fixed Expenses Increase,210460,112025.0,55302,167327.0,43133.0,20.49,-0.05,Medium Risk
U912,2024,12,749992.0,Salary Increases & Fixed Expenses Increase,210460,112025.0,58703,170728.0,39732.0,18.88,-0.03,Medium Risk
U913,2024,1,131692.0,Stable Salary & Increasing Fixed Expenses,54320,39510.0,11605,51115.0,3205.0,5.9,0.01,High Risk
U913,2024,2,134897.0,Stable Salary & Increasing Fixed Expenses,54320,39510.0,11120,50630.0,3690.0,6.79,0.01,High Risk
U913,2024,3,138587.0,Stable Salary & Increasing Fixed Expenses,54320,39510.0,16245,55755.0,-1435.0,-2.64,-0.0,High Risk
U913,2024,4,137152.0,Stable Salary & Increasing Fixed Expenses,54320,39510.0,14009,53519.0,801.0,1.47,-0.01,High Risk
U913,2024,5,137953.0,Stable Salary & Increasing Fixed Expenses,54320,39510.0,15983,55493.0,-1173.0,-2.16,0.04,High Risk
U913,2024,6,136780.0,Stable Salary & Increasing Fixed Expenses,54320,39510.0,16004,55514.0,-1194.0,-2.2,-0.04,High Risk
U913,2024,7,135586.0,Stable Salary & Increasing Fixed Expenses,54320,39510.0,12147,51657.0,2663.0,4.9,-0.04,High Risk
U913,2024,8,138249.0,Stable Salary & Increasing Fixed Expenses,54320,39510.0,14334,53844.0,476.0,0.88,-0.02,High Risk
U913,2024,9,138725.0,Stable Salary & Increasing Fixed Expenses,54320,39510.0,18365,57875.0,-3555.0,-6.54,-0.05,High Risk
U913,2024,10,135170.0,Stable Salary & Increasing Fixed Expenses,54320,39510.0,15804,55314.0,-994.0,-1.83,0.01,High Risk
U913,2024,11,134176.0,Stable Salary & Increasing Fixed Expenses,54320,39510.0,15892,55402.0,-1082.0,-1.99,-0.03,High Risk
U913,2024,12,133094.0,Stable Salary & Increasing Fixed Expenses,54320,39510.0,13561,53071.0,1249.0,2.3,-0.02,High Risk
U914,2024,1,208063.0,Salary Increases & Fixed Expenses Increase,111418,66706.0,32927,99633.0,11785.0,10.58,-0.01,High Risk
U914,2024,2,219848.0,Salary Increases & Fixed Expenses Increase,111418,66706.0,30549,97255.0,14163.0,12.71,-0.03,High Risk
U914,2024,3,234011.0,Salary Increases & Fixed Expenses Increase,111418,67807.0,29043,96850.0,14568.0,13.08,0.0,High Risk
U914,2024,4,248579.0,Salary Increases & Fixed Expenses Increase,111418,67807.0,29118,96925.0,14493.0,13.01,-0.05,High Risk
U914,2024,5,263072.0,Salary Increases & Fixed Expenses Increase,131985,67807.0,34552,102359.0,29626.0,22.45,0.03,Medium Risk
U914,2024,6,292698.0,Salary Increases & Fixed Expenses Increase,131985,67807.0,34352,102159.0,29826.0,22.6,-0.0,Medium Risk
U914,2024,7,322524.0,Salary Increases & Fixed Expenses Increase,131985,67807.0,33757,101564.0,30421.0,23.05,0.0,Medium Risk
U914,2024,8,352945.0,Salary Increases & Fixed Expenses Increase,131985,67807.0,29449,97256.0,34729.0,26.31,-0.02,Low Risk
U914,2024,9,387674.0,Salary Increases & Fixed Expenses Increase,131985,67807.0,33040,100847.0,31138.0,23.59,-0.04,Medium Risk
U914,2024,10,418812.0,Salary Increases & Fixed Expenses Increase,131985,67807.0,34599,102406.0,29579.0,22.41,-0.03,Medium Risk
U914,2024,11,448391.0,Salary Increases & Fixed Expenses Increase,131985,67807.0,33587,101394.0,30591.0,23.18,0.03,Medium Risk
U914,2024,12,478982.0,Salary Increases & Fixed Expenses Increase,131985,67807.0,37555,105362.0,26623.0,20.17,0.03,Medium Risk
U915,2024,1,140979.0,Salary Increases & Fixed Expenses Remain Stable,45228,13662.0,14531,28193.0,17035.0,37.66,-0.01,Low Risk
U915,2024,2,158014.0,Salary Increases & Fixed Expenses Remain Stable,45228,13662.0,18420,32082.0,13146.0,29.07,-0.04,Low Risk
U915,2024,3,171160.0,Salary Increases & Fixed Expenses Remain Stable,59129,13662.0,24945,38607.0,20522.0,34.71,0.01,Low Risk
U915,2024,4,191682.0,Salary Increases & Fixed Expenses Remain Stable,59129,13662.0,23907,37569.0,21560.0,36.46,0.01,Low Risk
U915,2024,5,213242.0,Salary Increases & Fixed Expenses Remain Stable,59129,13662.0,26814,40476.0,18653.0,31.55,-0.01,Low Risk
U915,2024,6,231895.0,Salary Increases & Fixed Expenses Remain Stable,59129,13662.0,25615,39277.0,19852.0,33.57,-0.04,Low Risk
U915,2024,7,251747.0,Salary Increases & Fixed Expenses Remain Stable,59129,13662.0,23560,37222.0,21907.0,37.05,-0.04,Low Risk
U915,2024,8,273654.0,Salary Increases & Fixed Expenses Remain Stable,59129,13662.0,18191,31853.0,27276.0,46.13,0.05,Low Risk
U915,2024,9,300930.0,Salary Increases & Fixed Expenses Remain Stable,59129,13662.0,21520,35182.0,23947.0,40.5,-0.04,Low Risk
U915,2024,10,324877.0,Salary Increases & Fixed Expenses Remain Stable,59129,13662.0,22662,36324.0,22805.0,38.57,0.03,Low Risk
U915,2024,11,347682.0,Salary Increases & Fixed Expenses Remain Stable,59129,13662.0,21363,35025.0,24104.0,40.77,0.05,Low Risk
U915,2024,12,371786.0,Salary Increases & Fixed Expenses Remain Stable,59129,13662.0,23920,37582.0,21547.0,36.44,-0.03,Low Risk
U916,2024,1,171784.0,Stable Salary & Stable Fixed Expenses,37384,18049.0,9716,27765.0,9619.0,25.73,0.03,Low Risk
U916,2024,2,181403.0,Stable Salary & Stable Fixed Expenses,37384,18049.0,9347,27396.0,9988.0,26.72,-0.04,Low Risk
U916,2024,3,191391.0,Stable Salary & Stable Fixed Expenses,37384,18049.0,8440,26489.0,10895.0,29.14,0.0,Low Risk
U916,2024,4,202286.0,Stable Salary & Stable Fixed Expenses,37384,18049.0,10329,28378.0,9006.0,24.09,0.03,Medium Risk
U916,2024,5,211292.0,Stable Salary & Stable Fixed Expenses,37384,18049.0,10405,28454.0,8930.0,23.89,-0.03,Medium Risk
U916,2024,6,220222.0,Stable Salary & Stable Fixed Expenses,37384,18049.0,10147,28196.0,9188.0,24.58,0.05,Medium Risk
U916,2024,7,229410.0,Stable Salary & Stable Fixed Expenses,37384,18049.0,9586,27635.0,9749.0,26.08,0.0,Low Risk
U916,2024,8,239159.0,Stable Salary & Stable Fixed Expenses,37384,18049.0,9650,27699.0,9685.0,25.91,-0.01,Low Risk
U916,2024,9,248844.0,Stable Salary & Stable Fixed Expenses,37384,18049.0,11750,29799.0,7585.0,20.29,-0.03,Medium Risk
U916,2024,10,256429.0,Stable Salary & Stable Fixed Expenses,37384,18049.0,7719,25768.0,11616.0,31.07,0.03,Low Risk
U916,2024,11,268045.0,Stable Salary & Stable Fixed Expenses,37384,18049.0,9083,27132.0,10252.0,27.42,0.02,Low Risk
U916,2024,12,278297.0,Stable Salary & Stable Fixed Expenses,37384,18049.0,10039,28088.0,9296.0,24.87,0.04,Medium Risk
U917,2024,1,123787.0,Stable Salary & Increasing Fixed Expenses,22576,15602.0,7417,23019.0,-443.0,-1.96,-0.03,High Risk
U917,2024,2,123344.0,Stable Salary & Increasing Fixed Expenses,22576,15602.0,10314,25916.0,-3340.0,-14.79,0.01,High Risk
U917,2024,3,120004.0,Stable Salary & Increasing Fixed Expenses,22576,15602.0,10215,25817.0,-3241.0,-14.36,0.0,High Risk
U917,2024,4,116763.0,Stable Salary & Increasing Fixed Expenses,22576,15602.0,9979,25581.0,-3005.0,-13.31,0.02,High Risk
U917,2024,5,113758.0,Stable Salary & Increasing Fixed Expenses,22576,15602.0,7715,23317.0,-741.0,-3.28,-0.02,High Risk
U917,2024,6,113017.0,Stable Salary & Increasing Fixed Expenses,22576,15602.0,10743,26345.0,-3769.0,-16.69,-0.04,High Risk
U917,2024,7,109248.0,Stable Salary & Increasing Fixed Expenses,22576,17359.0,7417,24776.0,-2200.0,-9.74,-0.02,High Risk
U917,2024,8,107048.0,Stable Salary & Increasing Fixed Expenses,22576,17359.0,10710,28069.0,-5493.0,-24.33,-0.01,High Risk
U917,2024,9,101555.0,Stable Salary & Increasing Fixed Expenses,22576,17359.0,11580,28939.0,-6363.0,-28.18,0.03,High Risk
U917,2024,10,95192.0,Stable Salary & Increasing Fixed Expenses,22576,17359.0,12754,30113.0,-7537.0,-33.39,-0.04,High Risk
U917,2024,11,87655.0,Stable Salary & Increasing Fixed Expenses,22576,17359.0,10728,28087.0,-5511.0,-24.41,-0.01,High Risk
U917,2024,12,82144.0,Stable Salary & Increasing Fixed Expenses,22576,17359.0,10276,27635.0,-5059.0,-22.41,0.04,High Risk
U918,2024,1,246577.0,Stable Salary & Decreasing Fixed Expenses,241452,69737.0,103500,173237.0,68215.0,28.25,0.0,Low Risk
U918,2024,2,314792.0,Stable Salary & Decreasing Fixed Expenses,241452,69737.0,80193,149930.0,91522.0,37.9,-0.03,Low Risk
U918,2024,3,406314.0,Stable Salary & Decreasing Fixed Expenses,241452,69737.0,141122,210859.0,30593.0,12.67,0.05,High Risk
U918,2024,4,436907.0,Stable Salary & Decreasing Fixed Expenses,241452,69737.0,105290,175027.0,66425.0,27.51,0.01,Low Risk
U918,2024,5,503332.0,Stable Salary & Decreasing Fixed Expenses,241452,69737.0,76924,146661.0,94791.0,39.26,0.01,Low Risk
U918,2024,6,598123.0,Stable Salary & Decreasing Fixed Expenses,241452,69737.0,109933,179670.0,61782.0,25.59,0.01,Low Risk
U918,2024,7,659905.0,Stable Salary & Decreasing Fixed Expenses,241452,69737.0,119263,189000.0,52452.0,21.72,0.03,Medium Risk
U918,2024,8,712357.0,Stable Salary & Decreasing Fixed Expenses,241452,69737.0,83065,152802.0,88650.0,36.72,-0.02,Low Risk
U918,2024,9,801007.0,Stable Salary & Decreasing Fixed Expenses,241452,69737.0,92663,162400.0,79052.0,32.74,0.03,Low Risk
U918,2024,10,880059.0,Stable Salary & Decreasing Fixed Expenses,241452,69737.0,103943,173680.0,67772.0,28.07,-0.0,Low Risk
U918,2024,11,947831.0,Stable Salary & Decreasing Fixed Expenses,241452,69737.0,135156,204893.0,36559.0,15.14,-0.01,Medium Risk
U918,2024,12,984390.0,Stable Salary & Decreasing Fixed Expenses,241452,69737.0,106897,176634.0,64818.0,26.85,0.02,Low Risk
U919,2024,1,208661.0,Stable Salary & Increasing Fixed Expenses,197561,62380.0,78006,140386.0,57175.0,28.94,0.0,Low Risk
U919,2024,2,265836.0,Stable Salary & Increasing Fixed Expenses,197561,62380.0,73195,135575.0,61986.0,31.38,-0.04,Low Risk
U919,2024,3,327822.0,Stable Salary & Increasing Fixed Expenses,197561,63628.0,61331,124959.0,72602.0,36.75,0.01,Low Risk
U919,2024,4,400424.0,Stable Salary & Increasing Fixed Expenses,197561,63628.0,75340,138968.0,58593.0,29.66,0.04,Low Risk
U919,2024,5,459017.0,Stable Salary & Increasing Fixed Expenses,197561,65117.0,68237,133354.0,64207.0,32.5,0.03,Low Risk
U919,2024,6,523224.0,Stable Salary & Increasing Fixed Expenses,197561,65117.0,69161,134278.0,63283.0,32.03,0.03,Low Risk
U919,2024,7,586507.0,Stable Salary & Increasing Fixed Expenses,197561,65117.0,98086,163203.0,34358.0,17.39,0.03,Medium Risk
U919,2024,8,620865.0,Stable Salary & Increasing Fixed Expenses,197561,65117.0,72386,137503.0,60058.0,30.4,0.01,Low Risk
U919,2024,9,680923.0,Stable Salary & Increasing Fixed Expenses,197561,65117.0,64952,130069.0,67492.0,34.16,0.01,Low Risk
U919,2024,10,748415.0,Stable Salary & Increasing Fixed Expenses,197561,65117.0,93561,158678.0,38883.0,19.68,0.02,Medium Risk
U919,2024,11,787298.0,Stable Salary & Increasing Fixed Expenses,197561,65117.0,63968,129085.0,68476.0,34.66,-0.04,Low Risk
U919,2024,12,855774.0,Stable Salary & Increasing Fixed Expenses,197561,65117.0,87222,152339.0,45222.0,22.89,-0.04,Medium Risk
U920,2024,1,227340.0,Stable Salary & Increasing Fixed Expenses,139205,43472.0,32688,76160.0,63045.0,45.29,0.05,Low Risk
U920,2024,2,290385.0,Stable Salary & Increasing Fixed Expenses,139205,43472.0,29685,73157.0,66048.0,47.45,0.02,Low Risk
U920,2024,3,356433.0,Stable Salary & Increasing Fixed Expenses,139205,43472.0,47036,90508.0,48697.0,34.98,0.0,Low Risk
U920,2024,4,405130.0,Stable Salary & Increasing Fixed Expenses,139205,43472.0,29817,73289.0,65916.0,47.35,-0.02,Low Risk
U920,2024,5,471046.0,Stable Salary & Increasing Fixed Expenses,139205,43472.0,37411,80883.0,58322.0,41.9,0.02,Low Risk
U920,2024,6,529368.0,Stable Salary & Increasing Fixed Expenses,139205,43472.0,28375,71847.0,67358.0,48.39,0.01,Low Risk
U920,2024,7,596726.0,Stable Salary & Increasing Fixed Expenses,139205,43472.0,30442,73914.0,65291.0,46.9,0.01,Low Risk
U920,2024,8,662017.0,Stable Salary & Increasing Fixed Expenses,139205,43472.0,30099,73571.0,65634.0,47.15,-0.03,Low Risk
U920,2024,9,727651.0,Stable Salary & Increasing Fixed Expenses,139205,43472.0,31701,75173.0,64032.0,46.0,0.01,Low Risk
U920,2024,10,791683.0,Stable Salary & Increasing Fixed Expenses,139205,44043.0,43735,87778.0,51427.0,36.94,-0.01,Low Risk
U920,2024,11,843110.0,Stable Salary & Increasing Fixed Expenses,139205,44043.0,43194,87237.0,51968.0,37.33,0.03,Low Risk
U920,2024,12,895078.0,Stable Salary & Increasing Fixed Expenses,139205,44043.0,46556,90599.0,48606.0,34.92,-0.02,Low Risk
U921,2024,1,239676.0,Stable Salary & Increasing Fixed Expenses,137918,75226.0,56062,131288.0,6630.0,4.81,0.02,High Risk
U921,2024,2,246306.0,Stable Salary & Increasing Fixed Expenses,137918,75226.0,55157,130383.0,7535.0,5.46,0.04,High Risk
U921,2024,3,253841.0,Stable Salary & Increasing Fixed Expenses,137918,75226.0,61749,136975.0,943.0,0.68,0.03,High Risk
U921,2024,4,254784.0,Stable Salary & Increasing Fixed Expenses,137918,75226.0,56598,131824.0,6094.0,4.42,-0.02,High Risk
U921,2024,5,260878.0,Stable Salary & Increasing Fixed Expenses,137918,76959.0,56312,133271.0,4647.0,3.37,0.03,High Risk
U921,2024,6,265525.0,Stable Salary & Increasing Fixed Expenses,137918,76959.0,50732,127691.0,10227.0,7.42,-0.0,High Risk
U921,2024,7,275752.0,Stable Salary & Increasing Fixed Expenses,137918,78909.0,62609,141518.0,-3600.0,-2.61,-0.0,High Risk
U921,2024,8,272152.0,Stable Salary & Increasing Fixed Expenses,137918,78909.0,53285,132194.0,5724.0,4.15,0.03,High Risk
U921,2024,9,277876.0,Stable Salary & Increasing Fixed Expenses,137918,78909.0,71709,150618.0,-12700.0,-9.21,0.02,High Risk
U921,2024,10,265176.0,Stable Salary & Increasing Fixed Expenses,137918,78909.0,58148,137057.0,861.0,0.62,0.01,High Risk
U921,2024,11,266037.0,Stable Salary & Increasing Fixed Expenses,137918,78909.0,65771,144680.0,-6762.0,-4.9,0.0,High Risk
U921,2024,12,259275.0,Stable Salary & Increasing Fixed Expenses,137918,80777.0,58609,139386.0,-1468.0,-1.06,-0.05,High Risk
U922,2024,1,250000.0,Stable Salary & Increasing Fixed Expenses,294424,117396.0,159196,276592.0,17832.0,6.06,-0.05,High Risk
U922,2024,2,267832.0,Stable Salary & Increasing Fixed Expenses,294424,117396.0,151551,268947.0,25477.0,8.65,0.05,High Risk
U922,2024,3,293309.0,Stable Salary & Increasing Fixed Expenses,294424,118573.0,258437,377010.0,-82586.0,-28.05,-0.04,High Risk
U922,2024,4,210723.0,Stable Salary & Increasing Fixed Expenses,294424,118573.0,195857,314430.0,-20006.0,-6.79,0.04,High Risk
U922,2024,5,190717.0,Stable Salary & Increasing Fixed Expenses,294424,118573.0,178879,297452.0,-3028.0,-1.03,-0.04,High Risk
U922,2024,6,187689.0,Stable Salary & Increasing Fixed Expenses,294424,120244.0,198422,318666.0,-24242.0,-8.23,0.03,High Risk
U922,2024,7,163447.0,Stable Salary & Increasing Fixed Expenses,294424,120244.0,183838,304082.0,-9658.0,-3.28,-0.04,High Risk
U922,2024,8,153789.0,Stable Salary & Increasing Fixed Expenses,294424,120244.0,160111,280355.0,14069.0,4.78,0.01,High Risk
U922,2024,9,167858.0,Stable Salary & Increasing Fixed Expenses,294424,120244.0,170934,291178.0,3246.0,1.1,0.04,High Risk
U922,2024,10,171104.0,Stable Salary & Increasing Fixed Expenses,294424,120244.0,198368,318612.0,-24188.0,-8.22,0.02,High Risk
U922,2024,11,146916.0,Stable Salary & Increasing Fixed Expenses,294424,120244.0,211401,331645.0,-37221.0,-12.64,0.01,High Risk
U922,2024,12,109695.0,Stable Salary & Increasing Fixed Expenses,294424,120244.0,248025,368269.0,-73845.0,-25.08,-0.04,High Risk
U923,2024,1,68796.0,Stable Salary & Decreasing Fixed Expenses,52732,33236.0,27541,60777.0,-8045.0,-15.26,0.02,High Risk
U923,2024,2,60751.0,Stable Salary & Decreasing Fixed Expenses,52732,33236.0,31118,64354.0,-11622.0,-22.04,-0.03,High Risk
U923,2024,3,49129.0,Stable Salary & Decreasing Fixed Expenses,52732,33236.0,41920,75156.0,-22424.0,-42.52,0.04,High Risk
U923,2024,4,26705.0,Stable Salary & Decreasing Fixed Expenses,52732,33236.0,34318,67554.0,-14822.0,-28.11,-0.01,High Risk
U923,2024,5,11883.0,Stable Salary & Decreasing Fixed Expenses,52732,31243.0,36148,67391.0,-14659.0,-27.8,-0.04,High Risk
U923,2024,6,-2776.0,Stable Salary & Decreasing Fixed Expenses,52732,31243.0,27910,59153.0,-6421.0,-12.18,0.0,High Risk
U923,2024,7,-9197.0,Stable Salary & Decreasing Fixed Expenses,52732,31243.0,34849,66092.0,-13360.0,-25.34,-0.01,High Risk
U923,2024,8,-22557.0,Stable Salary & Decreasing Fixed Expenses,52732,31243.0,30601,61844.0,-9112.0,-17.28,0.01,High Risk
U923,2024,9,-31669.0,Stable Salary & Decreasing Fixed Expenses,52732,31243.0,33508,64751.0,-12019.0,-22.79,-0.04,High Risk
U923,2024,10,-43688.0,Stable Salary & Decreasing Fixed Expenses,52732,31243.0,44871,76114.0,-23382.0,-44.34,-0.01,High Risk
U923,2024,11,-67070.0,Stable Salary & Decreasing Fixed Expenses,52732,31243.0,39967,71210.0,-18478.0,-35.04,-0.03,High Risk
U923,2024,12,-85548.0,Stable Salary & Decreasing Fixed Expenses,52732,31243.0,41243,72486.0,-19754.0,-37.46,0.03,High Risk
U924,2024,1,250000.0,Stable Salary & Stable Fixed Expenses,284390,87298.0,117361,204659.0,79731.0,28.04,0.02,Low Risk
U924,2024,2,329731.0,Stable Salary & Stable Fixed Expenses,284390,87298.0,110177,197475.0,86915.0,30.56,-0.03,Low Risk
U924,2024,3,416646.0,Stable Salary & Stable Fixed Expenses,284390,87298.0,131426,218724.0,65666.0,23.09,0.05,Medium Risk
U924,2024,4,482312.0,Stable Salary & Stable Fixed Expenses,284390,87298.0,105407,192705.0,91685.0,32.24,-0.05,Low Risk
U924,2024,5,573997.0,Stable Salary & Stable Fixed Expenses,284390,87298.0,116940,204238.0,80152.0,28.18,0.04,Low Risk
U924,2024,6,654149.0,Stable Salary & Stable Fixed Expenses,284390,87298.0,135872,223170.0,61220.0,21.53,-0.02,Medium Risk
U924,2024,7,715369.0,Stable Salary & Stable Fixed Expenses,284390,87298.0,107383,194681.0,89709.0,31.54,-0.03,Low Risk
U924,2024,8,805078.0,Stable Salary & Stable Fixed Expenses,284390,87298.0,137421,224719.0,59671.0,20.98,-0.04,Medium Risk
U924,2024,9,864749.0,Stable Salary & Stable Fixed Expenses,284390,87298.0,157187,244485.0,39905.0,14.03,-0.01,High Risk
U924,2024,10,904654.0,Stable Salary & Stable Fixed Expenses,284390,87298.0,124744,212042.0,72348.0,25.44,0.01,Low Risk
U924,2024,11,977002.0,Stable Salary & Stable Fixed Expenses,284390,87298.0,99678,186976.0,97414.0,34.25,-0.04,Low Risk
U924,2024,12,1074416.0,Stable Salary & Stable Fixed Expenses,284390,87298.0,113048,200346.0,84044.0,29.55,-0.04,Low Risk
U925,2024,1,244581.0,Stable Salary & Stable Fixed Expenses,138288,45273.0,46996,92269.0,46019.0,33.28,-0.02,Low Risk
U925,2024,2,290600.0,Stable Salary & Stable Fixed Expenses,138288,45273.0,48949,94222.0,44066.0,31.87,-0.05,Low Risk
U925,2024,3,334666.0,Stable Salary & Stable Fixed Expenses,138288,45273.0,75907,121180.0,17108.0,12.37,0.03,High Risk
U925,2024,4,351774.0,Stable Salary & Stable Fixed Expenses,138288,45273.0,55785,101058.0,37230.0,26.92,-0.02,Low Risk
U925,2024,5,389004.0,Stable Salary & Stable Fixed Expenses,138288,45273.0,52344,97617.0,40671.0,29.41,0.04,Low Risk
U925,2024,6,429675.0,Stable Salary & Stable Fixed Expenses,138288,45273.0,45963,91236.0,47052.0,34.02,-0.02,Low Risk
U925,2024,7,476727.0,Stable Salary & Stable Fixed Expenses,138288,45273.0,43417,88690.0,49598.0,35.87,-0.02,Low Risk
U925,2024,8,526325.0,Stable Salary & Stable Fixed Expenses,138288,45273.0,67773,113046.0,25242.0,18.25,-0.0,Medium Risk
U925,2024,9,551567.0,Stable Salary & Stable Fixed Expenses,138288,45273.0,73565,118838.0,19450.0,14.06,0.0,High Risk
U925,2024,10,571017.0,Stable Salary & Stable Fixed Expenses,138288,45273.0,61914,107187.0,31101.0,22.49,0.04,Medium Risk
U925,2024,11,602118.0,Stable Salary & Stable Fixed Expenses,138288,45273.0,59851,105124.0,33164.0,23.98,0.02,Medium Risk
U925,2024,12,635282.0,Stable Salary & Stable Fixed Expenses,138288,45273.0,86882,132155.0,6133.0,4.43,-0.04,High Risk
U926,2024,1,248075.0,Salary Increases & Fixed Expenses Remain Stable,218655,78571.0,151350,229921.0,-11266.0,-5.15,-0.02,High Risk
U926,2024,2,236809.0,Salary Increases & Fixed Expenses Remain Stable,218655,78571.0,128436,207007.0,11648.0,5.33,-0.03,High Risk
U926,2024,3,248457.0,Salary Increases & Fixed Expenses Remain Stable,218655,78571.0,125094,203665.0,14990.0,6.86,-0.04,High Risk
U926,2024,4,263447.0,Salary Increases & Fixed Expenses Remain Stable,218655,78571.0,122921,201492.0,17163.0,7.85,0.0,High Risk
U926,2024,5,280610.0,Salary Increases & Fixed Expenses Remain Stable,218655,78571.0,112015,190586.0,28069.0,12.84,-0.03,High Risk
U926,2024,6,308679.0,Salary Increases & Fixed Expenses Remain Stable,231662,78571.0,119146,197717.0,33945.0,14.65,0.0,High Risk
U926,2024,7,342624.0,Salary Increases & Fixed Expenses Remain Stable,231662,78571.0,128762,207333.0,24329.0,10.5,0.02,High Risk
U926,2024,8,366953.0,Salary Increases & Fixed Expenses Remain Stable,231662,78571.0,128663,207234.0,24428.0,10.54,0.01,High Risk
U926,2024,9,391381.0,Salary Increases & Fixed Expenses Remain Stable,231662,78571.0,140894,219465.0,12197.0,5.26,0.01,High Risk
U926,2024,10,403578.0,Salary Increases & Fixed Expenses Remain Stable,231662,78571.0,129657,208228.0,23434.0,10.12,0.01,High Risk
U926,2024,11,427012.0,Salary Increases & Fixed Expenses Remain Stable,231662,78571.0,141604,220175.0,11487.0,4.96,-0.0,High Risk
U926,2024,12,438499.0,Salary Increases & Fixed Expenses Remain Stable,231662,78571.0,154795,233366.0,-1704.0,-0.74,-0.01,High Risk
U927,2024,1,195094.0,Stable Salary & Increasing Fixed Expenses,143325,40260.0,30065,70325.0,73000.0,50.93,-0.02,Low Risk
U927,2024,2,268094.0,Stable Salary & Increasing Fixed Expenses,143325,41364.0,34477,75841.0,67484.0,47.08,0.02,Low Risk
U927,2024,3,335578.0,Stable Salary & Increasing Fixed Expenses,143325,41364.0,35787,77151.0,66174.0,46.17,-0.03,Low Risk
U927,2024,4,401752.0,Stable Salary & Increasing Fixed Expenses,143325,41364.0,30623,71987.0,71338.0,49.77,-0.04,Low Risk
U927,2024,5,473090.0,Stable Salary & Increasing Fixed Expenses,143325,43290.0,34012,77302.0,66023.0,46.07,-0.02,Low Risk
U927,2024,6,539113.0,Stable Salary & Increasing Fixed Expenses,143325,43290.0,33245,76535.0,66790.0,46.6,-0.03,Low Risk
U927,2024,7,605903.0,Stable Salary & Increasing Fixed Expenses,143325,43290.0,39612,82902.0,60423.0,42.16,0.03,Low Risk
U927,2024,8,666326.0,Stable Salary & Increasing Fixed Expenses,143325,43290.0,31353,74643.0,68682.0,47.92,-0.05,Low Risk
U927,2024,9,735008.0,Stable Salary & Increasing Fixed Expenses,143325,43290.0,33437,76727.0,66598.0,46.47,0.04,Low Risk
U927,2024,10,801606.0,Stable Salary & Increasing Fixed Expenses,143325,44004.0,30531,74535.0,68790.0,48.0,-0.02,Low Risk
U927,2024,11,870396.0,Stable Salary & Increasing Fixed Expenses,143325,44004.0,42671,86675.0,56650.0,39.53,0.02,Low Risk
U927,2024,12,927046.0,Stable Salary & Increasing Fixed Expenses,143325,44004.0,33904,77908.0,65417.0,45.64,-0.04,Low Risk
U928,2024,1,211024.0,Stable Salary & Increasing Fixed Expenses,161696,57744.0,52696,110440.0,51256.0,31.7,0.01,Low Risk
U928,2024,2,262280.0,Stable Salary & Increasing Fixed Expenses,161696,57744.0,71276,129020.0,32676.0,20.21,0.01,Medium Risk
U928,2024,3,294956.0,Stable Salary & Increasing Fixed Expenses,161696,59644.0,95446,155090.0,6606.0,4.09,-0.04,High Risk
U928,2024,4,301562.0,Stable Salary & Increasing Fixed Expenses,161696,60400.0,64711,125111.0,36585.0,22.63,-0.03,Medium Risk
U928,2024,5,338147.0,Stable Salary & Increasing Fixed Expenses,161696,60400.0,77481,137881.0,23815.0,14.73,0.01,High Risk
U928,2024,6,361962.0,Stable Salary & Increasing Fixed Expenses,161696,60400.0,52838,113238.0,48458.0,29.97,-0.0,Low Risk
U928,2024,7,410420.0,Stable Salary & Increasing Fixed Expenses,161696,60400.0,75887,136287.0,25409.0,15.71,-0.05,Medium Risk
U928,2024,8,435829.0,Stable Salary & Increasing Fixed Expenses,161696,60400.0,72869,133269.0,28427.0,17.58,0.04,Medium Risk
U928,2024,9,464256.0,Stable Salary & Increasing Fixed Expenses,161696,61249.0,85381,146630.0,15066.0,9.32,0.02,High Risk
U928,2024,10,479322.0,Stable Salary & Increasing Fixed Expenses,161696,61249.0,68626,129875.0,31821.0,19.68,0.02,Medium Risk
U928,2024,11,511143.0,Stable Salary & Increasing Fixed Expenses,161696,61249.0,88738,149987.0,11709.0,7.24,-0.02,High Risk
U928,2024,12,522852.0,Stable Salary & Increasing Fixed Expenses,161696,61249.0,68110,129359.0,32337.0,20.0,0.04,Medium Risk
U929,2024,1,170861.0,Salary Increases & Fixed Expenses Remain Stable,23640,15183.0,6700,21883.0,1757.0,7.43,0.05,High Risk
U929,2024,2,172618.0,Salary Increases & Fixed Expenses Remain Stable,23640,15183.0,7046,22229.0,1411.0,5.97,-0.02,High Risk
U929,2024,3,174029.0,Salary Increases & Fixed Expenses Remain Stable,51265,15183.0,10707,25890.0,25375.0,49.5,0.02,Low Risk
U929,2024,4,199404.0,Salary Increases & Fixed Expenses Remain Stable,51265,15183.0,11722,26905.0,24360.0,47.52,-0.01,Low Risk
U929,2024,5,223764.0,Salary Increases & Fixed Expenses Remain Stable,51265,15183.0,10407,25590.0,25675.0,50.08,0.01,Low Risk
U929,2024,6,249439.0,Salary Increases & Fixed Expenses Remain Stable,51265,15183.0,12252,27435.0,23830.0,46.48,0.01,Low Risk
U929,2024,7,273269.0,Salary Increases & Fixed Expenses Remain Stable,51265,15183.0,11817,27000.0,24265.0,47.33,-0.01,Low Risk
U929,2024,8,297534.0,Salary Increases & Fixed Expenses Remain Stable,51265,15183.0,14543,29726.0,21539.0,42.02,0.03,Low Risk
U929,2024,9,319073.0,Salary Increases & Fixed Expenses Remain Stable,51265,15183.0,12106,27289.0,23976.0,46.77,0.02,Low Risk
U929,2024,10,343049.0,Salary Increases & Fixed Expenses Remain Stable,51265,15183.0,10783,25966.0,25299.0,49.35,0.05,Low Risk
U929,2024,11,368348.0,Salary Increases & Fixed Expenses Remain Stable,51265,15183.0,14267,29450.0,21815.0,42.55,0.01,Low Risk
U929,2024,12,390163.0,Salary Increases & Fixed Expenses Remain Stable,51265,15183.0,12752,27935.0,23330.0,45.51,0.03,Low Risk
U930,2024,1,221427.0,Stable Salary & Stable Fixed Expenses,197266,46893.0,131344,178237.0,19029.0,9.65,0.03,High Risk
U930,2024,2,240456.0,Stable Salary & Stable Fixed Expenses,197266,46893.0,115855,162748.0,34518.0,17.5,0.02,Medium Risk
U930,2024,3,274974.0,Stable Salary & Stable Fixed Expenses,197266,46893.0,108592,155485.0,41781.0,21.18,0.04,Medium Risk
U930,2024,4,316755.0,Stable Salary & Stable Fixed Expenses,197266,46893.0,120712,167605.0,29661.0,15.04,0.04,Medium Risk
U930,2024,5,346416.0,Stable Salary & Stable Fixed Expenses,197266,46893.0,114395,161288.0,35978.0,18.24,-0.05,Medium Risk
U930,2024,6,382394.0,Stable Salary & Stable Fixed Expenses,197266,46893.0,109341,156234.0,41032.0,20.8,-0.04,Medium Risk
U930,2024,7,423426.0,Stable Salary & Stable Fixed Expenses,197266,46893.0,122285,169178.0,28088.0,14.24,0.01,High Risk
U930,2024,8,451514.0,Stable Salary & Stable Fixed Expenses,197266,46893.0,116999,163892.0,33374.0,16.92,-0.05,Medium Risk
U930,2024,9,484888.0,Stable Salary & Stable Fixed Expenses,197266,46893.0,116164,163057.0,34209.0,17.34,0.03,Medium Risk
U930,2024,10,519097.0,Stable Salary & Stable Fixed Expenses,197266,46893.0,111146,158039.0,39227.0,19.89,-0.0,Medium Risk
U930,2024,11,558324.0,Stable Salary & Stable Fixed Expenses,197266,46893.0,98896,145789.0,51477.0,26.1,-0.03,Low Risk
U930,2024,12,609801.0,Stable Salary & Stable Fixed Expenses,197266,46893.0,128923,175816.0,21450.0,10.87,-0.04,High Risk
U931,2024,1,239559.0,Stable Salary & Increasing Fixed Expenses,237117,85862.0,112732,198594.0,38523.0,16.25,-0.05,Medium Risk
U931,2024,2,278082.0,Stable Salary & Increasing Fixed Expenses,237117,85862.0,102259,188121.0,48996.0,20.66,-0.04,Medium Risk
U931,2024,3,327078.0,Stable Salary & Increasing Fixed Expenses,237117,85862.0,99362,185224.0,51893.0,21.88,-0.02,Medium Risk
U931,2024,4,378971.0,Stable Salary & Increasing Fixed Expenses,237117,85862.0,117606,203468.0,33649.0,14.19,0.03,High Risk
U931,2024,5,412620.0,Stable Salary & Increasing Fixed Expenses,237117,85862.0,106007,191869.0,45248.0,19.08,-0.03,Medium Risk
U931,2024,6,457868.0,Stable Salary & Increasing Fixed Expenses,237117,85862.0,107220,193082.0,44035.0,18.57,-0.01,Medium Risk
U931,2024,7,501903.0,Stable Salary & Increasing Fixed Expenses,237117,85862.0,102171,188033.0,49084.0,20.7,0.04,Medium Risk
U931,2024,8,550987.0,Stable Salary & Increasing Fixed Expenses,237117,85862.0,99852,185714.0,51403.0,21.68,0.03,Medium Risk
U931,2024,9,602390.0,Stable Salary & Increasing Fixed Expenses,237117,85862.0,94865,180727.0,56390.0,23.78,-0.05,Medium Risk
U931,2024,10,658780.0,Stable Salary & Increasing Fixed Expenses,237117,87810.0,101438,189248.0,47869.0,20.19,-0.01,Medium Risk
U931,2024,11,706649.0,Stable Salary & Increasing Fixed Expenses,237117,87810.0,100614,188424.0,48693.0,20.54,0.02,Medium Risk
U931,2024,12,755342.0,Stable Salary & Increasing Fixed Expenses,237117,87810.0,84922,172732.0,64385.0,27.15,0.02,Low Risk
U932,2024,1,245812.0,Stable Salary & Decreasing Fixed Expenses,72619,23445.0,29814,53259.0,19360.0,26.66,0.02,Low Risk
U932,2024,2,265172.0,Stable Salary & Decreasing Fixed Expenses,72619,23445.0,26349,49794.0,22825.0,31.43,-0.03,Low Risk
U932,2024,3,287997.0,Stable Salary & Decreasing Fixed Expenses,72619,23445.0,26131,49576.0,23043.0,31.73,0.04,Low Risk
U932,2024,4,311040.0,Stable Salary & Decreasing Fixed Expenses,72619,23445.0,23415,46860.0,25759.0,35.47,0.02,Low Risk
U932,2024,5,336799.0,Stable Salary & Decreasing Fixed Expenses,72619,23445.0,22621,46066.0,26553.0,36.56,0.01,Low Risk
U932,2024,6,363352.0,Stable Salary & Decreasing Fixed Expenses,72619,23445.0,25979,49424.0,23195.0,31.94,-0.05,Low Risk
U932,2024,7,386547.0,Stable Salary & Decreasing Fixed Expenses,72619,23445.0,25774,49219.0,23400.0,32.22,0.04,Low Risk
U932,2024,8,409947.0,Stable Salary & Decreasing Fixed Expenses,72619,23445.0,25977,49422.0,23197.0,31.94,0.02,Low Risk
U932,2024,9,433144.0,Stable Salary & Decreasing Fixed Expenses,72619,23445.0,29135,52580.0,20039.0,27.59,-0.02,Low Risk
U932,2024,10,453183.0,Stable Salary & Decreasing Fixed Expenses,72619,23445.0,26602,50047.0,22572.0,31.08,-0.03,Low Risk
U932,2024,11,475755.0,Stable Salary & Decreasing Fixed Expenses,72619,23445.0,34052,57497.0,15122.0,20.82,0.04,Medium Risk
U932,2024,12,490877.0,Stable Salary & Decreasing Fixed Expenses,72619,23445.0,33213,56658.0,15961.0,21.98,-0.02,Medium Risk
U933,2024,1,250000.0,Stable Salary & Stable Fixed Expenses,289760,117914.0,131981,249895.0,39865.0,13.76,-0.05,High Risk
U933,2024,2,289865.0,Stable Salary & Stable Fixed Expenses,289760,117914.0,129441,247355.0,42405.0,14.63,0.01,High Risk
U933,2024,3,332270.0,Stable Salary & Stable Fixed Expenses,289760,117914.0,101326,219240.0,70520.0,24.34,0.04,Medium Risk
U933,2024,4,402790.0,Stable Salary & Stable Fixed Expenses,289760,117914.0,122518,240432.0,49328.0,17.02,0.02,Medium Risk
U933,2024,5,452118.0,Stable Salary & Stable Fixed Expenses,289760,117914.0,99613,217527.0,72233.0,24.93,-0.05,Medium Risk
U933,2024,6,524351.0,Stable Salary & Stable Fixed Expenses,289760,117914.0,123487,241401.0,48359.0,16.69,-0.03,Medium Risk
U933,2024,7,572710.0,Stable Salary & Stable Fixed Expenses,289760,117914.0,113810,231724.0,58036.0,20.03,0.0,Medium Risk
U933,2024,8,630746.0,Stable Salary & Stable Fixed Expenses,289760,117914.0,113651,231565.0,58195.0,20.08,0.01,Medium Risk
U933,2024,9,688941.0,Stable Salary & Stable Fixed Expenses,289760,117914.0,151514,269428.0,20332.0,7.02,-0.05,High Risk
U933,2024,10,709273.0,Stable Salary & Stable Fixed Expenses,289760,117914.0,112834,230748.0,59012.0,20.37,0.02,Medium Risk
U933,2024,11,768285.0,Stable Salary & Stable Fixed Expenses,289760,117914.0,147481,265395.0,24365.0,8.41,0.05,High Risk
U933,2024,12,792650.0,Stable Salary & Stable Fixed Expenses,289760,117914.0,108321,226235.0,63525.0,21.92,-0.02,Medium Risk
U934,2024,1,232496.0,Stable Salary & Stable Fixed Expenses,211736,101324.0,127246,228570.0,-16834.0,-7.95,0.05,High Risk
U934,2024,2,215662.0,Stable Salary & Stable Fixed Expenses,211736,101324.0,114508,215832.0,-4096.0,-1.93,0.01,High Risk
U934,2024,3,211566.0,Stable Salary & Stable Fixed Expenses,211736,101324.0,117188,218512.0,-6776.0,-3.2,-0.04,High Risk
U934,2024,4,204790.0,Stable Salary & Stable Fixed Expenses,211736,101324.0,118129,219453.0,-7717.0,-3.64,0.02,High Risk
U934,2024,5,197073.0,Stable Salary & Stable Fixed Expenses,211736,101324.0,132057,233381.0,-21645.0,-10.22,-0.04,High Risk
U934,2024,6,175428.0,Stable Salary & Stable Fixed Expenses,211736,101324.0,117117,218441.0,-6705.0,-3.17,-0.05,High Risk
U934,2024,7,168723.0,Stable Salary & Stable Fixed Expenses,211736,101324.0,141950,243274.0,-31538.0,-14.89,-0.0,High Risk
U934,2024,8,137185.0,Stable Salary & Stable Fixed Expenses,211736,101324.0,126804,228128.0,-16392.0,-7.74,0.01,High Risk
U934,2024,9,120793.0,Stable Salary & Stable Fixed Expenses,211736,101324.0,113215,214539.0,-2803.0,-1.32,0.03,High Risk
U934,2024,10,117990.0,Stable Salary & Stable Fixed Expenses,211736,101324.0,132393,233717.0,-21981.0,-10.38,-0.01,High Risk
U934,2024,11,96009.0,Stable Salary & Stable Fixed Expenses,211736,101324.0,140709,242033.0,-30297.0,-14.31,-0.01,High Risk
U934,2024,12,65712.0,Stable Salary & Stable Fixed Expenses,211736,101324.0,134801,236125.0,-24389.0,-11.52,-0.04,High Risk
U935,2024,1,125588.0,Salary Increases & Fixed Expenses Increase,75371,34653.0,26170,60823.0,14548.0,19.3,0.0,Medium Risk
U935,2024,2,140136.0,Salary Increases & Fixed Expenses Increase,75371,34653.0,37395,72048.0,3323.0,4.41,0.02,High Risk
U935,2024,3,143459.0,Salary Increases & Fixed Expenses Increase,75371,34653.0,41664,76317.0,-946.0,-1.26,0.03,High Risk
U935,2024,4,142513.0,Salary Increases & Fixed Expenses Increase,101631,34653.0,44018,78671.0,22960.0,22.59,-0.0,Medium Risk
U935,2024,5,165473.0,Salary Increases & Fixed Expenses Increase,101631,34653.0,47670,82323.0,19308.0,19.0,0.03,Medium Risk
U935,2024,6,184781.0,Salary Increases & Fixed Expenses Increase,101631,35440.0,43296,78736.0,22895.0,22.53,-0.02,Medium Risk
U935,2024,7,207676.0,Salary Increases & Fixed Expenses Increase,101631,35440.0,47467,82907.0,18724.0,18.42,0.03,Medium Risk
U935,2024,8,226400.0,Salary Increases & Fixed Expenses Increase,101631,35440.0,31577,67017.0,34614.0,34.06,-0.04,Low Risk
U935,2024,9,261014.0,Salary Increases & Fixed Expenses Increase,101631,35440.0,37651,73091.0,28540.0,28.08,0.04,Low Risk
U935,2024,10,289554.0,Salary Increases & Fixed Expenses Increase,101631,35440.0,46283,81723.0,19908.0,19.59,0.04,Medium Risk
U935,2024,11,309462.0,Salary Increases & Fixed Expenses Increase,101631,36062.0,38329,74391.0,27240.0,26.8,-0.02,Low Risk
U935,2024,12,336702.0,Salary Increases & Fixed Expenses Increase,101631,36062.0,41326,77388.0,24243.0,23.85,0.01,Medium Risk
U936,2024,1,250000.0,Salary Increases & Fixed Expenses Remain Stable,297274,72812.0,125830,198642.0,98632.0,33.18,-0.02,Low Risk
U936,2024,2,348632.0,Salary Increases & Fixed Expenses Remain Stable,297274,72812.0,127935,200747.0,96527.0,32.47,-0.03,Low Risk
U936,2024,3,445159.0,Salary Increases & Fixed Expenses Remain Stable,297274,72812.0,105278,178090.0,119184.0,40.09,0.0,Low Risk
U936,2024,4,564343.0,Salary Increases & Fixed Expenses Remain Stable,297274,72812.0,120665,193477.0,103797.0,34.92,-0.05,Low Risk
U936,2024,5,668140.0,Salary Increases & Fixed Expenses Remain Stable,297274,72812.0,121894,194706.0,102568.0,34.5,0.02,Low Risk
U936,2024,6,770708.0,Salary Increases & Fixed Expenses Remain Stable,303388,72812.0,109106,181918.0,121470.0,40.04,0.03,Low Risk
U936,2024,7,892178.0,Salary Increases & Fixed Expenses Remain Stable,303388,72812.0,128166,200978.0,102410.0,33.76,-0.01,Low Risk
U936,2024,8,994588.0,Salary Increases & Fixed Expenses Remain Stable,303388,72812.0,145698,218510.0,84878.0,27.98,0.02,Low Risk
U936,2024,9,1079466.0,Salary Increases & Fixed Expenses Remain Stable,303388,72812.0,127392,200204.0,103184.0,34.01,-0.0,Low Risk
U936,2024,10,1182650.0,Salary Increases & Fixed Expenses Remain Stable,303388,72812.0,148824,221636.0,81752.0,26.95,-0.02,Low Risk
U936,2024,11,1264402.0,Salary Increases & Fixed Expenses Remain Stable,303388,72812.0,132660,205472.0,97916.0,32.27,-0.03,Low Risk
U936,2024,12,1362318.0,Salary Increases & Fixed Expenses Remain Stable,303388,72812.0,125053,197865.0,105523.0,34.78,-0.0,Low Risk
U937,2024,1,249085.0,Salary Increases & Fixed Expenses Increase,244438,69219.0,94620,163839.0,80599.0,32.97,0.03,Low Risk
U937,2024,2,329684.0,Salary Increases & Fixed Expenses Increase,244438,69219.0,112009,181228.0,63210.0,25.86,0.05,Low Risk
U937,2024,3,392894.0,Salary Increases & Fixed Expenses Increase,269010,69941.0,145288,215229.0,53781.0,19.99,0.02,Medium Risk
U937,2024,4,446675.0,Salary Increases & Fixed Expenses Increase,269010,71394.0,125658,197052.0,71958.0,26.75,0.03,Low Risk
U937,2024,5,518633.0,Salary Increases & Fixed Expenses Increase,269010,71394.0,96100,167494.0,101516.0,37.74,0.03,Low Risk
U937,2024,6,620149.0,Salary Increases & Fixed Expenses Increase,269010,72640.0,118471,191111.0,77899.0,28.96,0.03,Low Risk
U937,2024,7,698048.0,Salary Increases & Fixed Expenses Increase,269010,72640.0,106590,179230.0,89780.0,33.37,0.03,Low Risk
U937,2024,8,787828.0,Salary Increases & Fixed Expenses Increase,269010,72640.0,114103,186743.0,82267.0,30.58,-0.05,Low Risk
U937,2024,9,870095.0,Salary Increases & Fixed Expenses Increase,269010,72640.0,108297,180937.0,88073.0,32.74,-0.0,Low Risk
U937,2024,10,958168.0,Salary Increases & Fixed Expenses Increase,269010,72640.0,119477,192117.0,76893.0,28.58,-0.05,Low Risk
U937,2024,11,1035061.0,Salary Increases & Fixed Expenses Increase,269010,72640.0,126599,199239.0,69771.0,25.94,-0.03,Low Risk
U937,2024,12,1104832.0,Salary Increases & Fixed Expenses Increase,269010,72640.0,112943,185583.0,83427.0,31.01,-0.02,Low Risk
U938,2024,1,220929.0,Stable Salary & Stable Fixed Expenses,131081,71096.0,55562,126658.0,4423.0,3.37,0.03,High Risk
U938,2024,2,225352.0,Stable Salary & Stable Fixed Expenses,131081,71096.0,53615,124711.0,6370.0,4.86,-0.04,High Risk
U938,2024,3,231722.0,Stable Salary & Stable Fixed Expenses,131081,71096.0,58094,129190.0,1891.0,1.44,0.05,High Risk
U938,2024,4,233613.0,Stable Salary & Stable Fixed Expenses,131081,71096.0,62638,133734.0,-2653.0,-2.02,0.02,High Risk
U938,2024,5,230960.0,Stable Salary & Stable Fixed Expenses,131081,71096.0,51234,122330.0,8751.0,6.68,-0.01,High Risk
U938,2024,6,239711.0,Stable Salary & Stable Fixed Expenses,131081,71096.0,43608,114704.0,16377.0,12.49,-0.01,High Risk
U938,2024,7,256088.0,Stable Salary & Stable Fixed Expenses,131081,71096.0,39736,110832.0,20249.0,15.45,0.01,Medium Risk
U938,2024,8,276337.0,Stable Salary & Stable Fixed Expenses,131081,71096.0,41468,112564.0,18517.0,14.13,0.02,High Risk
U938,2024,9,294854.0,Stable Salary & Stable Fixed Expenses,131081,71096.0,53541,124637.0,6444.0,4.92,0.0,High Risk
U938,2024,10,301298.0,Stable Salary & Stable Fixed Expenses,131081,71096.0,61483,132579.0,-1498.0,-1.14,-0.05,High Risk
U938,2024,11,299800.0,Stable Salary & Stable Fixed Expenses,131081,71096.0,71434,142530.0,-11449.0,-8.73,-0.05,High Risk
U938,2024,12,288351.0,Stable Salary & Stable Fixed Expenses,131081,71096.0,60112,131208.0,-127.0,-0.1,0.03,High Risk
U939,2024,1,245237.0,Salary Increases & Fixed Expenses Increase,48900,15223.0,10471,25694.0,23206.0,47.46,-0.02,Low Risk
U939,2024,2,268443.0,Salary Increases & Fixed Expenses Increase,48900,15223.0,13519,28742.0,20158.0,41.22,-0.04,Low Risk
U939,2024,3,288601.0,Salary Increases & Fixed Expenses Increase,48900,15223.0,10864,26087.0,22813.0,46.65,0.0,Low Risk
U939,2024,4,311414.0,Salary Increases & Fixed Expenses Increase,48900,15223.0,10367,25590.0,23310.0,47.67,0.02,Low Risk
U939,2024,5,334724.0,Salary Increases & Fixed Expenses Increase,48900,16466.0,10165,26631.0,22269.0,45.54,-0.04,Low Risk
U939,2024,6,356993.0,Salary Increases & Fixed Expenses Increase,48900,16466.0,14275,30741.0,18159.0,37.13,-0.02,Low Risk
U939,2024,7,375152.0,Salary Increases & Fixed Expenses Increase,48900,18233.0,13987,32220.0,16680.0,34.11,-0.0,Low Risk
U939,2024,8,391832.0,Salary Increases & Fixed Expenses Increase,62120,19711.0,14489,34200.0,27920.0,44.95,0.03,Low Risk
U939,2024,9,419752.0,Salary Increases & Fixed Expenses Increase,62120,19711.0,15108,34819.0,27301.0,43.95,0.04,Low Risk
U939,2024,10,447053.0,Salary Increases & Fixed Expenses Increase,62120,19711.0,14336,34047.0,28073.0,45.19,-0.05,Low Risk
U939,2024,11,475126.0,Salary Increases & Fixed Expenses Increase,62120,19711.0,17030,36741.0,25379.0,40.85,0.02,Low Risk
U939,2024,12,500505.0,Salary Increases & Fixed Expenses Increase,62120,19711.0,14702,34413.0,27707.0,44.6,0.03,Low Risk
U940,2024,1,180160.0,Stable Salary & Stable Fixed Expenses,146288,65158.0,41852,107010.0,39278.0,26.85,0.0,Low Risk
U940,2024,2,219438.0,Stable Salary & Stable Fixed Expenses,146288,65158.0,36106,101264.0,45024.0,30.78,-0.03,Low Risk
U940,2024,3,264462.0,Stable Salary & Stable Fixed Expenses,146288,65158.0,30439,95597.0,50691.0,34.65,0.0,Low Risk
U940,2024,4,315153.0,Stable Salary & Stable Fixed Expenses,146288,65158.0,35764,100922.0,45366.0,31.01,-0.01,Low Risk
U940,2024,5,360519.0,Stable Salary & Stable Fixed Expenses,146288,65158.0,35606,100764.0,45524.0,31.12,0.04,Low Risk
U940,2024,6,406043.0,Stable Salary & Stable Fixed Expenses,146288,65158.0,37194,102352.0,43936.0,30.03,0.03,Low Risk
U940,2024,7,449979.0,Stable Salary & Stable Fixed Expenses,146288,65158.0,31185,96343.0,49945.0,34.14,0.05,Low Risk
U940,2024,8,499924.0,Stable Salary & Stable Fixed Expenses,146288,65158.0,31996,97154.0,49134.0,33.59,-0.01,Low Risk
U940,2024,9,549058.0,Stable Salary & Stable Fixed Expenses,146288,65158.0,32684,97842.0,48446.0,33.12,-0.04,Low Risk
U940,2024,10,597504.0,Stable Salary & Stable Fixed Expenses,146288,65158.0,39307,104465.0,41823.0,28.59,-0.03,Low Risk
U940,2024,11,639327.0,Stable Salary & Stable Fixed Expenses,146288,65158.0,43822,108980.0,37308.0,25.5,-0.02,Low Risk
U940,2024,12,676635.0,Stable Salary & Stable Fixed Expenses,146288,65158.0,38894,104052.0,42236.0,28.87,0.02,Low Risk
U941,2024,1,187856.0,Stable Salary & Stable Fixed Expenses,166849,50636.0,48394,99030.0,67819.0,40.65,-0.01,Low Risk
U941,2024,2,255675.0,Stable Salary & Stable Fixed Expenses,166849,50636.0,48809,99445.0,67404.0,40.4,-0.01,Low Risk
U941,2024,3,323079.0,Stable Salary & Stable Fixed Expenses,166849,50636.0,49373,100009.0,66840.0,40.06,0.01,Low Risk
U941,2024,4,389919.0,Stable Salary & Stable Fixed Expenses,166849,50636.0,42691,93327.0,73522.0,44.06,0.01,Low Risk
U941,2024,5,463441.0,Stable Salary & Stable Fixed Expenses,166849,50636.0,37699,88335.0,78514.0,47.06,-0.05,Low Risk
U941,2024,6,541955.0,Stable Salary & Stable Fixed Expenses,166849,50636.0,44734,95370.0,71479.0,42.84,-0.04,Low Risk
U941,2024,7,613434.0,Stable Salary & Stable Fixed Expenses,166849,50636.0,46026,96662.0,70187.0,42.07,-0.02,Low Risk
U941,2024,8,683621.0,Stable Salary & Stable Fixed Expenses,166849,50636.0,47973,98609.0,68240.0,40.9,0.03,Low Risk
U941,2024,9,751861.0,Stable Salary & Stable Fixed Expenses,166849,50636.0,51991,102627.0,64222.0,38.49,-0.03,Low Risk
U941,2024,10,816083.0,Stable Salary & Stable Fixed Expenses,166849,50636.0,37839,88475.0,78374.0,46.97,-0.05,Low Risk
U941,2024,11,894457.0,Stable Salary & Stable Fixed Expenses,166849,50636.0,46586,97222.0,69627.0,41.73,0.02,Low Risk
U941,2024,12,964084.0,Stable Salary & Stable Fixed Expenses,166849,50636.0,47964,98600.0,68249.0,40.9,-0.02,Low Risk
U942,2024,1,250000.0,Stable Salary & Stable Fixed Expenses,272367,93506.0,62156,155662.0,116705.0,42.85,0.01,Low Risk
U942,2024,2,366705.0,Stable Salary & Stable Fixed Expenses,272367,93506.0,76689,170195.0,102172.0,37.51,0.02,Low Risk
U942,2024,3,468877.0,Stable Salary & Stable Fixed Expenses,272367,93506.0,87381,180887.0,91480.0,33.59,0.05,Low Risk
U942,2024,4,560357.0,Stable Salary & Stable Fixed Expenses,272367,93506.0,61448,154954.0,117413.0,43.11,0.04,Low Risk
U942,2024,5,677770.0,Stable Salary & Stable Fixed Expenses,272367,93506.0,60260,153766.0,118601.0,43.54,-0.02,Low Risk
U942,2024,6,796371.0,Stable Salary & Stable Fixed Expenses,272367,93506.0,80017,173523.0,98844.0,36.29,-0.05,Low Risk
U942,2024,7,895215.0,Stable Salary & Stable Fixed Expenses,272367,93506.0,55041,148547.0,123820.0,45.46,0.03,Low Risk
U942,2024,8,1019035.0,Stable Salary & Stable Fixed Expenses,272367,93506.0,77628,171134.0,101233.0,37.17,-0.02,Low Risk
U942,2024,9,1120268.0,Stable Salary & Stable Fixed Expenses,272367,93506.0,78038,171544.0,100823.0,37.02,0.04,Low Risk
U942,2024,10,1221091.0,Stable Salary & Stable Fixed Expenses,272367,93506.0,86298,179804.0,92563.0,33.98,0.01,Low Risk
U942,2024,11,1313654.0,Stable Salary & Stable Fixed Expenses,272367,93506.0,79519,173025.0,99342.0,36.47,-0.04,Low Risk
U942,2024,12,1412996.0,Stable Salary & Stable Fixed Expenses,272367,93506.0,75249,168755.0,103612.0,38.04,0.01,Low Risk
U943,2024,1,246218.0,Stable Salary & Stable Fixed Expenses,203775,81328.0,92910,174238.0,29537.0,14.49,-0.02,High Risk
U943,2024,2,275755.0,Stable Salary & Stable Fixed Expenses,203775,81328.0,90108,171436.0,32339.0,15.87,-0.0,Medium Risk
U943,2024,3,308094.0,Stable Salary & Stable Fixed Expenses,203775,81328.0,89896,171224.0,32551.0,15.97,-0.03,Medium Risk
U943,2024,4,340645.0,Stable Salary & Stable Fixed Expenses,203775,81328.0,63204,144532.0,59243.0,29.07,0.04,Low Risk
U943,2024,5,399888.0,Stable Salary & Stable Fixed Expenses,203775,81328.0,80688,162016.0,41759.0,20.49,-0.01,Medium Risk
U943,2024,6,441647.0,Stable Salary & Stable Fixed Expenses,203775,81328.0,97074,178402.0,25373.0,12.45,-0.02,High Risk
U943,2024,7,467020.0,Stable Salary & Stable Fixed Expenses,203775,81328.0,86644,167972.0,35803.0,17.57,-0.02,Medium Risk
U943,2024,8,502823.0,Stable Salary & Stable Fixed Expenses,203775,81328.0,88430,169758.0,34017.0,16.69,-0.05,Medium Risk
U943,2024,9,536840.0,Stable Salary & Stable Fixed Expenses,203775,81328.0,71561,152889.0,50886.0,24.97,-0.01,Medium Risk
U943,2024,10,587726.0,Stable Salary & Stable Fixed Expenses,203775,81328.0,79560,160888.0,42887.0,21.05,0.01,Medium Risk
U943,2024,11,630613.0,Stable Salary & Stable Fixed Expenses,203775,81328.0,100615,181943.0,21832.0,10.71,-0.01,High Risk
U943,2024,12,652445.0,Stable Salary & Stable Fixed Expenses,203775,81328.0,87874,169202.0,34573.0,16.97,-0.03,Medium Risk
U944,2024,1,81666.0,Salary Increases & Fixed Expenses Increase,60946,25997.0,17471,43468.0,17478.0,28.68,0.05,Low Risk
U944,2024,2,99144.0,Salary Increases & Fixed Expenses Increase,60946,25997.0,16094,42091.0,18855.0,30.94,-0.03,Low Risk
U944,2024,3,117999.0,Salary Increases & Fixed Expenses Increase,86670,27716.0,32723,60439.0,26231.0,30.27,0.01,Low Risk
U944,2024,4,144230.0,Salary Increases & Fixed Expenses Increase,86670,27716.0,23023,50739.0,35931.0,41.46,-0.03,Low Risk
U944,2024,5,180161.0,Salary Increases & Fixed Expenses Increase,86670,27716.0,24039,51755.0,34915.0,40.28,0.01,Low Risk
U944,2024,6,215076.0,Salary Increases & Fixed Expenses Increase,86670,29624.0,19256,48880.0,37790.0,43.6,0.02,Low Risk
U944,2024,7,252866.0,Salary Increases & Fixed Expenses Increase,86670,29624.0,18455,48079.0,38591.0,44.53,-0.0,Low Risk
U944,2024,8,291457.0,Salary Increases & Fixed Expenses Increase,86670,29624.0,18300,47924.0,38746.0,44.71,0.05,Low Risk
U944,2024,9,330203.0,Salary Increases & Fixed Expenses Increase,86670,29624.0,25965,55589.0,31081.0,35.86,0.02,Low Risk
U944,2024,10,361284.0,Salary Increases & Fixed Expenses Increase,86670,31450.0,25655,57105.0,29565.0,34.11,-0.03,Low Risk
U944,2024,11,390849.0,Salary Increases & Fixed Expenses Increase,86670,31450.0,22488,53938.0,32732.0,37.77,0.03,Low Risk
U944,2024,12,423581.0,Salary Increases & Fixed Expenses Increase,86670,31450.0,29845,61295.0,25375.0,29.28,0.0,Low Risk
U945,2024,1,250000.0,Stable Salary & Stable Fixed Expenses,260477,67067.0,180283,247350.0,13127.0,5.04,-0.0,High Risk
U945,2024,2,263127.0,Stable Salary & Stable Fixed Expenses,260477,67067.0,162149,229216.0,31261.0,12.0,-0.0,High Risk
U945,2024,3,294388.0,Stable Salary & Stable Fixed Expenses,260477,67067.0,140775,207842.0,52635.0,20.21,0.03,Medium Risk
U945,2024,4,347023.0,Stable Salary & Stable Fixed Expenses,260477,67067.0,179922,246989.0,13488.0,5.18,-0.03,High Risk
U945,2024,5,360511.0,Stable Salary & Stable Fixed Expenses,260477,67067.0,161491,228558.0,31919.0,12.25,0.04,High Risk
U945,2024,6,392430.0,Stable Salary & Stable Fixed Expenses,260477,67067.0,156398,223465.0,37012.0,14.21,-0.03,High Risk
U945,2024,7,429442.0,Stable Salary & Stable Fixed Expenses,260477,67067.0,162962,230029.0,30448.0,11.69,0.04,High Risk
U945,2024,8,459890.0,Stable Salary & Stable Fixed Expenses,260477,67067.0,136577,203644.0,56833.0,21.82,0.01,Medium Risk
U945,2024,9,516723.0,Stable Salary & Stable Fixed Expenses,260477,67067.0,166071,233138.0,27339.0,10.5,0.03,High Risk
U945,2024,10,544062.0,Stable Salary & Stable Fixed Expenses,260477,67067.0,132238,199305.0,61172.0,23.48,-0.02,Medium Risk
U945,2024,11,605234.0,Stable Salary & Stable Fixed Expenses,260477,67067.0,180731,247798.0,12679.0,4.87,-0.02,High Risk
U945,2024,12,617913.0,Stable Salary & Stable Fixed Expenses,260477,67067.0,149859,216926.0,43551.0,16.72,0.04,Medium Risk
U946,2024,1,156232.0,Stable Salary & Increasing Fixed Expenses,149970,67999.0,36626,104625.0,45345.0,30.24,0.02,Low Risk
U946,2024,2,201577.0,Stable Salary & Increasing Fixed Expenses,149970,67999.0,42366,110365.0,39605.0,26.41,-0.0,Low Risk
U946,2024,3,241182.0,Stable Salary & Increasing Fixed Expenses,149970,68648.0,40107,108755.0,41215.0,27.48,0.03,Low Risk
U946,2024,4,282397.0,Stable Salary & Increasing Fixed Expenses,149970,68648.0,32962,101610.0,48360.0,32.25,0.04,Low Risk
U946,2024,5,330757.0,Stable Salary & Increasing Fixed Expenses,149970,68648.0,37741,106389.0,43581.0,29.06,-0.04,Low Risk
U946,2024,6,374338.0,Stable Salary & Increasing Fixed Expenses,149970,68648.0,40891,109539.0,40431.0,26.96,-0.01,Low Risk
U946,2024,7,414769.0,Stable Salary & Increasing Fixed Expenses,149970,68648.0,33912,102560.0,47410.0,31.61,-0.01,Low Risk
U946,2024,8,462179.0,Stable Salary & Increasing Fixed Expenses,149970,69226.0,30282,99508.0,50462.0,33.65,-0.0,Low Risk
U946,2024,9,512641.0,Stable Salary & Increasing Fixed Expenses,149970,69226.0,47187,116413.0,33557.0,22.38,-0.03,Medium Risk
U946,2024,10,546198.0,Stable Salary & Increasing Fixed Expenses,149970,69783.0,44342,114125.0,35845.0,23.9,0.04,Medium Risk
U946,2024,11,582043.0,Stable Salary & Increasing Fixed Expenses,149970,69783.0,40258,110041.0,39929.0,26.62,-0.01,Low Risk
U946,2024,12,621972.0,Stable Salary & Increasing Fixed Expenses,149970,69783.0,38314,108097.0,41873.0,27.92,0.04,Low Risk
U947,2024,1,248567.0,Stable Salary & Decreasing Fixed Expenses,21753,18663.0,7581,26244.0,-4491.0,-20.65,0.03,High Risk
U947,2024,2,244076.0,Stable Salary & Decreasing Fixed Expenses,21753,18663.0,10536,29199.0,-7446.0,-34.23,-0.05,High Risk
U947,2024,3,236630.0,Stable Salary & Decreasing Fixed Expenses,21753,18663.0,6701,25364.0,-3611.0,-16.6,-0.0,High Risk
U947,2024,4,233019.0,Stable Salary & Decreasing Fixed Expenses,21753,18663.0,6863,25526.0,-3773.0,-17.34,0.02,High Risk
U947,2024,5,229246.0,Stable Salary & Decreasing Fixed Expenses,21753,18663.0,9727,28390.0,-6637.0,-30.51,0.05,High Risk
U947,2024,6,222609.0,Stable Salary & Decreasing Fixed Expenses,21753,18663.0,10097,28760.0,-7007.0,-32.21,0.04,High Risk
U947,2024,7,215602.0,Stable Salary & Decreasing Fixed Expenses,21753,18663.0,8756,27419.0,-5666.0,-26.05,-0.03,High Risk
U947,2024,8,209936.0,Stable Salary & Decreasing Fixed Expenses,21753,18663.0,7985,26648.0,-4895.0,-22.5,0.03,High Risk
U947,2024,9,205041.0,Stable Salary & Decreasing Fixed Expenses,21753,18663.0,7861,26524.0,-4771.0,-21.93,-0.01,High Risk
U947,2024,10,200270.0,Stable Salary & Decreasing Fixed Expenses,21753,18663.0,8900,27563.0,-5810.0,-26.71,-0.05,High Risk
U947,2024,11,194460.0,Stable Salary & Decreasing Fixed Expenses,21753,18663.0,9052,27715.0,-5962.0,-27.41,0.04,High Risk
U947,2024,12,188498.0,Stable Salary & Decreasing Fixed Expenses,21753,18663.0,7331,25994.0,-4241.0,-19.5,0.02,High Risk
U948,2024,1,247751.0,Salary Increases & Fixed Expenses Increase,105698,46333.0,60247,106580.0,-882.0,-0.83,-0.03,High Risk
U948,2024,2,246869.0,Salary Increases & Fixed Expenses Increase,105698,46333.0,62903,109236.0,-3538.0,-3.35,-0.02,High Risk
U948,2024,3,243331.0,Salary Increases & Fixed Expenses Increase,105698,46333.0,65154,111487.0,-5789.0,-5.48,-0.03,High Risk
U948,2024,4,237542.0,Salary Increases & Fixed Expenses Increase,105698,46333.0,71747,118080.0,-12382.0,-11.71,-0.04,High Risk
U948,2024,5,225160.0,Salary Increases & Fixed Expenses Increase,111025,47152.0,62224,109376.0,1649.0,1.49,0.02,High Risk
U948,2024,6,226809.0,Salary Increases & Fixed Expenses Increase,111025,47152.0,74334,121486.0,-10461.0,-9.42,0.01,High Risk
U948,2024,7,216348.0,Salary Increases & Fixed Expenses Increase,111025,47152.0,60148,107300.0,3725.0,3.36,0.01,High Risk
U948,2024,8,220073.0,Salary Increases & Fixed Expenses Increase,111025,48049.0,56916,104965.0,6060.0,5.46,-0.01,High Risk
U948,2024,9,226133.0,Salary Increases & Fixed Expenses Increase,111025,48049.0,74230,122279.0,-11254.0,-10.14,-0.04,High Risk
U948,2024,10,214879.0,Salary Increases & Fixed Expenses Increase,111025,49917.0,56266,106183.0,4842.0,4.36,0.02,High Risk
U948,2024,11,219721.0,Salary Increases & Fixed Expenses Increase,111025,49917.0,65129,115046.0,-4021.0,-3.62,-0.0,High Risk
U948,2024,12,215700.0,Salary Increases & Fixed Expenses Increase,111025,49917.0,69688,119605.0,-8580.0,-7.73,0.03,High Risk
U949,2024,1,236903.0,Salary Increases & Fixed Expenses Increase,220457,94091.0,108140,202231.0,18226.0,8.27,-0.02,High Risk
U949,2024,2,255129.0,Salary Increases & Fixed Expenses Increase,220457,94091.0,81250,175341.0,45116.0,20.46,0.03,Medium Risk
U949,2024,3,300245.0,Salary Increases & Fixed Expenses Increase,220457,94091.0,106123,200214.0,20243.0,9.18,0.02,High Risk
U949,2024,4,320488.0,Salary Increases & Fixed Expenses Increase,240190,94091.0,103761,197852.0,42338.0,17.63,0.02,Medium Risk
U949,2024,5,362826.0,Salary Increases & Fixed Expenses Increase,240190,95540.0,94899,190439.0,49751.0,20.71,-0.05,Medium Risk
U949,2024,6,412577.0,Salary Increases & Fixed Expenses Increase,240190,96065.0,82740,178805.0,61385.0,25.56,0.02,Low Risk
U949,2024,7,473962.0,Salary Increases & Fixed Expenses Increase,240190,96065.0,96470,192535.0,47655.0,19.84,0.01,Medium Risk
U949,2024,8,521617.0,Salary Increases & Fixed Expenses Increase,240190,96065.0,90332,186397.0,53793.0,22.4,0.05,Medium Risk
U949,2024,9,575410.0,Salary Increases & Fixed Expenses Increase,240190,96065.0,87210,183275.0,56915.0,23.7,0.01,Medium Risk
U949,2024,10,632325.0,Salary Increases & Fixed Expenses Increase,240190,96065.0,104858,200923.0,39267.0,16.35,-0.01,Medium Risk
U949,2024,11,671592.0,Salary Increases & Fixed Expenses Increase,240190,96065.0,123457,219522.0,20668.0,8.6,0.01,High Risk
U949,2024,12,692260.0,Salary Increases & Fixed Expenses Increase,240190,96065.0,93840,189905.0,50285.0,20.94,0.02,Medium Risk
U950,2024,1,176299.0,Stable Salary & Increasing Fixed Expenses,85297,38588.0,20605,59193.0,26104.0,30.6,-0.0,Low Risk
U950,2024,2,202403.0,Stable Salary & Increasing Fixed Expenses,85297,38588.0,21968,60556.0,24741.0,29.01,-0.05,Low Risk
U950,2024,3,227144.0,Stable Salary & Increasing Fixed Expenses,85297,38588.0,24042,62630.0,22667.0,26.57,-0.02,Low Risk
U950,2024,4,249811.0,Stable Salary & Increasing Fixed Expenses,85297,38588.0,23737,62325.0,22972.0,26.93,0.05,Low Risk
U950,2024,5,272783.0,Stable Salary & Increasing Fixed Expenses,85297,38588.0,18024,56612.0,28685.0,33.63,0.04,Low Risk
U950,2024,6,301468.0,Stable Salary & Increasing Fixed Expenses,85297,38588.0,18119,56707.0,28590.0,33.52,0.0,Low Risk
U950,2024,7,330058.0,Stable Salary & Increasing Fixed Expenses,85297,38588.0,19515,58103.0,27194.0,31.88,-0.04,Low Risk
U950,2024,8,357252.0,Stable Salary & Increasing Fixed Expenses,85297,38588.0,21607,60195.0,25102.0,29.43,-0.04,Low Risk
U950,2024,9,382354.0,Stable Salary & Increasing Fixed Expenses,85297,38588.0,20481,59069.0,26228.0,30.75,0.03,Low Risk
U950,2024,10,408582.0,Stable Salary & Increasing Fixed Expenses,85297,40246.0,22807,63053.0,22244.0,26.08,-0.04,Low Risk
U950,2024,11,430826.0,Stable Salary & Increasing Fixed Expenses,85297,40246.0,22561,62807.0,22490.0,26.37,-0.05,Low Risk
U950,2024,12,453316.0,Stable Salary & Increasing Fixed Expenses,85297,41606.0,21990,63596.0,21701.0,25.44,0.03,Low Risk
U951,2024,1,180940.0,Stable Salary & Increasing Fixed Expenses,125641,60909.0,59574,120483.0,5158.0,4.11,0.05,High Risk
U951,2024,2,186098.0,Stable Salary & Increasing Fixed Expenses,125641,60909.0,38426,99335.0,26306.0,20.94,0.01,Medium Risk
U951,2024,3,212404.0,Stable Salary & Increasing Fixed Expenses,125641,60909.0,50019,110928.0,14713.0,11.71,0.01,High Risk
U951,2024,4,227117.0,Stable Salary & Increasing Fixed Expenses,125641,60909.0,48902,109811.0,15830.0,12.6,-0.03,High Risk
U951,2024,5,242947.0,Stable Salary & Increasing Fixed Expenses,125641,60909.0,38450,99359.0,26282.0,20.92,0.0,Medium Risk
U951,2024,6,269229.0,Stable Salary & Increasing Fixed Expenses,125641,60909.0,59496,120405.0,5236.0,4.17,-0.03,High Risk
U951,2024,7,274465.0,Stable Salary & Increasing Fixed Expenses,125641,60909.0,56704,117613.0,8028.0,6.39,0.02,High Risk
U951,2024,8,282493.0,Stable Salary & Increasing Fixed Expenses,125641,60909.0,44114,105023.0,20618.0,16.41,-0.0,Medium Risk
U951,2024,9,303111.0,Stable Salary & Increasing Fixed Expenses,125641,60909.0,55942,116851.0,8790.0,7.0,-0.02,High Risk
U951,2024,10,311901.0,Stable Salary & Increasing Fixed Expenses,125641,60909.0,48952,109861.0,15780.0,12.56,-0.01,High Risk
U951,2024,11,327681.0,Stable Salary & Increasing Fixed Expenses,125641,60909.0,53266,114175.0,11466.0,9.13,-0.04,High Risk
U951,2024,12,339147.0,Stable Salary & Increasing Fixed Expenses,125641,60909.0,65951,126860.0,-1219.0,-0.97,-0.02,High Risk
U952,2024,1,71144.0,Stable Salary & Increasing Fixed Expenses,55972,30913.0,23248,54161.0,1811.0,3.24,0.04,High Risk
U952,2024,2,72955.0,Stable Salary & Increasing Fixed Expenses,55972,30913.0,25338,56251.0,-279.0,-0.5,-0.0,High Risk
U952,2024,3,72676.0,Stable Salary & Increasing Fixed Expenses,55972,30913.0,26841,57754.0,-1782.0,-3.18,-0.02,High Risk
U952,2024,4,70894.0,Stable Salary & Increasing Fixed Expenses,55972,30913.0,20326,51239.0,4733.0,8.46,-0.04,High Risk
U952,2024,5,75627.0,Stable Salary & Increasing Fixed Expenses,55972,30913.0,19801,50714.0,5258.0,9.39,-0.04,High Risk
U952,2024,6,80885.0,Stable Salary & Increasing Fixed Expenses,55972,30913.0,22159,53072.0,2900.0,5.18,-0.04,High Risk
U952,2024,7,83785.0,Stable Salary & Increasing Fixed Expenses,55972,30913.0,24996,55909.0,63.0,0.11,0.03,High Risk
U952,2024,8,83848.0,Stable Salary & Increasing Fixed Expenses,55972,30913.0,23991,54904.0,1068.0,1.91,0.0,High Risk
U952,2024,9,84916.0,Stable Salary & Increasing Fixed Expenses,55972,30913.0,29772,60685.0,-4713.0,-8.42,-0.03,High Risk
U952,2024,10,80203.0,Stable Salary & Increasing Fixed Expenses,55972,30913.0,26777,57690.0,-1718.0,-3.07,-0.04,High Risk
U952,2024,11,78485.0,Stable Salary & Increasing Fixed Expenses,55972,30913.0,21536,52449.0,3523.0,6.29,-0.0,High Risk
U952,2024,12,82008.0,Stable Salary & Increasing Fixed Expenses,55972,30913.0,23242,54155.0,1817.0,3.25,-0.0,High Risk
U953,2024,1,228169.0,Stable Salary & Increasing Fixed Expenses,143357,75989.0,31214,107203.0,36154.0,25.22,0.03,Low Risk
U953,2024,2,264323.0,Stable Salary & Increasing Fixed Expenses,143357,75989.0,29856,105845.0,37512.0,26.17,-0.05,Low Risk
U953,2024,3,301835.0,Stable Salary & Increasing Fixed Expenses,143357,75989.0,37544,113533.0,29824.0,20.8,-0.02,Medium Risk
U953,2024,4,331659.0,Stable Salary & Increasing Fixed Expenses,143357,75989.0,41114,117103.0,26254.0,18.31,-0.01,Medium Risk
U953,2024,5,357913.0,Stable Salary & Increasing Fixed Expenses,143357,75989.0,42392,118381.0,24976.0,17.42,0.04,Medium Risk
U953,2024,6,382889.0,Stable Salary & Increasing Fixed Expenses,143357,75989.0,41097,117086.0,26271.0,18.33,0.0,Medium Risk
U953,2024,7,409160.0,Stable Salary & Increasing Fixed Expenses,143357,77920.0,29623,107543.0,35814.0,24.98,0.03,Medium Risk
U953,2024,8,444974.0,Stable Salary & Increasing Fixed Expenses,143357,77920.0,38025,115945.0,27412.0,19.12,-0.03,Medium Risk
U953,2024,9,472386.0,Stable Salary & Increasing Fixed Expenses,143357,77920.0,36412,114332.0,29025.0,20.25,-0.04,Medium Risk
U953,2024,10,501411.0,Stable Salary & Increasing Fixed Expenses,143357,77920.0,42943,120863.0,22494.0,15.69,0.02,Medium Risk
U953,2024,11,523905.0,Stable Salary & Increasing Fixed Expenses,143357,77920.0,30090,108010.0,35347.0,24.66,0.05,Medium Risk
U953,2024,12,559252.0,Stable Salary & Increasing Fixed Expenses,143357,77920.0,31270,109190.0,34167.0,23.83,-0.01,Medium Risk
U954,2024,1,77255.0,Stable Salary & Stable Fixed Expenses,57501,34482.0,24166,58648.0,-1147.0,-1.99,0.01,High Risk
U954,2024,2,76108.0,Stable Salary & Stable Fixed Expenses,57501,34482.0,21558,56040.0,1461.0,2.54,-0.04,High Risk
U954,2024,3,77569.0,Stable Salary & Stable Fixed Expenses,57501,34482.0,30323,64805.0,-7304.0,-12.7,-0.05,High Risk
U954,2024,4,70265.0,Stable Salary & Stable Fixed Expenses,57501,34482.0,24218,58700.0,-1199.0,-2.09,0.02,High Risk
U954,2024,5,69066.0,Stable Salary & Stable Fixed Expenses,57501,34482.0,26872,61354.0,-3853.0,-6.7,-0.04,High Risk
U954,2024,6,65213.0,Stable Salary & Stable Fixed Expenses,57501,34482.0,26557,61039.0,-3538.0,-6.15,-0.02,High Risk
U954,2024,7,61675.0,Stable Salary & Stable Fixed Expenses,57501,34482.0,18508,52990.0,4511.0,7.85,0.0,High Risk
U954,2024,8,66186.0,Stable Salary & Stable Fixed Expenses,57501,34482.0,25330,59812.0,-2311.0,-4.02,-0.05,High Risk
U954,2024,9,63875.0,Stable Salary & Stable Fixed Expenses,57501,34482.0,30416,64898.0,-7397.0,-12.86,-0.02,High Risk
U954,2024,10,56478.0,Stable Salary & Stable Fixed Expenses,57501,34482.0,27642,62124.0,-4623.0,-8.04,0.03,High Risk
U954,2024,11,51855.0,Stable Salary & Stable Fixed Expenses,57501,34482.0,25967,60449.0,-2948.0,-5.13,0.04,High Risk
U954,2024,12,48907.0,Stable Salary & Stable Fixed Expenses,57501,34482.0,27357,61839.0,-4338.0,-7.54,0.01,High Risk
U955,2024,1,224433.0,Salary Increases & Fixed Expenses Decrease,170650,53938.0,50276,104214.0,66436.0,38.93,0.04,Low Risk
U955,2024,2,290869.0,Salary Increases & Fixed Expenses Decrease,170650,53938.0,41419,95357.0,75293.0,44.12,-0.01,Low Risk
U955,2024,3,366162.0,Salary Increases & Fixed Expenses Decrease,170650,53938.0,36364,90302.0,80348.0,47.08,-0.02,Low Risk
U955,2024,4,446510.0,Salary Increases & Fixed Expenses Decrease,170650,53938.0,48957,102895.0,67755.0,39.7,-0.04,Low Risk
U955,2024,5,514265.0,Salary Increases & Fixed Expenses Decrease,170650,53938.0,43691,97629.0,73021.0,42.79,0.02,Low Risk
U955,2024,6,587286.0,Salary Increases & Fixed Expenses Decrease,193612,53938.0,49208,103146.0,90466.0,46.73,-0.03,Low Risk
U955,2024,7,677752.0,Salary Increases & Fixed Expenses Decrease,193612,53938.0,53602,107540.0,86072.0,44.46,0.03,Low Risk
U955,2024,8,763824.0,Salary Increases & Fixed Expenses Decrease,193612,53938.0,39464,93402.0,100210.0,51.76,-0.02,Low Risk
U955,2024,9,864034.0,Salary Increases & Fixed Expenses Decrease,193612,53938.0,54576,108514.0,85098.0,43.95,0.05,Low Risk
U955,2024,10,949132.0,Salary Increases & Fixed Expenses Decrease,193612,53938.0,45353,99291.0,94321.0,48.72,0.04,Low Risk
U955,2024,11,1043453.0,Salary Increases & Fixed Expenses Decrease,193612,53938.0,48875,102813.0,90799.0,46.9,0.02,Low Risk
U955,2024,12,1134252.0,Salary Increases & Fixed Expenses Decrease,193612,53938.0,40538,94476.0,99136.0,51.2,-0.02,Low Risk
U956,2024,1,219498.0,Salary Increases & Fixed Expenses Remain Stable,185520,54827.0,43545,98372.0,87148.0,46.97,0.05,Low Risk
U956,2024,2,306646.0,Salary Increases & Fixed Expenses Remain Stable,185520,54827.0,48422,103249.0,82271.0,44.35,0.02,Low Risk
U956,2024,3,388917.0,Salary Increases & Fixed Expenses Remain Stable,185520,54827.0,42382,97209.0,88311.0,47.6,-0.02,Low Risk
U956,2024,4,477228.0,Salary Increases & Fixed Expenses Remain Stable,185520,54827.0,49232,104059.0,81461.0,43.91,-0.02,Low Risk
U956,2024,5,558689.0,Salary Increases & Fixed Expenses Remain Stable,185520,54827.0,48995,103822.0,81698.0,44.04,0.03,Low Risk
U956,2024,6,640387.0,Salary Increases & Fixed Expenses Remain Stable,185520,54827.0,53075,107902.0,77618.0,41.84,0.04,Low Risk
U956,2024,7,718005.0,Salary Increases & Fixed Expenses Remain Stable,197852,54827.0,51084,105911.0,91941.0,46.47,0.0,Low Risk
U956,2024,8,809946.0,Salary Increases & Fixed Expenses Remain Stable,197852,54827.0,57841,112668.0,85184.0,43.05,-0.02,Low Risk
U956,2024,9,895130.0,Salary Increases & Fixed Expenses Remain Stable,197852,54827.0,59021,113848.0,84004.0,42.46,-0.02,Low Risk
U956,2024,10,979134.0,Salary Increases & Fixed Expenses Remain Stable,197852,54827.0,44478,99305.0,98547.0,49.81,-0.04,Low Risk
U956,2024,11,1077681.0,Salary Increases & Fixed Expenses Remain Stable,197852,54827.0,65182,120009.0,77843.0,39.34,-0.01,Low Risk
U956,2024,12,1155524.0,Salary Increases & Fixed Expenses Remain Stable,197852,54827.0,55443,110270.0,87582.0,44.27,0.04,Low Risk
U957,2024,1,144759.0,Salary Increases & Fixed Expenses Remain Stable,125983,46647.0,80428,127075.0,-1092.0,-0.87,0.0,High Risk
U957,2024,2,143667.0,Salary Increases & Fixed Expenses Remain Stable,125983,46647.0,66238,112885.0,13098.0,10.4,0.03,High Risk
U957,2024,3,156765.0,Salary Increases & Fixed Expenses Remain Stable,125983,46647.0,71305,117952.0,8031.0,6.37,0.02,High Risk
U957,2024,4,164796.0,Salary Increases & Fixed Expenses Remain Stable,125983,46647.0,84295,130942.0,-4959.0,-3.94,0.01,High Risk
U957,2024,5,159837.0,Salary Increases & Fixed Expenses Remain Stable,125983,46647.0,70358,117005.0,8978.0,7.13,-0.04,High Risk
U957,2024,6,168815.0,Salary Increases & Fixed Expenses Remain Stable,140438,46647.0,82247,128894.0,11544.0,8.22,0.04,High Risk
U957,2024,7,180359.0,Salary Increases & Fixed Expenses Remain Stable,140438,46647.0,87074,133721.0,6717.0,4.78,-0.02,High Risk
U957,2024,8,187076.0,Salary Increases & Fixed Expenses Remain Stable,140438,46647.0,75443,122090.0,18348.0,13.06,-0.01,High Risk
U957,2024,9,205424.0,Salary Increases & Fixed Expenses Remain Stable,140438,46647.0,92070,138717.0,1721.0,1.23,0.05,High Risk
U957,2024,10,207145.0,Salary Increases & Fixed Expenses Remain Stable,140438,46647.0,70584,117231.0,23207.0,16.52,-0.0,Medium Risk
U957,2024,11,230352.0,Salary Increases & Fixed Expenses Remain Stable,140438,46647.0,93654,140301.0,137.0,0.1,0.03,High Risk
U957,2024,12,230489.0,Salary Increases & Fixed Expenses Remain Stable,140438,46647.0,84935,131582.0,8856.0,6.31,-0.04,High Risk
U958,2024,1,187017.0,Salary Increases & Fixed Expenses Remain Stable,126906,41523.0,60971,102494.0,24412.0,19.24,-0.03,Medium Risk
U958,2024,2,211429.0,Salary Increases & Fixed Expenses Remain Stable,126906,41523.0,46228,87751.0,39155.0,30.85,0.03,Low Risk
U958,2024,3,250584.0,Salary Increases & Fixed Expenses Remain Stable,126906,41523.0,46425,87948.0,38958.0,30.7,0.0,Low Risk
U958,2024,4,289542.0,Salary Increases & Fixed Expenses Remain Stable,126906,41523.0,38402,79925.0,46981.0,37.02,-0.02,Low Risk
U958,2024,5,336523.0,Salary Increases & Fixed Expenses Remain Stable,126906,41523.0,61547,103070.0,23836.0,18.78,-0.04,Medium Risk
U958,2024,6,360359.0,Salary Increases & Fixed Expenses Remain Stable,126906,41523.0,53057,94580.0,32326.0,25.47,0.03,Low Risk
U958,2024,7,392685.0,Salary Increases & Fixed Expenses Remain Stable,134337,41523.0,45294,86817.0,47520.0,35.37,-0.04,Low Risk
U958,2024,8,440205.0,Salary Increases & Fixed Expenses Remain Stable,134337,41523.0,63543,105066.0,29271.0,21.79,0.01,Medium Risk
U958,2024,9,469476.0,Salary Increases & Fixed Expenses Remain Stable,134337,41523.0,55720,97243.0,37094.0,27.61,0.03,Low Risk
U958,2024,10,506570.0,Salary Increases & Fixed Expenses Remain Stable,134337,41523.0,63924,105447.0,28890.0,21.51,0.01,Medium Risk
U958,2024,11,535460.0,Salary Increases & Fixed Expenses Remain Stable,134337,41523.0,44029,85552.0,48785.0,36.32,-0.04,Low Risk
U958,2024,12,584245.0,Salary Increases & Fixed Expenses Remain Stable,134337,41523.0,48841,90364.0,43973.0,32.73,-0.01,Low Risk
U959,2024,1,250000.0,Salary Increases & Fixed Expenses Remain Stable,251280,96091.0,62628,158719.0,92561.0,36.84,-0.04,Low Risk
U959,2024,2,342561.0,Salary Increases & Fixed Expenses Remain Stable,251280,96091.0,65348,161439.0,89841.0,35.75,0.0,Low Risk
U959,2024,3,432402.0,Salary Increases & Fixed Expenses Remain Stable,251280,96091.0,68661,164752.0,86528.0,34.43,-0.02,Low Risk
U959,2024,4,518930.0,Salary Increases & Fixed Expenses Remain Stable,251280,96091.0,55725,151816.0,99464.0,39.58,-0.04,Low Risk
U959,2024,5,618394.0,Salary Increases & Fixed Expenses Remain Stable,258518,96091.0,52379,148470.0,110048.0,42.57,0.05,Low Risk
U959,2024,6,728442.0,Salary Increases & Fixed Expenses Remain Stable,258518,96091.0,56090,152181.0,106337.0,41.13,0.01,Low Risk
U959,2024,7,834779.0,Salary Increases & Fixed Expenses Remain Stable,258518,96091.0,59124,155215.0,103303.0,39.96,-0.03,Low Risk
U959,2024,8,938082.0,Salary Increases & Fixed Expenses Remain Stable,258518,96091.0,64677,160768.0,97750.0,37.81,0.03,Low Risk
U959,2024,9,1035832.0,Salary Increases & Fixed Expenses Remain Stable,258518,96091.0,80661,176752.0,81766.0,31.63,-0.05,Low Risk
U959,2024,10,1117598.0,Salary Increases & Fixed Expenses Remain Stable,258518,96091.0,61608,157699.0,100819.0,39.0,-0.0,Low Risk
U959,2024,11,1218417.0,Salary Increases & Fixed Expenses Remain Stable,258518,96091.0,68646,164737.0,93781.0,36.28,-0.05,Low Risk
U959,2024,12,1312198.0,Salary Increases & Fixed Expenses Remain Stable,258518,96091.0,60938,157029.0,101489.0,39.26,0.02,Low Risk
U960,2024,1,129269.0,Stable Salary & Increasing Fixed Expenses,65002,32814.0,18969,51783.0,13219.0,20.34,-0.05,Medium Risk
U960,2024,2,142488.0,Stable Salary & Increasing Fixed Expenses,65002,32814.0,18866,51680.0,13322.0,20.49,0.04,Medium Risk
U960,2024,3,155810.0,Stable Salary & Increasing Fixed Expenses,65002,34441.0,19269,53710.0,11292.0,17.37,0.03,Medium Risk
U960,2024,4,167102.0,Stable Salary & Increasing Fixed Expenses,65002,34441.0,15685,50126.0,14876.0,22.89,0.03,Medium Risk
U960,2024,5,181978.0,Stable Salary & Increasing Fixed Expenses,65002,34441.0,14364,48805.0,16197.0,24.92,0.0,Medium Risk
U960,2024,6,198175.0,Stable Salary & Increasing Fixed Expenses,65002,34441.0,13001,47442.0,17560.0,27.01,-0.02,Low Risk
U960,2024,7,215735.0,Stable Salary & Increasing Fixed Expenses,65002,34441.0,16405,50846.0,14156.0,21.78,0.02,Medium Risk
U960,2024,8,229891.0,Stable Salary & Increasing Fixed Expenses,65002,34441.0,16621,51062.0,13940.0,21.45,-0.0,Medium Risk
U960,2024,9,243831.0,Stable Salary & Increasing Fixed Expenses,65002,34441.0,17921,52362.0,12640.0,19.45,-0.03,Medium Risk
U960,2024,10,256471.0,Stable Salary & Increasing Fixed Expenses,65002,34441.0,16732,51173.0,13829.0,21.27,0.03,Medium Risk
U960,2024,11,270300.0,Stable Salary & Increasing Fixed Expenses,65002,34441.0,15334,49775.0,15227.0,23.43,0.02,Medium Risk
U960,2024,12,285527.0,Stable Salary & Increasing Fixed Expenses,65002,34441.0,13348,47789.0,17213.0,26.48,-0.03,Low Risk
U961,2024,1,74530.0,Salary Increases & Fixed Expenses Remain Stable,66637,23017.0,31842,54859.0,11778.0,17.67,0.02,Medium Risk
U961,2024,2,86308.0,Salary Increases & Fixed Expenses Remain Stable,66637,23017.0,33287,56304.0,10333.0,15.51,-0.05,Medium Risk
U961,2024,3,96641.0,Salary Increases & Fixed Expenses Remain Stable,66637,23017.0,27829,50846.0,15791.0,23.7,0.05,Medium Risk
U961,2024,4,112432.0,Salary Increases & Fixed Expenses Remain Stable,66637,23017.0,28084,51101.0,15536.0,23.31,0.01,Medium Risk
U961,2024,5,127968.0,Salary Increases & Fixed Expenses Remain Stable,80513,23017.0,25804,48821.0,31692.0,39.36,-0.02,Low Risk
U961,2024,6,159660.0,Salary Increases & Fixed Expenses Remain Stable,80513,23017.0,27430,50447.0,30066.0,37.34,-0.01,Low Risk
U961,2024,7,189726.0,Salary Increases & Fixed Expenses Remain Stable,80513,23017.0,33310,56327.0,24186.0,30.04,-0.04,Low Risk
U961,2024,8,213912.0,Salary Increases & Fixed Expenses Remain Stable,80513,23017.0,27122,50139.0,30374.0,37.73,-0.03,Low Risk
U961,2024,9,244286.0,Salary Increases & Fixed Expenses Remain Stable,80513,23017.0,25153,48170.0,32343.0,40.17,-0.01,Low Risk
U961,2024,10,276629.0,Salary Increases & Fixed Expenses Remain Stable,80513,23017.0,27408,50425.0,30088.0,37.37,0.02,Low Risk
U961,2024,11,306717.0,Salary Increases & Fixed Expenses Remain Stable,80513,23017.0,31610,54627.0,25886.0,32.15,0.02,Low Risk
U961,2024,12,332603.0,Salary Increases & Fixed Expenses Remain Stable,80513,23017.0,35795,58812.0,21701.0,26.95,0.01,Low Risk
U962,2024,1,223523.0,Stable Salary & Stable Fixed Expenses,180691,62857.0,61914,124771.0,55920.0,30.95,0.01,Low Risk
U962,2024,2,279443.0,Stable Salary & Stable Fixed Expenses,180691,62857.0,55649,118506.0,62185.0,34.42,0.0,Low Risk
U962,2024,3,341628.0,Stable Salary & Stable Fixed Expenses,180691,62857.0,94953,157810.0,22881.0,12.66,0.02,High Risk
U962,2024,4,364509.0,Stable Salary & Stable Fixed Expenses,180691,62857.0,54407,117264.0,63427.0,35.1,-0.03,Low Risk
U962,2024,5,427936.0,Stable Salary & Stable Fixed Expenses,180691,62857.0,58669,121526.0,59165.0,32.74,-0.01,Low Risk
U962,2024,6,487101.0,Stable Salary & Stable Fixed Expenses,180691,62857.0,73335,136192.0,44499.0,24.63,-0.03,Medium Risk
U962,2024,7,531600.0,Stable Salary & Stable Fixed Expenses,180691,62857.0,90277,153134.0,27557.0,15.25,-0.03,Medium Risk
U962,2024,8,559157.0,Stable Salary & Stable Fixed Expenses,180691,62857.0,66313,129170.0,51521.0,28.51,-0.04,Low Risk
U962,2024,9,610678.0,Stable Salary & Stable Fixed Expenses,180691,62857.0,76698,139555.0,41136.0,22.77,0.03,Medium Risk
U962,2024,10,651814.0,Stable Salary & Stable Fixed Expenses,180691,62857.0,75545,138402.0,42289.0,23.4,0.04,Medium Risk
U962,2024,11,694103.0,Stable Salary & Stable Fixed Expenses,180691,62857.0,97989,160846.0,19845.0,10.98,0.05,High Risk
U962,2024,12,713948.0,Stable Salary & Stable Fixed Expenses,180691,62857.0,88093,150950.0,29741.0,16.46,0.04,Medium Risk
U963,2024,1,250000.0,Salary Increases & Fixed Expenses Increase,258910,114367.0,67145,181512.0,77398.0,29.89,0.02,Low Risk
U963,2024,2,327398.0,Salary Increases & Fixed Expenses Increase,258910,114367.0,65545,179912.0,78998.0,30.51,0.0,Low Risk
U963,2024,3,406396.0,Salary Increases & Fixed Expenses Increase,258910,114367.0,66403,180770.0,78140.0,30.18,-0.02,Low Risk
U963,2024,4,484536.0,Salary Increases & Fixed Expenses Increase,258910,114367.0,73867,188234.0,70676.0,27.3,0.05,Low Risk
U963,2024,5,555212.0,Salary Increases & Fixed Expenses Increase,258910,114367.0,66531,180898.0,78012.0,30.13,-0.02,Low Risk
U963,2024,6,633224.0,Salary Increases & Fixed Expenses Increase,267347,114367.0,74272,188639.0,78708.0,29.44,-0.03,Low Risk
U963,2024,7,711932.0,Salary Increases & Fixed Expenses Increase,267347,116093.0,62012,178105.0,89242.0,33.38,-0.01,Low Risk
U963,2024,8,801174.0,Salary Increases & Fixed Expenses Increase,267347,116937.0,72982,189919.0,77428.0,28.96,0.02,Low Risk
U963,2024,9,878602.0,Salary Increases & Fixed Expenses Increase,267347,116937.0,82835,199772.0,67575.0,25.28,0.01,Low Risk
U963,2024,10,946177.0,Salary Increases & Fixed Expenses Increase,267347,118336.0,72190,190526.0,76821.0,28.73,-0.03,Low Risk
U963,2024,11,1022998.0,Salary Increases & Fixed Expenses Increase,267347,118336.0,62023,180359.0,86988.0,32.54,-0.02,Low Risk
U963,2024,12,1109986.0,Salary Increases & Fixed Expenses Increase,267347,118336.0,102155,220491.0,46856.0,17.53,0.02,Medium Risk
U964,2024,1,250000.0,Salary Increases & Fixed Expenses Remain Stable,259855,111994.0,54550,166544.0,93311.0,35.91,-0.02,Low Risk
U964,2024,2,343311.0,Salary Increases & Fixed Expenses Remain Stable,259855,111994.0,60628,172622.0,87233.0,33.57,0.01,Low Risk
U964,2024,3,430544.0,Salary Increases & Fixed Expenses Remain Stable,259855,111994.0,56771,168765.0,91090.0,35.05,-0.0,Low Risk
U964,2024,4,521634.0,Salary Increases & Fixed Expenses Remain Stable,259855,111994.0,70763,182757.0,77098.0,29.67,0.03,Low Risk
U964,2024,5,598732.0,Salary Increases & Fixed Expenses Remain Stable,265810,111994.0,67486,179480.0,86330.0,32.48,0.0,Low Risk
U964,2024,6,685062.0,Salary Increases & Fixed Expenses Remain Stable,265810,111994.0,67999,179993.0,85817.0,32.29,0.04,Low Risk
U964,2024,7,770879.0,Salary Increases & Fixed Expenses Remain Stable,265810,111994.0,77773,189767.0,76043.0,28.61,-0.04,Low Risk
U964,2024,8,846922.0,Salary Increases & Fixed Expenses Remain Stable,265810,111994.0,70112,182106.0,83704.0,31.49,0.04,Low Risk
U964,2024,9,930626.0,Salary Increases & Fixed Expenses Remain Stable,265810,111994.0,57852,169846.0,95964.0,36.1,-0.05,Low Risk
U964,2024,10,1026590.0,Salary Increases & Fixed Expenses Remain Stable,265810,111994.0,55917,167911.0,97899.0,36.83,0.02,Low Risk
U964,2024,11,1124489.0,Salary Increases & Fixed Expenses Remain Stable,265810,111994.0,88299,200293.0,65517.0,24.65,-0.03,Medium Risk
U964,2024,12,1190006.0,Salary Increases & Fixed Expenses Remain Stable,265810,111994.0,66677,178671.0,87139.0,32.78,-0.0,Low Risk
U965,2024,1,227508.0,Salary Increases & Fixed Expenses Increase,83457,39696.0,39571,79267.0,4190.0,5.02,-0.01,High Risk
U965,2024,2,231698.0,Salary Increases & Fixed Expenses Increase,83457,39696.0,37027,76723.0,6734.0,8.07,0.03,High Risk
U965,2024,3,238432.0,Salary Increases & Fixed Expenses Increase,83457,39696.0,35355,75051.0,8406.0,10.07,-0.04,High Risk
U965,2024,4,246838.0,Salary Increases & Fixed Expenses Increase,90565,39696.0,44205,83901.0,6664.0,7.36,-0.01,High Risk
U965,2024,5,253502.0,Salary Increases & Fixed Expenses Increase,90565,39696.0,28393,68089.0,22476.0,24.82,-0.04,Medium Risk
U965,2024,6,275978.0,Salary Increases & Fixed Expenses Increase,90565,40752.0,35208,75960.0,14605.0,16.13,0.03,Medium Risk
U965,2024,7,290583.0,Salary Increases & Fixed Expenses Increase,90565,40752.0,36356,77108.0,13457.0,14.86,0.0,High Risk
U965,2024,8,304040.0,Salary Increases & Fixed Expenses Increase,90565,40752.0,31813,72565.0,18000.0,19.88,0.0,Medium Risk
U965,2024,9,322040.0,Salary Increases & Fixed Expenses Increase,90565,40752.0,45023,85775.0,4790.0,5.29,0.04,High Risk
U965,2024,10,326830.0,Salary Increases & Fixed Expenses Increase,90565,42366.0,39877,82243.0,8322.0,9.19,-0.05,High Risk
U965,2024,11,335152.0,Salary Increases & Fixed Expenses Increase,90565,43920.0,43650,87570.0,2995.0,3.31,0.01,High Risk
U965,2024,12,338147.0,Salary Increases & Fixed Expenses Increase,90565,43920.0,44151,88071.0,2494.0,2.75,0.03,High Risk
U966,2024,1,202195.0,Salary Increases & Fixed Expenses Increase,135612,72154.0,52517,124671.0,10941.0,8.07,-0.02,High Risk
U966,2024,2,213136.0,Salary Increases & Fixed Expenses Increase,135612,72154.0,47729,119883.0,15729.0,11.6,-0.04,High Risk
U966,2024,3,228865.0,Salary Increases & Fixed Expenses Increase,135612,72154.0,65223,137377.0,-1765.0,-1.3,-0.01,High Risk
U966,2024,4,227100.0,Salary Increases & Fixed Expenses Increase,162727,72154.0,55916,128070.0,34657.0,21.3,-0.05,Medium Risk
U966,2024,5,261757.0,Salary Increases & Fixed Expenses Increase,162727,72154.0,56419,128573.0,34154.0,20.99,0.02,Medium Risk
U966,2024,6,295911.0,Salary Increases & Fixed Expenses Increase,162727,73951.0,77830,151781.0,10946.0,6.73,0.03,High Risk
U966,2024,7,306857.0,Salary Increases & Fixed Expenses Increase,162727,74860.0,79538,154398.0,8329.0,5.12,-0.0,High Risk
U966,2024,8,315186.0,Salary Increases & Fixed Expenses Increase,162727,74860.0,61486,136346.0,26381.0,16.21,0.05,Medium Risk
U966,2024,9,341567.0,Salary Increases & Fixed Expenses Increase,162727,74860.0,82042,156902.0,5825.0,3.58,0.02,High Risk
U966,2024,10,347392.0,Salary Increases & Fixed Expenses Increase,162727,74860.0,67040,141900.0,20827.0,12.8,0.04,High Risk
U966,2024,11,368219.0,Salary Increases & Fixed Expenses Increase,162727,74860.0,84231,159091.0,3636.0,2.23,0.04,High Risk
U966,2024,12,371855.0,Salary Increases & Fixed Expenses Increase,162727,74860.0,64246,139106.0,23621.0,14.52,-0.03,High Risk
U967,2024,1,250000.0,Stable Salary & Stable Fixed Expenses,295131,87172.0,146455,233627.0,61504.0,20.84,-0.02,Medium Risk
U967,2024,2,311504.0,Stable Salary & Stable Fixed Expenses,295131,87172.0,121603,208775.0,86356.0,29.26,-0.0,Low Risk
U967,2024,3,397860.0,Stable Salary & Stable Fixed Expenses,295131,87172.0,97820,184992.0,110139.0,37.32,0.02,Low Risk
U967,2024,4,507999.0,Stable Salary & Stable Fixed Expenses,295131,87172.0,127376,214548.0,80583.0,27.3,-0.04,Low Risk
U967,2024,5,588582.0,Stable Salary & Stable Fixed Expenses,295131,87172.0,105106,192278.0,102853.0,34.85,-0.01,Low Risk
U967,2024,6,691435.0,Stable Salary & Stable Fixed Expenses,295131,87172.0,102925,190097.0,105034.0,35.59,0.02,Low Risk
U967,2024,7,796469.0,Stable Salary & Stable Fixed Expenses,295131,87172.0,110927,198099.0,97032.0,32.88,0.02,Low Risk
U967,2024,8,893501.0,Stable Salary & Stable Fixed Expenses,295131,87172.0,101955,189127.0,106004.0,35.92,0.04,Low Risk
U967,2024,9,999505.0,Stable Salary & Stable Fixed Expenses,295131,87172.0,110556,197728.0,97403.0,33.0,-0.0,Low Risk
U967,2024,10,1096908.0,Stable Salary & Stable Fixed Expenses,295131,87172.0,116177,203349.0,91782.0,31.1,-0.02,Low Risk
U967,2024,11,1188690.0,Stable Salary & Stable Fixed Expenses,295131,87172.0,104404,191576.0,103555.0,35.09,0.02,Low Risk
U967,2024,12,1292245.0,Stable Salary & Stable Fixed Expenses,295131,87172.0,114109,201281.0,93850.0,31.8,0.04,Low Risk
U968,2024,1,205637.0,Stable Salary & Stable Fixed Expenses,187436,69081.0,56477,125558.0,61878.0,33.01,0.0,Low Risk
U968,2024,2,267515.0,Stable Salary & Stable Fixed Expenses,187436,69081.0,60976,130057.0,57379.0,30.61,0.05,Low Risk
U968,2024,3,324894.0,Stable Salary & Stable Fixed Expenses,187436,69081.0,86806,155887.0,31549.0,16.83,-0.0,Medium Risk
U968,2024,4,356443.0,Stable Salary & Stable Fixed Expenses,187436,69081.0,72846,141927.0,45509.0,24.28,0.02,Medium Risk
U968,2024,5,401952.0,Stable Salary & Stable Fixed Expenses,187436,69081.0,79143,148224.0,39212.0,20.92,0.03,Medium Risk
U968,2024,6,441164.0,Stable Salary & Stable Fixed Expenses,187436,69081.0,79077,148158.0,39278.0,20.96,-0.02,Medium Risk
U968,2024,7,480442.0,Stable Salary & Stable Fixed Expenses,187436,69081.0,65943,135024.0,52412.0,27.96,-0.04,Low Risk
U968,2024,8,532854.0,Stable Salary & Stable Fixed Expenses,187436,69081.0,82648,151729.0,35707.0,19.05,0.0,Medium Risk
U968,2024,9,568561.0,Stable Salary & Stable Fixed Expenses,187436,69081.0,102939,172020.0,15416.0,8.22,0.0,High Risk
U968,2024,10,583977.0,Stable Salary & Stable Fixed Expenses,187436,69081.0,87231,156312.0,31124.0,16.61,-0.04,Medium Risk
U968,2024,11,615101.0,Stable Salary & Stable Fixed Expenses,187436,69081.0,100113,169194.0,18242.0,9.73,0.0,High Risk
U968,2024,12,633343.0,Stable Salary & Stable Fixed Expenses,187436,69081.0,110074,179155.0,8281.0,4.42,0.03,High Risk
U969,2024,1,238989.0,Salary Increases & Fixed Expenses Increase,187114,64034.0,59619,123653.0,63461.0,33.92,-0.02,Low Risk
U969,2024,2,302450.0,Salary Increases & Fixed Expenses Increase,187114,64034.0,83669,147703.0,39411.0,21.06,0.01,Medium Risk
U969,2024,3,341861.0,Salary Increases & Fixed Expenses Increase,187114,64034.0,78286,142320.0,44794.0,23.94,-0.03,Medium Risk
U969,2024,4,386655.0,Salary Increases & Fixed Expenses Increase,187114,64034.0,76787,140821.0,46293.0,24.74,-0.02,Medium Risk
U969,2024,5,432948.0,Salary Increases & Fixed Expenses Increase,195476,64034.0,81418,145452.0,50024.0,25.59,0.03,Low Risk
U969,2024,6,482972.0,Salary Increases & Fixed Expenses Increase,195476,64034.0,77998,142032.0,53444.0,27.34,0.02,Low Risk
U969,2024,7,536416.0,Salary Increases & Fixed Expenses Increase,195476,64985.0,84665,149650.0,45826.0,23.44,0.04,Medium Risk
U969,2024,8,582242.0,Salary Increases & Fixed Expenses Increase,195476,64985.0,78639,143624.0,51852.0,26.53,-0.01,Low Risk
U969,2024,9,634094.0,Salary Increases & Fixed Expenses Increase,195476,64985.0,106004,170989.0,24487.0,12.53,-0.0,High Risk
U969,2024,10,658581.0,Salary Increases & Fixed Expenses Increase,195476,64985.0,96758,161743.0,33733.0,17.26,-0.04,Medium Risk
U969,2024,11,692314.0,Salary Increases & Fixed Expenses Increase,195476,64985.0,89764,154749.0,40727.0,20.83,0.01,Medium Risk
U969,2024,12,733041.0,Salary Increases & Fixed Expenses Increase,195476,64985.0,84787,149772.0,45704.0,23.38,-0.02,Medium Risk
U970,2024,1,250000.0,Salary Increases & Fixed Expenses Increase,290624,80040.0,115500,195540.0,95084.0,32.72,0.01,Low Risk
U970,2024,2,345084.0,Salary Increases & Fixed Expenses Increase,290624,80040.0,139023,219063.0,71561.0,24.62,-0.05,Medium Risk
U970,2024,3,416645.0,Salary Increases & Fixed Expenses Increase,290624,80040.0,130090,210130.0,80494.0,27.7,0.04,Low Risk
U970,2024,4,497139.0,Salary Increases & Fixed Expenses Increase,290624,80773.0,116414,197187.0,93437.0,32.15,0.0,Low Risk
U970,2024,5,590576.0,Salary Increases & Fixed Expenses Increase,309977,80773.0,134293,215066.0,94911.0,30.62,-0.0,Low Risk
U970,2024,6,685487.0,Salary Increases & Fixed Expenses Increase,309977,80773.0,117322,198095.0,111882.0,36.09,-0.04,Low Risk
U970,2024,7,797369.0,Salary Increases & Fixed Expenses Increase,309977,80773.0,131752,212525.0,97452.0,31.44,0.0,Low Risk
U970,2024,8,894821.0,Salary Increases & Fixed Expenses Increase,309977,80773.0,108453,189226.0,120751.0,38.95,-0.01,Low Risk
U970,2024,9,1015572.0,Salary Increases & Fixed Expenses Increase,309977,80773.0,135803,216576.0,93401.0,30.13,0.04,Low Risk
U970,2024,10,1108973.0,Salary Increases & Fixed Expenses Increase,309977,80773.0,134974,215747.0,94230.0,30.4,0.03,Low Risk
U970,2024,11,1203203.0,Salary Increases & Fixed Expenses Increase,309977,81716.0,173332,255048.0,54929.0,17.72,-0.05,Medium Risk
U970,2024,12,1258132.0,Salary Increases & Fixed Expenses Increase,309977,82579.0,107843,190422.0,119555.0,38.57,-0.01,Low Risk
U971,2024,1,242606.0,Stable Salary & Stable Fixed Expenses,184302,72263.0,77920,150183.0,34119.0,18.51,-0.04,Medium Risk
U971,2024,2,276725.0,Stable Salary & Stable Fixed Expenses,184302,72263.0,63413,135676.0,48626.0,26.38,-0.01,Low Risk
U971,2024,3,325351.0,Stable Salary & Stable Fixed Expenses,184302,72263.0,78381,150644.0,33658.0,18.26,-0.03,Medium Risk
U971,2024,4,359009.0,Stable Salary & Stable Fixed Expenses,184302,72263.0,76046,148309.0,35993.0,19.53,0.04,Medium Risk
U971,2024,5,395002.0,Stable Salary & Stable Fixed Expenses,184302,72263.0,90920,163183.0,21119.0,11.46,0.03,High Risk
U971,2024,6,416121.0,Stable Salary & Stable Fixed Expenses,184302,72263.0,84997,157260.0,27042.0,14.67,0.01,High Risk
U971,2024,7,443163.0,Stable Salary & Stable Fixed Expenses,184302,72263.0,73947,146210.0,38092.0,20.67,-0.05,Medium Risk
U971,2024,8,481255.0,Stable Salary & Stable Fixed Expenses,184302,72263.0,84510,156773.0,27529.0,14.94,0.04,High Risk
U971,2024,9,508784.0,Stable Salary & Stable Fixed Expenses,184302,72263.0,76145,148408.0,35894.0,19.48,0.0,Medium Risk
U971,2024,10,544678.0,Stable Salary & Stable Fixed Expenses,184302,72263.0,91571,163834.0,20468.0,11.11,0.01,High Risk
U971,2024,11,565146.0,Stable Salary & Stable Fixed Expenses,184302,72263.0,85770,158033.0,26269.0,14.25,0.0,High Risk
U971,2024,12,591415.0,Stable Salary & Stable Fixed Expenses,184302,72263.0,90717,162980.0,21322.0,11.57,0.01,High Risk
U972,2024,1,250000.0,Salary Increases & Fixed Expenses Increase,275805,67827.0,132280,200107.0,75698.0,27.45,-0.01,Low Risk
U972,2024,2,325698.0,Salary Increases & Fixed Expenses Increase,275805,69269.0,115403,184672.0,91133.0,33.04,-0.03,Low Risk
U972,2024,3,416831.0,Salary Increases & Fixed Expenses Increase,275805,69269.0,147630,216899.0,58906.0,21.36,0.02,Medium Risk
U972,2024,4,475737.0,Salary Increases & Fixed Expenses Increase,304457,69269.0,105766,175035.0,129422.0,42.51,-0.04,Low Risk
U972,2024,5,605159.0,Salary Increases & Fixed Expenses Increase,304457,69269.0,96319,165588.0,138869.0,45.61,-0.01,Low Risk
U972,2024,6,744028.0,Salary Increases & Fixed Expenses Increase,304457,69269.0,100917,170186.0,134271.0,44.1,0.02,Low Risk
U972,2024,7,878299.0,Salary Increases & Fixed Expenses Increase,304457,69269.0,143717,212986.0,91471.0,30.04,0.02,Low Risk
U972,2024,8,969770.0,Salary Increases & Fixed Expenses Increase,304457,69269.0,117056,186325.0,118132.0,38.8,0.01,Low Risk
U972,2024,9,1087902.0,Salary Increases & Fixed Expenses Increase,304457,69269.0,124603,193872.0,110585.0,36.32,0.05,Low Risk
U972,2024,10,1198487.0,Salary Increases & Fixed Expenses Increase,304457,69269.0,157798,227067.0,77390.0,25.42,0.02,Low Risk
U972,2024,11,1275877.0,Salary Increases & Fixed Expenses Increase,304457,69269.0,132172,201441.0,103016.0,33.84,0.03,Low Risk
U972,2024,12,1378893.0,Salary Increases & Fixed Expenses Increase,304457,70099.0,153799,223898.0,80559.0,26.46,0.04,Low Risk
U973,2024,1,250000.0,Salary Increases & Fixed Expenses Increase,268878,79304.0,125750,205054.0,63824.0,23.74,-0.01,Medium Risk
U973,2024,2,313824.0,Salary Increases & Fixed Expenses Increase,268878,79304.0,83976,163280.0,105598.0,39.27,-0.04,Low Risk
U973,2024,3,419422.0,Salary Increases & Fixed Expenses Increase,268878,79304.0,114738,194042.0,74836.0,27.83,0.01,Low Risk
U973,2024,4,494258.0,Salary Increases & Fixed Expenses Increase,285069,79304.0,86317,165621.0,119448.0,41.9,-0.02,Low Risk
U973,2024,5,613706.0,Salary Increases & Fixed Expenses Increase,285069,79304.0,106071,185375.0,99694.0,34.97,-0.0,Low Risk
U973,2024,6,713400.0,Salary Increases & Fixed Expenses Increase,285069,79304.0,119113,198417.0,86652.0,30.4,0.01,Low Risk
U973,2024,7,800052.0,Salary Increases & Fixed Expenses Increase,285069,79304.0,107338,186642.0,98427.0,34.53,0.01,Low Risk
U973,2024,8,898479.0,Salary Increases & Fixed Expenses Increase,285069,79304.0,104322,183626.0,101443.0,35.59,-0.05,Low Risk
U973,2024,9,999922.0,Salary Increases & Fixed Expenses Increase,285069,79304.0,129085,208389.0,76680.0,26.9,-0.0,Low Risk
U973,2024,10,1076602.0,Salary Increases & Fixed Expenses Increase,285069,79304.0,104917,184221.0,100848.0,35.38,0.01,Low Risk
U973,2024,11,1177450.0,Salary Increases & Fixed Expenses Increase,285069,79304.0,139218,218522.0,66547.0,23.34,-0.03,Medium Risk
U973,2024,12,1243997.0,Salary Increases & Fixed Expenses Increase,285069,80286.0,124675,204961.0,80108.0,28.1,-0.01,Low Risk
U974,2024,1,232740.0,Stable Salary & Increasing Fixed Expenses,149102,68402.0,61493,129895.0,19207.0,12.88,-0.03,High Risk
U974,2024,2,251947.0,Stable Salary & Increasing Fixed Expenses,149102,69898.0,55152,125050.0,24052.0,16.13,0.01,Medium Risk
U974,2024,3,275999.0,Stable Salary & Increasing Fixed Expenses,149102,71067.0,51293,122360.0,26742.0,17.94,0.0,Medium Risk
U974,2024,4,302741.0,Stable Salary & Increasing Fixed Expenses,149102,71067.0,57523,128590.0,20512.0,13.76,0.02,High Risk
U974,2024,5,323253.0,Stable Salary & Increasing Fixed Expenses,149102,71067.0,59482,130549.0,18553.0,12.44,-0.02,High Risk
U974,2024,6,341806.0,Stable Salary & Increasing Fixed Expenses,149102,71067.0,74123,145190.0,3912.0,2.62,-0.02,High Risk
U974,2024,7,345718.0,Stable Salary & Increasing Fixed Expenses,149102,72008.0,53072,125080.0,24022.0,16.11,-0.0,Medium Risk
U974,2024,8,369740.0,Stable Salary & Increasing Fixed Expenses,149102,72008.0,47028,119036.0,30066.0,20.16,-0.03,Medium Risk
U974,2024,9,399806.0,Stable Salary & Increasing Fixed Expenses,149102,72008.0,50928,122936.0,26166.0,17.55,0.03,Medium Risk
U974,2024,10,425972.0,Stable Salary & Increasing Fixed Expenses,149102,72008.0,48111,120119.0,28983.0,19.44,-0.01,Medium Risk
U974,2024,11,454955.0,Stable Salary & Increasing Fixed Expenses,149102,72008.0,67965,139973.0,9129.0,6.12,0.01,High Risk
U974,2024,12,464084.0,Stable Salary & Increasing Fixed Expenses,149102,72008.0,72866,144874.0,4228.0,2.84,0.03,High Risk
U975,2024,1,250000.0,Stable Salary & Stable Fixed Expenses,262803,104176.0,119966,224142.0,38661.0,14.71,-0.05,High Risk
U975,2024,2,288661.0,Stable Salary & Stable Fixed Expenses,262803,104176.0,109069,213245.0,49558.0,18.86,-0.01,Medium Risk
U975,2024,3,338219.0,Stable Salary & Stable Fixed Expenses,262803,104176.0,107029,211205.0,51598.0,19.63,-0.02,Medium Risk
U975,2024,4,389817.0,Stable Salary & Stable Fixed Expenses,262803,104176.0,114260,218436.0,44367.0,16.88,0.02,Medium Risk
U975,2024,5,434184.0,Stable Salary & Stable Fixed Expenses,262803,104176.0,114405,218581.0,44222.0,16.83,0.05,Medium Risk
U975,2024,6,478406.0,Stable Salary & Stable Fixed Expenses,262803,104176.0,122715,226891.0,35912.0,13.66,0.0,High Risk
U975,2024,7,514318.0,Stable Salary & Stable Fixed Expenses,262803,104176.0,80408,184584.0,78219.0,29.76,-0.0,Low Risk
U975,2024,8,592537.0,Stable Salary & Stable Fixed Expenses,262803,104176.0,87168,191344.0,71459.0,27.19,-0.02,Low Risk
U975,2024,9,663996.0,Stable Salary & Stable Fixed Expenses,262803,104176.0,84390,188566.0,74237.0,28.25,0.02,Low Risk
U975,2024,10,738233.0,Stable Salary & Stable Fixed Expenses,262803,104176.0,123419,227595.0,35208.0,13.4,0.01,High Risk
U975,2024,11,773441.0,Stable Salary & Stable Fixed Expenses,262803,104176.0,126057,230233.0,32570.0,12.39,-0.03,High Risk
U975,2024,12,806011.0,Stable Salary & Stable Fixed Expenses,262803,104176.0,82908,187084.0,75719.0,28.81,0.02,Low Risk
U976,2024,1,206866.0,Stable Salary & Increasing Fixed Expenses,193766,65199.0,51350,116549.0,77217.0,39.85,-0.04,Low Risk
U976,2024,2,284083.0,Stable Salary & Increasing Fixed Expenses,193766,65199.0,49882,115081.0,78685.0,40.61,-0.01,Low Risk
U976,2024,3,362768.0,Stable Salary & Increasing Fixed Expenses,193766,66029.0,68116,134145.0,59621.0,30.77,0.03,Low Risk
U976,2024,4,422389.0,Stable Salary & Increasing Fixed Expenses,193766,66029.0,44955,110984.0,82782.0,42.72,-0.01,Low Risk
U976,2024,5,505171.0,Stable Salary & Increasing Fixed Expenses,193766,66029.0,49134,115163.0,78603.0,40.57,-0.01,Low Risk
U976,2024,6,583774.0,Stable Salary & Increasing Fixed Expenses,193766,66029.0,54555,120584.0,73182.0,37.77,0.01,Low Risk
U976,2024,7,656956.0,Stable Salary & Increasing Fixed Expenses,193766,66029.0,42736,108765.0,85001.0,43.87,0.01,Low Risk
U976,2024,8,741957.0,Stable Salary & Increasing Fixed Expenses,193766,66029.0,38755,104784.0,88982.0,45.92,-0.03,Low Risk
U976,2024,9,830939.0,Stable Salary & Increasing Fixed Expenses,193766,67858.0,63056,130914.0,62852.0,32.44,0.02,Low Risk
U976,2024,10,893791.0,Stable Salary & Increasing Fixed Expenses,193766,67858.0,48046,115904.0,77862.0,40.18,0.01,Low Risk
U976,2024,11,971653.0,Stable Salary & Increasing Fixed Expenses,193766,67858.0,60585,128443.0,65323.0,33.71,0.04,Low Risk
U976,2024,12,1036976.0,Stable Salary & Increasing Fixed Expenses,193766,67858.0,67464,135322.0,58444.0,30.16,0.0,Low Risk
U977,2024,1,250000.0,Salary Increases & Fixed Expenses Increase,286583,101774.0,144124,245898.0,40685.0,14.2,0.03,High Risk
U977,2024,2,290685.0,Salary Increases & Fixed Expenses Increase,286583,101774.0,155173,256947.0,29636.0,10.34,0.03,High Risk
U977,2024,3,320321.0,Salary Increases & Fixed Expenses Increase,298029,101774.0,198058,299832.0,-1803.0,-0.6,0.03,High Risk
U977,2024,4,318518.0,Salary Increases & Fixed Expenses Increase,298029,101774.0,167092,268866.0,29163.0,9.79,0.01,High Risk
U977,2024,5,347681.0,Salary Increases & Fixed Expenses Increase,298029,101774.0,204820,306594.0,-8565.0,-2.87,0.01,High Risk
U977,2024,6,339116.0,Salary Increases & Fixed Expenses Increase,298029,101774.0,188509,290283.0,7746.0,2.6,-0.05,High Risk
U977,2024,7,346862.0,Salary Increases & Fixed Expenses Increase,298029,101774.0,192059,293833.0,4196.0,1.41,0.05,High Risk
U977,2024,8,351058.0,Salary Increases & Fixed Expenses Increase,298029,103005.0,176555,279560.0,18469.0,6.2,-0.02,High Risk
U977,2024,9,369527.0,Salary Increases & Fixed Expenses Increase,298029,103005.0,196749,299754.0,-1725.0,-0.58,-0.02,High Risk
U977,2024,10,367802.0,Salary Increases & Fixed Expenses Increase,298029,103005.0,183049,286054.0,11975.0,4.02,-0.04,High Risk
U977,2024,11,379777.0,Salary Increases & Fixed Expenses Increase,298029,103005.0,175137,278142.0,19887.0,6.67,0.0,High Risk
U977,2024,12,399664.0,Salary Increases & Fixed Expenses Increase,298029,103005.0,195687,298692.0,-663.0,-0.22,0.05,High Risk
U978,2024,1,250000.0,Salary Increases & Fixed Expenses Increase,284804,103152.0,149377,252529.0,32275.0,11.33,-0.05,High Risk
U978,2024,2,282275.0,Salary Increases & Fixed Expenses Increase,284804,103152.0,168582,271734.0,13070.0,4.59,-0.0,High Risk
U978,2024,3,295345.0,Salary Increases & Fixed Expenses Increase,284804,103152.0,205890,309042.0,-24238.0,-8.51,-0.02,High Risk
U978,2024,4,271107.0,Salary Increases & Fixed Expenses Increase,284804,104393.0,175215,279608.0,5196.0,1.82,-0.0,High Risk
U978,2024,5,276303.0,Salary Increases & Fixed Expenses Increase,284804,106056.0,145201,251257.0,33547.0,11.78,-0.02,High Risk
U978,2024,6,309850.0,Salary Increases & Fixed Expenses Increase,284804,106056.0,142618,248674.0,36130.0,12.69,0.0,High Risk
U978,2024,7,345980.0,Salary Increases & Fixed Expenses Increase,284804,106056.0,147961,254017.0,30787.0,10.81,-0.04,High Risk
U978,2024,8,376767.0,Salary Increases & Fixed Expenses Increase,299093,106056.0,158547,264603.0,34490.0,11.53,0.02,High Risk
U978,2024,9,411257.0,Salary Increases & Fixed Expenses Increase,299093,106056.0,170638,276694.0,22399.0,7.49,-0.0,High Risk
U978,2024,10,433656.0,Salary Increases & Fixed Expenses Increase,299093,107143.0,188576,295719.0,3374.0,1.13,-0.01,High Risk
U978,2024,11,437030.0,Salary Increases & Fixed Expenses Increase,299093,107143.0,200628,307771.0,-8678.0,-2.9,-0.01,High Risk
U978,2024,12,428352.0,Salary Increases & Fixed Expenses Increase,299093,107143.0,184280,291423.0,7670.0,2.56,0.02,High Risk
U979,2024,1,234328.0,Salary Increases & Fixed Expenses Remain Stable,186929,49274.0,98457,147731.0,39198.0,20.97,0.05,Medium Risk
U979,2024,2,273526.0,Salary Increases & Fixed Expenses Remain Stable,186929,49274.0,100166,149440.0,37489.0,20.06,0.02,Medium Risk
U979,2024,3,311015.0,Salary Increases & Fixed Expenses Remain Stable,186929,49274.0,129702,178976.0,7953.0,4.25,-0.02,High Risk
U979,2024,4,318968.0,Salary Increases & Fixed Expenses Remain Stable,186929,49274.0,95034,144308.0,42621.0,22.8,0.01,Medium Risk
U979,2024,5,361589.0,Salary Increases & Fixed Expenses Remain Stable,186929,49274.0,119568,168842.0,18087.0,9.68,-0.02,High Risk
U979,2024,6,379676.0,Salary Increases & Fixed Expenses Remain Stable,186929,49274.0,94529,143803.0,43126.0,23.07,0.01,Medium Risk
U979,2024,7,422802.0,Salary Increases & Fixed Expenses Remain Stable,186929,49274.0,99376,148650.0,38279.0,20.48,-0.04,Medium Risk
U979,2024,8,461081.0,Salary Increases & Fixed Expenses Remain Stable,203280,49274.0,127343,176617.0,26663.0,13.12,-0.04,High Risk
U979,2024,9,487744.0,Salary Increases & Fixed Expenses Remain Stable,203280,49274.0,124530,173804.0,29476.0,14.5,-0.04,High Risk
U979,2024,10,517220.0,Salary Increases & Fixed Expenses Remain Stable,203280,49274.0,135568,184842.0,18438.0,9.07,-0.03,High Risk
U979,2024,11,535658.0,Salary Increases & Fixed Expenses Remain Stable,203280,49274.0,138546,187820.0,15460.0,7.61,0.01,High Risk
U979,2024,12,551118.0,Salary Increases & Fixed Expenses Remain Stable,203280,49274.0,102494,151768.0,51512.0,25.34,-0.02,Low Risk
U980,2024,1,208618.0,Salary Increases & Fixed Expenses Remain Stable,68793,36496.0,36803,73299.0,-4506.0,-6.55,-0.04,High Risk
U980,2024,2,204112.0,Salary Increases & Fixed Expenses Remain Stable,68793,36496.0,42510,79006.0,-10213.0,-14.85,0.02,High Risk
U980,2024,3,193899.0,Salary Increases & Fixed Expenses Remain Stable,84941,36496.0,43540,80036.0,4905.0,5.77,-0.02,High Risk
U980,2024,4,198804.0,Salary Increases & Fixed Expenses Remain Stable,84941,36496.0,52855,89351.0,-4410.0,-5.19,0.03,High Risk
U980,2024,5,194394.0,Salary Increases & Fixed Expenses Remain Stable,84941,36496.0,56755,93251.0,-8310.0,-9.78,0.01,High Risk
U980,2024,6,186084.0,Salary Increases & Fixed Expenses Remain Stable,84941,36496.0,48839,85335.0,-394.0,-0.46,-0.02,High Risk
U980,2024,7,185690.0,Salary Increases & Fixed Expenses Remain Stable,84941,36496.0,45805,82301.0,2640.0,3.11,-0.02,High Risk
U980,2024,8,188330.0,Salary Increases & Fixed Expenses Remain Stable,84941,36496.0,46036,82532.0,2409.0,2.84,-0.03,High Risk
U980,2024,9,190739.0,Salary Increases & Fixed Expenses Remain Stable,84941,36496.0,59393,95889.0,-10948.0,-12.89,0.04,High Risk
U980,2024,10,179791.0,Salary Increases & Fixed Expenses Remain Stable,84941,36496.0,58902,95398.0,-10457.0,-12.31,-0.03,High Risk
U980,2024,11,169334.0,Salary Increases & Fixed Expenses Remain Stable,84941,36496.0,45227,81723.0,3218.0,3.79,-0.0,High Risk
U980,2024,12,172552.0,Salary Increases & Fixed Expenses Remain Stable,84941,36496.0,46932,83428.0,1513.0,1.78,-0.03,High Risk
U981,2024,1,250000.0,Salary Increases & Fixed Expenses Increase,251454,109490.0,98709,208199.0,43255.0,17.2,-0.0,Medium Risk
U981,2024,2,293255.0,Salary Increases & Fixed Expenses Increase,251454,109490.0,116944,226434.0,25020.0,9.95,0.0,High Risk
U981,2024,3,318275.0,Salary Increases & Fixed Expenses Increase,251454,109490.0,105876,215366.0,36088.0,14.35,0.03,High Risk
U981,2024,4,354363.0,Salary Increases & Fixed Expenses Increase,251454,109490.0,75835,185325.0,66129.0,26.3,-0.04,Low Risk
U981,2024,5,420492.0,Salary Increases & Fixed Expenses Increase,274086,109490.0,105163,214653.0,59433.0,21.68,-0.0,Medium Risk
U981,2024,6,479925.0,Salary Increases & Fixed Expenses Increase,274086,109490.0,134598,244088.0,29998.0,10.94,0.01,High Risk
U981,2024,7,509923.0,Salary Increases & Fixed Expenses Increase,274086,111426.0,127965,239391.0,34695.0,12.66,-0.01,High Risk
U981,2024,8,544618.0,Salary Increases & Fixed Expenses Increase,274086,111426.0,125018,236444.0,37642.0,13.73,-0.03,High Risk
U981,2024,9,582260.0,Salary Increases & Fixed Expenses Increase,274086,111426.0,96805,208231.0,65855.0,24.03,-0.01,Medium Risk
U981,2024,10,648115.0,Salary Increases & Fixed Expenses Increase,274086,111426.0,128537,239963.0,34123.0,12.45,0.05,High Risk
U981,2024,11,682238.0,Salary Increases & Fixed Expenses Increase,274086,111426.0,107650,219076.0,55010.0,20.07,-0.02,Medium Risk
U981,2024,12,737248.0,Salary Increases & Fixed Expenses Increase,274086,111426.0,133158,244584.0,29502.0,10.76,0.0,High Risk
U982,2024,1,250000.0,Stable Salary & Stable Fixed Expenses,267106,87253.0,99502,186755.0,80351.0,30.08,-0.01,Low Risk
U982,2024,2,330351.0,Stable Salary & Stable Fixed Expenses,267106,87253.0,127413,214666.0,52440.0,19.63,-0.01,Medium Risk
U982,2024,3,382791.0,Stable Salary & Stable Fixed Expenses,267106,87253.0,113252,200505.0,66601.0,24.93,-0.01,Medium Risk
U982,2024,4,449392.0,Stable Salary & Stable Fixed Expenses,267106,87253.0,97119,184372.0,82734.0,30.97,0.01,Low Risk
U982,2024,5,532126.0,Stable Salary & Stable Fixed Expenses,267106,87253.0,122576,209829.0,57277.0,21.44,-0.05,Medium Risk
U982,2024,6,589403.0,Stable Salary & Stable Fixed Expenses,267106,87253.0,103438,190691.0,76415.0,28.61,-0.04,Low Risk
U982,2024,7,665818.0,Stable Salary & Stable Fixed Expenses,267106,87253.0,97201,184454.0,82652.0,30.94,-0.02,Low Risk
U982,2024,8,748470.0,Stable Salary & Stable Fixed Expenses,267106,87253.0,118980,206233.0,60873.0,22.79,-0.0,Medium Risk
U982,2024,9,809343.0,Stable Salary & Stable Fixed Expenses,267106,87253.0,88049,175302.0,91804.0,34.37,-0.03,Low Risk
U982,2024,10,901147.0,Stable Salary & Stable Fixed Expenses,267106,87253.0,128495,215748.0,51358.0,19.23,0.04,Medium Risk
U982,2024,11,952505.0,Stable Salary & Stable Fixed Expenses,267106,87253.0,134892,222145.0,44961.0,16.83,-0.05,Medium Risk
U982,2024,12,997466.0,Stable Salary & Stable Fixed Expenses,267106,87253.0,94366,181619.0,85487.0,32.0,-0.0,Low Risk
U983,2024,1,248878.0,Salary Increases & Fixed Expenses Increase,241354,64068.0,91956,156024.0,85330.0,35.35,-0.02,Low Risk
U983,2024,2,334208.0,Salary Increases & Fixed Expenses Increase,241354,64068.0,99442,163510.0,77844.0,32.25,-0.04,Low Risk
U983,2024,3,412052.0,Salary Increases & Fixed Expenses Increase,241354,65237.0,141016,206253.0,35101.0,14.54,0.04,High Risk
U983,2024,4,447153.0,Salary Increases & Fixed Expenses Increase,241354,65237.0,110333,175570.0,65784.0,27.26,-0.02,Low Risk
U983,2024,5,512937.0,Salary Increases & Fixed Expenses Increase,241354,65237.0,73341,138578.0,102776.0,42.58,-0.0,Low Risk
U983,2024,6,615713.0,Salary Increases & Fixed Expenses Increase,265855,65237.0,92867,158104.0,107751.0,40.53,-0.03,Low Risk
U983,2024,7,723464.0,Salary Increases & Fixed Expenses Increase,265855,65237.0,124974,190211.0,75644.0,28.45,0.02,Low Risk
U983,2024,8,799108.0,Salary Increases & Fixed Expenses Increase,265855,66740.0,117842,184582.0,81273.0,30.57,-0.05,Low Risk
U983,2024,9,880381.0,Salary Increases & Fixed Expenses Increase,265855,67534.0,110255,177789.0,88066.0,33.13,0.03,Low Risk
U983,2024,10,968447.0,Salary Increases & Fixed Expenses Increase,265855,67534.0,120524,188058.0,77797.0,29.26,0.01,Low Risk
U983,2024,11,1046244.0,Salary Increases & Fixed Expenses Increase,265855,67534.0,147452,214986.0,50869.0,19.13,-0.02,Medium Risk
U983,2024,12,1097113.0,Salary Increases & Fixed Expenses Increase,265855,67534.0,125573,193107.0,72748.0,27.36,0.03,Low Risk
U984,2024,1,248969.0,Stable Salary & Decreasing Fixed Expenses,240884,76321.0,144987,221308.0,19576.0,8.13,0.02,High Risk
U984,2024,2,268545.0,Stable Salary & Decreasing Fixed Expenses,240884,76321.0,151306,227627.0,13257.0,5.5,-0.02,High Risk
U984,2024,3,281802.0,Stable Salary & Decreasing Fixed Expenses,240884,75336.0,140858,216194.0,24690.0,10.25,-0.04,High Risk
U984,2024,4,306492.0,Stable Salary & Decreasing Fixed Expenses,240884,75336.0,155106,230442.0,10442.0,4.33,-0.02,High Risk
U984,2024,5,316934.0,Stable Salary & Decreasing Fixed Expenses,240884,75336.0,141575,216911.0,23973.0,9.95,0.05,High Risk
U984,2024,6,340907.0,Stable Salary & Decreasing Fixed Expenses,240884,75336.0,165634,240970.0,-86.0,-0.04,0.03,High Risk
U984,2024,7,340821.0,Stable Salary & Decreasing Fixed Expenses,240884,75336.0,144894,220230.0,20654.0,8.57,-0.02,High Risk
U984,2024,8,361475.0,Stable Salary & Decreasing Fixed Expenses,240884,75336.0,160380,235716.0,5168.0,2.15,-0.04,High Risk
U984,2024,9,366643.0,Stable Salary & Decreasing Fixed Expenses,240884,75336.0,181797,257133.0,-16249.0,-6.75,-0.01,High Risk
U984,2024,10,350394.0,Stable Salary & Decreasing Fixed Expenses,240884,75336.0,170023,245359.0,-4475.0,-1.86,0.04,High Risk
U984,2024,11,345919.0,Stable Salary & Decreasing Fixed Expenses,240884,75336.0,132758,208094.0,32790.0,13.61,-0.01,High Risk
U984,2024,12,378709.0,Stable Salary & Decreasing Fixed Expenses,240884,74828.0,162897,237725.0,3159.0,1.31,0.03,High Risk
U985,2024,1,233401.0,Salary Increases & Fixed Expenses Increase,216162,108658.0,52827,161485.0,54677.0,25.29,-0.01,Low Risk
U985,2024,2,288078.0,Salary Increases & Fixed Expenses Increase,216162,108658.0,44366,153024.0,63138.0,29.21,-0.04,Low Risk
U985,2024,3,351216.0,Salary Increases & Fixed Expenses Increase,216162,108658.0,52029,160687.0,55475.0,25.66,0.01,Low Risk
U985,2024,4,406691.0,Salary Increases & Fixed Expenses Increase,216162,108658.0,60736,169394.0,46768.0,21.64,0.02,Medium Risk
U985,2024,5,453459.0,Salary Increases & Fixed Expenses Increase,222700,108658.0,66509,175167.0,47533.0,21.34,-0.02,Medium Risk
U985,2024,6,500992.0,Salary Increases & Fixed Expenses Increase,222700,108658.0,50609,159267.0,63433.0,28.48,-0.05,Low Risk
U985,2024,7,564425.0,Salary Increases & Fixed Expenses Increase,222700,108658.0,60686,169344.0,53356.0,23.96,-0.02,Medium Risk
U985,2024,8,617781.0,Salary Increases & Fixed Expenses Increase,222700,109501.0,62740,172241.0,50459.0,22.66,0.04,Medium Risk
U985,2024,9,668240.0,Salary Increases & Fixed Expenses Increase,222700,109501.0,61457,170958.0,51742.0,23.23,0.01,Medium Risk
U985,2024,10,719982.0,Salary Increases & Fixed Expenses Increase,222700,109501.0,55673,165174.0,57526.0,25.83,-0.0,Low Risk
U985,2024,11,777508.0,Salary Increases & Fixed Expenses Increase,222700,109501.0,72554,182055.0,40645.0,18.25,0.02,Medium Risk
U985,2024,12,818153.0,Salary Increases & Fixed Expenses Increase,222700,109501.0,52596,162097.0,60603.0,27.21,-0.03,Low Risk
U986,2024,1,250000.0,Stable Salary & Decreasing Fixed Expenses,253872,76481.0,52611,129092.0,124780.0,49.15,0.02,Low Risk
U986,2024,2,374780.0,Stable Salary & Decreasing Fixed Expenses,253872,76481.0,68302,144783.0,109089.0,42.97,-0.01,Low Risk
U986,2024,3,483869.0,Stable Salary & Decreasing Fixed Expenses,253872,76481.0,73530,150011.0,103861.0,40.91,-0.02,Low Risk
U986,2024,4,587730.0,Stable Salary & Decreasing Fixed Expenses,253872,76481.0,53971,130452.0,123420.0,48.62,0.04,Low Risk
U986,2024,5,711150.0,Stable Salary & Decreasing Fixed Expenses,253872,76481.0,63529,140010.0,113862.0,44.85,0.01,Low Risk
U986,2024,6,825012.0,Stable Salary & Decreasing Fixed Expenses,253872,74566.0,59933,134499.0,119373.0,47.02,0.04,Low Risk
U986,2024,7,944385.0,Stable Salary & Decreasing Fixed Expenses,253872,74566.0,68092,142658.0,111214.0,43.81,0.05,Low Risk
U986,2024,8,1055599.0,Stable Salary & Decreasing Fixed Expenses,253872,74566.0,69775,144341.0,109531.0,43.14,-0.04,Low Risk
U986,2024,9,1165130.0,Stable Salary & Decreasing Fixed Expenses,253872,74566.0,74740,149306.0,104566.0,41.19,0.02,Low Risk
U986,2024,10,1269696.0,Stable Salary & Decreasing Fixed Expenses,253872,74566.0,72334,146900.0,106972.0,42.14,-0.01,Low Risk
U986,2024,11,1376668.0,Stable Salary & Decreasing Fixed Expenses,253872,74566.0,59746,134312.0,119560.0,47.09,0.04,Low Risk
U986,2024,12,1496228.0,Stable Salary & Decreasing Fixed Expenses,253872,74566.0,82751,157317.0,96555.0,38.03,0.04,Low Risk
U987,2024,1,208132.0,Stable Salary & Stable Fixed Expenses,182373,78854.0,37904,116758.0,65615.0,35.98,-0.02,Low Risk
U987,2024,2,273747.0,Stable Salary & Stable Fixed Expenses,182373,78854.0,36963,115817.0,66556.0,36.49,0.01,Low Risk
U987,2024,3,340303.0,Stable Salary & Stable Fixed Expenses,182373,78854.0,46981,125835.0,56538.0,31.0,-0.01,Low Risk
U987,2024,4,396841.0,Stable Salary & Stable Fixed Expenses,182373,78854.0,49791,128645.0,53728.0,29.46,-0.0,Low Risk
U987,2024,5,450569.0,Stable Salary & Stable Fixed Expenses,182373,78854.0,38869,117723.0,64650.0,35.45,0.01,Low Risk
U987,2024,6,515219.0,Stable Salary & Stable Fixed Expenses,182373,78854.0,46027,124881.0,57492.0,31.52,0.02,Low Risk
U987,2024,7,572711.0,Stable Salary & Stable Fixed Expenses,182373,78854.0,53805,132659.0,49714.0,27.26,-0.03,Low Risk
U987,2024,8,622425.0,Stable Salary & Stable Fixed Expenses,182373,78854.0,39002,117856.0,64517.0,35.38,-0.04,Low Risk
U987,2024,9,686942.0,Stable Salary & Stable Fixed Expenses,182373,78854.0,41043,119897.0,62476.0,34.26,0.01,Low Risk
U987,2024,10,749418.0,Stable Salary & Stable Fixed Expenses,182373,78854.0,37527,116381.0,65992.0,36.19,0.03,Low Risk
U987,2024,11,815410.0,Stable Salary & Stable Fixed Expenses,182373,78854.0,52323,131177.0,51196.0,28.07,0.05,Low Risk
U987,2024,12,866606.0,Stable Salary & Stable Fixed Expenses,182373,78854.0,38575,117429.0,64944.0,35.61,-0.03,Low Risk
U988,2024,1,205212.0,Stable Salary & Decreasing Fixed Expenses,142164,61979.0,38971,100950.0,41214.0,28.99,0.02,Low Risk
U988,2024,2,246426.0,Stable Salary & Decreasing Fixed Expenses,142164,61979.0,29343,91322.0,50842.0,35.76,-0.01,Low Risk
U988,2024,3,297268.0,Stable Salary & Decreasing Fixed Expenses,142164,61979.0,39750,101729.0,40435.0,28.44,-0.01,Low Risk
U988,2024,4,337703.0,Stable Salary & Decreasing Fixed Expenses,142164,61979.0,42096,104075.0,38089.0,26.79,0.05,Low Risk
U988,2024,5,375792.0,Stable Salary & Decreasing Fixed Expenses,142164,61979.0,30746,92725.0,49439.0,34.78,0.01,Low Risk
U988,2024,6,425231.0,Stable Salary & Decreasing Fixed Expenses,142164,61979.0,32395,94374.0,47790.0,33.62,-0.05,Low Risk
U988,2024,7,473021.0,Stable Salary & Decreasing Fixed Expenses,142164,61979.0,38092,100071.0,42093.0,29.61,-0.01,Low Risk
U988,2024,8,515114.0,Stable Salary & Decreasing Fixed Expenses,142164,61979.0,32394,94373.0,47791.0,33.62,-0.0,Low Risk
U988,2024,9,562905.0,Stable Salary & Decreasing Fixed Expenses,142164,61979.0,47996,109975.0,32189.0,22.64,-0.03,Medium Risk
U988,2024,10,595094.0,Stable Salary & Decreasing Fixed Expenses,142164,61979.0,30085,92064.0,50100.0,35.24,0.01,Low Risk
U988,2024,11,645194.0,Stable Salary & Decreasing Fixed Expenses,142164,61979.0,34016,95995.0,46169.0,32.48,-0.04,Low Risk
U988,2024,12,691363.0,Stable Salary & Decreasing Fixed Expenses,142164,61979.0,34811,96790.0,45374.0,31.92,0.03,Low Risk
U989,2024,1,250000.0,Salary Increases & Fixed Expenses Remain Stable,287444,64102.0,94153,158255.0,129189.0,44.94,0.04,Low Risk
U989,2024,2,379189.0,Salary Increases & Fixed Expenses Remain Stable,287444,64102.0,88502,152604.0,134840.0,46.91,0.05,Low Risk
U989,2024,3,514029.0,Salary Increases & Fixed Expenses Remain Stable,311735,64102.0,137540,201642.0,110093.0,35.32,0.05,Low Risk
U989,2024,4,624122.0,Salary Increases & Fixed Expenses Remain Stable,311735,64102.0,140031,204133.0,107602.0,34.52,-0.05,Low Risk
U989,2024,5,731724.0,Salary Increases & Fixed Expenses Remain Stable,311735,64102.0,99118,163220.0,148515.0,47.64,-0.0,Low Risk
U989,2024,6,880239.0,Salary Increases & Fixed Expenses Remain Stable,311735,64102.0,143375,207477.0,104258.0,33.44,0.0,Low Risk
U989,2024,7,984497.0,Salary Increases & Fixed Expenses Remain Stable,311735,64102.0,117834,181936.0,129799.0,41.64,0.02,Low Risk
U989,2024,8,1114296.0,Salary Increases & Fixed Expenses Remain Stable,311735,64102.0,96838,160940.0,150795.0,48.37,0.02,Low Risk
U989,2024,9,1265091.0,Salary Increases & Fixed Expenses Remain Stable,311735,64102.0,169726,233828.0,77907.0,24.99,0.02,Medium Risk
U989,2024,10,1342998.0,Salary Increases & Fixed Expenses Remain Stable,311735,64102.0,100778,164880.0,146855.0,47.11,0.01,Low Risk
U989,2024,11,1489853.0,Salary Increases & Fixed Expenses Remain Stable,311735,64102.0,141651,205753.0,105982.0,34.0,0.02,Low Risk
U989,2024,12,1595835.0,Salary Increases & Fixed Expenses Remain Stable,311735,64102.0,120518,184620.0,127115.0,40.78,-0.0,Low Risk
U990,2024,1,139735.0,Salary Increases & Fixed Expenses Increase,27853,17410.0,11261,28671.0,-818.0,-2.94,-0.03,High Risk
U990,2024,2,138917.0,Salary Increases & Fixed Expenses Increase,27853,18045.0,10858,28903.0,-1050.0,-3.77,-0.0,High Risk
U990,2024,3,137867.0,Salary Increases & Fixed Expenses Increase,27853,19202.0,13609,32811.0,-4958.0,-17.8,-0.02,High Risk
U990,2024,4,132909.0,Salary Increases & Fixed Expenses Increase,27853,19202.0,11407,30609.0,-2756.0,-9.89,-0.04,High Risk
U990,2024,5,130153.0,Salary Increases & Fixed Expenses Increase,27853,19202.0,8518,27720.0,133.0,0.48,0.04,High Risk
U990,2024,6,130286.0,Salary Increases & Fixed Expenses Increase,44620,19202.0,15653,34855.0,9765.0,21.88,0.02,Medium Risk
U990,2024,7,140051.0,Salary Increases & Fixed Expenses Increase,44620,19202.0,17540,36742.0,7878.0,17.66,-0.04,Medium Risk
U990,2024,8,147929.0,Salary Increases & Fixed Expenses Increase,44620,19202.0,20637,39839.0,4781.0,10.71,-0.03,High Risk
U990,2024,9,152710.0,Salary Increases & Fixed Expenses Increase,44620,19202.0,14533,33735.0,10885.0,24.39,0.02,Medium Risk
U990,2024,10,163595.0,Salary Increases & Fixed Expenses Increase,44620,19836.0,18110,37946.0,6674.0,14.96,0.04,High Risk
U990,2024,11,170269.0,Salary Increases & Fixed Expenses Increase,44620,21833.0,20975,42808.0,1812.0,4.06,0.03,High Risk
U990,2024,12,172081.0,Salary Increases & Fixed Expenses Increase,44620,22805.0,20648,43453.0,1167.0,2.62,-0.02,High Risk
U991,2024,1,197195.0,Stable Salary & Increasing Fixed Expenses,158485,72118.0,37157,109275.0,49210.0,31.05,-0.04,Low Risk
U991,2024,2,246405.0,Stable Salary & Increasing Fixed Expenses,158485,72118.0,46292,118410.0,40075.0,25.29,0.05,Low Risk
U991,2024,3,286480.0,Stable Salary & Increasing Fixed Expenses,158485,74104.0,31974,106078.0,52407.0,33.07,0.04,Low Risk
U991,2024,4,338887.0,Stable Salary & Increasing Fixed Expenses,158485,75324.0,41122,116446.0,42039.0,26.53,0.05,Low Risk
U991,2024,5,380926.0,Stable Salary & Increasing Fixed Expenses,158485,75324.0,45626,120950.0,37535.0,23.68,-0.04,Medium Risk
U991,2024,6,418461.0,Stable Salary & Increasing Fixed Expenses,158485,77015.0,37119,114134.0,44351.0,27.98,-0.02,Low Risk
U991,2024,7,462812.0,Stable Salary & Increasing Fixed Expenses,158485,77015.0,43769,120784.0,37701.0,23.79,-0.04,Medium Risk
U991,2024,8,500513.0,Stable Salary & Increasing Fixed Expenses,158485,77015.0,46809,123824.0,34661.0,21.87,0.01,Medium Risk
U991,2024,9,535174.0,Stable Salary & Increasing Fixed Expenses,158485,77015.0,45322,122337.0,36148.0,22.81,0.05,Medium Risk
U991,2024,10,571322.0,Stable Salary & Increasing Fixed Expenses,158485,77015.0,41826,118841.0,39644.0,25.01,-0.0,Low Risk
U991,2024,11,610966.0,Stable Salary & Increasing Fixed Expenses,158485,77015.0,46965,123980.0,34505.0,21.77,0.0,Medium Risk
U991,2024,12,645471.0,Stable Salary & Increasing Fixed Expenses,158485,77015.0,40442,117457.0,41028.0,25.89,-0.03,Low Risk
U992,2024,1,250000.0,Salary Increases & Fixed Expenses Increase,297526,119520.0,104861,224381.0,73145.0,24.58,0.01,Medium Risk
U992,2024,2,323145.0,Salary Increases & Fixed Expenses Increase,297526,119520.0,108383,227903.0,69623.0,23.4,0.02,Medium Risk
U992,2024,3,392768.0,Salary Increases & Fixed Expenses Increase,297526,119520.0,141422,260942.0,36584.0,12.3,-0.04,High Risk
U992,2024,4,429352.0,Salary Increases & Fixed Expenses Increase,297526,119520.0,132238,251758.0,45768.0,15.38,-0.04,Medium Risk
U992,2024,5,475120.0,Salary Increases & Fixed Expenses Increase,297526,119520.0,110814,230334.0,67192.0,22.58,0.05,Medium Risk
U992,2024,6,542312.0,Salary Increases & Fixed Expenses Increase,297526,119520.0,139626,259146.0,38380.0,12.9,0.03,High Risk
U992,2024,7,580692.0,Salary Increases & Fixed Expenses Increase,297526,120267.0,130357,250624.0,46902.0,15.76,-0.02,Medium Risk
U992,2024,8,627594.0,Salary Increases & Fixed Expenses Increase,319017,120267.0,148867,269134.0,49883.0,15.64,-0.02,Medium Risk
U992,2024,9,677477.0,Salary Increases & Fixed Expenses Increase,319017,120267.0,133481,253748.0,65269.0,20.46,-0.01,Medium Risk
U992,2024,10,742746.0,Salary Increases & Fixed Expenses Increase,319017,120267.0,130566,250833.0,68184.0,21.37,0.02,Medium Risk
U992,2024,11,810930.0,Salary Increases & Fixed Expenses Increase,319017,120267.0,164143,284410.0,34607.0,10.85,-0.01,High Risk
U992,2024,12,845537.0,Salary Increases & Fixed Expenses Increase,319017,120267.0,106736,227003.0,92014.0,28.84,0.02,Low Risk
U993,2024,1,250000.0,Salary Increases & Fixed Expenses Remain Stable,252503,98760.0,67356,166116.0,86387.0,34.21,-0.02,Low Risk
U993,2024,2,336387.0,Salary Increases & Fixed Expenses Remain Stable,252503,98760.0,74531,173291.0,79212.0,31.37,-0.04,Low Risk
U993,2024,3,415599.0,Salary Increases & Fixed Expenses Remain Stable,252503,98760.0,72580,171340.0,81163.0,32.14,0.01,Low Risk
U993,2024,4,496762.0,Salary Increases & Fixed Expenses Remain Stable,252503,98760.0,63075,161835.0,90668.0,35.91,-0.0,Low Risk
U993,2024,5,587430.0,Salary Increases & Fixed Expenses Remain Stable,252503,98760.0,55717,154477.0,98026.0,38.82,0.0,Low Risk
U993,2024,6,685456.0,Salary Increases & Fixed Expenses Remain Stable,252503,98760.0,61615,160375.0,92128.0,36.49,-0.01,Low Risk
U993,2024,7,777584.0,Salary Increases & Fixed Expenses Remain Stable,252503,98760.0,71174,169934.0,82569.0,32.7,-0.03,Low Risk
U993,2024,8,860153.0,Salary Increases & Fixed Expenses Remain Stable,259038,98760.0,54266,153026.0,106012.0,40.93,-0.02,Low Risk
U993,2024,9,966165.0,Salary Increases & Fixed Expenses Remain Stable,259038,98760.0,75224,173984.0,85054.0,32.83,-0.03,Low Risk
U993,2024,10,1051219.0,Salary Increases & Fixed Expenses Remain Stable,259038,98760.0,69816,168576.0,90462.0,34.92,0.04,Low Risk
U993,2024,11,1141681.0,Salary Increases & Fixed Expenses Remain Stable,259038,98760.0,62625,161385.0,97653.0,37.7,-0.03,Low Risk
U993,2024,12,1239334.0,Salary Increases & Fixed Expenses Remain Stable,259038,98760.0,69930,168690.0,90348.0,34.88,-0.04,Low Risk
U994,2024,1,70817.0,Salary Increases & Fixed Expenses Increase,29079,22351.0,9902,32253.0,-3174.0,-10.92,0.01,High Risk
U994,2024,2,67643.0,Salary Increases & Fixed Expenses Increase,29079,22972.0,10750,33722.0,-4643.0,-15.97,-0.01,High Risk
U994,2024,3,63000.0,Salary Increases & Fixed Expenses Increase,29079,23656.0,16770,40426.0,-11347.0,-39.02,-0.04,High Risk
U994,2024,4,51653.0,Salary Increases & Fixed Expenses Increase,29079,23656.0,8911,32567.0,-3488.0,-11.99,0.03,High Risk
U994,2024,5,48165.0,Salary Increases & Fixed Expenses Increase,29079,24421.0,14442,38863.0,-9784.0,-33.65,-0.03,High Risk
U994,2024,6,38381.0,Salary Increases & Fixed Expenses Increase,38655,24421.0,17215,41636.0,-2981.0,-7.71,0.04,High Risk
U994,2024,7,35400.0,Salary Increases & Fixed Expenses Increase,38655,24421.0,17391,41812.0,-3157.0,-8.17,-0.02,High Risk
U994,2024,8,32243.0,Salary Increases & Fixed Expenses Increase,38655,24421.0,13836,38257.0,398.0,1.03,-0.05,High Risk
U994,2024,9,32641.0,Salary Increases & Fixed Expenses Increase,38655,24421.0,16975,41396.0,-2741.0,-7.09,0.04,High Risk
U994,2024,10,29900.0,Salary Increases & Fixed Expenses Increase,38655,24421.0,17529,41950.0,-3295.0,-8.52,-0.03,High Risk
U994,2024,11,26605.0,Salary Increases & Fixed Expenses Increase,38655,24421.0,14778,39199.0,-544.0,-1.41,-0.04,High Risk
U994,2024,12,26061.0,Salary Increases & Fixed Expenses Increase,38655,24421.0,13867,38288.0,367.0,0.95,0.01,High Risk
U995,2024,1,227936.0,Salary Increases & Fixed Expenses Increase,215578,117860.0,60009,177869.0,37709.0,17.49,-0.0,Medium Risk
U995,2024,2,265645.0,Salary Increases & Fixed Expenses Increase,215578,119168.0,57630,176798.0,38780.0,17.99,-0.02,Medium Risk
U995,2024,3,304425.0,Salary Increases & Fixed Expenses Increase,215578,119168.0,49164,168332.0,47246.0,21.92,-0.02,Medium Risk
U995,2024,4,351671.0,Salary Increases & Fixed Expenses Increase,215578,119168.0,61785,180953.0,34625.0,16.06,-0.04,Medium Risk
U995,2024,5,386296.0,Salary Increases & Fixed Expenses Increase,215578,120391.0,53915,174306.0,41272.0,19.14,-0.04,Medium Risk
U995,2024,6,427568.0,Salary Increases & Fixed Expenses Increase,215578,120391.0,44797,165188.0,50390.0,23.37,0.0,Medium Risk
U995,2024,7,477958.0,Salary Increases & Fixed Expenses Increase,215578,120391.0,64416,184807.0,30771.0,14.27,0.01,High Risk
U995,2024,8,508729.0,Salary Increases & Fixed Expenses Increase,238443,120391.0,61255,181646.0,56797.0,23.82,0.05,Medium Risk
U995,2024,9,565526.0,Salary Increases & Fixed Expenses Increase,238443,120391.0,57648,178039.0,60404.0,25.33,-0.03,Low Risk
U995,2024,10,625930.0,Salary Increases & Fixed Expenses Increase,238443,120391.0,66851,187242.0,51201.0,21.47,-0.03,Medium Risk
U995,2024,11,677131.0,Salary Increases & Fixed Expenses Increase,238443,120391.0,67372,187763.0,50680.0,21.25,0.01,Medium Risk
U995,2024,12,727811.0,Salary Increases & Fixed Expenses Increase,238443,120391.0,62092,182483.0,55960.0,23.47,-0.0,Medium Risk
U996,2024,1,246797.0,Salary Increases & Fixed Expenses Increase,246367,62043.0,80099,142142.0,104225.0,42.3,0.02,Low Risk
U996,2024,2,351022.0,Salary Increases & Fixed Expenses Increase,246367,62043.0,89833,151876.0,94491.0,38.35,-0.04,Low Risk
U996,2024,3,445513.0,Salary Increases & Fixed Expenses Increase,246367,62043.0,136975,199018.0,47349.0,19.22,0.03,Medium Risk
U996,2024,4,492862.0,Salary Increases & Fixed Expenses Increase,246367,62043.0,81741,143784.0,102583.0,41.64,0.04,Low Risk
U996,2024,5,595445.0,Salary Increases & Fixed Expenses Increase,246367,63376.0,122538,185914.0,60453.0,24.54,-0.05,Medium Risk
U996,2024,6,655898.0,Salary Increases & Fixed Expenses Increase,246367,63376.0,112215,175591.0,70776.0,28.73,0.01,Low Risk
U996,2024,7,726674.0,Salary Increases & Fixed Expenses Increase,262886,63376.0,113115,176491.0,86395.0,32.86,-0.03,Low Risk
U996,2024,8,813069.0,Salary Increases & Fixed Expenses Increase,262886,63376.0,100695,164071.0,98815.0,37.59,-0.05,Low Risk
U996,2024,9,911884.0,Salary Increases & Fixed Expenses Increase,262886,63376.0,104818,168194.0,94692.0,36.02,0.01,Low Risk
U996,2024,10,1006576.0,Salary Increases & Fixed Expenses Increase,262886,63376.0,140456,203832.0,59054.0,22.46,0.02,Medium Risk
U996,2024,11,1065630.0,Salary Increases & Fixed Expenses Increase,262886,63376.0,130691,194067.0,68819.0,26.18,0.03,Low Risk
U996,2024,12,1134449.0,Salary Increases & Fixed Expenses Increase,262886,63376.0,149488,212864.0,50022.0,19.03,-0.01,Medium Risk
U997,2024,1,250000.0,Salary Increases & Fixed Expenses Remain Stable,289922,77607.0,132723,210330.0,79592.0,27.45,-0.0,Low Risk
U997,2024,2,329592.0,Salary Increases & Fixed Expenses Remain Stable,289922,77607.0,119069,196676.0,93246.0,32.16,0.04,Low Risk
U997,2024,3,422838.0,Salary Increases & Fixed Expenses Remain Stable,289922,77607.0,117685,195292.0,94630.0,32.64,0.04,Low Risk
U997,2024,4,517468.0,Salary Increases & Fixed Expenses Remain Stable,289922,77607.0,121219,198826.0,91096.0,31.42,-0.03,Low Risk
U997,2024,5,608564.0,Salary Increases & Fixed Expenses Remain Stable,289922,77607.0,104528,182135.0,107787.0,37.18,-0.03,Low Risk
U997,2024,6,716351.0,Salary Increases & Fixed Expenses Remain Stable,289922,77607.0,105118,182725.0,107197.0,36.97,-0.01,Low Risk
U997,2024,7,823548.0,Salary Increases & Fixed Expenses Remain Stable,289922,77607.0,133964,211571.0,78351.0,27.02,0.04,Low Risk
U997,2024,8,901899.0,Salary Increases & Fixed Expenses Remain Stable,318192,77607.0,143799,221406.0,96786.0,30.42,-0.02,Low Risk
U997,2024,9,998685.0,Salary Increases & Fixed Expenses Remain Stable,318192,77607.0,102661,180268.0,137924.0,43.35,-0.05,Low Risk
U997,2024,10,1136609.0,Salary Increases & Fixed Expenses Remain Stable,318192,77607.0,113445,191052.0,127140.0,39.96,-0.04,Low Risk
U997,2024,11,1263749.0,Salary Increases & Fixed Expenses Remain Stable,318192,77607.0,112844,190451.0,127741.0,40.15,-0.01,Low Risk
U997,2024,12,1391490.0,Salary Increases & Fixed Expenses Remain Stable,318192,77607.0,158650,236257.0,81935.0,25.75,-0.01,Low Risk
U998,2024,1,124814.0,Salary Increases & Fixed Expenses Increase,110449,58147.0,42067,100214.0,10235.0,9.27,0.01,High Risk
U998,2024,2,135049.0,Salary Increases & Fixed Expenses Increase,110449,58147.0,48924,107071.0,3378.0,3.06,-0.01,High Risk
U998,2024,3,138427.0,Salary Increases & Fixed Expenses Increase,110449,59553.0,45702,105255.0,5194.0,4.7,-0.0,High Risk
U998,2024,4,143621.0,Salary Increases & Fixed Expenses Increase,110449,61077.0,34808,95885.0,14564.0,13.19,-0.02,High Risk
U998,2024,5,158185.0,Salary Increases & Fixed Expenses Increase,110449,61077.0,52604,113681.0,-3232.0,-2.93,0.0,High Risk
U998,2024,6,154953.0,Salary Increases & Fixed Expenses Increase,110449,61077.0,46269,107346.0,3103.0,2.81,-0.02,High Risk
U998,2024,7,158056.0,Salary Increases & Fixed Expenses Increase,130259,61077.0,61318,122395.0,7864.0,6.04,-0.03,High Risk
U998,2024,8,165920.0,Salary Increases & Fixed Expenses Increase,130259,61077.0,60422,121499.0,8760.0,6.73,-0.02,High Risk
U998,2024,9,174680.0,Salary Increases & Fixed Expenses Increase,130259,61077.0,58541,119618.0,10641.0,8.17,0.04,High Risk
U998,2024,10,185321.0,Salary Increases & Fixed Expenses Increase,130259,61077.0,46785,107862.0,22397.0,17.19,0.02,Medium Risk
U998,2024,11,207718.0,Salary Increases & Fixed Expenses Increase,130259,61077.0,48107,109184.0,21075.0,16.18,0.04,Medium Risk
U998,2024,12,228793.0,Salary Increases & Fixed Expenses Increase,130259,62347.0,49775,112122.0,18137.0,13.92,-0.02,High Risk
U999,2024,1,93946.0,Stable Salary & Stable Fixed Expenses,53672,23558.0,26357,49915.0,3757.0,7.0,-0.01,High Risk
U999,2024,2,97703.0,Stable Salary & Stable Fixed Expenses,53672,23558.0,26543,50101.0,3571.0,6.65,0.03,High Risk
U999,2024,3,101274.0,Stable Salary & Stable Fixed Expenses,53672,23558.0,23444,47002.0,6670.0,12.43,-0.03,High Risk
U999,2024,4,107944.0,Stable Salary & Stable Fixed Expenses,53672,23558.0,20596,44154.0,9518.0,17.73,0.02,Medium Risk
U999,2024,5,117462.0,Stable Salary & Stable Fixed Expenses,53672,23558.0,25984,49542.0,4130.0,7.69,0.0,High Risk
U999,2024,6,121592.0,Stable Salary & Stable Fixed Expenses,53672,23558.0,17922,41480.0,12192.0,22.72,-0.0,Medium Risk
U999,2024,7,133784.0,Stable Salary & Stable Fixed Expenses,53672,23558.0,16491,40049.0,13623.0,25.38,-0.03,Low Risk
U999,2024,8,147407.0,Stable Salary & Stable Fixed Expenses,53672,23558.0,24781,48339.0,5333.0,9.94,-0.05,High Risk
U999,2024,9,152740.0,Stable Salary & Stable Fixed Expenses,53672,23558.0,25373,48931.0,4741.0,8.83,-0.03,High Risk
U999,2024,10,157481.0,Stable Salary & Stable Fixed Expenses,53672,23558.0,29842,53400.0,272.0,0.51,-0.02,High Risk
U999,2024,11,157753.0,Stable Salary & Stable Fixed Expenses,53672,23558.0,24445,48003.0,5669.0,10.56,0.03,High Risk
U999,2024,12,163422.0,Stable Salary & Stable Fixed Expenses,53672,23558.0,29872,53430.0,242.0,0.45,0.01,High Risk
U1000,2024,1,166352.0,Salary Increases & Fixed Expenses Increase,96242,27899.0,45172,73071.0,23171.0,24.08,-0.02,Medium Risk
U1000,2024,2,189523.0,Salary Increases & Fixed Expenses Increase,96242,29151.0,46842,75993.0,20249.0,21.04,-0.05,Medium Risk
U1000,2024,3,209772.0,Salary Increases & Fixed Expenses Increase,96242,29151.0,59722,88873.0,7369.0,7.66,0.02,High Risk
U1000,2024,4,217141.0,Salary Increases & Fixed Expenses Increase,122618,30510.0,39136,69646.0,52972.0,43.2,0.01,Low Risk
U1000,2024,5,270113.0,Salary Increases & Fixed Expenses Increase,122618,30510.0,54762,85272.0,37346.0,30.46,0.03,Low Risk
U1000,2024,6,307459.0,Salary Increases & Fixed Expenses Increase,122618,30510.0,41866,72376.0,50242.0,40.97,0.02,Low Risk
U1000,2024,7,357701.0,Salary Increases & Fixed Expenses Increase,122618,30510.0,45166,75676.0,46942.0,38.28,-0.04,Low Risk
U1000,2024,8,404643.0,Salary Increases & Fixed Expenses Increase,122618,31777.0,47966,79743.0,42875.0,34.97,-0.04,Low Risk
U1000,2024,9,447518.0,Salary Increases & Fixed Expenses Increase,122618,31777.0,53584,85361.0,37257.0,30.38,0.01,Low Risk
U1000,2024,10,484775.0,Salary Increases & Fixed Expenses Increase,122618,31777.0,54815,86592.0,36026.0,29.38,0.03,Low Risk
U1000,2024,11,520801.0,Salary Increases & Fixed Expenses Increase,122618,31777.0,45467,77244.0,45374.0,37.0,0.03,Low Risk
U1000,2024,12,566175.0,Salary Increases & Fixed Expenses Increase,122618,31777.0,54964,86741.0,35877.0,29.26,-0.01,Low Risk
